Codmundv_A;nomemun_A;Codmundv_B;nomemun_B;VAR01;VAR02;VAR03;VAR04
3304557;Rio de Janeiro;3550308;São Paulo;2422;4582;7004;355
3550308;São Paulo;4314902;Porto Alegre;742;2240;2982;827
3550308;São Paulo;5300108;Brasília;683;2022;2705;879
3509502;Campinas;3550308;São Paulo;978;1458;2436;93
3106200;Belo Horizonte;3550308;São Paulo;814;1466;2280;495
3505708;Barueri;3550308;São Paulo;770;1492;2262;28
3550308;São Paulo;4106902;Curitiba;863;1371;2234;330
3534401;Osasco;3550308;São Paulo;549;1427;1976;19
3518800;Guarulhos;3550308;São Paulo;820;1103;1923;26
3548708;São Bernardo do Campo;3550308;São Paulo;561;952;1513;10
3548500;Santos;3550308;São Paulo;591;777;1368;41
3547809;Santo André;3550308;São Paulo;530;794;1324;12
2927408;Salvador;3550308;São Paulo;483;819;1302;1430
3106200;Belo Horizonte;3118601;Contagem;490;682;1172;11
2611606;Recife;3550308;São Paulo;469;691;1160;2066
3304557;Rio de Janeiro;5300108;Brasília;258;863;1121;934
3548807;São Caetano do Sul;3550308;São Paulo;386;702;1088;10
3543402;Ribeirão Preto;3550308;São Paulo;429;599;1028;300
3303302;Niterói;3304557;Rio de Janeiro;399;607;1006;17
3106200;Belo Horizonte;3304557;Rio de Janeiro;350;579;929;338
3549904;São José dos Campos;3550308;São Paulo;370;553;923;93
3550308;São Paulo;5208707;Goiânia;359;557;916;822
1302603;Manaus;3550308;São Paulo;370;520;890;2619
2304400;Fortaleza;3550308;São Paulo;337;532;869;2337
3301702;Duque de Caxias;3304557;Rio de Janeiro;335;519;854;14
5208707;Goiânia;5300108;Brasília;282;504;786;176
3547304;Santana de Parnaíba;3550308;São Paulo;372;413;785;36
3525904;Jundiaí;3550308;São Paulo;277;458;735;58
5201405;Aparecida de Goiânia;5208707;Goiânia;309;420;729;13
3550308;São Paulo;3552205;Sorocaba;289;420;709;89
3304557;Rio de Janeiro;3505708;Barueri;204;499;703;375
3304557;Rio de Janeiro;4314902;Porto Alegre;195;490;685;1087
2607901;Jaboatão dos Guararapes;2611606;Recife;281;402;683;11
4304606;Canoas;4314902;Porto Alegre;281;401;682;16
2919207;Lauro de Freitas;2927408;Salvador;293;385;678;20
4205407;Florianópolis;4216602;São José;305;362;667;17
4106902;Curitiba;4125506;São José dos Pinhais;293;342;635;16
2927408;Salvador;3304557;Rio de Janeiro;243;390;633;1194
3549805;São José do Rio Preto;3550308;São Paulo;270;360;630;418
3513009;Cotia;3550308;São Paulo;263;356;619;28
3205309;Vitória;3550308;São Paulo;264;341;605;742
4106902;Curitiba;4314902;Porto Alegre;218;357;575;543
3205200;Vila Velha;3205309;Vitória;240;328;568;12
4305108;Caxias do Sul;4314902;Porto Alegre;251;314;565;99
3550308;São Paulo;5002704;Campo Grande;240;322;562;917
3550308;São Paulo;4113700;Londrina;221;340;561;463
3550308;São Paulo;4205407;Florianópolis;231;296;527;473
3550308;São Paulo;4208203;Itajaí;253;272;525;418
3506003;Bauru;3550308;São Paulo;233;284;517;286
3513801;Diadema;3550308;São Paulo;220;289;509;5
3304557;Rio de Janeiro;4106902;Curitiba;190;312;502;664
3302403;Macaé;3304557;Rio de Janeiro;217;283;500;151
3530607;Moji das Cruzes;3550308;São Paulo;216;283;499;48
3304557;Rio de Janeiro;3305109;São João de Meriti;159;340;499;15
3205002;Serra;3205309;Vitória;212;285;497;13
3170206;Uberlândia;3550308;São Paulo;202;284;486;551
3106200;Belo Horizonte;5300108;Brasília;132;351;483;623
3303500;Nova Iguaçu;3304557;Rio de Janeiro;201;275;476;26
3550308;São Paulo;3552809;Taboão da Serra;198;276;474;14
3521903;Itajobi;3545605;Santa Adélia;1;455;456;27
2304400;Fortaleza;2611606;Recife;175;269;444;623
5103403;Cuiabá;5108402;Várzea Grande;182;261;443;13
2304400;Fortaleza;2307650;Maracanaú;191;251;442;15
4313409;Novo Hamburgo;4314902;Porto Alegre;190;247;437;41
2611606;Recife;3304557;Rio de Janeiro;172;261;433;1828
3550308;São Paulo;5103403;Cuiabá;191;236;427;1371
3205309;Vitória;3304557;Rio de Janeiro;183;244;427;419
1500800;Ananindeua;1501402;Belém;174;247;421;7
2910800;Feira de Santana;2927408;Salvador;170;249;419;94
3550308;São Paulo;4202404;Blumenau;165;246;411;436
3205002;Serra;3550308;São Paulo;188;220;408;749
3550308;São Paulo;4209102;Joinville;184;224;408;364
3538709;Piracicaba;3550308;São Paulo;175;225;400;142
3550308;São Paulo;4115200;Maringá;172;227;399;540
3118601;Contagem;3550308;São Paulo;167;231;398;488
3304557;Rio de Janeiro;3304904;São Gonçalo;162;229;391;23
3304557;Rio de Janeiro;3534401;Osasco;62;328;390;367
3547809;Santo André;3548708;São Bernardo do Campo;174;211;385;9
2403251;Parnamirim;2408102;Natal;148;226;374;11
3550308;São Paulo;4305108;Caxias do Sul;155;217;372;746
1501402;Belém;3550308;São Paulo;148;224;372;2470
4106902;Curitiba;4113700;Londrina;155;214;369;305
3303302;Niterói;3304904;São Gonçalo;155;211;366;11
4106902;Curitiba;4209102;Joinville;158;204;362;103
3304557;Rio de Janeiro;3518800;Guarulhos;156;204;360;342
2609600;Olinda;2611606;Recife;149;202;351;14
4113700;Londrina;4115200;Maringá;154;192;346;81
2304400;Fortaleza;3304557;Rio de Janeiro;128;212;340;2164
4106902;Curitiba;4115200;Maringá;141;184;325;351
3106200;Belo Horizonte;3106705;Betim;141;178;319;23
4314902;Porto Alegre;5300108;Brasília;55;262;317;1619
2408102;Natal;3550308;São Paulo;124;192;316;2265
2611606;Recife;2927408;Salvador;132;179;311;659
3529401;Mauá;3550308;São Paulo;140;169;309;19
4106902;Curitiba;5300108;Brasília;58;250;308;1076
2111300;São Luís;3550308;São Paulo;126;178;304;2348
3301702;Duque de Caxias;3550308;São Paulo;124;178;302;353
1302603;Manaus;3304557;Rio de Janeiro;129;171;300;2738
3550308;São Paulo;3554102;Taubaté;121;177;298;132
3518701;Guarujá;3550308;São Paulo;118;180;298;51
3303302;Niterói;3550308;São Paulo;106;190;296;371
4314902;Porto Alegre;4318705;São Leopoldo;115;179;294;33
2504009;Campina Grande;2507507;João Pessoa;131;160;291;115
3541406;Presidente Prudente;3550308;São Paulo;123;167;290;510
4106902;Curitiba;4119905;Ponta Grossa;124;164;288;95
3550308;São Paulo;3552502;Suzano;129;155;284;37
2507507;João Pessoa;2611606;Recife;112;168;280;103
2927408;Salvador;5300108;Brasília;53;226;279;1053
2704302;Maceió;3550308;São Paulo;122;156;278;1884
4303103;Cachoeirinha;4314902;Porto Alegre;120;158;278;14
3303906;Petrópolis;3304557;Rio de Janeiro;112;164;276;39
3548906;São Carlos;3550308;São Paulo;121;154;275;220
3304557;Rio de Janeiro;3509502;Campinas;116;159;275;389
4105508;Cianorte;4115200;Maringá;125;148;273;73
4106902;Curitiba;4119152;Pinhais;129;143;272;10
4105805;Colombo;4106902;Curitiba;116;153;269;21
4202008;Balneário Camboriú;4208203;Itajaí;127;138;265;9
5201108;Anápolis;5208707;Goiânia;116;149;265;55
4309209;Gravataí;4314902;Porto Alegre;116;147;263;24
2304400;Fortaleza;2408102;Natal;104;155;259;429
4211900;Palhoça;4216602;São José;117;137;254;9
3541000;Praia Grande;3550308;São Paulo;99;155;254;47
3201308;Cariacica;3205309;Vitória;110;142;252;14
3304557;Rio de Janeiro;3305505;Saquarema;114;137;251;82
4205407;Florianópolis;4314902;Porto Alegre;101;150;251;374
3548500;Santos;3551009;São Vicente;115;135;250;12
2304400;Fortaleza;2307304;Juazeiro do Norte;101;146;247;392
3170107;Uberaba;3170206;Uberlândia;116;129;245;100
3501608;Americana;3550308;São Paulo;108;137;245;123
2408003;Mossoró;2408102;Natal;110;134;244;243
2304400;Fortaleza;5300108;Brasília;55;189;244;1656
4314407;Pelotas;4314902;Porto Alegre;96;146;242;218
2604106;Caruaru;2611606;Recife;105;136;241;119
3550308;São Paulo;4125506;São José dos Pinhais;112;127;239;328
3539806;Poá;3550308;São Paulo;111;128;239;34
4314407;Pelotas;4315602;Rio Grande;111;127;238;43
3520509;Indaiatuba;3550308;São Paulo;109;129;238;86
2800308;Aracaju;3550308;São Paulo;100;137;237;1697
2611101;Petrolina;2918407;Juazeiro;114;122;236;19
4205407;Florianópolis;4211900;Palhoça;102;131;233;23
2211001;Teresina;2304400;Fortaleza;100;132;232;495
2408102;Natal;2611606;Recife;99;133;232;258
4313409;Novo Hamburgo;4318705;São Leopoldo;104;127;231;8
2303709;Caucaia;2304400;Fortaleza;102;129;231;16
4202404;Blumenau;4209102;Joinville;99;130;229;77
3515004;Embu;3550308;São Paulo;105;121;226;20
2611606;Recife;2704302;Maceió;91;135;226;190
3505708;Barueri;5300108;Brasília;63;163;226;860
3550308;São Paulo;3551009;São Vicente;98;127;225;39
3106200;Belo Horizonte;3157807;Santa Luzia;95;130;225;20
4106902;Curitiba;4205407;Florianópolis;96;124;220;251
5002704;Campo Grande;5103403;Cuiabá;93;127;220;562
2611606;Recife;5300108;Brasília;50;170;220;1613
3516200;Franca;3550308;São Paulo;79;139;218;353
4314902;Porto Alegre;4323002;Viamão;96;121;217;18
3304557;Rio de Janeiro;3548500;Santos;96;121;217;333
2905701;Camaçari;2927408;Salvador;102;113;215;36
4101804;Araucária;4106902;Curitiba;97;118;215;20
5103403;Cuiabá;5107602;Rondonópolis;94;121;215;180
4106902;Curitiba;4118204;Paranaguá;102;112;214;76
2304400;Fortaleza;2927408;Salvador;82;132;214;1020
2607901;Jaboatão dos Guararapes;3550308;São Paulo;100;113;213;2061
3106200;Belo Horizonte;3205309;Vitória;99;113;212;385
3550308;São Paulo;4304606;Canoas;96;116;212;814
3106200;Belo Horizonte;3170206;Uberlândia;96;116;212;466
3526902;Limeira;3550308;São Paulo;95;117;212;142
3205200;Vila Velha;3550308;São Paulo;90;122;212;732
3205002;Serra;3304557;Rio de Janeiro;99;110;209;428
4205407;Florianópolis;4209102;Joinville;80;127;207;149
4305108;Caxias do Sul;4307906;Farroupilha;91;115;206;18
3205002;Serra;3205200;Vila Velha;87;119;206;24
4304630;Capão da Canoa;4314902;Porto Alegre;98;107;205;116
3505708;Barueri;3534401;Osasco;78;126;204;9
3529005;Marília;3550308;São Paulo;96;107;203;370
3523107;Itaquaquecetuba;3550308;São Paulo;99;103;202;36
2700300;Arapiraca;2704302;Maceió;93;108;201;105
5002704;Campo Grande;5003702;Dourados;90;111;201;200
3304557;Rio de Janeiro;5208707;Goiânia;87;114;201;947
4104808;Cascavel;4106902;Curitiba;87;114;201;422
4314902;Porto Alegre;4316907;Santa Maria;80;120;200;257
3106200;Belo Horizonte;4106902;Curitiba;68;131;199;806
4300604;Alvorada;4314902;Porto Alegre;92;106;198;13
1501402;Belém;3304557;Rio de Janeiro;85;113;198;2432
2507507;João Pessoa;3550308;São Paulo;84;114;198;2156
3502804;Araçatuba;3550308;São Paulo;94;103;197;470
3550308;São Paulo;4313409;Novo Hamburgo;81;115;196;791
3541000;Praia Grande;3548500;Santos;89;106;195;13
2111300;São Luís;2304400;Fortaleza;81;114;195;647
3106200;Belo Horizonte;3144805;Nova Lima;86;108;194;18
3524006;Itupeva;3550308;São Paulo;90;102;192;69
3136702;Juiz de Fora;3304557;Rio de Janeiro;79;113;192;125
3523909;Itu;3550308;São Paulo;89;102;191;78
3106200;Belo Horizonte;4314902;Porto Alegre;62;128;190;1308
3505708;Barueri;4106902;Curitiba;73;116;189;322
1100205;Porto Velho;3550308;São Paulo;85;103;188;2358
3504107;Atibaia;3550308;São Paulo;86;100;186;60
3136702;Juiz de Fora;3550308;São Paulo;83;103;186;396
3510609;Carapicuíba;3550308;São Paulo;83;103;186;24
4106902;Curitiba;4202404;Blumenau;80;106;186;169
4314902;Porto Alegre;4315602;Rio Grande;78;107;185;243
3170107;Uberaba;3550308;São Paulo;75;110;185;451
3503208;Araraquara;3550308;São Paulo;82;102;184;258
3524402;Jacareí;3550308;São Paulo;74;110;184;81
3550308;São Paulo;4119905;Ponta Grossa;82;101;183;387
3538105;Pindorama;3545605;Santa Adélia;2;181;183;12
3106200;Belo Horizonte;3167202;Sete Lagoas;87;95;182;58
3300407;Barra Mansa;3306305;Volta Redonda;86;96;182;11
4104808;Cascavel;4108304;Foz do Iguaçu;85;97;182;122
3106200;Belo Horizonte;3136702;Juiz de Fora;84;98;182;216
3106200;Belo Horizonte;3154606;Ribeirão das Neves;71;111;182;19
3201308;Cariacica;3205200;Vila Velha;84;97;181;12
3304557;Rio de Janeiro;3306305;Volta Redonda;83;98;181;96
4204608;Criciúma;4218707;Tubarão;86;94;180;39
2800308;Aracaju;2927408;Salvador;84;96;180;276
2903201;Barreiras;2919553;Luís Eduardo magalhães;83;97;180;92
3509502;Campinas;3525904;Jundiaí;80;100;180;35
1302603;Manaus;1501402;Belém;78;102;180;1305
3543402;Ribeirão Preto;3549805;São José do Rio Preto;83;96;179;171
3505708;Barueri;4314902;Porto Alegre;69;110;179;830
2105302;Imperatriz;2111300;São Luís;65;114;179;486
3106200;Belo Horizonte;3505708;Barueri;63;116;179;495
2304400;Fortaleza;2312908;Sobral;82;96;178;203
4314100;Passo Fundo;4314902;Porto Alegre;72;106;178;230
2800308;Aracaju;2804805;Nossa Senhora do Socorro;65;112;177;6
3505708;Barueri;3509502;Campinas;73;103;176;70
1100205;Porto Velho;1302603;Manaus;73;103;176;759
3304557;Rio de Janeiro;3548807;São Caetano do Sul;31;145;176;346
3304557;Rio de Janeiro;4205407;Florianópolis;81;94;175;729
3543402;Ribeirão Preto;3551702;Sertãozinho;77;97;174;20
3529401;Mauá;3547809;Santo André;84;89;173;8
3201308;Cariacica;3550308;São Paulo;80;93;173;730
2604106;Caruaru;2612505;Santa Cruz do Capibaribe;78;95;173;43
3522505;Itapevi;3550308;São Paulo;80;92;172;32
3528858;Marapoama;3556008;Urupês;2;169;171;18
4208906;Jaraguá do Sul;4209102;Joinville;80;89;169;31
3106705;Betim;3118601;Contagem;77;92;169;12
3524402;Jacareí;3549904;São José dos Campos;69;100;169;15
3513504;Cubatão;3550308;São Paulo;79;89;168;35
4202404;Blumenau;4205407;Florianópolis;76;92;168;90
3507605;Bragança Paulista;3550308;São Paulo;73;95;168;79
3549904;São José dos Campos;3554102;Taubaté;80;87;167;38
3302403;Macaé;3550308;São Paulo;76;91;167;504
2913606;Ilhéus;2914802;Itabuna;80;86;166;17
3302007;Itaguaí;3304557;Rio de Janeiro;79;87;166;57
3501608;Americana;3545803;Santa Bárbara d'Oeste;74;92;166;8
4104204;Campo Largo;4106902;Curitiba;74;91;165;24
3509502;Campinas;5300108;Brasília;29;136;165;791
3304300;Rio Bonito;3304557;Rio de Janeiro;81;83;164;68
1721000;Palmas;3550308;São Paulo;75;89;164;1481
3547809;Santo André;3548807;São Caetano do Sul;72;92;164;5
2408102;Natal;2507507;João Pessoa;65;98;163;158
3511102;Catanduva;3552601;Tabapuã;4;159;163;21
3119401;Coronel Fabriciano;3131307;Ipatinga;74;88;162;10
4202404;Blumenau;4202909;Brusque;76;84;160;23
3550308;São Paulo;4216602;São José;74;86;160;478
3301009;Campos dos Goytacazes;3304557;Rio de Janeiro;68;92;160;232
5002704;Campo Grande;5300108;Brasília;39;121;160;891
3543907;Rio Claro;3550308;São Paulo;73;86;159;166
2111300;São Luís;2211001;Teresina;70;89;159;325
3535002;Palestina;3545605;Santa Adélia;1;158;159;118
3550308;São Paulo;5201405;Aparecida de Goiânia;68;90;158;809
5103403;Cuiabá;5300108;Brasília;45;113;158;876
1302603;Manaus;5300108;Brasília;29;129;158;1893
1600303;Macapá;1600600;Santana;77;80;157;13
2408102;Natal;3304557;Rio de Janeiro;67;90;157;2046
1501402;Belém;2304400;Fortaleza;52;105;157;1129
3509502;Campinas;3543402;Ribeirão Preto;71;85;156;208
2304285;Eusébio;2304400;Fortaleza;68;88;156;17
3534401;Osasco;4106902;Curitiba;38;118;156;327
2602902;Cabo de Santo Agostinho;2611606;Recife;72;83;155;20
2905701;Camaçari;3550308;São Paulo;66;89;155;1465
3205200;Vila Velha;3304557;Rio de Janeiro;70;84;154;407
1302603;Manaus;1400100;Boa Vista;68;86;154;666
2304202;Crato;2307304;Juazeiro do Norte;71;82;153;11
2211001;Teresina;3550308;São Paulo;68;85;153;2087
2927408;Salvador;2930709;Simões Filho;68;85;153;24
1501402;Belém;2111300;São Luís;40;113;153;484
3106200;Belo Horizonte;3122306;Divinópolis;73;77;150;99
3550308;São Paulo;4104808;Cascavel;68;82;150;699
3516200;Franca;3543402;Ribeirão Preto;67;82;149;79
3550308;São Paulo;5201108;Anápolis;65;83;148;850
4202404;Blumenau;4207502;Indaial;71;76;147;16
4303103;Cachoeirinha;4309209;Gravataí;70;77;147;12
3550308;São Paulo;4118204;Paranaguá;70;76;146;286
3106200;Belo Horizonte;3143302;Montes Claros;70;76;146;351
3518701;Guarujá;3548500;Santos;69;77;146;10
3106705;Betim;3550308;São Paulo;66;80;146;478
3513801;Diadema;3548708;São Bernardo do Campo;66;80;146;5
4103701;Cambé;4113700;Londrina;63;83;146;12
3543303;Ribeirão Pires;3550308;São Paulo;60;86;146;23
4104808;Cascavel;4127700;Toledo;69;76;145;39
3509205;Cajamar;3550308;São Paulo;67;78;145;40
2111300;São Luís;3304557;Rio de Janeiro;64;81;145;2253
3106200;Belo Horizonte;3131307;Ipatinga;69;75;144;158
2610707;Paulista;2611606;Recife;66;78;144;22
1501402;Belém;1600303;Macapá;61;83;144;337
2112209;Timon;2211001;Teresina;68;75;143;8
3522208;Itapecerica da Serra;3550308;São Paulo;65;76;141;21
4202008;Balneário Camboriú;4202404;Blumenau;66;74;140;39
3536505;Paulínia;3550308;São Paulo;64;75;139;111
3507506;Botucatu;3550308;São Paulo;61;78;139;201
3303500;Nova Iguaçu;3550308;São Paulo;56;83;139;338
3106200;Belo Horizonte;3534401;Osasco;27;112;139;492
3534401;Osasco;5300108;Brasília;23;116;139;864
3509502;Campinas;3520509;Indaiatuba;67;71;138;29
2910800;Feira de Santana;3550308;São Paulo;58;80;138;1469
4302105;Bento Gonçalves;4305108;Caxias do Sul;66;71;137;33
1501402;Belém;1502400;Castanhal;63;74;137;59
3503208;Araraquara;3548906;São Carlos;51;86;137;39
2919207;Lauro de Freitas;3550308;São Paulo;64;72;136;1448
3501608;Americana;3509502;Campinas;58;78;136;34
2800308;Aracaju;3304557;Rio de Janeiro;53;83;136;1462
3530607;Moji das Cruzes;3552502;Suzano;63;72;135;12
3304557;Rio de Janeiro;3543402;Ribeirão Preto;57;78;135;511
5201405;Aparecida de Goiânia;5300108;Brasília;53;82;135;182
3103504;Araguari;3170206;Uberlândia;65;69;134;29
4304408;Canela;4309100;Gramado;62;72;134;12
3548708;São Bernardo do Campo;3548807;São Caetano do Sul;58;76;134;12
3509502;Campinas;3534401;Osasco;38;96;134;75
4309100;Gramado;4314902;Porto Alegre;62;71;133;78
3304557;Rio de Janeiro;3306008;Três Rios;62;70;132;90
3509502;Campinas;3556206;Valinhos;61;71;132;10
3522307;Itapetininga;3550308;São Paulo;58;74;132;143
3304557;Rio de Janeiro;3548708;São Bernardo do Campo;56;76;132;350
2927408;Salvador;2933307;Vitória da Conquista;47;84;131;328
3509502;Campinas;4314902;Porto Alegre;36;95;131;882
4314902;Porto Alegre;4323804;Xangri-lá;63;67;130;113
5103403;Cuiabá;5107909;Sinop;62;68;130;414
3301009;Campos dos Goytacazes;3302403;Macaé;62;68;130;86
3304557;Rio de Janeiro;3549904;São José dos Campos;49;81;130;270
4106902;Curitiba;4208203;Itajaí;62;67;129;175
1100122;Ji-Paraná;1100205;Porto Velho;60;69;129;322
4216602;São José;4314902;Porto Alegre;59;70;129;364
2304400;Fortaleza;2507507;João Pessoa;45;83;128;555
3304557;Rio de Janeiro;5002704;Campo Grande;58;69;127;1230
3530706;Mogi Guaçu;3530805;Moji-Mirim;58;69;127;12
2704302;Maceió;2800308;Aracaju;52;75;127;202
3170206;Uberlândia;5300108;Brasília;42;85;127;344
3303203;Nilópolis;3304557;Rio de Janeiro;54;72;126;19
1501402;Belém;5300108;Brasília;24;102;126;1597
4202404;Blumenau;4208203;Itajaí;59;66;125;32
3306305;Volta Redonda;3550308;São Paulo;58;67;125;289
3503901;Arujá;3550308;São Paulo;52;73;125;44
4202008;Balneário Camboriú;4208302;Itapema;59;64;123;12
3552205;Sorocaba;3557006;Votorantim;56;67;123;12
3304904;São Gonçalo;3550308;São Paulo;42;81;123;377
3534401;Osasco;4314902;Porto Alegre;28;95;123;832
4104808;Cascavel;4115200;Maringá;58;64;122;230
3545803;Santa Bárbara d'Oeste;3550308;São Paulo;57;65;122;126
3170206;Uberlândia;3304557;Rio de Janeiro;56;66;122;671
2607208;Ipojuca;2611606;Recife;56;66;122;34
3118601;Contagem;3304557;Rio de Janeiro;50;72;122;339
1721000;Palmas;5300108;Brasília;43;79;122;605
2111300;São Luís;5300108;Brasília;22;100;122;1519
3106200;Belo Horizonte;5208707;Goiânia;57;64;121;672
2927408;Salvador;3106200;Belo Horizonte;55;66;121;951
3304557;Rio de Janeiro;5103403;Cuiabá;54;67;121;1623
2304400;Fortaleza;2408003;Mossoró;56;64;120;205
4204608;Criciúma;4207007;Içara;55;64;119;11
1100205;Porto Velho;1200401;Rio Branco;57;61;118;452
4101507;Arapongas;4113700;Londrina;56;62;118;32
3550308;São Paulo;4108304;Foz do Iguaçu;54;64;118;810
3148004;Patos de Minas;3170206;Uberlândia;54;64;118;189
3509502;Campinas;4106902;Curitiba;51;67;118;358
2704302;Maceió;3304557;Rio de Janeiro;47;71;118;1643
5221858;Valparaíso de Goiás;5300108;Brasília;55;62;117;29
3505708;Barueri;3547304;Santana de Parnaíba;55;62;117;9
3550308;São Paulo;3552403;Sumaré;54;63;117;112
3550308;São Paulo;3556206;Valinhos;52;65;117;83
4314902;Porto Alegre;4316808;Santa Cruz do Sul;47;70;117;124
3304557;Rio de Janeiro;4113700;Londrina;39;78;117;807
5212501;Luziânia;5300108;Brasília;55;61;116;50
4202008;Balneário Camboriú;4205407;Florianópolis;55;61;116;69
4106902;Curitiba;4107652;Fazenda Rio Grande;55;61;116;25
3550308;São Paulo;5008305;Três Lagoas;53;63;116;623
3170701;Varginha;3550308;São Paulo;54;61;115;269
4115200;Maringá;4126256;Sarandi;52;63;115;6
5103403;Cuiabá;5208707;Goiânia;51;64;115;736
1100106;Guajará-Mirim;1100205;Porto Velho;56;57;113;272
3550308;São Paulo;3556701;Vinhedo;53;60;113;77
3303401;Nova Friburgo;3304557;Rio de Janeiro;53;60;113;96
3304557;Rio de Janeiro;3305802;Teresópolis;50;63;113;57
4209102;Joinville;4314902;Porto Alegre;41;72;113;473
3543402;Ribeirão Preto;5300108;Brasília;25;88;113;592
3127701;Governador Valadares;3131307;Ipatinga;54;58;112;94
3509502;Campinas;3538709;Piracicaba;51;61;112;63
3538006;Pindamonhangaba;3550308;São Paulo;50;62;112;145
2211001;Teresina;5300108;Brasília;18;94;112;1302
5208707;Goiânia;5218805;Rio Verde;53;58;111;213
3509502;Campinas;3548500;Santos;53;58;111;132
3509502;Campinas;3518800;Guarulhos;52;59;111;78
3502804;Araçatuba;3506508;Birigui;52;59;111;15
5208707;Goiânia;5221403;Trindade;45;66;111;24
3151800;Poços de Caldas;3550308;São Paulo;45;66;111;209
3205309;Vitória;5300108;Brasília;27;84;111;961
2927408;Salvador;3534401;Osasco;24;87;111;1428
1721000;Palmas;5208707;Goiânia;53;57;110;707
3515707;Ferraz de Vasconcelos;3550308;São Paulo;52;58;110;31
3518404;Guaratinguetá;3550308;São Paulo;50;60;110;177
3300704;Cabo Frio;3304557;Rio de Janeiro;50;60;110;122
3510500;Caraguatatuba;3550308;São Paulo;48;62;110;122
3106200;Belo Horizonte;3156700;Sabará;48;62;110;17
3509007;Caieiras;3550308;São Paulo;40;70;110;33
4205407;Florianópolis;5300108;Brasília;23;87;110;1306
2603454;Camaragibe;2611606;Recife;50;59;109;14
3301009;Campos dos Goytacazes;3550308;São Paulo;49;60;109;578
3504107;Atibaia;3507605;Bragança Paulista;53;55;108;19
3509502;Campinas;3552403;Sumaré;50;58;108;23
3303906;Petrópolis;3550308;São Paulo;42;66;108;370
5201108;Anápolis;5300108;Brasília;39;69;108;124
3503703;Ariranha;3545605;Santa Adélia;3;105;108;6
3170206;Uberlândia;5208707;Goiânia;51;56;107;268
4109807;Ibiporã;4113700;Londrina;50;57;107;11
3131307;Ipatinga;3168705;Timóteo;51;55;106;16
4314902;Porto Alegre;4321600;Tramandaí;50;56;106;101
3201308;Cariacica;3205002;Serra;47;59;106;20
4204608;Criciúma;4205407;Florianópolis;42;64;106;147
2611606;Recife;4314902;Porto Alegre;32;74;106;2838
2804805;Nossa Senhora do Socorro;2925808;Queimadas;1;105;106;270
4215000;Rio Negrinho;4215802;São Bento do Sul;50;55;105;14
3170206;Uberlândia;3543402;Ribeirão Preto;47;58;105;254
2408102;Natal;5300108;Brasília;17;88;105;1732
3205309;Vitória;4208203;Itajaí;51;53;104;1103
5103403;Cuiabá;5107958;Tangará da Serra;49;55;104;182
3304557;Rio de Janeiro;3547809;Santo André;43;61;104;343
4106902;Curitiba;4216602;São José;47;56;103;245
3300100;Angra dos Reis;3304557;Rio de Janeiro;47;56;103;105
2304400;Fortaleza;2307700;Maranguape;46;57;103;21
3518800;Guarulhos;4314902;Porto Alegre;42;61;103;852
4202404;Blumenau;4314902;Porto Alegre;41;62;103;399
3509502;Campinas;3519071;Hortolândia;50;52;102;17
3550308;São Paulo;4101804;Araucária;49;53;102;348
4106902;Curitiba;4108304;Foz do Iguaçu;47;55;102;523
2611101;Petrolina;2611606;Recife;47;55;102;632
2611606;Recife;2800308;Aracaju;46;56;102;386
4304606;Canoas;4313409;Novo Hamburgo;45;57;102;25
3550308;São Paulo;4204202;Chapecó;48;53;101;698
4311403;Lajeado;4316808;Santa Cruz do Sul;47;54;101;50
3523404;Itatiba;3550308;São Paulo;46;55;101;74
3501608;Americana;3538709;Piracicaba;45;56;101;32
3503307;Araras;3550308;São Paulo;48;52;100;161
2611606;Recife;3505708;Barueri;38;62;100;2066
4307005;Erechim;4314100;Passo Fundo;48;51;99;70
3550308;São Paulo;4318705;São Leopoldo;47;52;99;798
4302105;Bento Gonçalves;4314902;Porto Alegre;47;52;99;103
3301702;Duque de Caxias;3303906;Petrópolis;45;54;99;28
4208203;Itajaí;4209102;Joinville;43;56;99;74
3106200;Belo Horizonte;3205002;Serra;47;51;98;384
4316808;Santa Cruz do Sul;4322608;Venâncio Aires;44;54;98;27
3301702;Duque de Caxias;3305109;São João de Meriti;43;55;98;7
3525003;Jandira;3550308;São Paulo;37;61;98;29
1100205;Porto Velho;5300108;Brasília;24;74;98;1855
4209102;Joinville;4216206;São Francisco do Sul;46;51;97;24
3303500;Nova Iguaçu;3305109;São João de Meriti;45;52;97;11
3530805;Moji-Mirim;3550308;São Paulo;44;53;97;139
3304557;Rio de Janeiro;3547304;Santana de Parnaíba;46;50;96;378
3300407;Barra Mansa;3304557;Rio de Janeiro;44;52;96;104
2208007;Picos;2211001;Teresina;44;52;96;264
3505708;Barueri;3518800;Guarulhos;34;62;96;33
2927408;Salvador;4314902;Porto Alegre;31;65;96;2215
3518800;Guarulhos;5300108;Brasília;26;70;96;857
3518800;Guarulhos;4106902;Curitiba;46;49;95;351
1504208;Marabá;1505536;Parauapebas;44;51;95;109
1302603;Manaus;3505708;Barueri;40;55;95;2596
2927408;Salvador;3505708;Barueri;34;61;95;1431
2704302;Maceió;5300108;Brasília;18;77;95;1458
3522703;Itápolis;3545605;Santa Adélia;1;94;95;39
4201406;Araranguá;4204608;Criciúma;46;48;94;33
2503209;Cabedelo;2507507;João Pessoa;46;48;94;15
4206504;Guaramirim;4208906;Jaraguá do Sul;45;49;94;8
4101408;Apucarana;4113700;Londrina;45;49;94;42
3304201;Resende;3306305;Volta Redonda;45;49;94;36
2304400;Fortaleza;2607901;Jaboatão dos Guararapes;45;49;94;616
4311403;Lajeado;4314902;Porto Alegre;44;50;94;105
3301702;Duque de Caxias;3303500;Nova Iguaçu;43;51;94;16
4202008;Balneário Camboriú;4209102;Joinville;42;52;94;80
2602902;Cabo de Santo Agostinho;2607901;Jaboatão dos Guararapes;41;53;94;18
3509502;Campinas;3549904;São José dos Campos;40;54;94;124
3304557;Rio de Janeiro;4208203;Itajaí;38;56;94;700
3550308;São Paulo;4204608;Criciúma;44;49;93;614
3300233;Armação dos Búzios;3304557;Rio de Janeiro;44;49;93;139
5211909;Jataí;5218805;Rio Verde;43;50;93;82
4106902;Curitiba;4202008;Balneário Camboriú;43;50;93;182
3152501;Pouso Alegre;3550308;São Paulo;43;50;93;174
4208203;Itajaí;4314902;Porto Alegre;42;51;93;416
3503208;Araraquara;3543402;Ribeirão Preto;42;51;93;80
1501402;Belém;1504208;Marabá;40;53;93;447
3201308;Cariacica;3304557;Rio de Janeiro;34;59;93;408
3509502;Campinas;3552205;Sorocaba;45;47;92;79
3106200;Belo Horizonte;3509502;Campinas;44;48;92;456
3523909;Itu;3545209;Salto;42;50;92;9
3304201;Resende;3550308;São Paulo;41;51;92;257
4309308;Guaíba;4314902;Porto Alegre;39;53;92;15
4307708;Esteio;4314902;Porto Alegre;37;55;92;23
3538006;Pindamonhangaba;3554102;Taubaté;43;48;91;15
3523909;Itu;3552205;Sorocaba;43;48;91;30
2304400;Fortaleza;2704302;Maceió;37;54;91;717
3527108;Lins;3550308;São Paulo;36;55;91;384
2304400;Fortaleza;3505708;Barueri;29;62;91;2331
3518800;Guarulhos;3534401;Osasco;25;66;91;26
3534401;Osasco;5208707;Goiânia;22;69;91;804
5208707;Goiânia;5220454;Senador Canedo;44;46;90;20
1702109;Araguaína;1721000;Palmas;44;46;90;351
3302403;Macaé;3304524;Rio das Ostras;43;47;90;13
4202008;Balneário Camboriú;4202909;Brusque;41;49;90;25
4104808;Cascavel;4113700;Londrina;39;51;90;299
3550308;São Paulo;5003702;Dourados;37;53;90;859
3508504;Caçapava;3550308;São Paulo;37;53;90;114
3519071;Hortolândia;3550308;São Paulo;42;47;89;105
3506003;Bauru;3529005;Marília;42;47;89;90
4303905;Campo Bom;4313409;Novo Hamburgo;41;48;89;7
3511102;Catanduva;3549805;São José do Rio Preto;40;49;89;56
3550308;São Paulo;3550704;São Sebastião;39;50;89;124
3305109;São João de Meriti;3550308;São Paulo;37;52;89;346
3541000;Praia Grande;3551009;São Vicente;43;45;88;7
4202404;Blumenau;4205902;Gaspar;42;46;88;12
5105259;Lucas do Rio Verde;5107925;Sorriso;41;47;88;60
4305108;Caxias do Sul;4313409;Novo Hamburgo;41;47;88;59
2111201;São José de Ribamar;2111300;São Luís;38;50;88;21
3304557;Rio de Janeiro;4202404;Blumenau;37;51;88;725
2507507;João Pessoa;5300108;Brasília;15;73;88;1675
3550308;São Paulo;4119152;Pinhais;41;46;87;322
3516408;Franco da Rocha;3550308;São Paulo;41;46;87;37
1501402;Belém;1506807;Santarém;40;47;87;710
3301900;Itaboraí;3304557;Rio de Janeiro;39;48;87;44
3545209;Salto;3550308;São Paulo;38;49;87;82
3525300;Jaú;3550308;São Paulo;37;50;87;248
2111300;São Luís;2611606;Recife;34;53;87;1193
5107909;Sinop;5107925;Sorriso;42;44;86;80
4202404;Blumenau;4208906;Jaraguá do Sul;41;45;86;52
3528502;Mairiporã;3550308;São Paulo;41;45;86;38
3550308;São Paulo;4314100;Passo Fundo;40;46;86;752
2611606;Recife;3106200;Belo Horizonte;39;47;86;1596
3106200;Belo Horizonte;3137601;Lagoa Santa;41;44;85;32
4104303;Campo Mourão;4115200;Maringá;40;45;85;83
2207702;Parnaíba;2211001;Teresina;39;46;85;269
1302603;Manaus;2304400;Fortaleza;37;48;85;2387
3106200;Belo Horizonte;3205200;Vila Velha;27;58;85;380
1302603;Manaus;3518800;Guarulhos;42;42;84;2604
4314902;Porto Alegre;4320008;Sapucaia do Sul;40;44;84;24
3122306;Divinópolis;3550308;São Paulo;38;46;84;426
4209102;Joinville;4216602;São José;37;47;84;145
3131307;Ipatinga;3550308;São Paulo;37;47;84;621
3509502;Campinas;3526902;Limeira;36;48;84;51
2408102;Natal;2412005;São Gonçalo do Amarante;36;48;84;9
4113700;Londrina;4314902;Porto Alegre;26;58;84;748
3530706;Mogi Guaçu;3550308;São Paulo;40;43;83;150
2933307;Vitória da Conquista;3550308;São Paulo;39;44;83;1131
3203205;Linhares;3205309;Vitória;39;44;83;103
3550308;São Paulo;5107602;Rondonópolis;38;45;83;1186
3304557;Rio de Janeiro;4209102;Joinville;38;45;83;668
5002704;Campo Grande;5003207;Corumbá;37;46;83;352
3511102;Catanduva;3550308;São Paulo;36;47;83;364
4207502;Indaial;4218202;Timbó;38;44;82;7
3509700;Campos do Jordão;3550308;São Paulo;38;44;82;151
2611606;Recife;2616407;Vitória de Santo Antão;38;44;82;40
3502804;Araçatuba;3549805;São José do Rio Preto;36;46;82;119
2301000;Aquiraz;2304400;Fortaleza;36;46;82;22
3526902;Limeira;3538709;Piracicaba;35;47;82;33
3201209;Cachoeiro de Itapemirim;3205309;Vitória;35;47;82;104
2507507;João Pessoa;3304557;Rio de Janeiro;34;48;82;1923
3303203;Nilópolis;3303500;Nova Iguaçu;33;49;82;7
3505708;Barueri;3543402;Ribeirão Preto;32;50;82;278
2914802;Itabuna;2927408;Salvador;37;44;81;218
4304606;Canoas;4305108;Caxias do Sul;34;47;81;83
2304400;Fortaleza;3106200;Belo Horizonte;33;48;81;1867
3505708;Barueri;5208707;Goiânia;26;55;81;799
3513504;Cubatão;3548500;Santos;39;41;80;8
4307807;Estrela;4311403;Lajeado;38;42;80;10
4128203;União da Vitória;4213609;Porto União;38;42;80;11
4202008;Balneário Camboriú;4203204;Camboriú;38;42;80;5
4100400;Almirante Tamandaré;4106902;Curitiba;38;42;80;12
3144805;Nova Lima;3550308;São Paulo;38;42;80;491
3550308;São Paulo;4314407;Pelotas;37;43;80;1036
3534401;Osasco;3552809;Taboão da Serra;36;44;80;7
3127701;Governador Valadares;3550308;São Paulo;36;44;80;712
3134905;Jacutinga;3143401;Monte Sião;36;44;80;17
3304557;Rio de Janeiro;3513009;Cotia;35;45;80;381
4113700;Londrina;5300108;Brasília;10;70;80;901
4101408;Apucarana;4101507;Arapongas;38;41;79;16
2930709;Simões Filho;3550308;São Paulo;38;41;79;1453
3550308;São Paulo;4303103;Cachoeirinha;37;42;79;814
4205407;Florianópolis;4208203;Itajaí;36;43;79;76
3550308;São Paulo;4202008;Balneário Camboriú;36;43;79;420
3304201;Resende;3304557;Rio de Janeiro;35;44;79;129
3106705;Betim;3304557;Rio de Janeiro;34;45;79;337
3548807;São Caetano do Sul;5300108;Brasília;9;70;79;876
3106200;Belo Horizonte;3127701;Governador Valadares;38;40;78;243
2800308;Aracaju;2802908;Itabaiana;38;40;78;47
5208004;Formosa;5300108;Brasília;37;41;78;71
1600303;Macapá;3550308;São Paulo;37;41;78;2660
3106200;Belo Horizonte;3171204;Vespasiano;37;41;78;23
1100205;Porto Velho;3304557;Rio de Janeiro;36;42;78;2567
2910727;Eunápolis;2925303;Porto Seguro;36;42;78;50
3550308;São Paulo;5218805;Rio Verde;34;44;78;797
2906501;Candeias;2927408;Salvador;34;44;78;36
4305108;Caxias do Sul;4308201;Flores da Cunha;29;49;78;15
3550308;São Paulo;3554003;Tatuí;38;39;77;127
3135100;Janaúba;3143302;Montes Claros;38;39;77;118
3510500;Caraguatatuba;3549904;São José dos Campos;37;40;77;63
3201506;Colatina;3205309;Vitória;37;40;77;84
4202404;Blumenau;4216602;São José;36;41;77;80
4202404;Blumenau;4214805;Rio do Sul;33;44;77;62
3534708;Ourinhos;3550308;São Paulo;32;45;77;339
3510500;Caraguatatuba;3550704;São Sebastião;38;38;76;16
3518800;Guarulhos;3548500;Santos;38;38;76;55
3106200;Belo Horizonte;3518800;Guarulhos;37;39;76;470
3506003;Bauru;3525300;Jaú;35;41;76;53
1500800;Ananindeua;3550308;São Paulo;34;42;76;2470
3143302;Montes Claros;3550308;São Paulo;34;42;76;815
4106902;Curitiba;5002704;Campo Grande;33;43;76;795
3510609;Carapicuíba;3534401;Osasco;33;43;76;5
2504009;Campina Grande;2611606;Recife;29;47;76;147
3509502;Campinas;3536505;Paulínia;37;38;75;18
3506003;Bauru;3543402;Ribeirão Preto;36;39;75;188
4202909;Brusque;4208203;Itajaí;35;40;75;23
2304400;Fortaleza;4314902;Porto Alegre;25;50;75;3125
2800308;Aracaju;5300108;Brasília;14;61;75;1270
3511102;Catanduva;3545605;Santa Adélia;6;69;75;22
3301900;Itaboraí;3304904;São Gonçalo;35;39;74;22
1709500;Gurupi;1721000;Palmas;35;39;74;167
4313508;Osório;4314902;Porto Alegre;32;42;74;92
3136702;Juiz de Fora;3160702;Santos Dumont;34;39;73;38
2612505;Santa Cruz do Capibaribe;2615409;Toritama;34;39;73;17
4205506;Fraiburgo;4219309;Videira;33;40;73;23
3504008;Assis;3550308;São Paulo;33;40;73;401
3509502;Campinas;3547809;Santo André;33;40;73;99
4304606;Canoas;4307708;Esteio;31;42;73;7
2211001;Teresina;3304557;Rio de Janeiro;29;44;73;1968
3550308;São Paulo;4208906;Jaraguá do Sul;28;45;73;394
5002704;Campo Grande;5008305;Três Lagoas;34;38;72;306
4106902;Curitiba;4109401;Guarapuava;34;38;72;218
3550308;São Paulo;3557006;Votorantim;33;39;72;77
3134202;Ituiutaba;3170206;Uberlândia;32;40;72;126
2910800;Feira de Santana;2933307;Vitória da Conquista;31;41;72;349
3505708;Barueri;3548708;São Bernardo do Campo;25;47;72;38
3522406;Itapeva;3550308;São Paulo;23;49;72;231
2304400;Fortaleza;3534401;Osasco;16;56;72;2330
4311809;Marau;4314100;Passo Fundo;35;36;71;29
3513801;Diadema;3547809;Santo André;35;36;71;10
3202405;Guarapari;3205309;Vitória;32;39;71;50
3304557;Rio de Janeiro;3549805;São José do Rio Preto;30;41;71;682
3550308;São Paulo;3556453;Vargem Grande Paulista;29;42;71;39
2611606;Recife;3534401;Osasco;20;51;71;2064
3534401;Osasco;3548708;São Bernardo do Campo;18;53;71;29
5102637;Campo Novo do Parecis;5107958;Tangará da Serra;35;35;70;114
3300456;Belford Roxo;3304557;Rio de Janeiro;34;36;70;19
2602902;Cabo de Santo Agostinho;3550308;São Paulo;33;37;70;2046
4202909;Brusque;4206306;Guabiruba;32;38;70;8
3505500;Barretos;3550308;São Paulo;32;38;70;395
2304400;Fortaleza;2800308;Aracaju;30;40;70;802
1302603;Manaus;4314902;Porto Alegre;26;44;70;3085
3506003;Bauru;5300108;Brasília;14;56;70;734
3515608;Fernando Prestes;3545605;Santa Adélia;2;68;70;13
2611101;Petrolina;3550308;São Paulo;33;36;69;1697
3136702;Juiz de Fora;3169901;Ubá;33;36;69;82
3140001;Mariana;3146107;Ouro Preto;33;36;69;13
2407104;Macaíba;2408102;Natal;31;38;69;13
3205309;Vitória;3505708;Barueri;30;39;69;755
4307906;Farroupilha;4314902;Porto Alegre;26;43;69;93
3534401;Osasco;3547809;Santo André;19;50;69;29
5107040;Primavera do Leste;5107602;Rondonópolis;34;34;68;105
3556206;Valinhos;3556701;Vinhedo;33;35;68;7
2611606;Recife;3518800;Guarulhos;33;35;68;2043
5103403;Cuiabá;5107040;Primavera do Leste;32;36;68;188
2604106;Caruaru;3550308;São Paulo;32;36;68;1995
2921005;Mata de São João;2927408;Salvador;32;36;68;54
4205407;Florianópolis;4218707;Tubarão;31;37;68;112
2611606;Recife;4106902;Curitiba;31;37;68;2359
3529401;Mauá;3548708;São Bernardo do Campo;31;37;68;14
3509502;Campinas;3548708;São Bernardo do Campo;28;40;68;103
2918001;Jequié;2927408;Salvador;22;46;68;196
1600303;Macapá;5300108;Brasília;14;54;68;1788
1100205;Porto Velho;1100304;Vilhena;33;34;67;598
4208203;Itajaí;4211306;Navegantes;32;35;67;10
3525904;Jundiaí;3556503;Várzea Paulista;32;35;67;9
3550308;São Paulo;4315602;Rio Grande;31;36;67;1061
4115200;Maringá;4118402;Paranavaí;31;36;67;65
3304557;Rio de Janeiro;4115200;Maringá;29;38;67;886
2927408;Salvador;4106902;Curitiba;29;38;67;1730
4113700;Londrina;4122404;Rolândia;28;39;67;22
4204202;Chapecó;4219507;Xanxerê;33;33;66;35
3523107;Itaquaquecetuba;3552502;Suzano;33;33;66;8
2304400;Fortaleza;3518800;Guarulhos;33;33;66;2312
3119401;Coronel Fabriciano;3168705;Timóteo;32;34;66;8
1100023;Ariquemes;1100205;Porto Velho;32;34;66;157
3522307;Itapetininga;3552205;Sorocaba;31;35;66;57
4104907;Castro;4119905;Ponta Grossa;30;36;66;38
3505708;Barueri;3548500;Santos;30;36;66;68
4304705;Carazinho;4314100;Passo Fundo;29;37;66;38
3507001;Boituva;3550308;São Paulo;28;38;66;112
1302603;Manaus;3106200;Belo Horizonte;26;40;66;2467
4302105;Bento Gonçalves;4307906;Farroupilha;32;33;65;18
4122305;Rio Negro;4210100;Mafra;32;33;65;6
3304524;Rio das Ostras;3304557;Rio de Janeiro;32;33;65;142
3169307;Três Corações;3170701;Varginha;32;33;65;26
3520509;Indaiatuba;3523909;Itu;31;34;65;22
3118007;Congonhas;3118304;Conselheiro Lafaiete;31;34;65;19
3550308;São Paulo;5108402;Várzea Grande;30;35;65;1369
4209102;Joinville;4215802;São Bento do Sul;30;35;65;51
4106407;Cornélio Procópio;4113700;Londrina;30;35;65;52
3506003;Bauru;3549805;São José do Rio Preto;30;35;65;171
3503208;Araraquara;3529302;Matão;28;37;65;31
4305108;Caxias do Sul;4314100;Passo Fundo;24;41;65;157
3170206;Uberlândia;5211503;Itumbiara;32;32;64;119
4302105;Bento Gonçalves;4308607;Garibaldi;31;33;64;11
4202305;Biguaçu;4205407;Florianópolis;31;33;64;21
3304557;Rio de Janeiro;4315602;Rio Grande;30;34;64;1301
3534401;Osasco;3547304;Santana de Parnaíba;30;34;64;16
5208707;Goiânia;5211800;Jaraguá;29;35;64;103
4106902;Curitiba;5103403;Cuiabá;29;35;64;1327
3550308;São Paulo;4316907;Santa Maria;29;35;64;951
4125506;São José dos Pinhais;4314902;Porto Alegre;29;35;64;535
3548708;São Bernardo do Campo;4106902;Curitiba;29;35;64;331
1504208;Marabá;3550308;São Paulo;29;35;64;2037
3504503;Avaré;3550308;São Paulo;29;35;64;240
3304557;Rio de Janeiro;4305108;Caxias do Sul;27;37;64;1022
3304557;Rio de Janeiro;4304606;Canoas;27;37;64;1076
3548708;São Bernardo do Campo;5300108;Brasília;13;51;64;888
3547809;Santo André;5300108;Brasília;10;54;64;881
3549805;São José do Rio Preto;5300108;Brasília;10;54;64;578
3300233;Armação dos Búzios;3300704;Cabo Frio;31;32;63;23
4108403;Francisco Beltrão;4118501;Pato Branco;30;33;63;43
3125101;Extrema;3550308;São Paulo;30;33;63;95
3503307;Araras;3543907;Rio Claro;30;33;63;20
1200401;Rio Branco;3550308;São Paulo;29;34;63;2572
1400100;Boa Vista;3550308;São Paulo;29;34;63;3235
1302603;Manaus;2611606;Recife;29;34;63;2808
2504009;Campina Grande;3550308;São Paulo;28;35;63;2101
3202405;Guarapari;3205200;Vila Velha;28;35;63;39
3505708;Barueri;3547809;Santo André;22;41;63;38
3106200;Belo Horizonte;3548807;São Caetano do Sul;11;52;63;487
5208707;Goiânia;5211503;Itumbiara;31;31;62;188
3525102;Jardinópolis;3551702;Sertãozinho;31;31;62;27
2604106;Caruaru;2615409;Toritama;30;32;62;33
3550308;São Paulo;4309209;Gravataí;29;33;62;807
4106902;Curitiba;4305108;Caxias do Sul;29;33;62;450
2600054;Abreu e Lima;2611606;Recife;29;33;62;25
4204202;Chapecó;4204301;Concórdia;28;34;62;61
3304557;Rio de Janeiro;4125506;São José dos Pinhais;28;34;62;658
4307609;Estância Velha;4313409;Novo Hamburgo;27;35;62;6
4106902;Curitiba;5208707;Goiânia;26;36;62;968
4204608;Criciúma;4209102;Joinville;25;37;62;269
3127701;Governador Valadares;3168606;Teófilo Otoni;23;39;62;117
3118601;Contagem;5300108;Brasília;19;43;62;616
4314902;Porto Alegre;5208707;Goiânia;19;43;62;1495
3549904;São José dos Campos;5300108;Brasília;10;52;62;848
2914802;Itabuna;3550308;São Paulo;30;31;61;1223
1721000;Palmas;3304557;Rio de Janeiro;30;31;61;1475
3506359;Bertioga;3550308;São Paulo;29;32;61;54
3509502;Campinas;3545803;Santa Bárbara d'Oeste;28;33;61;40
3106200;Belo Horizonte;3129806;Ibirité;28;33;61;16
3501905;Amparo;3550308;São Paulo;27;34;61;106
3527207;Lorena;3550308;São Paulo;27;34;61;189
3505708;Barueri;3549904;São José dos Campos;27;34;61;107
2606002;Garanhuns;2611606;Recife;27;34;61;194
3518800;Guarulhos;3548708;São Bernardo do Campo;25;36;61;31
4202404;Blumenau;4213203;Pomerode;30;30;60;25
3106200;Belo Horizonte;3170701;Varginha;30;30;60;230
1100106;Guajará-Mirim;1100122;Ji-Paraná;30;30;60;373
2607901;Jaboatão dos Guararapes;2927408;Salvador;29;31;60;654
2507507;João Pessoa;2513703;Santa Rita;29;31;60;16
1501402;Belém;1505536;Parauapebas;29;31;60;535
4204608;Criciúma;4205456;Forquilhinha;28;32;60;13
3518404;Guaratinguetá;3527207;Lorena;28;32;60;13
2408003;Mossoró;3304557;Rio de Janeiro;27;33;60;2042
2304202;Crato;2304400;Fortaleza;27;33;60;393
4204202;Chapecó;4314100;Passo Fundo;26;34;60;129
3501707;Américo Brasiliense;3503208;Araraquara;26;34;60;10
1302603;Manaus;3534401;Osasco;16;44;60;2602
3534708;Ourinhos;3546405;Santa Cruz do Rio Pardo;15;45;60;29
3503208;Araraquara;3506706;Boa Esperança do Sul;11;49;60;32
3521507;Irapuã;3528858;Marapoama;1;59;60;29
3550308;São Paulo;4302105;Bento Gonçalves;29;30;59;765
3524303;Jaboticabal;3551702;Sertãozinho;29;30;59;35
3538709;Piracicaba;3543907;Rio Claro;29;30;59;39
3300704;Cabo Frio;3305208;São Pedro da Aldeia;29;30;59;6
3152501;Pouso Alegre;3170701;Varginha;29;30;59;97
2107506;Paço do Lumiar;2111300;São Luís;29;30;59;14
4307005;Erechim;4314902;Porto Alegre;28;31;59;287
3550308;São Paulo;4209300;Lages;28;31;59;582
2913606;Ilhéus;3550308;São Paulo;28;31;59;1233
3524709;Jaguariúna;3550308;São Paulo;28;31;59;110
4314902;Porto Alegre;4322400;Uruguaiana;27;32;59;569
3550308;São Paulo;4307708;Esteio;27;32;59;807
4101408;Apucarana;4115200;Maringá;27;32;59;51
3302502;Magé;3304557;Rio de Janeiro;27;32;59;34
3534401;Osasco;3543402;Ribeirão Preto;16;43;59;284
3534401;Osasco;5002704;Campo Grande;14;45;59;898
3552205;Sorocaba;5300108;Brasília;8;51;59;851
3503208;Araraquara;3546900;Santa Lúcia;7;52;59;14
3501608;Americana;3552403;Sumaré;29;29;58;11
2607208;Ipojuca;3550308;São Paulo;29;29;58;2034
3300407;Barra Mansa;3304201;Resende;29;29;58;26
3151800;Poços de Caldas;3152501;Pouso Alegre;29;29;58;79
4201406;Araranguá;4217709;Sombrio;28;30;58;24
3550308;São Paulo;4101408;Apucarana;28;30;58;491
4303905;Campo Bom;4314902;Porto Alegre;27;31;58;44
3525904;Jundiaí;3552205;Sorocaba;27;31;58;70
3501608;Americana;3526902;Limeira;27;31;58;20
2100055;Açailândia;2105302;Imperatriz;27;31;58;61
3304557;Rio de Janeiro;3506003;Bauru;26;32;58;604
3548500;Santos;3548708;São Bernardo do Campo;25;33;58;31
3106200;Belo Horizonte;3149309;Pedro Leopoldo;24;34;58;33
4314902;Porto Alegre;5002704;Campo Grande;23;35;58;1130
4209102;Joinville;5300108;Brasília;10;48;58;1164
3520509;Indaiatuba;3545209;Salto;28;29;57;13
1501303;Barcarena;1501402;Belém;28;29;57;26
1100049;Cacoal;1100122;Ji-Paraná;28;29;57;73
4203006;Caçador;4219309;Videira;27;30;57;24
3505708;Barueri;3552205;Sorocaba;27;30;57;64
3505708;Barueri;3513009;Cotia;27;30;57;11
4125506;São José dos Pinhais;4209102;Joinville;26;31;57;88
4204202;Chapecó;4209102;Joinville;26;31;57;388
3505708;Barueri;3525904;Jundiaí;26;31;57;37
3522406;Itapeva;3523206;Itararé;26;31;57;48
4305108;Caxias do Sul;4313201;Nova Petrópolis;22;35;57;25
3548708;São Bernardo do Campo;4314902;Porto Alegre;19;38;57;825
4104253;Campo Magro;4106902;Curitiba;28;28;56;17
3106200;Belo Horizonte;3170107;Uberaba;28;28;56;413
2913903;Ipiaú;2918001;Jequié;28;28;56;51
3170206;Uberlândia;5205109;Catalão;27;29;56;89
2913606;Ilhéus;2927408;Salvador;27;29;56;211
4316808;Santa Cruz do Sul;4316907;Santa Maria;25;31;56;134
3300407;Barra Mansa;3550308;São Paulo;25;31;56;278
1301902;Itacoatiara;1302603;Manaus;25;31;56;179
1100205;Porto Velho;5103403;Cuiabá;24;32;56;1113
3538709;Piracicaba;3545803;Santa Bárbara d'Oeste;24;32;56;24
3304557;Rio de Janeiro;3530607;Moji das Cruzes;23;33;56;307
4314902;Porto Alegre;4317202;Santa Rosa;22;34;56;405
4113700;Londrina;5002704;Campo Grande;21;35;56;487
3530607;Moji das Cruzes;3549904;São José dos Campos;19;37;56;51
3511102;Catanduva;3555604;Uchoa;2;54;56;29
4202909;Brusque;4208302;Itapema;27;28;55;27
3505609;Barrinha;3551702;Sertãozinho;27;28;55;19
3518800;Guarulhos;3549904;São José dos Campos;27;28;55;74
3300209;Araruama;3305505;Saquarema;27;28;55;13
3115300;Cataguases;3138401;Leopoldina;27;28;55;19
3122306;Divinópolis;3133808;Itaúna;27;28;55;32
3201209;Cachoeiro de Itapemirim;3550308;São Paulo;26;29;55;643
2927408;Salvador;3518800;Guarulhos;26;29;55;1406
1501402;Belém;3106200;Belo Horizonte;26;29;55;2097
2900702;Alagoinhas;2910800;Feira de Santana;26;29;55;61
4314902;Porto Alegre;4321501;Torres;25;30;55;159
3304557;Rio de Janeiro;3552205;Sorocaba;25;30;55;437
2408003;Mossoró;3550308;São Paulo;25;30;55;2235
3505708;Barueri;3510609;Carapicuíba;25;30;55;4
4307708;Esteio;4320008;Sapucaia do Sul;24;31;55;3
3200607;Aracruz;3205309;Vitória;24;31;55;49
2304400;Fortaleza;5208707;Goiânia;23;32;55;1816
4106902;Curitiba;4304606;Canoas;23;32;55;527
3303401;Nova Friburgo;3550308;São Paulo;23;32;55;440
3106200;Belo Horizonte;3548708;São Bernardo do Campo;23;32;55;497
3548807;São Caetano do Sul;4106902;Curitiba;15;40;55;339
3548500;Santos;5300108;Brasília;7;48;55;912
3118601;Contagem;4106902;Curitiba;26;28;54;798
3529302;Matão;3550308;São Paulo;26;28;54;288
3106200;Belo Horizonte;3543402;Ribeirão Preto;26;28;54;418
4303103;Cachoeirinha;4304606;Canoas;25;29;54;8
3550308;São Paulo;3551702;Sertãozinho;25;29;54;312
2105302;Imperatriz;3550308;São Paulo;25;29;54;2008
3304557;Rio de Janeiro;3525904;Jundiaí;24;30;54;374
3505708;Barueri;3522505;Itapevi;24;30;54;8
3201209;Cachoeiro de Itapemirim;3201407;Castelo;24;30;54;31
3106200;Belo Horizonte;3118304;Conselheiro Lafaiete;24;30;54;86
4314902;Porto Alegre;4317509;Santo Ângelo;23;31;54;360
1302603;Manaus;2927408;Salvador;22;32;54;2552
2304400;Fortaleza;4106902;Curitiba;21;33;54;2608
3525904;Jundiaí;3534401;Osasco;19;35;54;41
3550308;São Paulo;4322400;Uruguaiana;26;27;53;1194
4202404;Blumenau;4218202;Timbó;26;27;53;22
3546801;Santa Isabel;3550308;São Paulo;26;27;53;58
3509502;Campinas;3524709;Jaguariúna;26;27;53;23
1716109;Paraíso do Tocantins;1721000;Palmas;26;27;53;62
5200258;Águas Lindas de Goiás;5300108;Brasília;25;28;53;39
3506102;Bebedouro;3550308;São Paulo;25;28;53;356
3516309;Francisco Morato;3550308;São Paulo;25;28;53;44
3541406;Presidente Prudente;3549805;São José do Rio Preto;25;28;53;254
3543402;Ribeirão Preto;3548906;São Carlos;25;28;53;97
3148004;Patos de Minas;3148103;Patrocínio;25;28;53;65
3550308;São Paulo;5205109;Catalão;24;29;53;624
2609600;Olinda;3550308;São Paulo;24;29;53;2079
3301702;Duque de Caxias;3303302;Niterói;24;29;53;25
3136702;Juiz de Fora;3306008;Três Rios;23;30;53;36
3303906;Petrópolis;3306008;Três Rios;23;30;53;51
3118601;Contagem;3170206;Uberlândia;23;30;53;456
2304400;Fortaleza;2305506;Iguatu;23;30;53;299
4304606;Canoas;4318705;São Leopoldo;21;32;53;17
1200401;Rio Branco;1302603;Manaus;21;32;53;1156
3170107;Uberaba;5300108;Brasília;16;37;53;435
3543402;Ribeirão Preto;4314902;Porto Alegre;13;40;53;1035
1702109;Araguaína;5208707;Goiânia;26;26;52;1057
3524006;Itupeva;3525904;Jundiaí;26;26;52;16
2507507;João Pessoa;2510808;Patos;26;26;52;268
3550308;São Paulo;5107909;Sinop;25;27;52;1639
5002704;Campo Grande;5107602;Rondonópolis;25;27;52;443
3515004;Embu;3552809;Taboão da Serra;25;27;52;10
3550308;São Paulo;3550605;São Roque;25;27;52;51
3122306;Divinópolis;3145208;Nova Serrana;25;27;52;33
3105608;Barbacena;3136702;Juiz de Fora;25;27;52;78
4301602;Bagé;4314407;Pelotas;24;28;52;169
4109401;Guarapuava;4119905;Ponta Grossa;24;28;52;134
3167202;Sete Lagoas;3550308;São Paulo;24;28;52;526
3509502;Campinas;3549805;São José do Rio Preto;24;28;52;336
2611606;Recife;2613701;São Lourenço da Mata;24;28;52;18
3550308;São Paulo;4103701;Cambé;23;29;52;475
3304557;Rio de Janeiro;4101804;Araucária;23;29;52;680
3143302;Montes Claros;3304557;Rio de Janeiro;22;30;52;684
3503307;Araras;3526704;Leme;20;32;52;19
2306306;Itapagé;4314902;Porto Alegre;1;51;52;3100
3544202;Riolândia;3545605;Santa Adélia;1;51;52;166
5107602;Rondonópolis;5108402;Várzea Grande;25;26;51;182
4313409;Novo Hamburgo;4319901;Sapiranga;25;26;51;13
4315701;Rio Pardo;4316808;Santa Cruz do Sul;25;26;51;21
4208203;Itajaí;4208302;Itapema;25;26;51;20
2501807;Bayeux;2507507;João Pessoa;25;26;51;11
4209409;Laguna;4218707;Tubarão;24;27;51;20
3550308;São Paulo;3555406;Ubatuba;24;27;51;159
3132404;Itajubá;3550308;São Paulo;24;27;51;182
3201209;Cachoeiro de Itapemirim;3205200;Vila Velha;21;30;51;93
1200401;Rio Branco;5300108;Brasília;12;39;51;2203
3511102;Catanduva;3519402;Ibirá;2;49;51;28
5204508;Caldas Novas;5208707;Goiânia;25;25;50;136
3548500;Santos;4118204;Paranaguá;25;25;50;289
4104006;Campina Grande do Sul;4106902;Curitiba;25;25;50;28
3106200;Belo Horizonte;3152501;Pouso Alegre;25;25;50;326
2800308;Aracaju;2803500;Lagarto;25;25;50;69
5105259;Lucas do Rio Verde;5106224;Nova Mutum;24;26;50;88
3549805;São José do Rio Preto;3557105;Votuporanga;24;26;50;75
3518800;Guarulhos;3552502;Suzano;24;26;50;28
3549102;São João da Boa Vista;3550308;São Paulo;24;26;50;188
3304144;Queimados;3304557;Rio de Janeiro;24;26;50;38
2704302;Maceió;2927408;Salvador;24;26;50;473
3550308;São Paulo;5211503;Itumbiara;23;27;50;646
3550308;São Paulo;5200308;Alexânia;23;27;50;862
4202909;Brusque;4205407;Florianópolis;23;27;50;68
2403251;Parnamirim;3550308;São Paulo;23;27;50;2255
3304557;Rio de Janeiro;3536505;Paulínia;23;27;50;400
3200300;Alfredo Chaves;3205309;Vitória;23;27;50;63
3508504;Caçapava;3549904;São José dos Campos;22;28;50;21
3300308;Barra do Piraí;3304557;Rio de Janeiro;22;28;50;73
3109402;Buritizeiro;3151206;Pirapora;22;28;50;8
2101202;Bacabal;2111300;São Luís;22;28;50;194
4305108;Caxias do Sul;4316808;Santa Cruz do Sul;20;30;50;136
3118601;Contagem;3154606;Ribeirão das Neves;15;35;50;17
4316808;Santa Cruz do Sul;4322707;Vera Cruz;24;25;49;7
4314050;Parobé;4321204;Taquara;24;25;49;6
3550308;São Paulo;3557105;Votuporanga;24;25;49;500
3554102;Taubaté;3554805;Tremembé;24;25;49;6
3529005;Marília;3541406;Presidente Prudente;24;25;49;149
3506003;Bauru;3507506;Botucatu;24;25;49;89
3131703;Itabira;3136207;João Monlevade;24;25;49;21
3515103;Embu-Guaçu;3550308;São Paulo;23;26;49;26
3547809;Santo André;3548500;Santos;23;26;49;33
3118304;Conselheiro Lafaiete;3145901;Ouro Branco;23;26;49;20
4314902;Porto Alegre;4322004;Triunfo;22;27;49;51
4303509;Camaquã;4314902;Porto Alegre;22;27;49;105
3550308;São Paulo;4101507;Arapongas;22;27;49;491
3506508;Birigui;3550308;São Paulo;22;27;49;455
2202208;Campo Maior;2211001;Teresina;22;27;49;72
3115300;Cataguases;3136702;Juiz de Fora;21;28;49;80
4204608;Criciúma;4314902;Porto Alegre;20;29;49;232
2607901;Jaboatão dos Guararapes;3304557;Rio de Janeiro;20;29;49;1824
4307708;Esteio;4318705;São Leopoldo;19;30;49;10
3513009;Cotia;3534401;Osasco;19;30;49;15
1400100;Boa Vista;5300108;Brasília;12;37;49;2458
3303302;Niterói;5300108;Brasília;6;43;49;943
4305108;Caxias do Sul;5300108;Brasília;5;44;49;1522
4304630;Capão da Canoa;4323804;Xangri-lá;24;24;48;5
2111300;São Luís;3106200;Belo Horizonte;24;24;48;1921
2304400;Fortaleza;2311801;Russas;24;24;48;143
4314902;Porto Alegre;4317608;Santo Antônio da Patrulha;23;25;48;71
3519071;Hortolândia;3552403;Sumaré;23;25;48;6
3304557;Rio de Janeiro;3541406;Presidente Prudente;23;25;48;845
5002704;Campo Grande;5108402;Várzea Grande;22;26;48;553
4303004;Cachoeira do Sul;4314902;Porto Alegre;22;26;48;165
3550308;São Paulo;4109401;Guarapuava;22;26;48;518
2307650;Maracanaú;3550308;São Paulo;22;26;48;2324
3522109;Itanhaém;3550308;São Paulo;22;26;48;60
3538709;Piracicaba;3544004;Rio das Pedras;21;27;48;11
3509502;Campinas;3543907;Rio Claro;21;27;48;76
1302603;Manaus;3509502;Campinas;21;27;48;2532
3127701;Governador Valadares;3304557;Rio de Janeiro;21;27;48;469
3505708;Barueri;4205407;Florianópolis;20;28;48;479
4106902;Curitiba;4115705;Matinhos;20;28;48;84
1302603;Manaus;4106902;Curitiba;20;28;48;2673
3170107;Uberaba;3543402;Ribeirão Preto;20;28;48;157
3304557;Rio de Janeiro;3513801;Diadema;20;28;48;353
3541406;Presidente Prudente;5002704;Campo Grande;18;30;48;391
3170206;Uberlândia;3516200;Franca;18;30;48;202
3548807;São Caetano do Sul;4314902;Porto Alegre;14;34;48;835
4115200;Maringá;5300108;Brasília;9;39;48;951
3136702;Juiz de Fora;5300108;Brasília;7;41;48;826
4201406;Araranguá;4201950;Balneário Arroio do Silva;23;24;47;6
4115200;Maringá;4128104;Umuarama;23;24;47;145
4106902;Curitiba;4109609;Guaratuba;23;24;47;85
3516309;Francisco Morato;3516408;Franco da Rocha;23;24;47;7
3143302;Montes Claros;3151206;Pirapora;23;24;47;128
2607901;Jaboatão dos Guararapes;2704302;Maceió;23;24;47;186
2503704;Cajazeiras;2516201;Sousa;23;24;47;37
3106200;Belo Horizonte;5002704;Campo Grande;23;24;47;1114
4306767;Eldorado do Sul;4314902;Porto Alegre;23;24;47;40
4208906;Jaraguá do Sul;4215802;São Bento do Sul;23;24;47;38
4201307;Araquari;4209102;Joinville;22;25;47;13
3518404;Guaratinguetá;3549904;São José dos Campos;22;25;47;84
3518800;Guarulhos;3547809;Santo André;22;25;47;24
3525102;Jardinópolis;3543402;Ribeirão Preto;22;25;47;15
3506003;Bauru;3509502;Campinas;22;25;47;216
3200607;Aracruz;3203205;Linhares;22;25;47;57
3201506;Colatina;3203205;Linhares;22;25;47;65
3152501;Pouso Alegre;3159605;Santa Rita do Sapucaí;22;25;47;26
3106200;Belo Horizonte;3136207;João Monlevade;21;26;47;85
2304400;Fortaleza;2910800;Feira de Santana;21;26;47;943
5103403;Cuiabá;5107925;Sorriso;21;26;47;336
4310207;Ijuí;4317509;Santo Ângelo;21;26;47;36
4101507;Arapongas;4122404;Rolândia;20;27;47;14
3542602;Registro;3550308;São Paulo;20;27;47;158
2607208;Ipojuca;3304557;Rio de Janeiro;20;27;47;1795
3509502;Campinas;3530706;Mogi Guaçu;18;29;47;64
3505708;Barueri;5103403;Cuiabá;17;30;47;1342
3509502;Campinas;3548807;São Caetano do Sul;13;34;47;93
1501402;Belém;3534401;Osasco;13;34;47;2456
5104807;Jaciara;5201108;Anápolis;2;45;47;647
5002951;Chapadão do Sul;5205471;Chapadão do Céu;23;23;46;44
4311403;Lajeado;4322608;Venâncio Aires;23;23;46;25
3548500;Santos;4208203;Itajaí;23;23;46;411
2607901;Jaboatão dos Guararapes;3518800;Guarulhos;23;23;46;2038
3118601;Contagem;3518800;Guarulhos;23;23;46;463
4202305;Biguaçu;4216602;São José;22;24;46;10
4202909;Brusque;4205902;Gaspar;22;24;46;18
3518404;Guaratinguetá;3554102;Taubaté;22;24;46;47
3505302;Barra Bonita;3525300;Jaú;22;24;46;24
3105608;Barbacena;3162500;São João del Rei;22;24;46;52
2704302;Maceió;2707701;Rio Largo;22;24;46;21
2506301;Guarabira;2507507;João Pessoa;22;24;46;79
2305506;Iguatu;2307304;Juazeiro do Norte;22;24;46;97
4309100;Gramado;4313201;Nova Petrópolis;21;25;46;20
4113700;Londrina;4119905;Ponta Grossa;21;25;46;223
3550308;São Paulo;3555000;Tupã;21;25;46;447
3148004;Patos de Minas;3550308;São Paulo;21;25;46;562
3201209;Cachoeiro de Itapemirim;3304557;Rio de Janeiro;21;25;46;317
3141108;Matozinhos;3149309;Pedro Leopoldo;21;25;46;6
2203909;Floriano;2211001;Teresina;21;25;46;191
3550308;São Paulo;4316808;Santa Cruz do Sul;20;26;46;865
2905701;Camaçari;3304557;Rio de Janeiro;20;26;46;1230
2914802;Itabuna;2933307;Vitória da Conquista;20;26;46;169
4303004;Cachoeira do Sul;4316808;Santa Cruz do Sul;19;27;46;56
2304400;Fortaleza;2309607;Pacajus;19;27;46;46
2403103;Currais Novos;2408102;Natal;16;30;46;148
4202404;Blumenau;5300108;Brasília;7;39;46;1240
2927408;Salvador;5208707;Goiânia;22;23;45;1215
5107909;Sinop;5108402;Várzea Grande;22;23;45;426
5003702;Dourados;5006606;Ponta Porã;22;23;45;98
4209102;Joinville;4305108;Caxias do Sul;22;23;45;389
4203204;Camboriú;4208203;Itajaí;22;23;45;11
4115200;Maringá;4119905;Ponta Grossa;22;23;45;256
1505536;Parauapebas;3550308;São Paulo;22;23;45;1977
3526209;Juquitiba;3550308;São Paulo;22;23;45;53
3301900;Itaboraí;3303302;Niterói;22;23;45;29
1200104;Brasiléia;1200401;Rio Branco;22;23;45;148
3550308;São Paulo;4211900;Palhoça;21;24;45;487
3527306;Louveira;3550308;São Paulo;21;24;45;71
3201209;Cachoeiro de Itapemirim;3301009;Campos dos Goytacazes;21;24;45;109
2905701;Camaçari;2919207;Lauro de Freitas;21;24;45;21
3170107;Uberaba;3304557;Rio de Janeiro;20;25;45;587
3300704;Cabo Frio;3303302;Niterói;20;25;45;106
3301702;Duque de Caxias;3304904;São Gonçalo;19;26;45;26
2103000;Caxias;2211001;Teresina;19;26;45;64
1718204;Porto Nacional;1721000;Palmas;19;26;45;38
1302504;Manacapuru;1302603;Manaus;19;26;45;67
3301702;Duque de Caxias;3505708;Barueri;17;28;45;372
3170206;Uberlândia;3534401;Osasco;16;29;45;534
3301702;Duque de Caxias;5300108;Brasília;11;34;45;920
5208707;Goiânia;5208806;Goianira;22;22;44;26
1709500;Gurupi;5208707;Goiânia;22;22;44;552
4106902;Curitiba;4119509;Piraquara;22;22;44;23
3511508;Cerquilho;3554508;Tietê;22;22;44;8
3514601;Dumont;3551702;Sertãozinho;22;22;44;11
2304400;Fortaleza;2311306;Quixadá;22;22;44;143
1503606;Itaituba;1506807;Santarém;22;22;44;240
1200252;Epitaciolândia;1200401;Rio Branco;22;22;44;152
5002704;Campo Grande;5208707;Goiânia;21;23;44;711
3550308;São Paulo;5003207;Corumbá;21;23;44;1281
4312401;Montenegro;4314902;Porto Alegre;21;23;44;51
4102604;Barracão;4205001;Dionísio Cerqueira;21;23;44;5
4114807;Marialva;4115200;Maringá;21;23;44;15
3526803;Lençóis Paulista;3550308;São Paulo;21;23;44;249
3528403;Mairinque;3550308;São Paulo;21;23;44;55
3504008;Assis;3541406;Presidente Prudente;21;23;44;114
3106200;Belo Horizonte;3109006;Brumadinho;21;23;44;35
2614501;Surubim;2615409;Toritama;21;23;44;39
2609600;Olinda;2610707;Paulista;21;23;44;7
1100023;Ariquemes;1100122;Ji-Paraná;21;23;44;165
4204202;Chapecó;4314902;Porto Alegre;20;24;44;353
3550308;São Paulo;4307906;Farroupilha;20;24;44;761
4106902;Curitiba;4118501;Pato Branco;20;24;44;347
4101507;Arapongas;4115200;Maringá;20;24;44;50
3504008;Assis;3534708;Ourinhos;20;24;44;66
2400208;Açu;2408003;Mossoró;20;24;44;63
4301602;Bagé;4314902;Porto Alegre;19;25;44;315
3550308;São Paulo;4105508;Cianorte;19;25;44;607
2304400;Fortaleza;2604106;Caruaru;19;25;44;572
4304606;Canoas;4309209;Gravataí;18;26;44;19
3505708;Barueri;3548807;São Caetano do Sul;18;26;44;33
3118601;Contagem;3136702;Juiz de Fora;16;28;44;218
4314100;Passo Fundo;4316907;Santa Maria;12;32;44;210
2804805;Nossa Senhora do Socorro;3304557;Rio de Janeiro;9;35;44;1463
3511102;Catanduva;3556008;Urupês;3;41;44;32
4314902;Porto Alegre;4321204;Taquara;21;22;43;60
4204608;Criciúma;4216602;São José;21;22;43;139
4208203;Itajaí;4216602;São José;21;22;43;71
4204202;Chapecó;4209003;Joaçaba;21;22;43;107
3550308;São Paulo;4118402;Paranavaí;21;22;43;598
3531308;Monte Alto;3550308;São Paulo;21;22;43;321
3303500;Nova Iguaçu;3304144;Queimados;21;22;43;13
2611606;Recife;3205309;Vitória;21;22;43;1448
3105400;Barão de Cocais;3157203;Santa Bárbara;21;22;43;10
3105608;Barbacena;3106200;Belo Horizonte;21;22;43;145
2800308;Aracaju;2806701;São Cristóvão;21;22;43;15
2402006;Caicó;2408102;Natal;21;22;43;220
2207009;Oeiras;2208007;Picos;21;22;43;74
5105259;Lucas do Rio Verde;5107909;Sinop;20;23;43;140
4317202;Santa Rosa;4317509;Santo Ângelo;20;23;43;52
3524303;Jaboticabal;3550308;São Paulo;20;23;43;314
3530300;Mirassol;3549805;São José do Rio Preto;20;23;43;13
3516705;Garça;3529005;Marília;20;23;43;31
3131901;Itabirito;3146107;Ouro Preto;20;23;43;33
3170206;Uberlândia;4106902;Curitiba;19;24;43;730
3106200;Belo Horizonte;3131901;Itabirito;19;24;43;45
2408102;Natal;2927408;Salvador;19;24;43;866
2910800;Feira de Santana;2914802;Itabuna;19;24;43;279
2606408;Gravatá;2611606;Recife;19;24;43;70
3147907;Passos;3550308;São Paulo;18;25;43;326
4209300;Lages;4314902;Porto Alegre;16;27;43;263
3304557;Rio de Janeiro;4313409;Novo Hamburgo;13;30;43;1056
3534401;Osasco;3549904;São José dos Campos;11;32;43;100
1501402;Belém;2105302;Imperatriz;11;32;43;470
3525904;Jundiaí;5300108;Brasília;7;36;43;823
3521903;Itajobi;3528858;Marapoama;2;41;43;10
5107875;Sapezal;5107958;Tangará da Serra;21;21;42;227
5102504;Cáceres;5103403;Cuiabá;21;21;42;177
3502804;Araçatuba;5008305;Três Lagoas;21;21;42;143
4303905;Campo Bom;4319901;Sapiranga;21;21;42;6
4310207;Ijuí;4314902;Porto Alegre;21;21;42;319
3550308;São Paulo;4216206;São Francisco do Sul;21;21;42;351
4212502;Penha;4212809;Piçarras;21;21;42;8
3505708;Barueri;4208203;Itajaí;21;21;42;422
3549953;São Lourenço da Serra;3550308;São Paulo;21;21;42;37
3518800;Guarulhos;3543402;Ribeirão Preto;21;21;42;284
3205002;Serra;3505708;Barueri;21;21;42;761
3300209;Araruama;3304557;Rio de Janeiro;21;21;42;94
3300209;Araruama;3300704;Cabo Frio;21;21;42;28
3152105;Ponte Nova;3171303;Viçosa;21;21;42;40
2927408;Salvador;2928703;Santo Antônio de Jesus;21;21;42;90
5102678;Campo Verde;5107040;Primavera do Leste;20;22;42;88
4305108;Caxias do Sul;4322509;Vacaria;20;22;42;76
4314407;Pelotas;4318804;São Lourenço do Sul;20;22;42;56
3550308;São Paulo;4128104;Umuarama;20;22;42;680
4104808;Cascavel;4128104;Umuarama;20;22;42;134
4109401;Guarapuava;4118501;Pato Branco;20;22;42;152
4101606;Arapoti;4112009;Jaguariaíva;20;22;42;19
3515509;Fernandópolis;3549805;São José do Rio Preto;20;22;42;107
3504008;Assis;3529005;Marília;20;22;42;71
3170206;Uberlândia;3509502;Campinas;20;22;42;459
3302700;Maricá;3304557;Rio de Janeiro;20;22;42;46
3118601;Contagem;3167202;Sete Lagoas;20;22;42;55
2604007;Carpina;2611606;Recife;20;22;42;47
3303708;Paraíba do Sul;3306008;Três Rios;19;23;42;12
3301702;Duque de Caxias;3302502;Magé;19;23;42;30
2704302;Maceió;3505708;Barueri;18;24;42;1885
3304557;Rio de Janeiro;3503208;Araraquara;18;24;42;524
3300100;Angra dos Reis;3306305;Volta Redonda;18;24;42;50
4115804;Medianeira;4125704;São Miguel do Iguaçu;16;26;42;16
3534401;Osasco;3552205;Sorocaba;13;29;42;73
1501402;Belém;2211001;Teresina;13;29;42;747
3548500;Santos;4314902;Porto Alegre;12;30;42;820
3534401;Osasco;3548500;Santos;10;32;42;60
3528858;Marapoama;3545605;Santa Adélia;1;41;42;34
5002704;Campo Grande;5007695;São Gabriel do Oeste;20;21;41;114
4310330;Imbé;4321600;Tramandaí;20;21;41;2
4306106;Cruz Alta;4314902;Porto Alegre;20;21;41;277
4310207;Ijuí;4313904;Panambi;20;21;41;43
4204608;Criciúma;4210407;Maracajá;20;21;41;21
4115200;Maringá;4116901;Nova Esperança;20;21;41;39
3522307;Itapetininga;3554003;Tatuí;20;21;41;33
3522109;Itanhaém;3537602;Peruíbe;20;21;41;25
3523404;Itatiba;3525904;Jundiaí;20;21;41;20
3504008;Assis;3510005;Cândido Mota;20;21;41;11
4318705;São Leopoldo;4320008;Sapucaia do Sul;19;22;41;9
4305108;Caxias do Sul;4309100;Gramado;19;22;41;37
3547809;Santo André;4106902;Curitiba;19;22;41;340
4101408;Apucarana;4106902;Curitiba;19;22;41;299
3550308;São Paulo;3556503;Várzea Paulista;19;22;41;52
3537602;Peruíbe;3550308;São Paulo;19;22;41;80
3548708;São Bernardo do Campo;3549904;São José dos Campos;19;22;41;92
3201209;Cachoeiro de Itapemirim;3205002;Serra;19;22;41;113
2503209;Cabedelo;2611606;Recife;19;22;41;119
1302603;Manaus;1506807;Santarém;19;22;41;593
2606200;Goiana;2611606;Recife;18;23;41;62
4311403;Lajeado;4321451;Teutônia;17;24;41;22
4202909;Brusque;4209102;Joinville;17;24;41;90
2105302;Imperatriz;2304400;Fortaleza;17;24;41;1009
3518305;Guararema;3550308;São Paulo;15;26;41;67
3205309;Vitória;4314902;Porto Alegre;13;28;41;1482
3541406;Presidente Prudente;5300108;Brasília;10;31;41;796
3518800;Guarulhos;3548807;São Caetano do Sul;9;32;41;19
3503208;Araraquara;3543709;Rincão;9;32;41;24
3511102;Catanduva;3521903;Itajobi;8;33;41;20
3106200;Belo Horizonte;5103403;Cuiabá;20;20;40;1401
3304557;Rio de Janeiro;4118204;Paranaguá;20;20;40;606
3300704;Cabo Frio;3304524;Rio das Ostras;20;20;40;47
3301108;Cantagalo;3301504;Cordeiro;20;20;40;11
3203205;Linhares;3205002;Serra;20;20;40;90
3169901;Ubá;3172004;Visconde do Rio Branco;20;20;40;17
2905701;Camaçari;2910057;Dias d'Ávila;20;20;40;10
1501402;Belém;1600600;Santana;20;20;40;340
4300406;Alegrete;4322400;Uruguaiana;19;21;40;127
4305355;Charqueadas;4318408;São Jerônimo;19;21;40;9
4204202;Chapecó;4217204;São Miguel do Oeste;19;21;40;102
4211900;Palhoça;4215703;Santo Amaro da Imperatriz;19;21;40;6
4110706;Irati;4119905;Ponta Grossa;19;21;40;63
3550308;São Paulo;4105805;Colombo;19;21;40;314
3300308;Barra do Piraí;3306107;Valença;19;21;40;29
3300704;Cabo Frio;3302403;Macaé;19;21;40;59
3169604;Tupaciguara;3170206;Uberlândia;19;21;40;57
3115508;Caxambu;3163706;São Lourenço;19;21;40;20
3136702;Juiz de Fora;3143906;Muriaé;19;21;40;128
4106902;Curitiba;4204608;Criciúma;18;22;40;358
3506003;Bauru;4113700;Londrina;18;22;40;236
1506807;Santarém;3550308;São Paulo;18;22;40;2471
2611606;Recife;3548708;São Bernardo do Campo;18;22;40;2068
3543402;Ribeirão Preto;4113700;Londrina;17;23;40;415
3548708;São Bernardo do Campo;3554102;Taubaté;17;23;40;130
3300704;Cabo Frio;3550308;São Paulo;17;23;40;474
3529401;Mauá;3548807;São Caetano do Sul;17;23;40;13
3170206;Uberlândia;3505708;Barueri;17;23;40;529
4309605;Horizontina;4321808;Três de Maio;16;24;40;15
3102605;Andradas;3151800;Poços de Caldas;16;24;40;33
3550308;São Paulo;5211909;Jataí;15;25;40;838
3170206;Uberlândia;4314902;Porto Alegre;15;25;40;1264
1302603;Manaus;5103403;Cuiabá;12;28;40;1437
2105302;Imperatriz;2211001;Teresina;12;28;40;517
3547809;Santo André;4314902;Porto Alegre;10;30;40;834
3550001;São Luís do Paraitinga;3550308;São Paulo;9;31;40;145
3550308;São Paulo;4202909;Brusque;19;20;39;440
4114609;Marechal Cândido Rondon;4127700;Toledo;19;20;39;35
4105805;Colombo;4119152;Pinhais;19;20;39;22
3518800;Guarulhos;3552205;Sorocaba;19;20;39;96
3537800;Piedade;3550308;São Paulo;19;20;39;80
3170701;Varginha;3548500;Santos;19;20;39;282
3501608;Americana;3533403;Nova Odessa;19;20;39;4
3201506;Colatina;3205002;Serra;19;20;39;72
3201209;Cachoeiro de Itapemirim;3203320;Marataízes;19;20;39;33
3147006;Paracatu;3170404;Unaí;19;20;39;92
3136702;Juiz de Fora;3140803;Matias Barbosa;19;20;39;13
2109908;Santa Inês;2111300;São Luís;19;20;39;197
5001102;Aquidauana;5002704;Campo Grande;18;21;39;117
4305108;Caxias do Sul;4319000;São Marcos;18;21;39;23
4204202;Chapecó;4216602;São José;18;21;39;392
3205309;Vitória;4106902;Curitiba;18;21;39;1057
3300100;Angra dos Reis;3550308;São Paulo;18;21;39;254
3502101;Andradina;3550308;São Paulo;18;21;39;567
3106705;Betim;3548708;São Bernardo do Campo;18;21;39;481
3203205;Linhares;3304557;Rio de Janeiro;18;21;39;509
2607901;Jaboatão dos Guararapes;2609600;Olinda;18;21;39;20
3543402;Ribeirão Preto;4106902;Curitiba;17;22;39;497
3117876;Confins;3550308;São Paulo;17;22;39;519
3500105;Adamantina;3550308;São Paulo;17;22;39;500
3518800;Guarulhos;3530607;Moji das Cruzes;17;22;39;40
3509502;Campinas;3523404;Itatiba;17;22;39;25
1302603;Manaus;1303403;Parintins;17;22;39;369
1501402;Belém;4106902;Curitiba;16;23;39;2662
4104808;Cascavel;4119905;Ponta Grossa;15;24;39;332
3106200;Belo Horizonte;3303302;Niterói;14;25;39;342
3110301;Caldas;3151800;Poços de Caldas;7;32;39;24
5102504;Cáceres;5105622;Mirassol d'Oeste;19;19;38;59
4313409;Novo Hamburgo;4323804;Xangri-lá;19;19;38;103
4313300;Nova Prata;4314902;Porto Alegre;19;19;38;146
4208203;Itajaí;4216206;São Francisco do Sul;19;19;38;73
4202404;Blumenau;4204202;Chapecó;19;19;38;352
3519709;Ibiúna;3550308;São Paulo;19;19;38;58
3536703;Pederneiras;3550308;São Paulo;19;19;38;259
3302858;Mesquita;3304557;Rio de Janeiro;19;19;38;21
3104007;Araxá;3170206;Uberlândia;19;19;38;159
3132404;Itajubá;3152501;Pouso Alegre;19;19;38;54
3106200;Belo Horizonte;3143906;Muriaé;19;19;38;214
3136652;Juatuba;3140704;Mateus Leme;19;19;38;10
3101607;Alfenas;3139003;Machado;19;19;38;30
3104007;Araxá;3129509;Ibiá;19;19;38;46
3104908;Baependi;3115508;Caxambu;19;19;38;10
2304400;Fortaleza;2403251;Parnamirim;19;19;38;433
1100049;Cacoal;1100205;Porto Velho;19;19;38;395
1100122;Ji-Paraná;1100155;Ouro Preto do Oeste;19;19;38;49
5217609;Planaltina;5300108;Brasília;18;20;38;53
4314902;Porto Alegre;4317103;Santana do Livramento;18;20;38;418
4107207;Dois Vizinhos;4108403;Francisco Beltrão;18;20;38;38
3540200;Pontal;3551702;Sertãozinho;18;20;38;14
3306008;Três Rios;3550308;São Paulo;18;20;38;388
3509601;Campo Limpo Paulista;3550308;São Paulo;18;20;38;51
3513405;Cruzeiro;3550308;São Paulo;18;20;38;209
3540705;Porto Ferreira;3550308;São Paulo;18;20;38;216
3543907;Rio Claro;3548906;São Carlos;18;20;38;54
3518800;Guarulhos;3523107;Itaquaquecetuba;18;20;38;22
3304557;Rio de Janeiro;3306107;Valença;18;20;38;89
3302205;Itaperuna;3304557;Rio de Janeiro;18;20;38;238
3133808;Itaúna;3147105;Pará de Minas;18;20;38;28
2925303;Porto Seguro;2927408;Salvador;18;20;38;387
2604007;Carpina;2615300;Timbaúba;18;20;38;37
2304400;Fortaleza;2312403;São Gonçalo do Amarante;18;20;38;51
5211909;Jataí;5213103;Mineiros;17;21;38;99
4305355;Charqueadas;4314902;Porto Alegre;17;21;38;42
4304804;Carlos Barbosa;4307906;Farroupilha;17;21;38;18
3304557;Rio de Janeiro;3554102;Taubaté;17;21;38;238
3518701;Guarujá;3551009;São Vicente;17;21;38;18
3509502;Campinas;3530805;Moji-Mirim;17;21;38;53
3509007;Caieiras;3516408;Franco da Rocha;17;21;38;5
2602902;Cabo de Santo Agostinho;3304557;Rio de Janeiro;17;21;38;1808
3302403;Macaé;3303302;Niterói;17;21;38;136
3106200;Belo Horizonte;3147105;Pará de Minas;17;21;38;67
2918407;Juazeiro;2927408;Salvador;17;21;38;447
2611606;Recife;2910800;Feira de Santana;17;21;38;634
2304400;Fortaleza;2504009;Campina Grande;17;21;38;479
4113700;Londrina;4209102;Joinville;16;22;38;400
4108304;Foz do Iguaçu;4115804;Medianeira;16;22;38;47
3304557;Rio de Janeiro;4108304;Foz do Iguaçu;16;22;38;1156
1302603;Manaus;1500800;Ananindeua;16;22;38;1312
4314902;Porto Alegre;5103403;Cuiabá;15;23;38;1697
4317202;Santa Rosa;4317905;Santo Cristo;15;23;38;21
4304705;Carazinho;4312658;Não-Me-Toque;15;23;38;19
3549805;São José do Rio Preto;4113700;Londrina;15;23;38;327
4310207;Ijuí;4314100;Passo Fundo;14;24;38;150
1501402;Belém;3505708;Barueri;13;25;38;2453
2507507;João Pessoa;2704302;Maceió;12;26;38;288
4306403;Dois Irmãos;4314902;Porto Alegre;9;29;38;54
5103403;Cuiabá;5105259;Lucas do Rio Verde;18;19;37;277
4304663;Capão do Leão;4314407;Pelotas;18;19;37;11
4201406;Araranguá;4218707;Tubarão;18;19;37;67
4205407;Florianópolis;4205704;Garopaba;18;19;37;50
3106200;Belo Horizonte;4205407;Florianópolis;18;19;37;956
4204202;Chapecó;4205407;Florianópolis;18;19;37;408
4104808;Cascavel;4118501;Pato Branco;18;19;37;163
3508504;Caçapava;3554102;Taubaté;18;19;37;17
3528403;Mairinque;3550605;São Roque;18;19;37;5
3522604;Itapira;3530805;Moji-Mirim;18;19;37;15
3504503;Avaré;3507506;Botucatu;18;19;37;56
2606804;Igarassu;2611606;Recife;18;19;37;31
2304400;Fortaleza;2305233;Horizonte;18;19;37;37
5002704;Campo Grande;5008008;Terenos;17;20;37;22
4300406;Alegrete;4314902;Porto Alegre;17;20;37;440
4304408;Canela;4314902;Porto Alegre;17;20;37;88
4304507;Canguçu;4314407;Pelotas;17;20;37;46
4208203;Itajaí;4208906;Jaraguá do Sul;17;20;37;61
4106902;Curitiba;4119954;Pontal do Paraná;17;20;37;83
3548500;Santos;4106902;Curitiba;17;20;37;340
3147006;Paracatu;3550308;São Paulo;17;20;37;711
3515509;Fernandópolis;3550308;São Paulo;17;20;37;521
3526704;Leme;3550308;São Paulo;17;20;37;179
3503901;Arujá;3518800;Guarulhos;17;20;37;25
3118601;Contagem;3505708;Barueri;17;20;37;487
2700300;Arapiraca;2706703;Penedo;17;20;37;58
2604106;Caruaru;2606002;Garanhuns;17;20;37;86
2504009;Campina Grande;2510808;Patos;17;20;37;154
2208403;Piripiri;2211001;Teresina;17;20;37;144
3523107;Itaquaquecetuba;3530607;Moji das Cruzes;16;21;37;18
3204906;São Mateus;3205309;Vitória;16;21;37;171
3505708;Barueri;4113700;Londrina;15;22;37;439
2903201;Barreiras;3550308;São Paulo;15;22;37;1277
5218805;Rio Verde;5300108;Brasília;13;24;37;392
3118601;Contagem;3122306;Divinópolis;13;24;37;88
3205002;Serra;5300108;Brasília;10;27;37;954
3538709;Piracicaba;5300108;Brasília;6;31;37;769
5105200;Juscimeira;5201108;Anápolis;1;36;37;637
4115200;Maringá;5002704;Campo Grande;18;18;36;439
4318002;São Borja;4322400;Uruguaiana;18;18;36;162
3518800;Guarulhos;4305108;Caxias do Sul;18;18;36;770
4202800;Braço do Norte;4218707;Tubarão;18;18;36;27
4118501;Pato Branco;4216909;São Lourenço do Oeste;18;18;36;27
3518800;Guarulhos;4209102;Joinville;18;18;36;388
4106902;Curitiba;4113205;Lapa;18;18;36;56
3509502;Campinas;3556701;Vinhedo;18;18;36;17
3538709;Piracicaba;3550407;São Pedro;18;18;36;36
3151800;Poços de Caldas;3549102;São João da Boa Vista;18;18;36;35
3526902;Limeira;3543907;Rio Claro;18;18;36;25
3522604;Itapira;3530706;Mogi Guaçu;18;18;36;18
3205002;Serra;3518800;Guarulhos;18;18;36;730
3300308;Barra do Piraí;3306305;Volta Redonda;18;18;36;28
3302700;Maricá;3303302;Niterói;18;18;36;29
3169901;Ubá;3171303;Viçosa;18;18;36;37
3169406;Três Pontas;3170701;Varginha;18;18;36;19
3106200;Belo Horizonte;3151800;Poços de Caldas;18;18;36;335
3106200;Belo Horizonte;3131703;Itabira;18;18;36;83
2905206;Caetité;2911709;Guanambi;18;18;36;38
2403251;Parnamirim;2611606;Recife;18;18;36;247
2507507;João Pessoa;2607901;Jaboatão dos Guararapes;18;18;36;104
2604106;Caruaru;2607901;Jaboatão dos Guararapes;18;18;36;108
1500800;Ananindeua;1502400;Castanhal;18;18;36;52
5103205;Colíder;5107909;Sinop;17;19;36;115
3550308;São Paulo;4218707;Tubarão;17;19;36;583
3550308;São Paulo;4211306;Navegantes;17;19;36;409
3106200;Belo Horizonte;4209102;Joinville;17;19;36;852
4105508;Cianorte;4128104;Umuarama;17;19;36;74
4104659;Carambeí;4119905;Ponta Grossa;17;19;36;22
3304557;Rio de Janeiro;3552809;Taboão da Serra;17;19;36;366
3533403;Nova Odessa;3552403;Sumaré;17;19;36;7
2906501;Candeias;3550308;São Paulo;17;19;36;1455
3201506;Colatina;3550308;São Paulo;17;19;36;758
3203205;Linhares;3550308;São Paulo;17;19;36;818
3524808;Jales;3550308;São Paulo;17;19;36;543
3138203;Lavras;3170701;Varginha;17;19;36;51
3147907;Passos;3164704;São Sebastião do Paraíso;17;19;36;44
3106200;Belo Horizonte;3148004;Patos de Minas;17;19;36;305
2910057;Dias d'Ávila;2927408;Salvador;17;19;36;46
2922003;Mucuri;2923001;Nova Viçosa;17;19;36;16
2803500;Lagarto;2807105;Simão Dias;17;19;36;21
2403251;Parnamirim;2408003;Mossoró;17;19;36;245
2101400;Balsas;2111300;São Luís;17;19;36;587
1500107;Abaetetuba;1501402;Belém;17;19;36;60
1100114;Jaru;1100122;Ji-Paraná;17;19;36;91
3547304;Santana de Parnaíba;5300108;Brasília;16;20;36;852
3505708;Barueri;5002704;Campo Grande;16;20;36;889
2607901;Jaboatão dos Guararapes;4314902;Porto Alegre;16;20;36;2833
4204202;Chapecó;4219705;Xaxim;16;20;36;19
4206207;Gravatal;4218707;Tubarão;16;20;36;17
4203808;Canoinhas;4210100;Mafra;16;20;36;58
3541406;Presidente Prudente;4113700;Londrina;16;20;36;131
3505708;Barueri;3552809;Taboão da Serra;16;20;36;14
2919553;Luís Eduardo magalhães;3550308;São Paulo;16;20;36;1281
3547809;Santo André;3549904;São José dos Campos;16;20;36;83
3106200;Belo Horizonte;3120904;Curvelo;16;20;36;137
2918001;Jequié;2933307;Vitória da Conquista;16;20;36;143
2611606;Recife;2613909;Serra Talhada;16;20;36;372
1501402;Belém;1502202;Capanema;16;20;36;140
4306403;Dois Irmãos;4313409;Novo Hamburgo;15;21;36;13
3522505;Itapevi;3534401;Osasco;15;21;36;16
2611101;Petrolina;3304557;Rio de Janeiro;15;21;36;1526
3136702;Juiz de Fora;3303906;Petrópolis;15;21;36;87
3504107;Atibaia;3509502;Campinas;14;22;36;57
2910800;Feira de Santana;3304557;Rio de Janeiro;14;22;36;1248
3552205;Sorocaba;4314902;Porto Alegre;10;26;36;806
3118601;Contagem;3534401;Osasco;10;26;36;484
4104808;Cascavel;5300108;Brasília;6;30;36;1181
3511102;Catanduva;3511201;Catiguá;6;30;36;13
3550308;São Paulo;4113205;Lapa;4;32;36;385
4306809;Encantado;4311403;Lajeado;17;18;35;25
4202909;Brusque;4217709;Sombrio;17;18;35;234
4202909;Brusque;4216305;São João Batista;17;18;35;21
4205407;Florianópolis;4209300;Lages;17;18;35;181
4106902;Curitiba;4110706;Irati;17;18;35;135
3550308;São Paulo;4104303;Campo Mourão;17;18;35;584
3508405;Cabreúva;3550308;São Paulo;17;18;35;62
3514403;Dracena;3550308;São Paulo;17;18;35;549
3170206;Uberlândia;3549805;São José do Rio Preto;17;18;35;243
3505708;Barueri;3549805;São José do Rio Preto;17;18;35;398
3502804;Araçatuba;3543402;Ribeirão Preto;17;18;35;277
3204906;São Mateus;3304557;Rio de Janeiro;17;18;35;571
3300605;Bom Jesus do Itabapoana;3302205;Itaperuna;17;18;35;22
2900702;Alagoinhas;2927408;Salvador;17;18;35;95
4314407;Pelotas;4317301;Santa Vitória do Palmar;16;19;35;220
3134905;Jacutinga;4307906;Farroupilha;16;19;35;889
4204202;Chapecó;4307005;Erechim;16;19;35;67
4301602;Bagé;4306601;Dom Pedrito;16;19;35;67
4204806;Curitibanos;4209300;Lages;16;19;35;64
3504107;Atibaia;3525904;Jundiaí;16;19;35;37
3144805;Nova Lima;3304557;Rio de Janeiro;16;19;35;323
3170701;Varginha;3304557;Rio de Janeiro;16;19;35;266
2906501;Candeias;2930709;Simões Filho;16;19;35;20
2903201;Barreiras;2927408;Salvador;16;19;35;710
4202008;Balneário Camboriú;4314902;Porto Alegre;15;20;35;416
3106200;Belo Horizonte;4305108;Caxias do Sul;15;20;35;1227
4106902;Curitiba;4204202;Chapecó;15;20;35;377
2918407;Juazeiro;3550308;São Paulo;15;20;35;1680
2903201;Barreiras;5300108;Brasília;14;21;35;506
4305108;Caxias do Sul;4318705;São Leopoldo;14;21;35;67
4314100;Passo Fundo;4317509;Santo Ângelo;14;21;35;184
4306809;Encantado;4314902;Porto Alegre;14;21;35;114
3122306;Divinópolis;3304557;Rio de Janeiro;14;21;35;343
3510203;Capão Bonito;3550308;São Paulo;13;22;35;178
3118601;Contagem;5208707;Goiânia;11;24;35;664
4115200;Maringá;4314902;Porto Alegre;11;24;35;737
3534401;Osasco;5103403;Cuiabá;10;25;35;1351
3525904;Jundiaí;4314902;Porto Alegre;10;25;35;861
3205200;Vila Velha;5300108;Brasília;8;27;35;961
3534401;Osasco;4205407;Florianópolis;8;27;35;480
2927408;Salvador;3548807;São Caetano do Sul;7;28;35;1422
3534401;Osasco;3548807;São Caetano do Sul;7;28;35;24
5208707;Goiânia;5211909;Jataí;17;17;34;288
5205109;Catalão;5208707;Goiânia;17;17;34;217
5103403;Cuiabá;5201405;Aparecida de Goiânia;17;17;34;740
5103403;Cuiabá;5107800;Santo Antônio do Leverger;17;17;34;30
4310108;Igrejinha;4321709;Três Coroas;17;17;34;6
4304630;Capão da Canoa;4321600;Tramandaí;17;17;34;27
4302352;Bom Princípio;4308102;Feliz;17;17;34;6
4202453;Bombinhas;4208302;Itapema;17;17;34;12
4118204;Paranaguá;4208203;Itajaí;17;17;34;152
4114203;Mandaguari;4115200;Maringá;17;17;34;27
3533403;Nova Odessa;3550308;São Paulo;17;17;34;119
3534302;Orlândia;3549409;São Joaquim da Barra;17;17;34;14
3205309;Vitória;3548500;Santos;17;17;34;729
3303906;Petrópolis;3305802;Teresópolis;17;17;34;24
3200607;Aracruz;3205002;Serra;17;17;34;35
3151206;Pirapora;3170800;Várzea da Palma;17;17;34;34
3143906;Muriaé;3169901;Ubá;17;17;34;67
3135209;Januária;3143302;Montes Claros;17;17;34;150
1100205;Porto Velho;3106200;Belo Horizonte;17;17;34;2373
2704302;Maceió;2708600;São Miguel dos Campos;17;17;34;42
1501402;Belém;2611606;Recife;17;17;34;1657
2304400;Fortaleza;2307601;Limoeiro do Norte;17;17;34;161
2304400;Fortaleza;2306405;Itapipoca;17;17;34;120
5002704;Campo Grande;5002951;Chapadão do Sul;16;18;34;280
4316402;Rosário do Sul;4318309;São Gabriel;16;18;34;63
4316907;Santa Maria;4317400;Santiago;16;18;34;116
4303509;Camaquã;4314407;Pelotas;16;18;34;112
4208302;Itapema;4218004;Tijucas;16;18;34;17
4202008;Balneário Camboriú;4216602;São José;16;18;34;66
4208500;Ituporanga;4214805;Rio do Sul;16;18;34;19
4204202;Chapecó;4209300;Lages;16;18;34;238
4204608;Criciúma;4209300;Lages;16;18;34;134
4117701;Palmeira;4119905;Ponta Grossa;16;18;34;39
4115200;Maringá;4117503;Paiçandu;16;18;34;13
3506003;Bauru;4106902;Curitiba;16;18;34;343
3538709;Piracicaba;3554508;Tietê;16;18;34;39
2925303;Porto Seguro;3550308;São Paulo;16;18;34;1096
3539301;Pirassununga;3550308;São Paulo;16;18;34;199
3509502;Campinas;3548005;Santo Antônio de Posse;16;18;34;36
3524303;Jaboticabal;3543402;Ribeirão Preto;16;18;34;54
3529005;Marília;3534708;Ourinhos;16;18;34;84
3505708;Barueri;3525003;Jandira;16;18;34;3
3143401;Monte Sião;3500501;Águas de Lindóia;16;18;34;8
3303203;Nilópolis;3305109;São João de Meriti;16;18;34;6
3131307;Ipatinga;3304557;Rio de Janeiro;16;18;34;385
3303302;Niterói;3303906;Petrópolis;16;18;34;41
3106200;Belo Horizonte;3117876;Confins;16;18;34;30
2606200;Goiana;2615300;Timbaúba;16;18;34;35
1100122;Ji-Paraná;1100304;Vilhena;16;18;34;280
4104808;Cascavel;4115804;Medianeira;15;19;34;75
3304557;Rio de Janeiro;3538709;Piracicaba;15;19;34;451
2304400;Fortaleza;3509502;Campinas;15;19;34;2276
3550308;São Paulo;5107925;Sorriso;14;20;34;1596
3505708;Barueri;4125506;São José dos Pinhais;14;20;34;321
3520509;Indaiatuba;3552205;Sorocaba;14;20;34;51
3304557;Rio de Janeiro;3513504;Cubatão;14;20;34;340
3142809;Monte Alegre de Minas;3170206;Uberlândia;14;20;34;65
3550308;São Paulo;5107040;Primavera do Leste;13;21;34;1234
3509502;Campinas;4113700;Londrina;11;23;34;421
2504009;Campina Grande;5300108;Brasília;8;26;34;1584
4304606;Canoas;5300108;Brasília;7;27;34;1604
3511102;Catanduva;3511300;Cedral;2;32;34;40
3501806;Américo de Campos;3545605;Santa Adélia;1;33;34;142
5208707;Goiânia;5220108;São Luís de Montes Belos;16;17;33;117
5101704;Barra do Bugres;5107958;Tangará da Serra;16;17;33;57
4314902;Porto Alegre;4322608;Venâncio Aires;16;17;33;109
4310108;Igrejinha;4321204;Taquara;16;17;33;9
4301008;Arroio do Meio;4311403;Lajeado;16;17;33;9
3552205;Sorocaba;3554003;Tatuí;16;17;33;39
3159605;Santa Rita do Sapucaí;3550308;São Paulo;16;17;33;183
3502754;Araçariguama;3550308;São Paulo;16;17;33;48
3506003;Bauru;3536703;Pederneiras;16;17;33;32
3502507;Aparecida;3518404;Guaratinguetá;16;17;33;7
3502804;Araçatuba;3506003;Bauru;16;17;33;188
2914802;Itabuna;3304557;Rio de Janeiro;16;17;33;980
3201506;Colatina;3205200;Vila Velha;16;17;33;91
3200409;Anchieta;3202405;Guarapari;16;17;33;25
3118601;Contagem;3144805;Nova Lima;16;17;33;27
2914604;Irecê;2933604;Xique-Xique;16;17;33;110
2915601;Itamaraju;2931350;Teixeira de Freitas;16;17;33;61
2602902;Cabo de Santo Agostinho;2607208;Ipojuca;16;17;33;13
2504009;Campina Grande;2604106;Caruaru;16;17;33;119
1505304;Oriximiná;1506807;Santarém;16;17;33;146
1500602;Altamira;1501402;Belém;16;17;33;467
4204301;Concórdia;4307005;Erechim;15;18;33;52
4302105;Bento Gonçalves;4304804;Carlos Barbosa;15;18;33;15
4202404;Blumenau;4204608;Criciúma;15;18;33;192
3525904;Jundiaí;4106902;Curitiba;15;18;33;345
3506003;Bauru;3552205;Sorocaba;15;18;33;205
3550605;São Roque;3552205;Sorocaba;15;18;33;38
3509502;Campinas;3547304;Santana de Parnaíba;15;18;33;62
3513108;Cravinhos;3543402;Ribeirão Preto;15;18;33;22
3539202;Pirapozinho;3541406;Presidente Prudente;15;18;33;19
2927408;Salvador;3509502;Campinas;15;18;33;1391
2403251;Parnamirim;3304557;Rio de Janeiro;15;18;33;2035
3300456;Belford Roxo;3303500;Nova Iguaçu;15;18;33;8
3301009;Campos dos Goytacazes;3303302;Niterói;15;18;33;218
3106200;Belo Horizonte;3138203;Lavras;15;18;33;181
2211001;Teresina;2611606;Recife;15;18;33;927
4113700;Londrina;5103403;Cuiabá;14;19;33;1014
3550308;São Paulo;5006903;Porto Murtinho;14;19;33;1190
4307708;Esteio;4313409;Novo Hamburgo;14;19;33;18
3549805;São José do Rio Preto;4106902;Curitiba;14;19;33;511
2304400;Fortaleza;3170206;Uberlândia;14;19;33;1947
1501402;Belém;1503606;Itaituba;14;19;33;896
3522604;Itapira;3550308;São Paulo;13;20;33;136
3538006;Pindamonhangaba;3549904;São José dos Campos;13;20;33;53
3118601;Contagem;3205002;Serra;13;20;33;396
4304606;Canoas;4314100;Passo Fundo;12;21;33;219
2105401;Itapecuru Mirim;2111300;São Luís;12;21;33;96
3205309;Vitória;3534401;Osasco;11;22;33;749
3303302;Niterói;3505708;Barueri;11;22;33;391
3304904;São Gonçalo;3505708;Barueri;11;22;33;396
2304400;Fortaleza;2933307;Vitória da Conquista;10;23;33;1251
3301009;Campos dos Goytacazes;5300108;Brasília;6;27;33;978
3303906;Petrópolis;5300108;Brasília;6;27;33;904
3513702;Descalvado;3547502;Santa Rita do Passa Quatro;6;27;33;26
5213103;Mineiros;5218805;Rio Verde;16;16;32;174
4314803;Portão;4318705;São Leopoldo;16;16;32;11
4106902;Curitiba;4215802;São Bento do Sul;16;16;32;92
4110706;Irati;4120606;Prudentópolis;16;16;32;49
3549805;São José do Rio Preto;4115200;Maringá;16;16;32;386
2307304;Juazeiro do Norte;3550308;São Paulo;16;16;32;1954
3525102;Jardinópolis;3550308;São Paulo;16;16;32;313
3531803;Monte Mor;3550308;São Paulo;16;16;32;103
3106200;Belo Horizonte;3549904;São José dos Campos;16;16;32;413
2905701;Camaçari;3548708;São Bernardo do Campo;16;16;32;1467
3502804;Araçatuba;3541406;Presidente Prudente;16;16;32;139
3301009;Campos dos Goytacazes;3305000;São João da Barra;16;16;32;29
1600303;Macapá;3304557;Rio de Janeiro;16;16;32;2653
2927408;Salvador;3205309;Vitória;16;16;32;825
3203908;Nova Venécia;3204906;São Mateus;16;16;32;54
3114204;Carmo do Cajuru;3122306;Divinópolis;16;16;32;12
2910800;Feira de Santana;2919207;Lauro de Freitas;16;16;32;96
2408102;Natal;2607901;Jaboatão dos Guararapes;16;16;32;256
5208707;Goiânia;5213806;Morrinhos;15;17;32;116
5002951;Chapadão do Sul;5003256;Costa Rica;15;17;32;67
4208906;Jaraguá do Sul;4217402;Schroeder;15;17;32;8
4202909;Brusque;4207502;Indaial;15;17;32;38
3547304;Santana de Parnaíba;4106902;Curitiba;15;17;32;324
3552205;Sorocaba;4106902;Curitiba;15;17;32;281
4104808;Cascavel;4106308;Corbélia;15;17;32;24
3537800;Piedade;3552205;Sorocaba;15;17;32;26
3101607;Alfenas;3550308;São Paulo;15;17;32;259
1200401;Rio Branco;3304557;Rio de Janeiro;15;17;32;2823
3143906;Muriaé;3302205;Itaperuna;15;17;32;47
3135050;Jaíba;3135100;Janaúba;15;17;32;67
2903904;Bom Jesus da Lapa;2911709;Guanambi;15;17;32;128
2800308;Aracaju;2802106;Estância;15;17;32;57
4207304;Imbituba;4218707;Tubarão;14;18;32;44
4105508;Cianorte;4202909;Brusque;14;18;32;524
4104808;Cascavel;4117909;Palotina;14;18;32;80
3305802;Teresópolis;3550308;São Paulo;14;18;32;394
3550209;São Miguel Arcanjo;3550308;São Paulo;14;18;32;140
2800308;Aracaju;2910800;Feira de Santana;14;18;32;255
5107958;Tangará da Serra;5108402;Várzea Grande;13;19;32;181
3300456;Belford Roxo;3550308;São Paulo;13;19;32;345
2927408;Salvador;3548708;São Bernardo do Campo;13;19;32;1432
3505708;Barueri;3538709;Piracicaba;13;19;32;115
2303501;Cascavel;2304400;Fortaleza;13;19;32;52
2105302;Imperatriz;5300108;Brasília;12;20;32;1140
4317202;Santa Rosa;4322301;Tuparendi;12;20;32;13
3304557;Rio de Janeiro;3534708;Ourinhos;11;21;32;681
1302603;Manaus;2111300;São Luís;11;21;32;1758
1302603;Manaus;1600303;Macapá;11;21;32;1056
2607901;Jaboatão dos Guararapes;5300108;Brasília;8;24;32;1604
3549805;São José do Rio Preto;4314902;Porto Alegre;8;24;32;1036
4119905;Ponta Grossa;5300108;Brasília;6;26;32;1058
4314407;Pelotas;5300108;Brasília;6;26;32;1833
2910800;Feira de Santana;5300108;Brasília;5;27;32;1029
4216602;São José;5300108;Brasília;5;27;32;1306
3511508;Cerquilho;3511607;Cesário Lange;2;30;32;22
3550308;São Paulo;5101803;Barra do Garças;15;16;31;1064
5002605;Camapuã;5002704;Campo Grande;15;16;31;117
4304705;Carazinho;4314902;Porto Alegre;15;16;31;247
4308607;Garibaldi;4314902;Porto Alegre;15;16;31;94
4202404;Blumenau;4211306;Navegantes;15;16;31;41
4104808;Cascavel;4204202;Chapecó;15;16;31;253
4106902;Curitiba;4127106;Telêmaco Borba;15;16;31;184
2610707;Paulista;3550308;São Paulo;15;16;31;2086
3529401;Mauá;3543303;Ribeirão Pires;15;16;31;5
3304557;Rio de Janeiro;3529401;Mauá;15;16;31;337
3106200;Belo Horizonte;3525904;Jundiaí;15;16;31;468
3523909;Itu;3525904;Jundiaí;15;16;31;42
3303401;Nova Friburgo;3305802;Teresópolis;15;16;31;47
2913606;Ilhéus;3304557;Rio de Janeiro;15;16;31;987
3202207;Fundão;3205309;Vitória;15;16;31;37
3202504;Ibiraçu;3205309;Vitória;15;16;31;47
3203205;Linhares;3205200;Vila Velha;15;16;31;114
3106200;Belo Horizonte;3168705;Timóteo;15;16;31;145
3131307;Ipatinga;3158953;Santana do Paraíso;15;16;31;12
3104007;Araxá;3148004;Patos de Minas;15;16;31;121
2900702;Alagoinhas;2907509;Catu;15;16;31;27
2905701;Camaçari;2906501;Candeias;15;16;31;24
2800308;Aracaju;2807402;Tobias Barreto;15;16;31;106
2307601;Limoeiro do Norte;2311801;Russas;15;16;31;27
1502707;Conceição do Araguaia;1506138;Redenção;15;16;31;82
1501709;Bragança;1502202;Capanema;15;16;31;51
1302603;Manaus;1303536;Presidente Figueiredo;15;16;31;120
1100049;Cacoal;1100304;Vilhena;15;16;31;208
3304557;Rio de Janeiro;5201108;Anápolis;14;17;31;955
3205002;Serra;4314902;Porto Alegre;14;17;31;1492
4304804;Carlos Barbosa;4308607;Garibaldi;14;17;31;5
4204202;Chapecó;4208203;Itajaí;14;17;31;385
4113700;Londrina;4126678;Tamarana;14;17;31;47
3550308;São Paulo;4118501;Pato Branco;14;17;31;659
3104007;Araxá;3550308;São Paulo;14;17;31;451
3537305;Penápolis;3550308;São Paulo;14;17;31;424
3510401;Capivari;3538709;Piracicaba;14;17;31;30
3300456;Belford Roxo;3305109;São João de Meriti;14;17;31;4
3302205;Itaperuna;3304706;Santo Antônio de Pádua;14;17;31;53
2301109;Aracati;2304400;Fortaleza;14;17;31;125
3534401;Osasco;4208203;Itajaí;13;18;31;423
3303203;Nilópolis;3550308;São Paulo;13;18;31;340
3549706;São José do Rio Pardo;3550308;São Paulo;13;18;31;229
3538709;Piracicaba;3543402;Ribeirão Preto;13;18;31;178
3525904;Jundiaí;3538709;Piracicaba;13;18;31;90
3541000;Praia Grande;3548708;São Bernardo do Campo;12;19;31;37
4306106;Cruz Alta;4314100;Passo Fundo;11;20;31;125
3301702;Duque de Caxias;4106902;Curitiba;11;20;31;665
3503208;Araraquara;3542909;Ribeirão Bonito;6;25;31;31
3556909;Vista Alegre do Alto;5201504;Aporé;1;30;31;426
5212501;Luziânia;5221858;Valparaíso de Goiás;15;15;30;22
5208707;Goiânia;5210000;Inhumas;15;15;30;43
1721000;Palmas;5201405;Aparecida de Goiânia;15;15;30;720
4313300;Nova Prata;4322806;Veranópolis;15;15;30;18
4313409;Novo Hamburgo;4321204;Taquara;15;15;30;34
4314902;Porto Alegre;4318309;São Gabriel;15;15;30;299
4305108;Caxias do Sul;4316907;Santa Maria;15;15;30;262
4210506;Maravilha;4217204;São Miguel do Oeste;15;15;30;38
4206900;Ibirama;4214003;Presidente Getúlio;15;15;30;10
4208302;Itapema;4213500;Porto Belo;15;15;30;9
4204608;Criciúma;4211702;Orleans;15;15;30;38
4118204;Paranaguá;4125506;São José dos Pinhais;15;15;30;63
4101507;Arapongas;4122701;Sabáudia;15;15;30;16
4106902;Curitiba;4117701;Palmeira;15;15;30;72
3515509;Fernandópolis;3557105;Votuporanga;15;15;30;33
3525904;Jundiaí;3556206;Valinhos;15;15;30;25
3539806;Poá;3552502;Suzano;15;15;30;5
3205101;Viana;3550308;São Paulo;15;15;30;711
3504008;Assis;3535507;Paraguaçu Paulista;15;15;30;33
3506003;Bauru;3526803;Lençóis Paulista;15;15;30;40
3170107;Uberaba;3520103;Igarapava;15;15;30;38
1500800;Ananindeua;3518800;Guarulhos;15;15;30;2447
2111300;São Luís;3518800;Guarulhos;15;15;30;2323
3300407;Barra Mansa;3518800;Guarulhos;15;15;30;261
3506359;Bertioga;3518701;Guarujá;15;15;30;19
3304557;Rio de Janeiro;3305208;São Pedro da Aldeia;15;15;30;118
3302601;Mangaratiba;3304557;Rio de Janeiro;15;15;30;79
3300100;Angra dos Reis;3303807;Parati;15;15;30;55
3106200;Belo Horizonte;3302403;Macaé;15;15;30;346
3104007;Araxá;3170107;Uberaba;15;15;30;103
3162500;São João del Rei;3168804;Tiradentes;15;15;30;12
3132404;Itajubá;3163706;São Lourenço;15;15;30;56
3104205;Arcos;3126109;Formiga;15;15;30;23
3113305;Carangola;3124203;Espera Feliz;15;15;30;16
2604007;Carpina;2608909;Limoeiro;15;15;30;23
2601706;Belo Jardim;2604106;Caruaru;15;15;30;48
2108603;Pinheiro;2111300;São Luís;15;15;30;99
3147006;Paracatu;5300108;Brasília;14;16;30;190
5218805;Rio Verde;5219308;Santa Helena de Goiás;14;16;30;36
4300604;Alvorada;4323002;Viamão;14;16;30;12
4314902;Porto Alegre;4319901;Sapiranga;14;16;30;50
4310207;Ijuí;4317202;Santa Rosa;14;16;30;79
4202909;Brusque;4216602;São José;14;16;30;59
3304557;Rio de Janeiro;4204202;Chapecó;14;16;30;1026
3106200;Belo Horizonte;4202404;Blumenau;14;16;30;923
3170206;Uberlândia;4113700;Londrina;14;16;30;567
3134905;Jacutinga;3550308;São Paulo;14;16;30;151
3301900;Itaboraí;3550308;São Paulo;14;16;30;399
3534609;Osvaldo Cruz;3550308;São Paulo;14;16;30;475
3522505;Itapevi;3525003;Jandira;14;16;30;5
3518602;Guariba;3524303;Jaboticabal;14;16;30;14
3302403;Macaé;3505708;Barueri;14;16;30;522
2916401;Itapetinga;2933307;Vitória da Conquista;14;16;30;79
2910727;Eunápolis;2914802;Itabuna;14;16;30;178
2700300;Arapiraca;2800308;Aracaju;14;16;30;131
2704302;Maceió;2706307;Palmeira dos Índios;14;16;30;101
2611606;Recife;2615300;Timbaúba;14;16;30;80
2304400;Fortaleza;2611101;Petrolina;14;16;30;650
2402600;Ceará-Mirim;2408102;Natal;14;16;30;26
2203909;Floriano;2208007;Picos;14;16;30;174
4305108;Caxias do Sul;4311403;Lajeado;13;17;30;88
3550308;São Paulo;4309308;Guaíba;13;17;30;840
3550308;São Paulo;4106407;Cornélio Procópio;13;17;30;414
3205200;Vila Velha;3505708;Barueri;13;17;30;745
3201209;Cachoeiro de Itapemirim;3205036;Vargem Alta;13;17;30;19
1502202;Capanema;1502400;Castanhal;13;17;30;81
1100122;Ji-Paraná;1302603;Manaus;13;17;30;890
5103403;Cuiabá;5106224;Nova Mutum;12;18;30;190
4104808;Cascavel;4314902;Porto Alegre;12;18;30;604
3105608;Barbacena;3550308;São Paulo;12;18;30;396
3134202;Ituiutaba;3550308;São Paulo;12;18;30;590
3513801;Diadema;3548807;São Caetano do Sul;12;18;30;9
3541406;Presidente Prudente;3542404;Regente Feijó;12;18;30;13
3303906;Petrópolis;3305109;São João de Meriti;12;18;30;33
3205101;Viana;3205309;Vitória;12;18;30;33
2914604;Irecê;2927408;Salvador;12;18;30;409
2503704;Cajazeiras;2507507;João Pessoa;12;18;30;413
3106705;Betim;5300108;Brasília;11;19;30;612
2408102;Natal;3505708;Barueri;11;19;30;2264
2611101;Petrolina;2907202;Casa Nova;11;19;30;46
4125506;São José dos Pinhais;5300108;Brasília;10;20;30;1086
3143401;Monte Sião;3550308;São Paulo;10;20;30;135
2704302;Maceió;2804805;Nossa Senhora do Socorro;10;20;30;203
3106200;Belo Horizonte;4113700;Londrina;9;21;30;817
3118601;Contagem;3157807;Santa Luzia;9;21;30;30
5003702;Dourados;5300108;Brasília;8;22;30;1033
3534401;Osasco;3549805;São José do Rio Preto;8;22;30;406
3503208;Araraquara;5300108;Brasília;7;23;30;662
3534401;Osasco;4202404;Blumenau;7;23;30;440
3534401;Osasco;4113700;Londrina;7;23;30;447
4108304;Foz do Iguaçu;5300108;Brasília;6;24;30;1296
3303302;Niterói;4314902;Porto Alegre;6;24;30;1098
3534401;Osasco;4209102;Joinville;6;24;30;367
4316907;Santa Maria;5300108;Brasília;5;25;30;1674
5107404;São Pedro da Cipa;5201108;Anápolis;1;29;30;639
3550308;São Paulo;5221858;Valparaíso de Goiás;14;15;29;852
3550308;São Paulo;5212501;Luziânia;14;15;29;831
1302603;Manaus;5208707;Goiânia;14;15;29;1873
5002704;Campo Grande;5007901;Sidrolândia;14;15;29;65
4314100;Passo Fundo;4320909;Tapejara;14;15;29;43
4303509;Camaquã;4318804;São Lourenço do Sul;14;15;29;57
4301602;Bagé;4317103;Santana do Livramento;14;15;29;143
4306106;Cruz Alta;4310207;Ijuí;14;15;29;43
4206900;Ibirama;4214805;Rio do Sul;14;15;29;22
4106902;Curitiba;4127700;Toledo;14;15;29;460
4119905;Ponta Grossa;4127106;Telêmaco Borba;14;15;29;97
4105508;Cianorte;4118402;Paranavaí;14;15;29;65
3541406;Presidente Prudente;4115200;Maringá;14;15;29;154
4108304;Foz do Iguaçu;4115200;Maringá;14;15;29;351
4104808;Cascavel;4109401;Guarapuava;14;15;29;207
3550308;São Paulo;4104204;Campo Largo;14;15;29;350
3507001;Boituva;3554003;Tatuí;14;15;29;19
3103504;Araguari;3550308;São Paulo;14;15;29;576
3529005;Marília;3549805;São José do Rio Preto;14;15;29;165
3506102;Bebedouro;3543402;Ribeirão Preto;14;15;29;81
3503307;Araras;3526902;Limeira;14;15;29;23
3509601;Campo Limpo Paulista;3525904;Jundiaí;14;15;29;13
3513405;Cruzeiro;3518404;Guaratinguetá;14;15;29;34
3301306;Casimiro de Abreu;3304524;Rio das Ostras;14;15;29;26
3301900;Itaboraí;3304300;Rio Bonito;14;15;29;24
3106200;Belo Horizonte;3201308;Cariacica;14;15;29;371
3101607;Alfenas;3170701;Varginha;14;15;29;59
3147006;Paracatu;3148004;Patos de Minas;14;15;29;156
3105608;Barbacena;3118304;Conselheiro Lafaiete;14;15;29;60
2611606;Recife;2919207;Lauro de Freitas;14;15;29;641
2612505;Santa Cruz do Capibaribe;2614501;Surubim;14;15;29;53
2504009;Campina Grande;2512507;Queimadas;14;15;29;13
2403103;Currais Novos;2411205;Santa Cruz;14;15;29;55
2305233;Horizonte;2309607;Pacajus;14;15;29;9
2301901;Barbalha;2307304;Juazeiro do Norte;14;15;29;11
3516200;Franca;4313409;Novo Hamburgo;13;16;29;1071
4307005;Erechim;4308904;Getúlio Vargas;13;16;29;27
3550308;São Paulo;4307005;Erechim;13;16;29;702
4203303;Campo Alegre;4215802;São Bento do Sul;13;16;29;13
3550308;São Paulo;4204301;Concórdia;13;16;29;656
3550308;São Paulo;4127700;Toledo;13;16;29;726
4118204;Paranaguá;4119954;Pontal do Paraná;13;16;29;11
3550308;São Paulo;3552106;Socorro;13;16;29;118
3539509;Pitangueiras;3551702;Sertãozinho;13;16;29;28
3509502;Campinas;3548906;São Carlos;13;16;29;130
3518800;Guarulhos;3525904;Jundiaí;13;16;29;45
3501608;Americana;3520509;Indaiatuba;13;16;29;40
3505708;Barueri;3506003;Bauru;13;16;29;262
3303302;Niterói;3303401;Nova Friburgo;13;16;29;84
3205309;Vitória;3301009;Campos dos Goytacazes;13;16;29;200
3200904;Barra de São Francisco;3201209;Cachoeiro de Itapemirim;13;16;29;229
3113404;Caratinga;3139409;Manhuaçu;13;16;29;49
2928703;Santo Antônio de Jesus;2932903;Valença;13;16;29;46
2611101;Petrolina;2612208;Salgueiro;13;16;29;200
1100205;Porto Velho;1501402;Belém;13;16;29;1909
3505708;Barueri;5201405;Aparecida de Goiânia;12;17;29;786
5002704;Campo Grande;5006606;Ponta Porã;12;17;29;255
3301702;Duque de Caxias;4314902;Porto Alegre;12;17;29;1093
4307906;Farroupilha;4308201;Flores da Cunha;12;17;29;27
4104501;Capanema;4119806;Planalto;12;17;29;5
3529401;Mauá;3534401;Osasco;11;18;29;37
3303302;Niterói;3306305;Volta Redonda;11;18;29;111
3511508;Cerquilho;3554003;Tatuí;10;19;29;23
3541604;Promissão;3550308;São Paulo;10;19;29;400
2507507;João Pessoa;2927408;Salvador;10;19;29;750
4314100;Passo Fundo;4316808;Santa Cruz do Sul;9;20;29;163
3523503;Itatinga;3550308;São Paulo;9;20;29;209
3303302;Niterói;3305109;São João de Meriti;9;20;29;30
3512902;Cosmorama;3545605;Santa Adélia;1;28;29;132
5219753;Santo Antônio do Descoberto;5300108;Brasília;14;14;28;43
5208707;Goiânia;5213103;Mineiros;14;14;28;360
3543402;Ribeirão Preto;5208707;Goiânia;14;14;28;519
5203302;Bela Vista de Goiás;5208707;Goiânia;14;14;28;47
4115200;Maringá;5107602;Rondonópolis;14;14;28;831
5105101;Juara;5105150;Juína;14;14;28;135
3518800;Guarulhos;5103403;Cuiabá;14;14;28;1363
5101803;Barra do Garças;5103403;Cuiabá;14;14;28;412
4115200;Maringá;5003702;Dourados;14;14;28;326
5001508;Bandeirantes;5002704;Campo Grande;14;14;28;59
4313409;Novo Hamburgo;4320008;Sapucaia do Sul;14;14;28;17
4309050;Glorinha;4314902;Porto Alegre;14;14;28;46
4310108;Igrejinha;4314902;Porto Alegre;14;14;28;66
4209003;Joaçaba;4219309;Videira;14;14;28;42
4203956;Capivari de Baixo;4218707;Tubarão;14;14;28;9
4208807;Jaguaruna;4218707;Tubarão;14;14;28;14
3509502;Campinas;4209102;Joinville;14;14;28;415
4202909;Brusque;4208906;Jaraguá do Sul;14;14;28;70
4202909;Brusque;4204608;Criciúma;14;14;28;180
4115705;Matinhos;4119954;Pontal do Paraná;14;14;28;17
3550308;São Paulo;4108403;Francisco Beltrão;14;14;28;689
3513009;Cotia;4106902;Curitiba;14;14;28;312
3514403;Dracena;3555109;Tupi Paulista;14;14;28;16
2303709;Caucaia;3550308;São Paulo;14;14;28;2337
3148103;Patrocínio;3550308;São Paulo;14;14;28;522
3510401;Capivari;3550308;São Paulo;14;14;28;114
3523206;Itararé;3550308;São Paulo;14;14;28;279
3505500;Barretos;3549805;São José do Rio Preto;14;14;28;90
3543907;Rio Claro;3546702;Santa Gertrudes;14;14;28;7
3526902;Limeira;3545803;Santa Bárbara d'Oeste;14;14;28;21
3541406;Presidente Prudente;3541505;Presidente Venceslau;14;14;28;60
3501905;Amparo;3537107;Pedreira;14;14;28;15
3125101;Extrema;3507605;Bragança Paulista;14;14;28;26
3101508;Além Paraíba;3305406;Sapucaia;14;14;28;29
2503209;Cabedelo;3304557;Rio de Janeiro;14;14;28;1937
3203205;Linhares;3205010;Sooretama;14;14;28;19
3203205;Linhares;3204906;São Mateus;14;14;28;68
3137601;Lagoa Santa;3171204;Vespasiano;14;14;28;9
3106200;Belo Horizonte;3145208;Nova Serrana;14;14;28;105
3106200;Belo Horizonte;3119401;Coronel Fabriciano;14;14;28;148
1505536;Parauapebas;3106200;Belo Horizonte;14;14;28;1649
2111300;São Luís;2927408;Salvador;14;14;28;1311
2917607;Jaguaquara;2918001;Jequié;14;14;28;35
2704302;Maceió;2709301;União dos Palmares;14;14;28;63
2507507;João Pessoa;2609600;Olinda;14;14;28;89
2302206;Beberibe;2304400;Fortaleza;14;14;28;64
1500800;Ananindeua;1600303;Macapá;14;14;28;342
1500800;Ananindeua;1504208;Marabá;14;14;28;450
1200203;Cruzeiro do Sul;1200401;Rio Branco;14;14;28;590
4115200;Maringá;5208707;Goiânia;13;15;28;799
5108402;Várzea Grande;5208707;Goiânia;13;15;28;741
4310603;Itaqui;4322400;Uruguaiana;13;15;28;87
4118204;Paranaguá;4314902;Porto Alegre;13;15;28;555
4305454;Cidreira;4314902;Porto Alegre;13;15;28;94
4313201;Nova Petrópolis;4314423;Picada Café;13;15;28;8
3505708;Barueri;4209102;Joinville;13;15;28;364
4202909;Brusque;4207106;Ilhota;13;15;28;23
4108304;Foz do Iguaçu;4124053;Santa Terezinha de Itaipu;13;15;28;10
4102109;Astorga;4115200;Maringá;13;15;28;35
3304557;Rio de Janeiro;4104808;Cascavel;13;15;28;1047
3505302;Barra Bonita;3550308;São Paulo;13;15;28;232
3530508;Mococa;3550308;São Paulo;13;15;28;245
3505302;Barra Bonita;3520004;Igaraçu do Tietê;13;15;28;2
3300456;Belford Roxo;3301702;Duque de Caxias;13;15;28;9
3106200;Belo Horizonte;3168606;Teófilo Otoni;13;15;28;347
3144300;Nanuque;3168606;Teófilo Otoni;13;15;28;121
3133105;Itanhandu;3147600;Passa Quatro;13;15;28;11
3106705;Betim;3130101;Igarapé;13;15;28;19
3106200;Belo Horizonte;3110004;Caeté;13;15;28;32
2917508;Jacobina;2930105;Senhor do Bonfim;13;15;28;95
1504208;Marabá;1508100;Tucuruí;13;15;28;192
5001003;Aparecida do Taboado;5006309;Paranaíba;12;16;28;50
3304557;Rio de Janeiro;4316907;Santa Maria;12;16;28;1247
4314050;Parobé;4314902;Porto Alegre;12;16;28;59
4113700;Londrina;4125506;São José dos Pinhais;12;16;28;316
3170404;Unaí;3550308;São Paulo;12;16;28;803
3509502;Campinas;3549102;São João da Boa Vista;12;16;28;107
3301702;Duque de Caxias;3305802;Teresópolis;12;16;28;49
2929206;São Francisco do Conde;3304557;Rio de Janeiro;12;16;28;1223
1302603;Manaus;3170206;Uberlândia;12;16;28;2120
3118601;Contagem;3131307;Ipatinga;12;16;28;170
2927408;Salvador;2928604;Santo Amaro;12;16;28;56
1600279;Laranjal do Jari;1600303;Macapá;12;16;28;166
5103056;Cláudia;5107909;Sinop;11;17;28;77
4108304;Foz do Iguaçu;4314902;Porto Alegre;11;17;28;592
3143104;Monte Carmelo;3170206;Uberlândia;10;18;28;82
5107602;Rondonópolis;5300108;Brasília;9;19;28;727
3509502;Campinas;3516200;Franca;9;19;28;264
3549904;São José dos Campos;4314902;Porto Alegre;8;20;28;908
3534401;Osasco;4115200;Maringá;7;21;28;525
2804805;Nossa Senhora do Socorro;2927408;Salvador;7;21;28;277
3511102;Catanduva;3540804;Potirendaba;5;23;28;42
3503703;Ariranha;3511102;Catanduva;4;24;28;21
3170404;Unaí;5300108;Brasília;13;14;27;126
5000203;Água Clara;5008305;Três Lagoas;13;14;27;123
3550308;São Paulo;5006309;Paranaíba;13;14;27;656
5002704;Campo Grande;5005400;Maracaju;13;14;27;141
4313508;Osório;4321600;Tramandaí;13;14;27;16
4310801;Ivoti;4313409;Novo Hamburgo;13;14;27;11
4306403;Dois Irmãos;4312476;Morro Reuter;13;14;27;5
4307609;Estância Velha;4310801;Ivoti;13;14;27;6
4205407;Florianópolis;4305108;Caxias do Sul;13;14;27;310
4202909;Brusque;4214805;Rio do Sul;13;14;27;71
4206504;Guaramirim;4209102;Joinville;13;14;27;26
4203006;Caçador;4204202;Chapecó;13;14;27;156
3543402;Ribeirão Preto;3551504;Serrana;13;14;27;22
3128709;Guaxupé;3549706;São José do Rio Pardo;13;14;27;37
3543402;Ribeirão Preto;3548708;São Bernardo do Campo;13;14;27;309
3106200;Belo Horizonte;3547809;Santo André;13;14;27;488
3506508;Birigui;3537305;Penápolis;13;14;27;32
3106200;Belo Horizonte;3506003;Bauru;13;14;27;587
2607901;Jaboatão dos Guararapes;3505708;Barueri;13;14;27;2061
3304557;Rio de Janeiro;3305554;Seropédica;13;14;27;48
1504208;Marabá;3304557;Rio de Janeiro;13;14;27;2021
3151800;Poços de Caldas;3304557;Rio de Janeiro;13;14;27;357
3301504;Cordeiro;3303401;Nova Friburgo;13;14;27;36
3205309;Vitória;3302403;Macaé;13;14;27;285
3143401;Monte Sião;3146008;Ouro Fino;13;14;27;27
3138401;Leopoldina;3143906;Muriaé;13;14;27;63
3106200;Belo Horizonte;3133808;Itaúna;13;14;27;67
3113404;Caratinga;3130903;Inhapim;13;14;27;27
2927408;Salvador;3118601;Contagem;13;14;27;959
2904605;Brumado;2933307;Vitória da Conquista;13;14;27;114
2800308;Aracaju;2919207;Lauro de Freitas;13;14;27;258
2607901;Jaboatão dos Guararapes;2800308;Aracaju;13;14;27;380
2402006;Caicó;2403103;Currais Novos;13;14;27;71
2304103;Crateús;2304400;Fortaleza;13;14;27;282
2208007;Picos;2211308;Valença do Piauí;13;14;27;85
1505437;Ourilândia do Norte;1508084;Tucumã;13;14;27;8
1500602;Altamira;1506807;Santarém;13;14;27;288
4115200;Maringá;5103403;Cuiabá;12;15;27;985
4307807;Estrela;4321451;Teutônia;12;15;27;17
3552809;Taboão da Serra;4314902;Porto Alegre;12;15;27;827
4307807;Estrela;4314902;Porto Alegre;12;15;27;96
3304557;Rio de Janeiro;4216602;São José;12;15;27;739
4205803;Garuva;4209102;Joinville;12;15;27;28
4204301;Concórdia;4209003;Joaçaba;12;15;27;48
4112108;Jandaia do Sul;4115200;Maringá;12;15;27;35
3519600;Ibitinga;3550308;São Paulo;12;15;27;306
3503208;Araraquara;3525300;Jaú;12;15;27;68
3118601;Contagem;3170701;Varginha;12;15;27;222
2905701;Camaçari;2930709;Simões Filho;12;15;27;13
2211001;Teresina;2211308;Valença do Piauí;12;15;27;180
1500800;Ananindeua;2111300;São Luís;12;15;27;478
3110608;Cambuí;3152501;Pouso Alegre;11;16;27;46
3118601;Contagem;3143302;Montes Claros;11;16;27;353
4209102;Joinville;4211900;Palhoça;10;17;27;152
4209102;Joinville;4209300;Lages;10;17;27;222
1504208;Marabá;5300108;Brasília;9;18;27;1162
3167202;Sete Lagoas;5300108;Brasília;9;18;27;566
3118601;Contagem;4314902;Porto Alegre;9;18;27;1301
4106902;Curitiba;4202909;Brusque;9;18;27;187
3548807;São Caetano do Sul;3549904;São José dos Campos;9;18;27;84
2507507;João Pessoa;2800308;Aracaju;9;18;27;476
3143302;Montes Claros;5300108;Brasília;7;20;27;447
5108402;Várzea Grande;5300108;Brasília;7;20;27;883
3529005;Marília;5300108;Brasília;6;21;27;743
3554102;Taubaté;5300108;Brasília;6;21;27;836
3304904;São Gonçalo;5300108;Brasília;5;22;27;937
3548906;São Carlos;5300108;Brasília;5;22;27;688
4314100;Passo Fundo;5300108;Brasília;4;23;27;1465
5206206;Cristalina;5300108;Brasília;13;13;26;115
3518800;Guarulhos;5208707;Goiânia;13;13;26;803
5105259;Lucas do Rio Verde;5108006;Tapurah;13;13;26;78
5106224;Nova Mutum;5107909;Sinop;13;13;26;228
4311809;Marau;4323408;Vila Maria;13;13;26;11
3550308;São Paulo;4320008;Sapucaia do Sul;13;13;26;805
4314407;Pelotas;4316907;Santa Maria;13;13;26;266
3548500;Santos;4315602;Rio Grande;13;13;26;1051
4309100;Gramado;4313409;Novo Hamburgo;13;13;26;39
4302808;Caçapava do Sul;4311502;Lavras do Sul;13;13;26;55
4306403;Dois Irmãos;4310801;Ivoti;13;13;26;7
4305108;Caxias do Sul;4308607;Garibaldi;13;13;26;37
4303806;Campinas do Sul;4307005;Erechim;13;13;26;36
3518800;Guarulhos;4304606;Canoas;13;13;26;838
3304557;Rio de Janeiro;4302105;Bento Gonçalves;13;13;26;1046
3512407;Cordeirópolis;4218707;Tubarão;13;13;26;682
4216305;São João Batista;4218004;Tijucas;13;13;26;22
4204608;Criciúma;4217600;Siderópolis;13;13;26;9
4202453;Bombinhas;4213500;Porto Belo;13;13;26;5
4204608;Criciúma;4211603;Nova Veneza;13;13;26;11
4118501;Pato Branco;4204004;Catanduvas;13;13;26;134
4115705;Matinhos;4118204;Paranaguá;13;13;26;26
4108403;Francisco Beltrão;4115408;Marmeleiro;13;13;26;8
4104907;Castro;4106902;Curitiba;13;13;26;105
4104303;Campo Mourão;4104808;Cascavel;13;13;26;147
3510500;Caraguatatuba;3555406;Ubatuba;13;13;26;41
3501905;Amparo;3551603;Serra Negra;13;13;26;12
3502507;Aparecida;3550308;São Paulo;13;13;26;170
3507902;Brotas;3550308;São Paulo;13;13;26;213
3512803;Cosmópolis;3550308;São Paulo;13;13;26;124
3548906;São Carlos;3549805;São José do Rio Preto;13;13;26;206
3549102;São João da Boa Vista;3549706;São José do Rio Pardo;13;13;26;41
3506003;Bauru;3541406;Presidente Prudente;13;13;26;240
3502804;Araçatuba;3537305;Penápolis;13;13;26;47
3524709;Jaguariúna;3537107;Pedreira;13;13;26;10
3522109;Itanhaém;3531100;Mongaguá;13;13;26;19
3510609;Carapicuíba;3525003;Jandira;13;13;26;7
3509502;Campinas;3523909;Itu;13;13;26;49
2611606;Recife;3509502;Campinas;13;13;26;2026
3205002;Serra;3509502;Campinas;13;13;26;751
1400100;Boa Vista;3304557;Rio de Janeiro;13;13;26;3321
2930709;Simões Filho;3304557;Rio de Janeiro;13;13;26;1218
3302908;Miguel Pereira;3304557;Rio de Janeiro;13;13;26;52
3106200;Belo Horizonte;3301702;Duque de Caxias;13;13;26;324
3123601;Elói Mendes;3170701;Varginha;13;13;26;21
3115300;Cataguases;3169901;Ubá;13;13;26;44
3165206;São Thomé das Letras;3169307;Três Corações;13;13;26;25
3143302;Montes Claros;3157005;Salinas;13;13;26;180
3106200;Belo Horizonte;3145901;Ouro Branco;13;13;26;75
3139409;Manhuaçu;3139508;Manhumirim;13;13;26;18
2903904;Bom Jesus da Lapa;2930154;Serra do Ramalho;13;13;26;41
2907806;Cícero Dantas;2926608;Ribeira do Pombal;13;13;26;27
2904605;Brumado;2919504;Livramento de Nossa Senhora;13;13;26;66
2800308;Aracaju;2805703;Propriá;13;13;26;79
2601201;Arcoverde;2611606;Recife;13;13;26;239
2507507;João Pessoa;2508901;Mamanguape;13;13;26;49
2211001;Teresina;2211100;União;13;13;26;55
2205508;José de Freitas;2211001;Teresina;13;13;26;44
1100122;Ji-Paraná;1100288;Rolim de Moura;13;13;26;98
5201108;Anápolis;5201405;Aparecida de Goiânia;12;14;26;64
1100205;Porto Velho;5108402;Várzea Grande;12;14;26;1114
3550308;São Paulo;5107958;Tangará da Serra;12;14;26;1560
4317202;Santa Rosa;4321808;Três de Maio;12;14;26;25
4203600;Campos Novos;4204806;Curitibanos;12;14;26;63
3548708;São Bernardo do Campo;4125506;São José dos Pinhais;12;14;26;329
4104808;Cascavel;4114609;Marechal Cândido Rondon;12;14;26;75
3545308;Salto de Pirapora;3552205;Sorocaba;12;14;26;20
3548708;São Bernardo do Campo;3552205;Sorocaba;12;14;26;97
1502400;Castanhal;3550308;São Paulo;12;14;26;2476
3302007;Itaguaí;3550308;São Paulo;12;14;26;304
3526803;Lençóis Paulista;3528007;Macatuba;12;14;26;16
1302603;Manaus;3525904;Jundiaí;12;14;26;2565
3303302;Niterói;3305505;Saquarema;12;14;26;65
3304300;Rio Bonito;3304904;São Gonçalo;12;14;26;46
3302254;Itatiaia;3304201;Resende;12;14;26;14
3300506;Bom Jardim;3303401;Nova Friburgo;12;14;26;23
3300100;Angra dos Reis;3300407;Barra Mansa;12;14;26;44
3201308;Cariacica;3203205;Linhares;12;14;26;109
3201209;Cachoeiro de Itapemirim;3201308;Cariacica;12;14;26;92
3101706;Almenara;3168606;Teófilo Otoni;12;14;26;207
3148004;Patos de Minas;3162104;São Gotardo;12;14;26;93
3146909;Papagaios;3152006;Pompéu;12;14;26;32
3113404;Caratinga;3127701;Governador Valadares;12;14;26;113
1501402;Belém;2927408;Salvador;12;14;26;1668
1702109;Araguaína;1705508;Colinas do Tocantins;12;14;26;100
1501402;Belém;1508100;Tucuruí;12;14;26;300
5106372;Pedra Preta;5107602;Rondonópolis;11;15;26;30
3550308;São Paulo;5007901;Sidrolândia;11;15;26;928
3550308;São Paulo;4322004;Triunfo;11;15;26;840
3513009;Cotia;4314902;Porto Alegre;11;15;26;819
3548708;São Bernardo do Campo;4305108;Caxias do Sul;11;15;26;744
4303103;Cachoeirinha;4305108;Caxias do Sul;11;15;26;88
4115200;Maringá;4202909;Brusque;11;15;26;501
3524402;Jacareí;3554102;Taubaté;11;15;26;51
3157807;Santa Luzia;3550308;São Paulo;11;15;26;514
3164704;São Sebastião do Paraíso;3550308;São Paulo;11;15;26;304
2507507;João Pessoa;3505708;Barueri;11;15;26;2155
2800308;Aracaju;3505708;Barueri;11;15;26;1697
2906501;Candeias;3304557;Rio de Janeiro;11;15;26;1224
2919207;Lauro de Freitas;3304557;Rio de Janeiro;11;15;26;1211
3106200;Belo Horizonte;3128006;Guanhães;11;15;26;170
4314902;Porto Alegre;4317301;Santa Vitória do Palmar;10;16;26;434
4209300;Lages;4314100;Passo Fundo;10;16;26;208
4311304;Lagoa Vermelha;4314100;Passo Fundo;10;16;26;86
2704302;Maceió;4314902;Porto Alegre;9;17;26;2657
3304557;Rio de Janeiro;4314407;Pelotas;9;17;26;1284
3548807;São Caetano do Sul;3552205;Sorocaba;9;17;26;96
2403608;Extremoz;2408102;Natal;9;17;26;14
3131307;Ipatinga;3168606;Teófilo Otoni;8;18;26;209
3525904;Jundiaí;3548807;São Caetano do Sul;7;19;26;59
3303500;Nova Iguaçu;5300108;Brasília;4;22;26;910
3303302;Niterói;3534401;Osasco;4;22;26;383
3162500;São João del Rei;3304557;Rio de Janeiro;4;22;26;221
4202404;Blumenau;4304606;Canoas;3;23;26;385
3529302;Matão;4205506;Fraiburgo;2;24;26;649
3134905;Jacutinga;3503703;Ariranha;2;24;26;257
3545605;Santa Adélia;3555604;Uchoa;1;25;26;50
5209101;Goiatuba;5211503;Itumbiara;12;13;25;44
5104807;Jaciara;5107602;Rondonópolis;12;13;25;63
3550308;São Paulo;5102504;Cáceres;12;13;25;1473
3502101;Andradina;5008305;Três Lagoas;12;13;25;39
5003702;Dourados;5007208;Rio Brilhante;12;13;25;54
5002704;Campo Grande;5006002;Nova Alvorada do Sul;12;13;25;118
5002209;Bonito;5002704;Campo Grande;12;13;25;210
4313375;Nova Santa Rita;4314902;Porto Alegre;12;13;25;23
3550308;São Paulo;4311403;Lajeado;12;13;25;818
4106902;Curitiba;4218707;Tubarão;12;13;25;339
4216602;São José;4218707;Tubarão;12;13;25;106
4208401;Itapiranga;4217204;São Miguel do Oeste;12;13;25;54
4205407;Florianópolis;4215703;Santo Amaro da Imperatriz;12;13;25;28
4206702;Herval d'Oeste;4209003;Joaçaba;12;13;25;7
4105508;Cianorte;4127205;Terra Boa;12;13;25;20
4111803;Jacarezinho;4124103;Santo Antônio da Platina;12;13;25;19
4109401;Guarapuava;4119301;Pinhão;12;13;25;39
3552809;Taboão da Serra;4106902;Curitiba;12;13;25;324
3509502;Campinas;3554102;Taubaté;12;13;25;152
3106200;Belo Horizonte;3552205;Sorocaba;12;13;25;533
3543402;Ribeirão Preto;3552205;Sorocaba;12;13;25;260
3551603;Serra Negra;3552106;Socorro;12;13;25;18
1500602;Altamira;3550308;São Paulo;12;13;25;2331
3110608;Cambuí;3550308;São Paulo;12;13;25;129
3118304;Conselheiro Lafaiete;3550308;São Paulo;12;13;25;437
3517406;Guaíra;3550308;São Paulo;12;13;25;405
3524105;Ituverava;3550308;São Paulo;12;13;25;385
3538600;Piracaia;3550308;São Paulo;12;13;25;73
3540606;Porto Feliz;3550308;São Paulo;12;13;25;101
3530508;Mococa;3549706;São José do Rio Pardo;12;13;25;21
3519709;Ibiúna;3537800;Piedade;12;13;25;22
3509502;Campinas;3531803;Monte Mor;12;13;25;27
3503901;Arujá;3530607;Moji das Cruzes;12;13;25;23
3304557;Rio de Janeiro;3524402;Jacareí;12;13;25;278
3518800;Guarulhos;3524402;Jacareí;12;13;25;64
3106705;Betim;3518800;Guarulhos;12;13;25;453
3301702;Duque de Caxias;3518800;Guarulhos;12;13;25;339
3507605;Bragança Paulista;3509502;Campinas;12;13;25;52
3301850;Guapimirim;3304557;Rio de Janeiro;12;13;25;48
3200409;Anchieta;3205309;Vitória;12;13;25;75
3202405;Guarapari;3205002;Serra;12;13;25;62
3201308;Cariacica;3201506;Colatina;12;13;25;80
2927408;Salvador;3170206;Uberlândia;12;13;25;1209
3122306;Divinópolis;3147105;Pará de Minas;12;13;25;44
3113404;Caratinga;3131307;Ipatinga;12;13;25;52
2408102;Natal;3106200;Belo Horizonte;12;13;25;1792
2910727;Eunápolis;2931350;Teixeira de Freitas;12;13;25;131
2908408;Conceição do Coité;2930501;Serrinha;12;13;25;28
2910800;Feira de Santana;2928703;Santo Antônio de Jesus;12;13;25;83
2604106;Caruaru;2611101;Petrolina;12;13;25;511
2408102;Natal;2504009;Campina Grande;12;13;25;170
2401107;Areia Branca;2408003;Mossoró;12;13;25;34
2402006;Caicó;2405603;Jardim de Piranhas;12;13;25;26
2101202;Bacabal;2109908;Santa Inês;12;13;25;88
1501402;Belém;1506203;Salinópolis;12;13;25;147
1501402;Belém;1505502;Paragominas;12;13;25;219
5211503;Itumbiara;5218805;Rio Verde;11;14;25;190
5103403;Cuiabá;5107875;Sapezal;11;14;25;406
1100122;Ji-Paraná;5103403;Cuiabá;11;14;25;801
4314100;Passo Fundo;4320800;Soledade;11;14;25;66
3547304;Santana de Parnaíba;4314902;Porto Alegre;11;14;25;835
4307906;Farroupilha;4308607;Garibaldi;11;14;25;19
4204608;Criciúma;4219002;Urussanga;11;14;25;17
4114104;Mandaguaçu;4115200;Maringá;11;14;25;23
3504008;Assis;4113700;Londrina;11;14;25;101
3549102;São João da Boa Vista;3556404;Vargem Grande do Sul;11;14;25;17
3304557;Rio de Janeiro;3550704;São Sebastião;11;14;25;241
2501807;Bayeux;3550308;São Paulo;11;14;25;2158
2909307;Correntina;3550308;São Paulo;11;14;25;1158
3138203;Lavras;3550308;São Paulo;11;14;25;316
3500709;Agudos;3550308;São Paulo;11;14;25;271
3533908;Olímpia;3550308;São Paulo;11;14;25;394
3525300;Jaú;3543402;Ribeirão Preto;11;14;25;148
3519600;Ibitinga;3522703;Itápolis;11;14;25;18
2907509;Catu;3304557;Rio de Janeiro;11;14;25;1263
2933307;Vitória da Conquista;3304557;Rio de Janeiro;11;14;25;920
3143302;Montes Claros;3167202;Sete Lagoas;11;14;25;302
3136702;Juiz de Fora;3162906;São João Nepomuceno;11;14;25;41
3132404;Itajubá;3159605;Santa Rita do Sapucaí;11;14;25;30
2914802;Itabuna;2918001;Jequié;11;14;25;138
3513009;Cotia;5300108;Brasília;10;15;25;870
3552809;Taboão da Serra;5300108;Brasília;10;15;25;871
4314902;Porto Alegre;4318408;São Jerônimo;10;15;25;51
4301602;Bagé;4316907;Santa Maria;10;15;25;183
4304606;Canoas;4311403;Lajeado;10;15;25;98
3550308;São Paulo;4308607;Garibaldi;10;15;25;774
4208203;Itajaí;4304606;Canoas;10;15;25;403
4113700;Londrina;4205407;Florianópolis;10;15;25;540
3548500;Santos;3548807;São Caetano do Sul;10;15;25;39
4113700;Londrina;5208707;Goiânia;9;16;25;759
3550308;São Paulo;5006200;Nova Andradina;9;16;25;717
4314100;Passo Fundo;4322509;Vacaria;9;16;25;145
2408102;Natal;4314902;Porto Alegre;9;16;25;3044
4115358;Maripá;4117909;Palotina;9;16;25;13
4103453;Cafelândia;4116703;Nova Aurora;9;16;25;12
3547502;Santa Rita do Passa Quatro;3550308;São Paulo;9;16;25;231
3505708;Barueri;3513801;Diadema;9;16;25;32
3548807;São Caetano do Sul;5208707;Goiânia;8;17;25;821
1501402;Belém;4314902;Porto Alegre;8;17;25;3182
4212908;Pinhalzinho;4217303;Saudades;8;17;25;8
3513801;Diadema;5300108;Brasília;7;18;25;883
2507507;João Pessoa;4314902;Porto Alegre;7;18;25;2929
3506003;Bauru;4314902;Porto Alegre;7;18;25;877
4119905;Ponta Grossa;4209102;Joinville;7;18;25;184
3302254;Itatiaia;3550308;São Paulo;7;18;25;246
3513801;Diadema;3534401;Osasco;6;19;25;24
3516200;Franca;4314902;Porto Alegre;5;20;25;1111
2111300;São Luís;3534401;Osasco;5;20;25;2336
3127701;Governador Valadares;5300108;Brasília;4;21;25;722
3530607;Moji das Cruzes;5300108;Brasília;4;21;25;878
3507407;Borborema;3545605;Santa Adélia;1;24;25;50
5208707;Goiânia;5218003;Porangatu;12;12;24;361
5208707;Goiânia;5214507;Nerópolis;12;12;24;33
5101803;Barra do Garças;5208707;Goiânia;12;12;24;332
3103504;Araguari;5205109;Catalão;12;12;24;61
5103403;Cuiabá;5105150;Juína;12;12;24;545
5100250;Alta Floresta;5103403;Cuiabá;12;12;24;627
5002704;Campo Grande;5005608;Miranda;12;12;24;181
4312153;Mato Leitão;4322608;Venâncio Aires;12;12;24;10
4314902;Porto Alegre;4318002;São Borja;12;12;24;498
4311403;Lajeado;4316907;Santa Maria;12;12;24;176
4307609;Estância Velha;4314902;Porto Alegre;12;12;24;45
4310330;Imbé;4314902;Porto Alegre;12;12;24;102
4306767;Eldorado do Sul;4309308;Guaíba;12;12;24;27
4101804;Araucária;4304606;Canoas;12;12;24;508
4209300;Lages;4216602;São José;12;12;24;165
4118204;Paranaguá;4216206;São Francisco do Sul;12;12;24;79
4210100;Mafra;4215802;São Bento do Sul;12;12;24;48
4209300;Lages;4214805;Rio do Sul;12;12;24;95
4211306;Navegantes;4212502;Penha;12;12;24;9
4106902;Curitiba;4208906;Jaraguá do Sul;12;12;24;118
3518800;Guarulhos;4125506;São José dos Pinhais;12;12;24;350
4119152;Pinhais;4125506;São José dos Pinhais;12;12;24;10
4109708;Ibaiti;4124103;Santo Antônio da Platina;12;12;24;62
4104808;Cascavel;4124020;Santa Tereza do Oeste;12;12;24;21
4117602;Palmas;4118501;Pato Branco;12;12;24;75
3106705;Betim;4106902;Curitiba;12;12;24;788
3205002;Serra;4106902;Curitiba;12;12;24;1064
4103701;Cambé;4106902;Curitiba;12;12;24;308
3527306;Louveira;3556701;Vinhedo;12;12;24;5
3550308;São Paulo;3551603;Serra Negra;12;12;24;115
3548500;Santos;3550704;São Sebastião;12;12;24;95
1100304;Vilhena;3550308;São Paulo;12;12;24;1795
2929206;São Francisco do Conde;3550308;São Paulo;12;12;24;1452
3507100;Bom Jesus dos Perdões;3550308;São Paulo;12;12;24;60
3515186;Espírito Santo do Pinhal;3550308;São Paulo;12;12;24;162
3546405;Santa Cruz do Rio Pardo;3550308;São Paulo;12;12;24;315
3524808;Jales;3549805;São José do Rio Preto;12;12;24;135
2927408;Salvador;3548500;Santos;12;12;24;1435
3505500;Barretos;3543402;Ribeirão Preto;12;12;24;105
3529005;Marília;3543402;Ribeirão Preto;12;12;24;254
3503307;Araras;3538709;Piracicaba;12;12;24;52
3520509;Indaiatuba;3525904;Jundiaí;12;12;24;36
3513801;Diadema;3518800;Guarulhos;12;12;24;28
3118601;Contagem;3509502;Campinas;12;12;24;447
3502101;Andradina;3502804;Araçatuba;12;12;24;103
3300258;Arraial do Cabo;3300704;Cabo Frio;12;12;24;11
3200805;Baixo Guandu;3201506;Colatina;12;12;24;41
3120904;Curvelo;3167202;Sete Lagoas;12;12;24;79
3149309;Pedro Leopoldo;3167202;Sete Lagoas;12;12;24;26
3106200;Belo Horizonte;3162500;São João del Rei;12;12;24;140
3122306;Divinópolis;3145604;Oliveira;12;12;24;60
3106200;Belo Horizonte;3124104;Esmeraldas;12;12;24;38
3106200;Belo Horizonte;3118007;Congonhas;12;12;24;67
2800308;Aracaju;3106200;Belo Horizonte;12;12;24;1221
2902906;Barra do Choça;2933307;Vitória da Conquista;12;12;24;29
2926608;Ribeira do Pombal;2931905;Tucano;12;12;24;33
2909802;Cruz das Almas;2928703;Santo Antônio de Jesus;12;12;24;38
2700300;Arapiraca;2706307;Palmeira dos Índios;12;12;24;37
2601201;Arcoverde;2602803;Buíque;12;12;24;20
1504208;Marabá;1505502;Paragominas;12;12;24;325
3304557;Rio de Janeiro;5201405;Aparecida de Goiânia;11;13;24;936
5002704;Campo Grande;5006200;Nova Andradina;11;13;24;238
2919207;Lauro de Freitas;4314902;Porto Alegre;11;13;24;2232
4211900;Palhoça;4314902;Porto Alegre;11;13;24;355
4314803;Portão;4314902;Porto Alegre;11;13;24;39
3304557;Rio de Janeiro;4314100;Passo Fundo;11;13;24;1060
4106902;Curitiba;4313409;Novo Hamburgo;11;13;24;503
4307906;Farroupilha;4313409;Novo Hamburgo;11;13;24;55
4304606;Canoas;4304630;Capão da Canoa;11;13;24;112
3505708;Barueri;4304606;Canoas;11;13;24;816
4213708;Pouso Redondo;4217808;Taió;11;13;24;19
4115200;Maringá;4209102;Joinville;11;13;24;437
4204202;Chapecó;4204350;Cordilheira Alta;11;13;24;14
4106902;Curitiba;4128203;União da Vitória;11;13;24;207
3523206;Itararé;4126306;Sengés;11;13;24;13
3515707;Ferraz de Vasconcelos;3552502;Suzano;11;13;24;6
3513504;Cubatão;3551009;São Vicente;11;13;24;7
3511508;Cerquilho;3550308;São Paulo;11;13;24;124
3529203;Martinópolis;3541406;Presidente Prudente;11;13;24;23
3506102;Bebedouro;3531506;Monte Azul Paulista;11;13;24;11
3304557;Rio de Janeiro;3523107;Itaquaquecetuba;11;13;24;322
3503208;Araraquara;3509502;Campinas;11;13;24;168
2211001;Teresina;3505708;Barueri;11;13;24;2076
3304557;Rio de Janeiro;3305000;São João da Barra;11;13;24;264
3167202;Sete Lagoas;3304557;Rio de Janeiro;11;13;24;394
3302254;Itatiaia;3304557;Rio de Janeiro;11;13;24;143
3303302;Niterói;3304300;Rio Bonito;11;13;24;52
3300704;Cabo Frio;3303401;Nova Friburgo;11;13;24;83
3127701;Governador Valadares;3205309;Vitória;11;13;24;236
3151800;Poços de Caldas;3170701;Varginha;11;13;24;122
3106200;Belo Horizonte;3113404;Caratinga;11;13;24;186
2407203;Macau;2408102;Natal;11;13;24;171
2303709;Caucaia;2307650;Maracanaú;11;13;24;16
1501402;Belém;1506500;Santa Isabel do Pará;11;13;24;32
1504208;Marabá;1506138;Redenção;11;13;24;308
1302603;Manaus;1304203;Tefé;11;13;24;520
1200401;Rio Branco;5103403;Cuiabá;10;14;24;1387
3304557;Rio de Janeiro;4318705;São Leopoldo;10;14;24;1062
4311403;Lajeado;4314100;Passo Fundo;10;14;24;135
3509502;Campinas;3522604;Itapira;10;14;24;57
3304003;Piraí;3304557;Rio de Janeiro;10;14;24;71
3550308;São Paulo;4322509;Vacaria;9;15;24;677
4309001;Giruá;4317202;Santa Rosa;9;15;24;21
4101903;Assaí;4113700;Londrina;9;15;24;33
3500501;Águas de Lindóia;3550308;São Paulo;9;15;24;130
2111300;São Luís;3505708;Barueri;9;15;24;2335
3117876;Confins;3304557;Rio de Janeiro;9;15;24;367
2611606;Recife;2700300;Arapiraca;9;15;24;265
1504208;Marabá;2105302;Imperatriz;9;15;24;185
4302105;Bento Gonçalves;5300108;Brasília;8;16;24;1532
2504009;Campina Grande;3304557;Rio de Janeiro;8;16;24;1880
1500800;Ananindeua;5300108;Brasília;7;17;24;1598
3501608;Americana;5300108;Brasília;6;18;24;770
4208203;Itajaí;5300108;Brasília;6;18;24;1236
4314100;Passo Fundo;4314407;Pelotas;6;18;24;385
3506003;Bauru;3534401;Osasco;6;18;24;268
4204202;Chapecó;5300108;Brasília;5;19;24;1355
3505708;Barueri;4104808;Cascavel;5;19;24;680
2611606;Recife;2933307;Vitória da Conquista;4;20;24;975
3502804;Araçatuba;5300108;Brasília;3;21;24;660
3533502;Novo Horizonte;3545605;Santa Adélia;1;23;24;50
2306306;Itapagé;2611606;Recife;1;23;24;708
5208707;Goiânia;5211206;Itapuranga;11;12;23;149
3106200;Belo Horizonte;5201405;Aparecida de Goiânia;11;12;23;663
5102678;Campo Verde;5104807;Jaciara;11;12;23;51
3170206;Uberlândia;5103403;Cuiabá;11;12;23;925
3549805;São José do Rio Preto;5103403;Cuiabá;11;12;23;934
5102637;Campo Novo do Parecis;5103403;Cuiabá;11;12;23;284
4305439;Chuí;4317301;Santa Vitória do Palmar;11;12;23;18
4300604;Alvorada;4303103;Cachoeirinha;11;12;23;5
3550308;São Paulo;4214805;Rio do Sul;11;12;23;491
4204608;Criciúma;4211207;Morro da Fumaça;11;12;23;17
4106902;Curitiba;4209300;Lages;11;12;23;281
4202107;Barra Velha;4209102;Joinville;11;12;23;41
4204509;Corupá;4208906;Jaraguá do Sul;11;12;23;17
4118402;Paranavaí;4128104;Umuarama;11;12;23;114
4117909;Palotina;4127700;Toledo;11;12;23;47
4118204;Paranaguá;4119905;Ponta Grossa;11;12;23;171
4104907;Castro;4119400;Piraí do Sul;11;12;23;27
4112108;Jandaia do Sul;4114203;Mandaguari;11;12;23;8
4101408;Apucarana;4112108;Jandaia do Sul;11;12;23;20
3550308;São Paulo;4104907;Castro;11;12;23;365
3547809;Santo André;3552205;Sorocaba;11;12;23;101
3519709;Ibiúna;3550605;São Roque;11;12;23;17
3131703;Itabira;3550308;São Paulo;11;12;23;562
3538709;Piracicaba;3549805;São José do Rio Preto;11;12;23;282
3106200;Belo Horizonte;3548500;Santos;11;12;23;502
3118601;Contagem;3543402;Ribeirão Preto;11;12;23;407
3527207;Lorena;3538006;Pindamonhangaba;11;12;23;44
3304557;Rio de Janeiro;3522505;Itapevi;11;12;23;382
3507001;Boituva;3511508;Cerquilho;11;12;23;15
2404507;Guamaré;3304557;Rio de Janeiro;11;12;23;2081
2927408;Salvador;3302403;Macaé;11;12;23;1092
3301405;Conceição de Macabu;3302403;Macaé;11;12;23;30
3301009;Campos dos Goytacazes;3302205;Itaperuna;11;12;23;93
3203908;Nova Venécia;3205309;Vitória;11;12;23;170
3200300;Alfredo Chaves;3205200;Vila Velha;11;12;23;52
3201308;Cariacica;3202405;Guarapari;11;12;23;44
3152808;Prata;3170206;Uberlândia;11;12;23;89
3117306;Conceição das Alagoas;3170107;Uberaba;11;12;23;53
3106200;Belo Horizonte;3146107;Ouro Preto;11;12;23;70
2910800;Feira de Santana;3106200;Belo Horizonte;11;12;23;987
2910727;Eunápolis;2927408;Salvador;11;12;23;393
2408003;Mossoró;2611606;Recife;11;12;23;419
2408102;Natal;2414209;Tibau do Sul;11;12;23;46
2403251;Parnamirim;2412005;São Gonçalo do Amarante;11;12;23;15
2403251;Parnamirim;2407104;Macaíba;11;12;23;12
2302503;Brejo Santo;2307304;Juazeiro do Norte;11;12;23;44
1702109;Araguaína;1709500;Gurupi;11;12;23;508
1501402;Belém;1501709;Bragança;11;12;23;188
1301209;Coari;1302603;Manaus;11;12;23;363
1100189;Pimenta Bueno;1100205;Porto Velho;11;12;23;434
1100023;Ariquemes;1100114;Jaru;11;12;23;77
1500602;Altamira;5300108;Brasília;10;13;23;1470
3550308;São Paulo;5105259;Lucas do Rio Verde;10;13;23;1561
4304606;Canoas;4323002;Viamão;10;13;23;25
4301958;Barra Funda;4320107;Sarandi;10;13;23;12
4316402;Rosário do Sul;4317103;Santana do Livramento;10;13;23;84
4315602;Rio Grande;4316808;Santa Cruz do Sul;10;13;23;262
4310009;Ibirubá;4315354;Quinze de Novembro;10;13;23;13
2111300;São Luís;4314902;Porto Alegre;10;13;23;3109
4218707;Tubarão;4314902;Porto Alegre;10;13;23;270
4204806;Curitibanos;4215505;Santa Cecília;10;13;23;35
4205407;Florianópolis;4208906;Jaraguá do Sul;10;13;23;135
3545209;Salto;3552205;Sorocaba;10;13;23;38
3527108;Lins;3541604;Promissão;10;13;23;18
3205002;Serra;3534401;Osasco;10;13;23;755
3505708;Barueri;3530607;Moji das Cruzes;10;13;23;70
3506607;Biritiba-Mirim;3530607;Moji das Cruzes;10;13;23;16
3506003;Bauru;3527108;Lins;10;13;23;102
3304557;Rio de Janeiro;3516200;Franca;10;13;23;507
3505500;Barretos;3506102;Bebedouro;10;13;23;43
3303500;Nova Iguaçu;3303906;Petrópolis;10;13;23;36
3136702;Juiz de Fora;3162500;São João del Rei;10;13;23;122
3120904;Curvelo;3143302;Montes Claros;10;13;23;234
2611606;Recife;2614501;Surubim;10;13;23;96
2108207;Pedreiras;2111300;São Luís;10;13;23;227
1702109;Araguaína;2105302;Imperatriz;10;13;23;204
4314902;Porto Alegre;4318200;São Francisco de Paula;9;14;23;90
4307559;Estação;4308904;Getúlio Vargas;9;14;23;4
3505708;Barueri;4202404;Blumenau;9;14;23;438
3520509;Indaiatuba;3538709;Piracicaba;9;14;23;56
3517406;Guaíra;3534302;Orlândia;9;14;23;63
2307304;Juazeiro do Norte;3304557;Rio de Janeiro;9;14;23;1775
2207702;Parnaíba;2304400;Fortaleza;9;14;23;374
4304606;Canoas;4315602;Rio Grande;8;15;23;258
4119905;Ponta Grossa;4314902;Porto Alegre;8;15;23;557
3505807;Bastos;3550308;São Paulo;8;15;23;456
1506807;Santarém;5300108;Brasília;7;16;23;1638
3201209;Cachoeiro de Itapemirim;5300108;Brasília;7;16;23;927
3305109;São João de Meriti;5300108;Brasília;7;16;23;919
4106902;Curitiba;4307906;Farroupilha;7;16;23;463
4202008;Balneário Camboriú;4204202;Chapecó;7;16;23;391
4102000;Assis Chateaubriand;4117909;Palotina;7;16;23;33
3530607;Moji das Cruzes;3554102;Taubaté;7;16;23;88
1100205;Porto Velho;3534401;Osasco;7;16;23;2340
3304904;São Gonçalo;3305109;São João de Meriti;7;16;23;32
3526902;Limeira;5300108;Brasília;6;17;23;750
3534401;Osasco;4305108;Caxias do Sul;6;17;23;749
2933307;Vitória da Conquista;5300108;Brasília;5;18;23;764
3131307;Ipatinga;5300108;Brasília;5;18;23;709
3543907;Rio Claro;5300108;Brasília;5;18;23;731
3201308;Cariacica;5300108;Brasília;4;19;23;949
3516200;Franca;5300108;Brasília;3;20;23;527
4313409;Novo Hamburgo;5300108;Brasília;3;20;23;1578
5205109;Catalão;5211503;Itumbiara;11;11;22;142
1504208;Marabá;5208707;Goiânia;11;11;22;1253
3509502;Campinas;5208707;Goiânia;11;11;22;728
5105622;Mirassol d'Oeste;5107107;São José dos Quatro Marcos;11;11;22;11
5101407;Aripuanã;5105150;Juína;11;11;22;150
3550308;São Paulo;5006606;Ponta Porã;11;11;22;943
5003702;Dourados;5004502;Itaporã;11;11;22;16
5002407;Caarapó;5003702;Dourados;11;11;22;46
1100205;Porto Velho;5002704;Campo Grande;11;11;22;1592
1721000;Palmas;5002704;Campo Grande;11;11;22;1284
3509502;Campinas;5002704;Campo Grande;11;11;22;845
3518800;Guarulhos;5002704;Campo Grande;11;11;22;916
5000708;Anastácio;5001102;Aquidauana;11;11;22;7
4314902;Porto Alegre;4322509;Vacaria;11;11;22;173
4317509;Santo Ângelo;4318903;São Luiz Gonzaga;11;11;22;69
4303004;Cachoeira do Sul;4316907;Santa Maria;11;11;22;94
4306809;Encantado;4315800;Roca Sales;11;11;22;7
4313904;Panambi;4314902;Porto Alegre;11;11;22;295
4208203;Itajaí;4305108;Caxias do Sul;11;11;22;339
3518800;Guarulhos;4303103;Cachoeirinha;11;11;22;838
4207007;Içara;4218707;Tubarão;11;11;22;36
3511300;Cedral;4217709;Sombrio;11;11;22;909
3106200;Belo Horizonte;4216602;São José;11;11;22;963
4203907;Capinzal;4209003;Joaçaba;11;11;22;23
4125506;São José dos Pinhais;4208203;Itajaí;11;11;22;161
4205902;Gaspar;4207502;Indaial;11;11;22;27
3304557;Rio de Janeiro;4204608;Criciúma;11;11;22;867
4118501;Pato Branco;4204202;Chapecó;11;11;22;98
4201406;Araranguá;4202909;Brusque;11;11;22;214
4106605;Cruzeiro do Oeste;4128104;Umuarama;11;11;22;25
3550308;São Paulo;4127106;Telêmaco Borba;11;11;22;415
3525904;Jundiaí;4125506;São José dos Pinhais;11;11;22;346
4119905;Ponta Grossa;4125506;São José dos Pinhais;11;11;22;110
4106902;Curitiba;4115804;Medianeira;11;11;22;485
4101200;Antonina;4106902;Curitiba;11;11;22;58
4104303;Campo Mourão;4106902;Curitiba;11;11;22;346
4102000;Assis Chateaubriand;4104808;Cascavel;11;11;22;57
3518800;Guarulhos;4101804;Araucária;11;11;22;370
3525904;Jundiaí;3556701;Vinhedo;11;11;22;18
3549904;São José dos Campos;3555406;Ubatuba;11;11;22;81
3550308;São Paulo;3553708;Taquaritinga;11;11;22;315
3133808;Itaúna;3550308;São Paulo;11;11;22;445
3169307;Três Corações;3550308;São Paulo;11;11;22;263
3520400;Ilhabela;3550308;São Paulo;11;11;22;133
3521002;Iperó;3550308;São Paulo;11;11;22;111
3548500;Santos;3549904;São José dos Campos;11;11;22;91
3525706;José Bonifácio;3549805;São José do Rio Preto;11;11;22;39
3540705;Porto Ferreira;3547502;Santa Rita do Passa Quatro;11;11;22;16
3501608;Americana;3543402;Ribeirão Preto;11;11;22;182
3505708;Barueri;3541406;Presidente Prudente;11;11;22;493
3304557;Rio de Janeiro;3539806;Poá;11;11;22;322
3525300;Jaú;3536703;Pederneiras;11;11;22;23
3524303;Jaboticabal;3531308;Monte Alto;11;11;22;19
3526902;Limeira;3530706;Mogi Guaçu;11;11;22;53
3515509;Fernandópolis;3524808;Jales;11;11;22;32
3201308;Cariacica;3518800;Guarulhos;11;11;22;711
3501905;Amparo;3509502;Campinas;11;11;22;37
3302502;Magé;3305802;Teresópolis;11;11;22;24
3302700;Maricá;3304904;São Gonçalo;11;11;22;29
3201506;Colatina;3304557;Rio de Janeiro;11;11;22;456
3303708;Paraíba do Sul;3304557;Rio de Janeiro;11;11;22;80
3205002;Serra;3301702;Duque de Caxias;11;11;22;423
2111300;São Luís;3205309;Vitória;11;11;22;1999
3201902;Domingos Martins;3203346;Marechal Floriano;11;11;22;6
3148103;Patrocínio;3170206;Uberlândia;11;11;22;136
3157005;Salinas;3168002;Taiobeiras;11;11;22;42
3106200;Belo Horizonte;3165537;Sarzedo;11;11;22;23
3101607;Alfenas;3151800;Poços de Caldas;11;11;22;73
3138203;Lavras;3149903;Perdões;11;11;22;19
3106200;Belo Horizonte;3147907;Passos;11;11;22;289
3133808;Itaúna;3140704;Mateus Leme;11;11;22;21
3105400;Barão de Cocais;3136207;João Monlevade;11;11;22;38
3133709;Itatiaiuçu;3133808;Itaúna;11;11;22;20
1504208;Marabá;3106200;Belo Horizonte;11;11;22;1689
1721000;Palmas;3106200;Belo Horizonte;11;11;22;1147
2927408;Salvador;2931350;Teixeira de Freitas;11;11;22;521
2910800;Feira de Santana;2930709;Simões Filho;11;11;22;82
2914604;Irecê;2929909;Seabra;11;11;22;123
2927408;Salvador;2929206;São Francisco do Conde;11;11;22;46
2905701;Camaçari;2910800;Feira de Santana;11;11;22;83
2704302;Maceió;2704708;Marechal Deodoro;11;11;22;18
2606408;Gravatá;2616407;Vitória de Santo Antão;11;11;22;32
2612208;Salgueiro;2613909;Serra Talhada;11;11;22;96
2607901;Jaboatão dos Guararapes;2610707;Paulista;11;11;22;26
2507507;João Pessoa;2515302;Sapé;11;11;22;42
2408102;Natal;2503209;Cabedelo;11;11;22;143
2311306;Quixadá;2311405;Quixeramobim;11;11;22;37
2302107;Baturité;2304400;Fortaleza;11;11;22;73
1500800;Ananindeua;1506807;Santarém;11;11;22;717
1505536;Parauapebas;1506138;Redenção;11;11;22;222
1502152;Canaã dos Carajás;1505536;Parauapebas;11;11;22;55
1500800;Ananindeua;1505502;Paragominas;11;11;22;216
1501402;Belém;1504422;Marituba;11;11;22;10
1100049;Cacoal;1100288;Rolim de Moura;11;11;22;50
2611606;Recife;5208707;Goiânia;10;12;22;1778
3543402;Ribeirão Preto;5205109;Catalão;10;12;22;332
2927408;Salvador;5201405;Aparecida de Goiânia;10;12;22;1216
4113700;Londrina;5108402;Várzea Grande;10;12;22;1009
5100250;Alta Floresta;5103205;Colíder;10;12;22;123
3550308;São Paulo;5100250;Alta Floresta;10;12;22;1859
3550308;São Paulo;5007109;Ribas do Rio Pardo;10;12;22;832
3550308;São Paulo;5004700;Ivinhema;10;12;22;755
5002704;Campo Grande;5003306;Coxim;10;12;22;222
4306205;Cruzeiro do Sul;4311403;Lajeado;10;12;22;8
4203808;Canoinhas;4215802;São Bento do Sul;10;12;22;104
4106902;Curitiba;4215000;Rio Negrinho;10;12;22;93
4209102;Joinville;4215000;Rio Negrinho;10;12;22;66
4202008;Balneário Camboriú;4204608;Criciúma;10;12;22;198
4106902;Curitiba;4114302;Mandirituba;10;12;22;38
4104303;Campo Mourão;4108601;Goioerê;10;12;22;66
4101804;Araucária;4104204;Campo Largo;10;12;22;19
2931350;Teixeira de Freitas;3550308;São Paulo;10;12;22;968
3168606;Teófilo Otoni;3550308;São Paulo;10;12;22;822
3300308;Barra do Piraí;3550308;São Paulo;10;12;22;315
3305505;Saquarema;3550308;São Paulo;10;12;22;435
3507506;Botucatu;3550100;São Manuel;10;12;22;21
3106200;Belo Horizonte;3549805;São José do Rio Preto;10;12;22;572
3304557;Rio de Janeiro;3548906;São Carlos;10;12;22;489
3536208;Pariquera-Açu;3542602;Registro;10;12;22;21
3507605;Bragança Paulista;3525904;Jundiaí;10;12;22;44
3507506;Botucatu;3525300;Jaú;10;12;22;68
1100205;Porto Velho;3505708;Barueri;10;12;22;2333
3106705;Betim;3505708;Barueri;10;12;22;478
3205200;Vila Velha;3302403;Macaé;10;12;22;273
3136702;Juiz de Fora;3300951;Comendador Levy Gasparian;10;12;22;33
2304400;Fortaleza;3205309;Vitória;10;12;22;1832
3204906;São Mateus;3205002;Serra;10;12;22;158
3136702;Juiz de Fora;3171303;Viçosa;10;12;22;118
3143302;Montes Claros;3170206;Uberlândia;10;12;22;519
2704302;Maceió;3106200;Belo Horizonte;10;12;22;1412
2909307;Correntina;2919553;Luís Eduardo magalhães;10;12;22;188
2916401;Itapetinga;2917102;Itororó;10;12;22;29
2611606;Recife;2612208;Salgueiro;10;12;22;466
2304400;Fortaleza;2609600;Olinda;10;12;22;615
2504009;Campina Grande;2506004;Esperança;10;12;22;23
1721000;Palmas;2304400;Fortaleza;10;12;22;1319
2201200;Barras;2211001;Teresina;10;12;22;108
1100023;Ariquemes;1100106;Guajará-Mirim;10;12;22;270
3550308;São Paulo;4312401;Montenegro;9;13;22;808
4301503;Augusto Pestana;4310207;Ijuí;9;13;22;15
3550308;São Paulo;4303905;Campo Bom;9;13;22;786
3304557;Rio de Janeiro;4119905;Ponta Grossa;9;13;22;733
3507001;Boituva;3552205;Sorocaba;9;13;22;28
3525904;Jundiaí;3548708;São Bernardo do Campo;9;13;22;68
3523909;Itu;3534401;Osasco;9;13;22;59
3301009;Campos dos Goytacazes;3505708;Barueri;9;13;22;595
3302403;Macaé;3303401;Nova Friburgo;9;13;22;71
1100205;Porto Velho;1100288;Rolim de Moura;9;13;22;408
2913606;Ilhéus;5300108;Brasília;8;14;22;948
3148004;Patos de Minas;5300108;Brasília;8;14;22;343
4304606;Canoas;4314407;Pelotas;8;14;22;230
4103701;Cambé;4122404;Rolândia;8;14;22;10
4104303;Campo Mourão;4114005;Mamborê;8;14;22;34
1302603;Manaus;5002704;Campo Grande;7;15;22;1990
3170107;Uberaba;4314902;Porto Alegre;7;15;22;1182
2927408;Salvador;3303302;Niterói;7;15;22;1188
2408003;Mossoró;5300108;Brasília;6;16;22;1618
3529401;Mauá;5300108;Brasília;6;16;22;885
3552403;Sumaré;5300108;Brasília;6;16;22;780
3538709;Piracicaba;4314902;Porto Alegre;6;16;22;874
2927408;Salvador;4113700;Londrina;6;16;22;1698
4115200;Maringá;4118907;Pérola;5;17;22;183
3526407;Laranjal Paulista;3554508;Tietê;5;17;22;14
2305233;Horizonte;3550308;São Paulo;5;17;22;2304
3301702;Duque de Caxias;3534401;Osasco;4;18;22;364
4208203;Itajaí;4219309;Videira;3;19;22;238
2105302;Imperatriz;5208707;Goiânia;10;11;21;1252
2111300;São Luís;5208707;Goiânia;10;11;21;1652
5205406;Ceres;5208707;Goiânia;10;11;21;162
4106902;Curitiba;5108402;Várzea Grande;10;11;21;1322
5003306;Coxim;5007406;Rio Verde de Mato Grosso;10;11;21;56
3550308;São Paulo;5002308;Brasilândia;10;11;21;626
4304606;Canoas;4321600;Tramandaí;10;11;21;100
4316808;Santa Cruz do Sul;4318705;São Leopoldo;10;11;21;124
4310603;Itaqui;4318002;São Borja;10;11;21;76
3548708;São Bernardo do Campo;4309209;Gravataí;10;11;21;804
3304557;Rio de Janeiro;4301602;Bagé;10;11;21;1365
3550308;São Paulo;4301602;Bagé;10;11;21;1092
3550308;São Paulo;4215802;São Bento do Sul;10;11;21;395
4106902;Curitiba;4214805;Rio do Sul;10;11;21;202
4202404;Blumenau;4208302;Itapema;10;11;21;46
4203006;Caçador;4205506;Fraiburgo;10;11;21;30
4203600;Campos Novos;4205506;Fraiburgo;10;11;21;53
4119905;Ponta Grossa;4127502;Tibagi;10;11;21;71
4109609;Guaratuba;4115705;Matinhos;10;11;21;17
3170206;Uberlândia;4115200;Maringá;10;11;21;622
3549904;São José dos Campos;4106902;Curitiba;10;11;21;421
3529005;Marília;3555000;Tupã;10;11;21;69
3502903;Araçoiaba da Serra;3552205;Sorocaba;10;11;21;12
2700300;Arapiraca;3550308;São Paulo;10;11;21;1821
3151206;Pirapora;3550308;São Paulo;10;11;21;722
3200607;Aracruz;3550308;São Paulo;10;11;21;770
3516705;Garça;3550308;São Paulo;10;11;21;343
3522703;Itápolis;3550308;São Paulo;10;11;21;316
3531100;Mongaguá;3550308;São Paulo;10;11;21;48
3534302;Orlândia;3550308;São Paulo;10;11;21;348
3550100;São Manuel;3550308;São Paulo;10;11;21;220
3503208;Araraquara;3549805;São José do Rio Preto;10;11;21;166
3504602;Bady Bassitt;3549805;São José do Rio Preto;10;11;21;11
3538709;Piracicaba;3548906;São Carlos;10;11;21;85
3520509;Indaiatuba;3548708;São Bernardo do Campo;10;11;21;96
3500105;Adamantina;3534609;Osvaldo Cruz;10;11;21;25
3170206;Uberlândia;3518800;Guarulhos;10;11;21;531
3505500;Barretos;3517406;Guaíra;10;11;21;38
3304557;Rio de Janeiro;3502804;Araçatuba;10;11;21;773
1506807;Santarém;3304557;Rio de Janeiro;10;11;21;2522
3140803;Matias Barbosa;3304557;Rio de Janeiro;10;11;21;112
3205101;Viana;3304557;Rio de Janeiro;10;11;21;387
3200904;Barra de São Francisco;3203908;Nova Venécia;10;11;21;56
3101607;Alfenas;3152501;Pouso Alegre;10;11;21;90
3106200;Belo Horizonte;3151206;Pirapora;10;11;21;302
3119302;Coromandel;3148103;Patrocínio;10;11;21;58
3118007;Congonhas;3145901;Ouro Branco;10;11;21;20
3107406;Bom Despacho;3145208;Nova Serrana;10;11;21;33
3124906;Eugenópolis;3143906;Muriaé;10;11;21;16
3112604;Capinópolis;3134202;Ituiutaba;10;11;21;33
3106200;Belo Horizonte;3130101;Igarapé;10;11;21;41
3128303;Guaranésia;3128709;Guaxupé;10;11;21;9
2917300;Ituberá;2932903;Valença;10;11;21;43
2304400;Fortaleza;2930709;Simões Filho;10;11;21;997
2914604;Irecê;2918357;João Dourado;10;11;21;22
2914000;Ipirá;2914703;Itaberaba;10;11;21;71
2612505;Santa Cruz do Capibaribe;2615003;Taquaritinga do Norte;10;11;21;18
2608909;Limoeiro;2614501;Surubim;10;11;21;34
2610905;Pesqueira;2611606;Recife;10;11;21;201
2304400;Fortaleza;2503209;Cabedelo;10;11;21;545
2205706;Luís Correia;2207702;Parnaíba;10;11;21;14
2101707;Barreirinhas;2111300;São Luís;10;11;21;162
1501402;Belém;1721000;Palmas;10;11;21;993
1504208;Marabá;1702109;Araguaína;10;11;21;225
1301852;Iranduba;1302603;Manaus;10;11;21;22
1100205;Porto Velho;1100809;Candeias do Jamari;10;11;21;21
5205109;Catalão;5300108;Brasília;9;12;21;260
5107602;Rondonópolis;5208707;Goiânia;9;12;21;575
5002001;Batayporã;5006200;Nova Andradina;9;12;21;14
4119152;Pinhais;4314902;Porto Alegre;9;12;21;545
4301636;Balneário Pinhal;4314902;Porto Alegre;9;12;21;93
4303103;Cachoeirinha;4314100;Passo Fundo;9;12;21;227
4204202;Chapecó;4206652;Guatambú;9;12;21;16
3550308;São Paulo;4122404;Rolândia;9;12;21;485
4102802;Bela Vista do Paraíso;4113700;Londrina;9;12;21;34
2111300;São Luís;4106902;Curitiba;9;12;21;2579
3550308;São Paulo;3554805;Tremembé;9;12;21;137
1302603;Manaus;3549904;São José dos Campos;9;12;21;2618
3518800;Guarulhos;3549805;São José do Rio Preto;9;12;21;415
3505708;Barueri;3543907;Rio Claro;9;12;21;142
2927408;Salvador;3543402;Ribeirão Preto;9;12;21;1308
3509502;Campinas;3525300;Jaú;9;12;21;171
3304557;Rio de Janeiro;3510500;Caraguatatuba;9;12;21;238
3304557;Rio de Janeiro;3501608;Americana;9;12;21;419
3301702;Duque de Caxias;3305505;Saquarema;9;12;21;88
3106200;Belo Horizonte;3202405;Guarapari;9;12;21;364
3201209;Cachoeiro de Itapemirim;3201506;Colatina;9;12;21;149
3118601;Contagem;3127701;Governador Valadares;9;12;21;254
2304400;Fortaleza;2310209;Paracuru;9;12;21;64
2211001;Teresina;2211209;Uruçuí;9;12;21;305
1505536;Parauapebas;5300108;Brasília;8;13;21;1103
2611101;Petrolina;5300108;Brasília;8;13;21;1062
3144805;Nova Lima;5300108;Brasília;8;13;21;641
4306932;Entre-Ijuís;4317509;Santo Ângelo;8;13;21;6
3520509;Indaiatuba;4314902;Porto Alegre;8;13;21;855
4210100;Mafra;4212205;Papanduva;8;13;21;40
4115606;Matelândia;4115804;Medianeira;8;13;21;12
4103701;Cambé;4115200;Maringá;8;13;21;69
3538709;Piracicaba;3548500;Santos;8;13;21;182
3302205;Itaperuna;3303302;Niterói;8;13;21;229
3200904;Barra de São Francisco;3205150;Vila Pavão;8;13;21;36
2909802;Cruz das Almas;2927408;Salvador;8;13;21;70
4314407;Pelotas;4318705;São Leopoldo;7;14;21;249
4117909;Palotina;4127403;Terra Roxa;7;14;21;33
3304557;Rio de Janeiro;3524709;Jaguariúna;7;14;21;383
3106200;Belo Horizonte;3303906;Petrópolis;7;14;21;301
3302403;Macaé;5300108;Brasília;6;15;21;979
2704302;Maceió;3534401;Osasco;6;15;21;1882
4314100;Passo Fundo;4318705;São Leopoldo;5;16;21;205
3545605;Santa Adélia;3553708;Taquaritinga;1;20;21;34
5215231;Novo Gama;5300108;Brasília;10;10;20;30
5215603;Padre Bernardo;5300108;Brasília;10;10;20;85
3170206;Uberlândia;5218805;Rio Verde;10;10;20;309
5205109;Catalão;5210109;Ipameri;10;10;20;53
5208707;Goiânia;5209705;Hidrolândia;10;10;20;30
1501402;Belém;5208707;Goiânia;10;10;20;1696
5200050;Abadia de Goiás;5208707;Goiânia;10;10;20;18
3170206;Uberlândia;5201405;Aparecida de Goiânia;10;10;20;255
5106307;Paranatinga;5107040;Primavera do Leste;10;10;20;123
5102504;Cáceres;5106752;Pontes e Lacerda;10;10;20;198
5102678;Campo Verde;5103403;Cuiabá;10;10;20;100
5003702;Dourados;5008305;Três Lagoas;10;10;20;359
5002704;Campo Grande;5007109;Ribas do Rio Pardo;10;10;20;92
4106902;Curitiba;5003702;Dourados;10;10;20;675
4312401;Montenegro;4322004;Triunfo;10;10;20;34
4307500;Espumoso;4321006;Tapera;10;10;20;11
4313060;Nova Hartz;4319901;Sapiranga;10;10;20;12
4316907;Santa Maria;4319406;São Pedro do Sul;10;10;20;36
4315602;Rio Grande;4318507;São José do Norte;10;10;20;17
4316907;Santa Maria;4318309;São Gabriel;10;10;20;84
4311809;Marau;4314902;Porto Alegre;10;10;20;202
4313409;Novo Hamburgo;4314803;Portão;10;10;20;11
4308904;Getúlio Vargas;4314100;Passo Fundo;10;10;20;44
4313409;Novo Hamburgo;4314100;Passo Fundo;10;10;20;202
4312401;Montenegro;4313409;Novo Hamburgo;10;10;20;36
4301305;Arroio Grande;4311007;Jaguarão;10;10;20;43
4304804;Carlos Barbosa;4305108;Caxias do Sul;10;10;20;36
4203808;Canoinhas;4218301;Três Barras;10;10;20;14
4213500;Porto Belo;4218004;Tijucas;10;10;20;11
4216701;São José do Cedro;4217204;São Miguel do Oeste;10;10;20;27
3304557;Rio de Janeiro;4216206;São Francisco do Sul;10;10;20;649
4207502;Indaial;4214805;Rio do Sul;10;10;20;53
4202305;Biguaçu;4211900;Palhoça;10;10;20;17
4209300;Lages;4211751;Otacílio Costa;10;10;20;41
4106902;Curitiba;4211306;Navegantes;10;10;20;171
4106902;Curitiba;4210100;Mafra;10;10;20;95
4202008;Balneário Camboriú;4209300;Lages;10;10;20;186
4204301;Concórdia;4209300;Lages;10;10;20;178
3550308;São Paulo;4209003;Joaçaba;10;10;20;615
4203600;Campos Novos;4209003;Joaçaba;10;10;20;45
2611606;Recife;4208203;Itajaí;10;10;20;2455
3518800;Guarulhos;4208203;Itajaí;10;10;20;443
4205902;Gaspar;4207106;Ilhota;10;10;20;14
4106902;Curitiba;4203808;Canoinhas;10;10;20;140
3518800;Guarulhos;4202404;Blumenau;10;10;20;461
4125605;São Mateus do Sul;4128203;União da Vitória;10;10;20;91
4104204;Campo Largo;4125506;São José dos Pinhais;10;10;20;36
4105805;Colombo;4122206;Rio Branco do Sul;10;10;20;10
4106902;Curitiba;4122206;Rio Branco do Sul;10;10;20;27
4119400;Piraí do Sul;4119905;Ponta Grossa;10;10;20;65
4109401;Guarapuava;4119608;Pitanga;10;10;20;75
4114609;Marechal Cândido Rondon;4118451;Pato Bragado;10;10;20;19
4116901;Nova Esperança;4118402;Paranavaí;10;10;20;26
4109401;Guarapuava;4110706;Irati;10;10;20;83
4108403;Francisco Beltrão;4109401;Guarapuava;10;10;20;179
2910800;Feira de Santana;4106902;Curitiba;10;10;20;1764
3501608;Americana;4106902;Curitiba;10;10;20;356
3513009;Cotia;3556453;Vargem Grande Paulista;10;10;20;11
3518800;Guarulhos;3554102;Taubaté;10;10;20;112
3547304;Santana de Parnaíba;3552205;Sorocaba;10;10;20;60
1100023;Ariquemes;3550308;São Paulo;10;10;20;2212
3137601;Lagoa Santa;3550308;São Paulo;10;10;20;525
3146008;Ouro Fino;3550308;São Paulo;10;10;20;154
3525201;Jarinu;3550308;São Paulo;10;10;20;62
3509700;Campos do Jordão;3549904;São José dos Campos;10;10;20;62
3511300;Cedral;3549805;São José do Rio Preto;10;10;20;16
3506003;Bauru;3548906;São Carlos;10;10;20;127
2304400;Fortaleza;3548708;São Bernardo do Campo;10;10;20;2342
2611606;Recife;3548500;Santos;10;10;20;2071
3522109;Itanhaém;3548500;Santos;10;10;20;55
3543303;Ribeirão Pires;3547809;Santo André;10;10;20;12
3505906;Batatais;3543402;Ribeirão Preto;10;10;20;35
3509502;Campinas;3540705;Porto Ferreira;10;10;20;124
3506003;Bauru;3538709;Piracicaba;10;10;20;154
3304557;Rio de Janeiro;3538006;Pindamonhangaba;10;10;20;226
3516200;Franca;3537008;Pedregulho;10;10;20;32
3518800;Guarulhos;3536505;Paulínia;10;10;20;97
3516200;Franca;3536307;Patrocínio Paulista;10;10;20;15
3516200;Franca;3534302;Orlândia;10;10;20;54
3527108;Lins;3529005;Marília;10;10;20;62
3504107;Atibaia;3528502;Mairiporã;10;10;20;23
3521408;Iracemápolis;3526902;Limeira;10;10;20;13
3509205;Cajamar;3525904;Jundiaí;10;10;20;20
3516200;Franca;3524105;Ituverava;10;10;20;49
3106200;Belo Horizonte;3513009;Cotia;10;10;20;506
3106200;Belo Horizonte;3306305;Volta Redonda;10;10;20;288
3304557;Rio de Janeiro;3305752;Tanguá;10;10;20;57
3304904;São Gonçalo;3305505;Saquarema;10;10;20;62
3152501;Pouso Alegre;3304557;Rio de Janeiro;10;10;20;285
3169901;Ubá;3304557;Rio de Janeiro;10;10;20;200
3300704;Cabo Frio;3303906;Petrópolis;10;10;20;124
3302908;Miguel Pereira;3303856;Paty do Alferes;10;10;20;6
3301702;Duque de Caxias;3302403;Macaé;10;10;20;153
3300704;Cabo Frio;3301009;Campos dos Goytacazes;10;10;20;143
1100205;Porto Velho;3205309;Vitória;10;10;20;2712
3163706;São Lourenço;3170701;Varginha;10;10;20;79
3120904;Curvelo;3169356;Três Marias;10;10;20;102
3147402;Paraopeba;3167202;Sete Lagoas;10;10;20;26
3105608;Barbacena;3160702;Santos Dumont;10;10;20;40
3137205;Lagoa da Prata;3160405;Santo Antônio do Monte;10;10;20;26
3146008;Ouro Fino;3152501;Pouso Alegre;10;10;20;44
3128709;Guaxupé;3151800;Poços de Caldas;10;10;20;54
3115300;Cataguases;3143906;Muriaé;10;10;20;49
3107307;Bocaiúva;3143302;Montes Claros;10;10;20;44
3106903;Bicas;3136702;Juiz de Fora;10;10;20;26
3108552;Brasilândia de Minas;3136306;João Pinheiro;10;10;20;85
3118601;Contagem;3136207;João Monlevade;10;10;20;96
3106705;Betim;3133808;Itaúna;10;10;20;44
3105400;Barão de Cocais;3131703;Itabira;10;10;20;44
3119401;Coronel Fabriciano;3127701;Governador Valadares;10;10;20;104
3107406;Bom Despacho;3122306;Divinópolis;10;10;20;62
2907202;Casa Nova;2918407;Juazeiro;10;10;20;58
2910727;Eunápolis;2914653;Itabela;10;10;20;24
2910800;Feira de Santana;2914604;Irecê;10;10;20;334
2803609;Laranjeiras;2906501;Candeias;10;10;20;255
2603454;Camaragibe;2613701;São Lourenço da Mata;10;10;20;4
2501807;Bayeux;2611606;Recife;10;10;20;110
2606804;Igarassu;2610707;Paulista;10;10;20;11
2606002;Garanhuns;2608800;Lajedo;10;10;20;31
2507507;João Pessoa;2606200;Goiana;10;10;20;44
2602100;Bom Conselho;2606002;Garanhuns;10;10;20;43
2507507;João Pessoa;2516201;Sousa;10;10;20;381
1500800;Ananindeua;2304400;Fortaleza;10;10;20;1123
2200400;Altos;2211001;Teresina;10;10;20;37
2207900;Pedro II;2208403;Piripiri;10;10;20;41
2103000;Caxias;2103307;Codó;10;10;20;80
1506138;Redenção;1508407;Xinguara;10;10;20;101
1501402;Belém;1502103;Cametá;10;10;20;154
1100114;Jaru;1100155;Ouro Preto do Oeste;10;10;20;44
5204508;Caldas Novas;5300108;Brasília;9;11;20;226
5216304;Paranaiguara;5220405;São Simão;9;11;20;14
5106224;Nova Mutum;5107925;Sorriso;9;11;20;148
3550308;São Paulo;5100300;Alto Araguaia;9;11;20;1001
5005400;Maracaju;5007901;Sidrolândia;9;11;20;79
4314902;Porto Alegre;4318804;São Lourenço do Sul;9;11;20;160
4310603;Itaqui;4314902;Porto Alegre;9;11;20;521
4313656;Palmares do Sul;4314902;Porto Alegre;9;11;20;71
4219507;Xanxerê;4219705;Xaxim;9;11;20;17
4209102;Joinville;4211306;Navegantes;9;11;20;69
4204301;Concórdia;4208203;Itajaí;9;11;20;326
4204202;Chapecó;4204400;Coronel Freitas;9;11;20;24
4108304;Foz do Iguaçu;4113700;Londrina;9;11;20;423
4111506;Ivaiporã;4113700;Londrina;9;11;20;120
3110509;Camanducaia;3550308;São Paulo;9;11;20;112
3545308;Salto de Pirapora;3550308;São Paulo;9;11;20;94
2927408;Salvador;3547304;Santana de Parnaíba;9;11;20;1428
3164704;São Sebastião do Paraíso;3543402;Ribeirão Preto;9;11;20;88
3501301;Álvares Machado;3541406;Presidente Prudente;9;11;20;10
3525904;Jundiaí;3526902;Limeira;9;11;20;85
3509502;Campinas;3524402;Jacareí;9;11;20;122
3505708;Barueri;3523909;Itu;9;11;20;50
3503901;Arujá;3523107;Itaquaquecetuba;9;11;20;10
3304557;Rio de Janeiro;3519071;Hortolândia;9;11;20;406
3501608;Americana;3519071;Hortolândia;9;11;20;18
3509502;Campinas;3513504;Cubatão;9;11;20;128
3300225;Areal;3304557;Rio de Janeiro;9;11;20;74
3106200;Belo Horizonte;3301009;Campos dos Goytacazes;9;11;20;344
3136702;Juiz de Fora;3170206;Uberlândia;9;11;20;612
3122306;Divinópolis;3137205;Lagoa da Prata;9;11;20;70
3116605;Cláudio;3133501;Itapecerica;9;11;20;38
3120904;Curvelo;3125705;Felixlândia;9;11;20;44
3106200;Belo Horizonte;3121605;Diamantina;9;11;20;190
2903201;Barreiras;2933307;Vitória da Conquista;9;11;20;531
2927408;Salvador;2932903;Valença;9;11;20;80
2918407;Juazeiro;2930105;Senhor do Bonfim;9;11;20;112
2910800;Feira de Santana;2918001;Jequié;9;11;20;207
2611101;Petrolina;2613909;Serra Talhada;9;11;20;288
1501402;Belém;1501501;Benevides;9;11;20;21
2403251;Parnamirim;5300108;Brasília;8;12;20;1724
3550308;São Paulo;5000203;Água Clara;8;12;20;746
4304606;Canoas;4316808;Santa Cruz do Sul;8;12;20;122
4302105;Bento Gonçalves;4304606;Canoas;8;12;20;89
4108809;Guaíra;4114609;Marechal Cândido Rondon;8;12;20;54
3548906;São Carlos;4106902;Curitiba;8;12;20;402
3516200;Franca;3551702;Sertãozinho;8;12;20;90
3505708;Barueri;3529401;Mauá;8;12;20;46
3505708;Barueri;3516200;Franca;8;12;20;334
3300225;Areal;3303906;Petrópolis;8;12;20;35
3106200;Belo Horizonte;3114204;Carmo do Cajuru;8;12;20;88
2601706;Belo Jardim;2611606;Recife;8;12;20;166
2609600;Olinda;3304557;Rio de Janeiro;7;13;20;1842
3106200;Belo Horizonte;3127800;Grão Mogol;7;13;20;388
1302603;Manaus;5108402;Várzea Grande;6;14;20;1445
3543402;Ribeirão Preto;3548807;São Caetano do Sul;6;14;20;299
3530607;Moji das Cruzes;3534401;Osasco;6;14;20;61
2611606;Recife;2924009;Paulo Afonso;6;14;20;399
4208906;Jaraguá do Sul;5300108;Brasília;5;15;20;1188
4209300;Lages;5300108;Brasília;5;15;20;1355
5213004;Maurilândia;5221551;Turvelândia;5;15;20;14
3301702;Duque de Caxias;3548807;São Caetano do Sul;5;15;20;344
3534401;Osasco;3538709;Piracicaba;5;15;20;123
3136702;Juiz de Fora;3534401;Osasco;5;15;20;402
2606002;Garanhuns;2704302;Maceió;5;15;20;122
4104303;Campo Mourão;4113734;Luiziana;4;16;20;29
3306305;Volta Redonda;5300108;Brasília;3;17;20;850
3534708;Ourinhos;3557204;Chavantes;3;17;20;21
2804805;Nossa Senhora do Socorro;2910800;Feira de Santana;3;17;20;254
3534302;Orlândia;5219308;Santa Helena de Goiás;1;19;20;434
3529658;Mesópolis;3545605;Santa Adélia;1;19;20;236
3536604;Paulo de Faria;3545605;Santa Adélia;1;19;20;147
5220454;Senador Canedo;5300108;Brasília;9;10;19;160
3550308;São Paulo;5213103;Mineiros;9;10;19;929
5107040;Primavera do Leste;5108402;Várzea Grande;9;10;19;196
5100250;Alta Floresta;5105259;Lucas do Rio Verde;9;10;19;352
3170206;Uberlândia;5006309;Paranaíba;9;10;19;317
4301206;Arroio do Tigre;4320701;Sobradinho;9;10;19;12
4303905;Campo Bom;4318705;São Leopoldo;9;10;19;13
4311205;Júlio de Castilhos;4316907;Santa Maria;9;10;19;54
4307807;Estrela;4316808;Santa Cruz do Sul;9;10;19;51
4101804;Araucária;4314902;Porto Alegre;9;10;19;523
4304358;Candiota;4314902;Porto Alegre;9;10;19;292
4312252;Minas do Leão;4314902;Porto Alegre;9;10;19;82
4106902;Curitiba;4314100;Passo Fundo;9;10;19;434
4308102;Feliz;4313201;Nova Petrópolis;9;10;19;20
3518800;Guarulhos;4309209;Gravataí;9;10;19;832
4304408;Canela;4305108;Caxias do Sul;9;10;19;41
4201406;Araranguá;4218806;Turvo;9;10;19;18
4214805;Rio do Sul;4217808;Taió;9;10;19;44
4205407;Florianópolis;4214805;Rio do Sul;9;10;19;115
4209003;Joaçaba;4209300;Lages;9;10;19;139
4207650;Iporã do Oeste;4208401;Itapiranga;9;10;19;27
3205002;Serra;4208203;Itajaí;9;10;19;1112
4128203;União da Vitória;4203006;Caçador;9;10;19;58
4108502;General Carneiro;4128203;União da Vitória;9;10;19;23
4109401;Guarapuava;4120606;Prudentópolis;9;10;19;47
3106200;Belo Horizonte;4115200;Maringá;9;10;19;893
3534708;Ourinhos;4113700;Londrina;9;10;19;133
3550308;São Paulo;4109807;Ibiporã;9;10;19;453
4104808;Cascavel;4108403;Francisco Beltrão;9;10;19;132
1100205;Porto Velho;4106902;Curitiba;9;10;19;2314
4101606;Arapoti;4106902;Curitiba;9;10;19;151
4103107;Bocaiúva do Sul;4106902;Curitiba;9;10;19;31
4104659;Carambeí;4104907;Castro;9;10;19;16
3304557;Rio de Janeiro;3552403;Sumaré;9;10;19;411
1504422;Marituba;3550308;São Paulo;9;10;19;2471
1702109;Araguaína;3550308;São Paulo;9;10;19;1827
1718204;Porto Nacional;3550308;São Paulo;9;10;19;1443
2921005;Mata de São João;3550308;São Paulo;9;10;19;1481
3168705;Timóteo;3550308;São Paulo;9;10;19;605
3302858;Mesquita;3550308;São Paulo;9;10;19;340
3512407;Cordeirópolis;3550308;São Paulo;9;10;19;153
3527405;Lucélia;3550308;São Paulo;9;10;19;492
3538808;Piraju;3550308;São Paulo;9;10;19;283
3531407;Monte Aprazível;3549805;São José do Rio Preto;9;10;19;34
1302603;Manaus;3548708;São Bernardo do Campo;9;10;19;2628
1302603;Manaus;3548500;Santos;9;10;19;2655
3518800;Guarulhos;3547304;Santana de Parnaíba;9;10;19;36
3509502;Campinas;3541406;Presidente Prudente;9;10;19;457
3539301;Pirassununga;3540705;Porto Ferreira;9;10;19;18
3523909;Itu;3540606;Porto Feliz;9;10;19;24
3518404;Guaratinguetá;3538006;Pindamonhangaba;9;10;19;32
3500105;Adamantina;3527405;Lucélia;9;10;19;8
3502200;Angatuba;3522307;Itapetininga;9;10;19;38
3129707;Ibiraci;3516200;Franca;9;10;19;31
3131307;Ipatinga;3513504;Cubatão;9;10;19;626
3306305;Volta Redonda;3505708;Barueri;9;10;19;304
1505536;Parauapebas;3304557;Rio de Janeiro;9;10;19;1976
3302270;Japeri;3304557;Rio de Janeiro;9;10;19;48
3301702;Duque de Caxias;3303401;Nova Friburgo;9;10;19;92
3204609;Santa Teresa;3205309;Vitória;9;10;19;46
2927408;Salvador;3205002;Serra;9;10;19;812
3132404;Itajubá;3170701;Varginha;9;10;19;101
3127107;Frutal;3170107;Uberaba;9;10;19;118
3164704;São Sebastião do Paraíso;3165107;São Tomás de Aquino;9;10;19;20
3126703;Francisco Sá;3143302;Montes Claros;9;10;19;46
3106309;Belo Oriente;3131307;Ipatinga;9;10;19;28
3104007;Araxá;3106200;Belo Horizonte;9;10;19;312
2910800;Feira de Santana;2928802;Santo Estêvão;9;10;19;35
2910701;Euclides da Cunha;2926608;Ribeira do Pombal;9;10;19;63
2700300;Arapiraca;2708600;São Miguel dos Campos;9;10;19;65
2608909;Limoeiro;2611606;Recife;9;10;19;63
2602902;Cabo de Santo Agostinho;2609600;Olinda;9;10;19;34
2408102;Natal;2409407;Pau dos Ferros;9;10;19;333
2312908;Sobral;2313401;Tianguá;9;10;19;70
2109908;Santa Inês;2110005;Santa Luzia;9;10;19;34
1709302;Guaraí;1716505;Pedro Afonso;9;10;19;42
1501402;Belém;1508209;Vigia;9;10;19;64
1500602;Altamira;1508159;Uruará;9;10;19;177
1501402;Belém;1507953;Tailândia;9;10;19;181
1302603;Manaus;1304062;Tabatinga;9;10;19;1100
4104808;Cascavel;5103403;Cuiabá;8;11;19;1080
4310009;Ibirubá;4321006;Tapera;8;11;19;22
4316105;Ronda Alta;4320107;Sarandi;8;11;19;23
4304606;Canoas;4320008;Sapucaia do Sul;8;11;19;9
4308409;Formigueiro;4319604;São Sepé;8;11;19;21
4305207;Cerro Largo;4317509;Santo Ângelo;8;11;19;48
4313706;Palmeira das Missões;4314902;Porto Alegre;8;11;19;312
4209102;Joinville;4218707;Tubarão;8;11;19;245
3509502;Campinas;4208203;Itajaí;8;11;19;477
4100400;Almirante Tamandaré;4122206;Rio Branco do Sul;8;11;19;15
3548500;Santos;4113700;Londrina;8;11;19;497
3550308;São Paulo;4112009;Jaguariaíva;8;11;19;316
3529005;Marília;4106902;Curitiba;8;11;19;362
3554102;Taubaté;3555406;Ubatuba;8;11;19;64
3526407;Laranjal Paulista;3550308;São Paulo;8;11;19;138
3547601;Santa Rosa de Viterbo;3550308;São Paulo;8;11;19;252
3537602;Peruíbe;3541000;Praia Grande;8;11;19;69
2607901;Jaboatão dos Guararapes;3534401;Osasco;8;11;19;2059
3510203;Capão Bonito;3522406;Itapeva;8;11;19;55
3303005;Miracema;3304706;Santo Antônio de Pádua;8;11;19;14
2900702;Alagoinhas;3304557;Rio de Janeiro;8;11;19;1283
2400208;Açu;2408102;Natal;8;11;19;188
2201903;Bom Jesus;2202901;Corrente;8;11;19;175
2103208;Chapadinha;2111300;São Luís;8;11;19;164
1504208;Marabá;1508407;Xinguara;8;11;19;212
1702109;Araguaína;5300108;Brasília;7;12;19;954
2207702;Parnaíba;5300108;Brasília;7;12;19;1568
3541406;Presidente Prudente;5103403;Cuiabá;7;12;19;891
3550308;São Paulo;5005004;Jardim;7;12;19;1026
4313904;Panambi;4316709;Santa Bárbara do Sul;7;12;19;26
4307708;Esteio;4309209;Gravataí;7;12;19;21
4110953;Itaipulândia;4115804;Medianeira;7;12;19;26
3502200;Angatuba;3550308;São Paulo;7;12;19;181
3532009;Morungaba;3550308;São Paulo;7;12;19;87
2910727;Eunápolis;3205309;Vitória;7;12;19;436
2604106;Caruaru;2704302;Maceió;7;12;19;153
4107801;Floraí;4115200;Maringá;6;13;19;40
3106200;Belo Horizonte;3516200;Franca;6;13;19;364
4115804;Medianeira;4123501;Santa Helena;5;14;19;50
3516200;Franca;3534401;Osasco;5;14;19;337
3106200;Belo Horizonte;3162922;São Joaquim de Bicas;5;14;19;35
3122306;Divinópolis;5300108;Brasília;4;15;19;584
3303500;Nova Iguaçu;3548807;São Caetano do Sul;4;15;19;329
3534302;Orlândia;5213004;Maurilândia;3;16;19;401
3550308;São Paulo;4315008;Porto Lucena;2;17;19;934
3545605;Santa Adélia;3555802;Urânia;1;18;19;224
3110301;Caldas;3550308;São Paulo;1;18;19;193
5208707;Goiânia;5221601;Uruaçu;9;9;18;241
5208707;Goiânia;5219738;Santo Antônio de Goiás;9;9;18;23
5208707;Goiânia;5218508;Quirinópolis;9;9;18;231
5208707;Goiânia;5213087;Minaçu;9;9;18;370
5206206;Cristalina;5212501;Luziânia;9;9;18;68
5208707;Goiânia;5209101;Goiatuba;9;9;18;146
1716109;Paraíso do Tocantins;5208707;Goiânia;9;9;18;723
5208608;Goianésia;5208707;Goiânia;9;9;18;153
3170206;Uberlândia;5201108;Anápolis;9;9;18;296
5103353;Confresa;5108600;Vila Rica;9;9;18;82
5100250;Alta Floresta;5107909;Sinop;9;9;18;227
5107602;Rondonópolis;5107909;Sinop;9;9;18;513
4113700;Londrina;5107602;Rondonópolis;9;9;18;852
5104609;Itiquira;5107602;Rondonópolis;9;9;18;103
5100201;Água Boa;5107065;Querência;9;9;18;175
5003702;Dourados;5006200;Nova Andradina;9;9;18;144
3547304;Santana de Parnaíba;5002704;Campo Grande;9;9;18;881
5000203;Água Clara;5002704;Campo Grande;9;9;18;187
4311304;Lagoa Vermelha;4322509;Vacaria;9;9;18;66
4304630;Capão da Canoa;4321436;Terra de Areia;9;9;18;19
4312401;Montenegro;4319505;São Sebastião do Caí;9;9;18;15
4317400;Santiago;4318903;São Luiz Gonzaga;9;9;18;89
4317509;Santo Ângelo;4318002;São Borja;9;9;18;174
4305207;Cerro Largo;4317905;Santo Cristo;9;9;18;37
4300406;Alegrete;4316402;Rosário do Sul;9;9;18;94
4301305;Arroio Grande;4314407;Pelotas;9;9;18;85
4310108;Igrejinha;4313409;Novo Hamburgo;9;9;18;35
4302105;Bento Gonçalves;4313300;Nova Prata;9;9;18;43
4303509;Camaquã;4309308;Guaíba;9;9;18;92
4305108;Caxias do Sul;4308102;Feliz;9;9;18;35
4301636;Balneário Pinhal;4305454;Cidreira;9;9;18;9
4301107;Arroio dos Ratos;4305355;Charqueadas;9;9;18;17
4202404;Blumenau;4305108;Caxias do Sul;9;9;18;317
4204301;Concórdia;4219507;Xanxerê;9;9;18;56
4204301;Concórdia;4219309;Videira;9;9;18;89
4214409;Rio das Antas;4219309;Videira;9;9;18;14
4205407;Florianópolis;4218004;Tijucas;9;9;18;41
4204905;Descanso;4217204;São Miguel do Oeste;9;9;18;14
4208104;Itaiópolis;4210100;Mafra;9;9;18;22
4209102;Joinville;4210100;Mafra;9;9;18;99
4208450;Itapoá;4209102;Joinville;9;9;18;28
4202008;Balneário Camboriú;4202453;Bombinhas;9;9;18;22
4106902;Curitiba;4202305;Biguaçu;9;9;18;236
4125100;São João do Triunfo;4125605;São Mateus do Sul;9;9;18;19
4101804;Araucária;4125506;São José dos Pinhais;9;9;18;23
4113304;Laranjeiras do Sul;4122156;Rio Bonito do Iguaçu;9;9;18;7
4110706;Irati;4121505;Rebouças;9;9;18;17
4108007;Florestópolis;4120002;Porecatu;9;9;18;12
4104808;Cascavel;4119152;Pinhais;9;9;18;432
4113502;Loanda;4118402;Paranavaí;9;9;18;73
4115200;Maringá;4118204;Paranaguá;9;9;18;412
4103701;Cambé;4109807;Ibiporã;9;9;18;23
1721000;Palmas;4106902;Curitiba;9;9;18;1671
2607901;Jaboatão dos Guararapes;4106902;Curitiba;9;9;18;2354
4102307;Balsa Nova;4106902;Curitiba;9;9;18;38
3500105;Adamantina;3555000;Tupã;9;9;18;63
3507001;Boituva;3554508;Tietê;9;9;18;21
3521804;Itaí;3553807;Taquarituba;9;9;18;20
3538709;Piracicaba;3552403;Sumaré;9;9;18;40
3538709;Piracicaba;3552205;Sorocaba;9;9;18;82
3549805;São José do Rio Preto;3552205;Sorocaba;9;9;18;351
3507605;Bragança Paulista;3552106;Socorro;9;9;18;39
3547809;Santo André;3551009;São Vicente;9;9;18;35
1502152;Canaã dos Carajás;3550308;São Paulo;9;9;18;1924
3165404;Sapucaí-Mirim;3550308;São Paulo;9;9;18;136
3502309;Anhembi;3550308;São Paulo;9;9;18;179
3530300;Mirassol;3550308;São Paulo;9;9;18;427
3542404;Regente Feijó;3550308;São Paulo;9;9;18;498
3152501;Pouso Alegre;3549904;São José dos Campos;9;9;18;109
3513405;Cruzeiro;3549904;São José dos Campos;9;9;18;117
3525904;Jundiaí;3549904;São José dos Campos;9;9;18;104
3506102;Bebedouro;3549805;São José do Rio Preto;9;9;18;90
3515186;Espírito Santo do Pinhal;3549102;São João da Boa Vista;9;9;18;26
3519303;Ibaté;3548906;São Carlos;9;9;18;13
2607901;Jaboatão dos Guararapes;3548708;São Bernardo do Campo;9;9;18;2063
3205309;Vitória;3548708;São Bernardo do Campo;9;9;18;740
3543303;Ribeirão Pires;3548708;São Bernardo do Campo;9;9;18;16
3540606;Porto Feliz;3545209;Salto;9;9;18;24
2611606;Recife;3543402;Ribeirão Preto;9;9;18;1937
3511102;Catanduva;3543402;Ribeirão Preto;9;9;18;124
3525904;Jundiaí;3543402;Ribeirão Preto;9;9;18;243
3540200;Pontal;3543402;Ribeirão Preto;9;9;18;29
3509254;Cajati;3542602;Registro;9;9;18;33
3514403;Dracena;3541406;Presidente Prudente;9;9;18;69
3518701;Guarujá;3541000;Praia Grande;9;9;18;14
3522109;Itanhaém;3541000;Praia Grande;9;9;18;44
3529005;Marília;3540002;Pompéia;9;9;18;26
3523107;Itaquaquecetuba;3539806;Poá;9;9;18;4
3530607;Moji das Cruzes;3539806;Poá;9;9;18;17
3511706;Charqueada;3538709;Piracicaba;9;9;18;30
3503307;Araras;3530706;Mogi Guaçu;9;9;18;44
3513801;Diadema;3529401;Mauá;9;9;18;16
3525300;Jaú;3529005;Marília;9;9;18;142
3513009;Cotia;3522505;Itapevi;9;9;18;7
3510203;Capão Bonito;3522307;Itapetininga;9;9;18;57
2800308;Aracaju;3518800;Guarulhos;9;9;18;1673
2930709;Simões Filho;3518800;Guarulhos;9;9;18;1429
3205200;Vila Velha;3518800;Guarulhos;9;9;18;714
3506003;Bauru;3518800;Guarulhos;9;9;18;284
3500105;Adamantina;3514403;Dracena;9;9;18;51
3501905;Amparo;3507605;Bragança Paulista;9;9;18;34
2919207;Lauro de Freitas;3505708;Barueri;9;9;18;1449
3300407;Barra Mansa;3504909;Bananal;9;9;18;21
3300308;Barra do Piraí;3306206;Vassouras;9;9;18;18
3300704;Cabo Frio;3305505;Saquarema;9;9;18;41
3302106;Itaocara;3304706;Santo Antônio de Pádua;9;9;18;19
2312403;São Gonçalo do Amarante;3304557;Rio de Janeiro;9;9;18;2173
2918001;Jequié;3304557;Rio de Janeiro;9;9;18;1053
2925204;Pojuca;3304557;Rio de Janeiro;9;9;18;1256
2925303;Porto Seguro;3304557;Rio de Janeiro;9;9;18;826
3105608;Barbacena;3304557;Rio de Janeiro;9;9;18;194
3115300;Cataguases;3304557;Rio de Janeiro;9;9;18;178
3143906;Muriaé;3304557;Rio de Janeiro;9;9;18;221
3171204;Vespasiano;3304557;Rio de Janeiro;9;9;18;359
3300951;Comendador Levy Gasparian;3304557;Rio de Janeiro;9;9;18;94
3301850;Guapimirim;3302502;Magé;9;9;18;14
3301900;Itaboraí;3302502;Magé;9;9;18;25
3205002;Serra;3302403;Macaé;9;9;18;296
3118601;Contagem;3301702;Duque de Caxias;9;9;18;325
3118601;Contagem;3205101;Viana;9;9;18;371
3201506;Colatina;3204708;São Gabriel da Palha;9;9;18;63
3203205;Linhares;3204351;Rio Bananal;9;9;18;33
3203056;Jaguaré;3203205;Linhares;9;9;18;50
3201209;Cachoeiro de Itapemirim;3202603;Iconha;9;9;18;29
3200201;Alegre;3201209;Cachoeiro de Itapemirim;9;9;18;50
3200169;Água Doce do Norte;3200904;Barra de São Francisco;9;9;18;25
3109303;Buritis;3170404;Unaí;9;9;18;100
3158300;Santana da Vargem;3169406;Três Pontas;9;9;18;13
3132701;Itambacuri;3168606;Teófilo Otoni;9;9;18;28
3143302;Montes Claros;3168002;Taiobeiras;9;9;18;203
3130101;Igarapé;3162922;São Joaquim de Bicas;9;9;18;6
3104007;Araxá;3162104;São Gotardo;9;9;18;99
3155504;Rio Paranaíba;3162104;São Gotardo;9;9;18;24
3136702;Juiz de Fora;3155405;Rio Novo;9;9;18;39
3138203;Lavras;3152501;Pouso Alegre;9;9;18;146
3106200;Belo Horizonte;3152105;Ponte Nova;9;9;18;125
3106200;Belo Horizonte;3148103;Patrocínio;9;9;18;334
3114303;Carmo do Paranaíba;3148004;Patos de Minas;9;9;18;50
3136306;João Pinheiro;3148004;Patos de Minas;9;9;18;96
3134905;Jacutinga;3146008;Ouro Fino;9;9;18;25
3106705;Betim;3144805;Nova Lima;9;9;18;36
3131901;Itabirito;3144805;Nova Lima;9;9;18;30
3136702;Juiz de Fora;3138609;Lima Duarte;9;9;18;48
3133006;Itamonte;3133105;Itanhandu;9;9;18;7
3112307;Capelinha;3132503;Itamarandiba;9;9;18;40
3118601;Contagem;3129806;Ibirité;9;9;18;12
3122306;Divinópolis;3126109;Formiga;9;9;18;65
3110608;Cambuí;3125101;Extrema;9;9;18;36
3110509;Camanducaia;3110608;Cambuí;9;9;18;17
2211001;Teresina;3106200;Belo Horizonte;9;9;18;1642
2507507;João Pessoa;3106200;Belo Horizonte;9;9;18;1684
2911709;Guanambi;2933307;Vitória da Conquista;9;9;18;219
2923001;Nova Viçosa;2931350;Teixeira de Freitas;9;9;18;41
2611606;Recife;2930709;Simões Filho;9;9;18;637
2910800;Feira de Santana;2929305;São Gonçalo dos Campos;9;9;18;16
2903201;Barreiras;2928901;São Desidério;9;9;18;17
2609600;Olinda;2927408;Salvador;9;9;18;673
2611101;Petrolina;2927408;Salvador;9;9;18;465
2904605;Brumado;2911709;Guanambi;9;9;18;123
2800308;Aracaju;2800605;Barra dos Coqueiros;9;9;18;8
2601102;Araripina;2612208;Salgueiro;9;9;18;158
2604106;Caruaru;2606408;Gravatá;9;9;18;48
2501807;Bayeux;2513703;Santa Rita;9;9;18;7
2402006;Caicó;2408003;Mossoró;9;9;18;142
2400208;Açu;2407203;Macau;9;9;18;60
2402006;Caicó;2406106;Jucurutu;9;9;18;49
2301901;Barbalha;2304400;Fortaleza;9;9;18;402
2200202;Água Branca;2211001;Teresina;9;9;18;90
2203701;Esperantina;2211001;Teresina;9;9;18;147
2111300;São Luís;2112209;Timon;9;9;18;325
1713205;Miracema do Tocantins;1721000;Palmas;9;9;18;89
1506138;Redenção;1508084;Tucumã;9;9;18;190
1503903;Juruti;1506807;Santarém;9;9;18;151
1100205;Porto Velho;1500602;Altamira;9;9;18;1439
1302603;Manaus;1303569;Rio Preto da Eva;9;9;18;61
1100023;Ariquemes;1100940;Cujubim;9;9;18;75
1100056;Cerejeiras;1100304;Vilhena;9;9;18;83
1100189;Pimenta Bueno;1100304;Vilhena;9;9;18;169
2919553;Luís Eduardo magalhães;5300108;Brasília;8;10;18;468
3550308;São Paulo;5104609;Itiquira;8;10;18;1082
1100304;Vilhena;5103304;Comodoro;8;10;18;103
5006309;Paranaíba;5008305;Três Lagoas;8;10;18;137
5002704;Campo Grande;5006309;Paranaíba;8;10;18;374
4303103;Cachoeirinha;4321600;Tramandaí;8;10;18;93
4316204;Rondinha;4320107;Sarandi;8;10;18;13
4306403;Dois Irmãos;4318705;São Leopoldo;8;10;18;21
4314902;Porto Alegre;4316402;Rosário do Sul;8;10;18;361
4306601;Dom Pedrito;4314902;Porto Alegre;8;10;18;350
4113700;Londrina;4305108;Caxias do Sul;8;10;18;649
4300034;Aceguá;4301602;Bagé;8;10;18;59
4217907;Tangará;4219309;Videira;8;10;18;14
4217709;Sombrio;4218806;Turvo;8;10;18;19
4209003;Joaçaba;4210035;Luzerna;8;10;18;6
4205407;Florianópolis;4208302;Itapema;8;10;18;57
3534401;Osasco;4125506;São José dos Pinhais;8;10;18;326
3304557;Rio de Janeiro;4109401;Guarapuava;8;10;18;863
4103701;Cambé;4104808;Cascavel;8;10;18;285
3518800;Guarulhos;3552809;Taboão da Serra;8;10;18;28
3505708;Barueri;3551009;São Vicente;8;10;18;66
1508100;Tucuruí;3550308;São Paulo;8;10;18;2222
3303708;Paraíba do Sul;3550308;São Paulo;8;10;18;379
3304300;Rio Bonito;3550308;São Paulo;8;10;18;422
3541307;Presidente Epitácio;3550308;São Paulo;8;10;18;591
2304400;Fortaleza;3547304;Santana de Parnaíba;8;10;18;2325
3106200;Belo Horizonte;3547304;Santana de Parnaíba;8;10;18;492
3509205;Cajamar;3547304;Santana de Parnaíba;8;10;18;11
3526902;Limeira;3543402;Ribeirão Preto;8;10;18;162
3525003;Jandira;3534401;Osasco;8;10;18;11
3531902;Morro Agudo;3534302;Orlândia;8;10;18;18
3511102;Catanduva;3533502;Novo Horizonte;8;10;18;43
3522406;Itapeva;3532827;Nova Campina;8;10;18;16
3513009;Cotia;3515004;Embu;8;10;18;8
3510609;Carapicuíba;3513009;Cotia;8;10;18;12
3506102;Bebedouro;3511102;Catanduva;8;10;18;52
3503307;Araras;3509502;Campinas;8;10;18;68
3503208;Araraquara;3506102;Bebedouro;8;10;18;102
3136702;Juiz de Fora;3505708;Barueri;8;10;18;409
3106200;Belo Horizonte;3304904;São Gonçalo;8;10;18;333
3302502;Magé;3303906;Petrópolis;8;10;18;20
3303302;Niterói;3303500;Nova Iguaçu;8;10;18;40
3203908;Nova Venécia;3204708;São Gabriel da Palha;8;10;18;35
3113404;Caratinga;3168606;Teófilo Otoni;8;10;18;228
3131901;Itabirito;3140001;Mariana;8;10;18;46
3101508;Além Paraíba;3136702;Juiz de Fora;8;10;18;65
2925303;Porto Seguro;2931350;Teixeira de Freitas;8;10;18;139
2927408;Salvador;2930105;Senhor do Bonfim;8;10;18;340
2802908;Itabaiana;2804508;Nossa Senhora da Glória;8;10;18;46
2408102;Natal;2704302;Maceió;8;10;18;426
2607653;Itambé;2615300;Timbaúba;8;10;18;24
2611606;Recife;2612505;Santa Cruz do Capibaribe;8;10;18;142
2609402;Moreno;2611606;Recife;8;10;18;19
2111300;São Luís;2408102;Natal;8;10;18;1057
5107909;Sinop;5300108;Brasília;7;11;18;915
4310207;Ijuí;4316808;Santa Cruz do Sul;7;11;18;206
4311007;Jaguarão;4314407;Pelotas;7;11;18;127
4303103;Cachoeirinha;4313409;Novo Hamburgo;7;11;18;29
3509502;Campinas;4305108;Caxias do Sul;7;11;18;796
4204707;Cunha Porã;4210506;Maravilha;7;11;18;14
2304400;Fortaleza;4205407;Florianópolis;7;11;18;2794
3509502;Campinas;4205407;Florianópolis;7;11;18;539
4106506;Coronel Vivida;4118501;Pato Branco;7;11;18;28
4101705;Araruna;4104303;Campo Mourão;7;11;18;17
3548708;São Bernardo do Campo;3552809;Taboão da Serra;7;11;18;24
3302502;Magé;3550308;São Paulo;7;11;18;382
3513702;Descalvado;3550308;São Paulo;7;11;18;217
3548807;São Caetano do Sul;3549805;São José do Rio Preto;7;11;18;429
3525904;Jundiaí;3547809;Santo André;7;11;18;64
3534401;Osasco;3543907;Rio Claro;7;11;18;148
3151800;Poços de Caldas;3534401;Osasco;7;11;18;197
3141801;Minas Novas;3169703;Turmalina;7;11;18;17
2914000;Ipirá;2927408;Salvador;7;11;18;164
2605202;Escada;2611606;Recife;7;11;18;41
1501402;Belém;1505304;Oriximiná;7;11;18;822
3304201;Resende;5300108;Brasília;6;12;18;833
3510609;Carapicuíba;5300108;Brasília;6;12;18;862
3526902;Limeira;4314902;Porto Alegre;6;12;18;902
4114203;Mandaguari;4114807;Marialva;6;12;18;12
3505708;Barueri;4108304;Foz do Iguaçu;6;12;18;792
3303302;Niterói;4106902;Curitiba;6;12;18;679
3506904;Bofete;3550308;São Paulo;6;12;18;175
3118601;Contagem;3548807;São Caetano do Sul;6;12;18;479
3205200;Vila Velha;3301009;Campos dos Goytacazes;6;12;18;189
3127701;Governador Valadares;3205200;Vila Velha;6;12;18;238
2919207;Lauro de Freitas;2933307;Vitória da Conquista;6;12;18;348
3556206;Valinhos;5300108;Brasília;5;13;18;799
2408102;Natal;3534401;Osasco;5;13;18;2262
2914802;Itabuna;5300108;Brasília;4;14;18;931
5213004;Maurilândia;5219308;Santa Helena de Goiás;4;14;18;33
3136702;Juiz de Fora;4314902;Porto Alegre;4;14;18;1175
4204608;Criciúma;5300108;Brasília;3;15;18;1433
4208203;Itajaí;4311809;Marau;3;15;18;375
3170206;Uberlândia;4204301;Concórdia;2;16;18;989
2306306;Itapagé;3304557;Rio de Janeiro;2;16;18;2154
3133808;Itaúna;3170651;Vargem Grande do Rio Pardo;2;16;18;576
5103601;Dom Aquino;5201108;Anápolis;1;17;18;639
3545605;Santa Adélia;3545704;Santa Albertina;1;17;18;243
3514205;Dolcinópolis;3545605;Santa Adélia;1;17;18;220
2408102;Natal;2933307;Vitória da Conquista;1;17;18;1163
5208707;Goiânia;5217104;Piracanjuba;8;9;17;73
5208707;Goiânia;5212501;Luziânia;8;9;17;152
3103504;Araguari;5208707;Goiânia;8;9;17;245
4209102;Joinville;5208707;Goiânia;8;9;17;1062
5208004;Formosa;5208707;Goiânia;8;9;17;244
5203203;Barro Alto;5208608;Goianésia;8;9;17;45
3550308;São Paulo;5204508;Caldas Novas;8;9;17;689
5105259;Lucas do Rio Verde;5107958;Tangará da Serra;8;9;17;242
5105606;Matupá;5107909;Sinop;8;9;17;195
3170206;Uberlândia;5107602;Rondonópolis;8;9;17;741
5103353;Confresa;5106778;Porto Alegre do Norte;8;9;17;29
3550308;São Paulo;5106224;Nova Mutum;8;9;17;1509
5104526;Ipiranga do Norte;5105259;Lucas do Rio Verde;8;9;17;94
5103205;Colíder;5104104;Guarantã do Norte;8;9;17;112
5103007;Chapada dos Guimarães;5103403;Cuiabá;8;9;17;39
3550308;São Paulo;5005707;Naviraí;8;9;17;779
5003702;Dourados;5005400;Maracaju;8;9;17;80
4316907;Santa Maria;4322400;Uruguaiana;8;9;17;314
4314902;Porto Alegre;4321303;Taquari;8;9;17;70
4301602;Bagé;4318309;São Gabriel;8;9;17;113
4106902;Curitiba;4315602;Rio Grande;8;9;17;783
4305108;Caxias do Sul;4315602;Rio Grande;8;9;17;337
4214805;Rio do Sul;4314902;Porto Alegre;8;9;17;347
4302808;Caçapava do Sul;4314902;Porto Alegre;8;9;17;223
4313201;Nova Petrópolis;4314902;Porto Alegre;8;9;17;75
4312807;Nova Araçá;4314001;Paraí;8;9;17;8
3505708;Barueri;4313409;Novo Hamburgo;8;9;17;793
4304606;Canoas;4312401;Montenegro;8;9;17;41
4304903;Casca;4311809;Marau;8;9;17;25
3550308;São Paulo;4310207;Ijuí;8;9;17;874
4300901;Aratiba;4307005;Erechim;8;9;17;27
4303004;Cachoeira do Sul;4304200;Candelária;8;9;17;36
4208203;Itajaí;4218707;Tubarão;8;9;17;174
4214805;Rio do Sul;4218608;Trombudo Central;8;9;17;22
4215653;Santa Rosa do Sul;4217709;Sombrio;8;9;17;6
4211504;Nova Trento;4216305;São João Batista;8;9;17;8
4203006;Caçador;4213609;Porto União;8;9;17;57
4208203;Itajaí;4212809;Piçarras;8;9;17;21
4203907;Capinzal;4211801;Ouro;8;9;17;4
4208203;Itajaí;4209300;Lages;8;9;17;182
4202008;Balneário Camboriú;4208906;Jaraguá do Sul;8;9;17;69
4203006;Caçador;4204806;Curitibanos;8;9;17;71
3543907;Rio Claro;4204608;Criciúma;8;9;17;715
3518800;Guarulhos;4204202;Chapecó;8;9;17;718
4103909;Campina da Lagoa;4128005;Ubiratã;8;9;17;19
4106902;Curitiba;4127882;Tunas do Paraná;8;9;17;55
4108809;Guaíra;4127403;Terra Roxa;8;9;17;15
4115200;Maringá;4125308;São Jorge do Ivaí;8;9;17;39
4114609;Marechal Cândido Rondon;4123501;Santa Helena;8;9;17;45
4101804;Araucária;4119905;Ponta Grossa;8;9;17;94
4105805;Colombo;4119905;Ponta Grossa;8;9;17;94
4105706;Clevelândia;4118501;Pato Branco;8;9;17;26
4101804;Araucária;4113700;Londrina;8;9;17;311
4104808;Cascavel;4113304;Laranjeiras do Sul;8;9;17;112
4101408;Apucarana;4111506;Ivaiporã;8;9;17;80
3529401;Mauá;4106902;Curitiba;8;9;17;344
3536505;Paulínia;4101804;Araucária;8;9;17;384
3522208;Itapecerica da Serra;3552809;Taboão da Serra;8;9;17;16
3304557;Rio de Janeiro;3552502;Suzano;8;9;17;319
2503209;Cabedelo;3550308;São Paulo;8;9;17;2169
3128709;Guaxupé;3550308;São Paulo;8;9;17;260
3502903;Araçoiaba da Serra;3550308;São Paulo;8;9;17;100
3513108;Cravinhos;3550308;São Paulo;8;9;17;278
3537107;Pedreira;3550308;São Paulo;8;9;17;104
3548005;Santo Antônio de Posse;3550308;São Paulo;8;9;17;119
3530805;Moji-Mirim;3549102;São João da Boa Vista;8;9;17;54
3516200;Franca;3548906;São Carlos;8;9;17;172
2304400;Fortaleza;3543402;Ribeirão Preto;8;9;17;2134
3106200;Belo Horizonte;3541406;Presidente Prudente;8;9;17;799
3509502;Campinas;3529005;Marília;8;9;17;308
3507506;Botucatu;3526803;Lençóis Paulista;8;9;17;49
3509502;Campinas;3526704;Leme;8;9;17;86
1100205;Porto Velho;3518800;Guarulhos;8;9;17;2350
3102605;Andradas;3515186;Espírito Santo do Pinhal;8;9;17;22
3106200;Belo Horizonte;3513801;Diadema;8;9;17;496
3106200;Belo Horizonte;3513504;Cubatão;8;9;17;506
3507506;Botucatu;3509502;Campinas;8;9;17;142
3504107;Atibaia;3507100;Bom Jesus dos Perdões;8;9;17;9
1721000;Palmas;3505708;Barueri;8;9;17;1463
3300951;Comendador Levy Gasparian;3306008;Três Rios;8;9;17;4
3302502;Magé;3304904;São Gonçalo;8;9;17;17
3101508;Além Paraíba;3304557;Rio de Janeiro;8;9;17;131
3136702;Juiz de Fora;3303302;Niterói;8;9;17;127
3203403;Mimoso do Sul;3203809;Muqui;8;9;17;13
3201209;Cachoeiro de Itapemirim;3202405;Guarapari;8;9;17;59
2611606;Recife;3170206;Uberlândia;8;9;17;1817
2910800;Feira de Santana;3170206;Uberlândia;8;9;17;1210
3105608;Barbacena;3169901;Ubá;8;9;17;86
3104007;Araxá;3148103;Patrocínio;8;9;17;71
3120904;Curvelo;3147402;Paraopeba;8;9;17;57
3116605;Cláudio;3145604;Oliveira;8;9;17;30
3127701;Governador Valadares;3143302;Montes Claros;8;9;17;307
3106200;Belo Horizonte;3126109;Formiga;8;9;17;163
2607901;Jaboatão dos Guararapes;3106200;Belo Horizonte;8;9;17;1590
2925105;Poções;2933307;Vitória da Conquista;8;9;17;67
2910800;Feira de Santana;2930501;Serrinha;8;9;17;71
2927408;Salvador;2930501;Serrinha;8;9;17;160
2917508;Jacobina;2927408;Salvador;8;9;17;291
2924009;Paulo Afonso;2927408;Salvador;8;9;17;396
2925204;Pojuca;2927408;Salvador;8;9;17;64
2918407;Juazeiro;2926004;Remanso;8;9;17;174
2600054;Abreu e Lima;2610707;Paulista;8;9;17;4
2604106;Caruaru;2610004;Palmares;8;9;17;64
2602902;Cabo de Santo Agostinho;2605202;Escada;8;9;17;23
2304285;Eusébio;2408102;Natal;8;9;17;413
2301109;Aracati;2307601;Limoeiro do Norte;8;9;17;74
2301208;Aracoiaba;2302107;Baturité;8;9;17;9
1504208;Marabá;2111300;São Luís;8;9;17;626
2104057;Estreito;2105302;Imperatriz;8;9;17;117
1501402;Belém;1501808;Breves;8;9;17;230
1500503;Almeirim;1501402;Belém;8;9;17;461
1500107;Abaetetuba;1501303;Barcarena;8;9;17;35
1100023;Ariquemes;1100452;Buritis;8;9;17;97
5101803;Barra do Garças;5300108;Brasília;7;10;17;466
4314902;Porto Alegre;5201108;Anápolis;7;10;17;1542
3550308;São Paulo;5100201;Água Boa;7;10;17;1227
2304400;Fortaleza;5002704;Campo Grande;7;10;17;2456
4306007;Crissiumal;4321808;Três de Maio;7;10;17;31
4305801;Constantina;4320107;Sarandi;7;10;17;24
4313409;Novo Hamburgo;4316808;Santa Cruz do Sul;7;10;17;126
3106705;Betim;4314902;Porto Alegre;7;10;17;1293
4208906;Jaraguá do Sul;4314902;Porto Alegre;7;10;17;444
4308201;Flores da Cunha;4314902;Porto Alegre;7;10;17;113
4313706;Palmeira das Missões;4314100;Passo Fundo;7;10;17;98
4301008;Arroio do Meio;4306809;Encantado;7;10;17;19
3550308;São Paulo;4207304;Imbituba;7;10;17;541
4202404;Blumenau;4206900;Ibirama;7;10;17;45
4104303;Campo Mourão;4118808;Peabiru;7;10;17;15
4106902;Curitiba;4111258;Itaperuçu;7;10;17;25
3143906;Muriaé;3550308;São Paulo;7;10;17;521
3542206;Rancharia;3550308;São Paulo;7;10;17;458
3511102;Catanduva;3538105;Pindorama;7;10;17;9
3502804;Araçatuba;3509502;Campinas;7;10;17;393
2910800;Feira de Santana;3505708;Barueri;7;10;17;1467
3205069;Venda Nova do Imigrante;3205309;Vitória;7;10;17;87
3127107;Frutal;3170206;Uberlândia;7;10;17;154
3108305;Borda da Mata;3152501;Pouso Alegre;7;10;17;23
3137700;Lajinha;3139409;Manhuaçu;7;10;17;47
3106200;Belo Horizonte;3123205;Dores do Indaiá;7;10;17;177
2910800;Feira de Santana;3118601;Contagem;7;10;17;994
2704302;Maceió;2706703;Penedo;7;10;17;112
2312908;Sobral;2611606;Recife;7;10;17;774
2507507;João Pessoa;2604106;Caruaru;7;10;17;174
2307650;Maracanaú;2309706;Pacatuba;7;10;17;14
2307304;Juazeiro do Norte;5300108;Brasília;6;11;17;1313
4105805;Colombo;5300108;Brasília;6;11;17;1056
3550308;São Paulo;5001904;Bataguassu;6;11;17;641
4314100;Passo Fundo;4317202;Santa Rosa;6;11;17;208
2211001;Teresina;4314902;Porto Alegre;6;11;17;2864
4204301;Concórdia;4314100;Passo Fundo;6;11;17;121
4304606;Canoas;4307906;Farroupilha;6;11;17;78
2304400;Fortaleza;4113700;Londrina;6;11;17;2488
2611606;Recife;3552809;Taboão da Serra;6;11;17;2068
3538709;Piracicaba;3548807;São Caetano do Sul;6;11;17;145
3506003;Bauru;3548708;São Bernardo do Campo;6;11;17;296
3530607;Moji das Cruzes;3548708;São Bernardo do Campo;6;11;17;44
3304557;Rio de Janeiro;3526902;Limeira;6;11;17;427
3303500;Nova Iguaçu;3505708;Barueri;6;11;17;357
3154606;Ribeirão das Neves;3157807;Santa Luzia;6;11;17;25
5211503;Itumbiara;5300108;Brasília;5;12;17;320
4115200;Maringá;4205407;Florianópolis;5;12;17;568
4104303;Campo Mourão;4127700;Toledo;5;12;17;158
3501608;Americana;3534401;Osasco;5;12;17;104
3520509;Indaiatuba;3534401;Osasco;5;12;17;67
3511102;Catanduva;3533254;Novais;5;12;17;18
2604106;Caruaru;3304557;Rio de Janeiro;5;12;17;1768
2304400;Fortaleza;2306306;Itapagé;5;12;17;117
2604106;Caruaru;5300108;Brasília;4;13;17;1509
3518701;Guarujá;5300108;Brasília;4;13;17;920
3507506;Botucatu;5300108;Brasília;3;14;17;784
4318705;São Leopoldo;5300108;Brasília;3;14;17;1586
2800308;Aracaju;4106902;Curitiba;3;14;17;1993
3304607;Santa Maria Madalena;3550308;São Paulo;3;14;17;507
4314100;Passo Fundo;4315602;Rio Grande;2;15;17;424
2927408;Salvador;3516200;Franca;2;15;17;1237
3532207;Narandiba;4105102;Centenário do Sul;1;16;17;46
2111300;São Luís;2111904;Sucupira do Norte;1;16;17;436
5208707;Goiânia;5221858;Valparaíso de Goiás;8;8;16;156
5201405;Aparecida de Goiânia;5220454;Senador Canedo;8;8;16;21
3550308;São Paulo;5220405;São Simão;8;8;16;663
5218508;Quirinópolis;5218805;Rio Verde;8;8;16;89
3550308;São Paulo;5218003;Porangatu;8;8;16;1166
5208707;Goiânia;5214606;Niquelândia;8;8;16;261
5204508;Caldas Novas;5213806;Morrinhos;8;8;16;54
5208707;Goiânia;5212204;Jussara;8;8;16;193
1100205;Porto Velho;5208707;Goiânia;8;8;16;1763
1506138;Redenção;5208707;Goiânia;8;8;16;964
2211001;Teresina;5208707;Goiânia;8;8;16;1451
3549805;São José do Rio Preto;5208707;Goiânia;8;8;16;458
3550308;São Paulo;5208004;Formosa;8;8;16;901
3550308;São Paulo;5206206;Cristalina;8;8;16;764
4106902;Curitiba;5201405;Aparecida de Goiânia;8;8;16;955
5102504;Cáceres;5108402;Várzea Grande;8;8;16;167
4106902;Curitiba;5107602;Rondonópolis;8;8;16;1159
4118204;Paranaguá;5107602;Rondonópolis;8;8;16;1216
5102678;Campo Verde;5107602;Rondonópolis;8;8;16;113
5102702;Canarana;5107065;Querência;8;8;16;118
5104104;Guarantã do Norte;5106422;Peixoto de Azevedo;8;8;16;34
1100304;Vilhena;5103403;Cuiabá;8;8;16;529
5100201;Água Boa;5101803;Barra do Garças;8;8;16;196
3550308;São Paulo;5007695;São Gabriel do Oeste;8;8;16;966
5000609;Amambaí;5006606;Ponta Porã;8;8;16;81
5002951;Chapadão do Sul;5006309;Paranaíba;8;8;16;177
5003702;Dourados;5005707;Naviraí;8;8;16;107
3304557;Rio de Janeiro;5003207;Corumbá;8;8;16;1592
3550308;São Paulo;5002951;Chapadão do Sul;8;8;16;836
3502804;Araçatuba;5002704;Campo Grande;8;8;16;448
3549805;São José do Rio Preto;5002704;Campo Grande;8;8;16;551
4202404;Blumenau;5002704;Campo Grande;8;8;16;936
4309209;Gravataí;4323002;Viamão;8;8;16;15
4305108;Caxias do Sul;4321600;Tramandaí;8;8;16;134
4313409;Novo Hamburgo;4321600;Tramandaí;8;8;16;99
4212254;Passo de Torres;4321501;Torres;8;8;16;10
4314902;Porto Alegre;4319505;São Sebastião do Caí;8;8;16;54
4314902;Porto Alegre;4318507;São José do Norte;8;8;16;230
4316907;Santa Maria;4317509;Santo Ângelo;8;8;16;161
4306601;Dom Pedrito;4317103;Santana do Livramento;8;8;16;80
4304200;Candelária;4316808;Santa Cruz do Sul;8;8;16;38
4315750;Riozinho;4316006;Rolante;8;8;16;12
4314902;Porto Alegre;4315701;Rio Pardo;8;8;16;114
4305108;Caxias do Sul;4314407;Pelotas;8;8;16;306
4303103;Cachoeirinha;4313508;Osório;8;8;16;82
4304630;Capão da Canoa;4313508;Osório;8;8;16;26
4304630;Capão da Canoa;4313409;Novo Hamburgo;8;8;16;105
4311403;Lajeado;4312401;Montenegro;8;8;16;57
4307906;Farroupilha;4311403;Lajeado;8;8;16;71
4305009;Catuípe;4310207;Ijuí;8;8;16;18
4307500;Espumoso;4310009;Ibirubá;8;8;16;26
4303103;Cachoeirinha;4307708;Esteio;8;8;16;13
4301602;Bagé;4304358;Candiota;8;8;16;47
4106902;Curitiba;4303103;Cachoeirinha;8;8;16;529
4202008;Balneário Camboriú;4218707;Tubarão;8;8;16;170
4214706;Rio dos Cedros;4218202;Timbó;8;8;16;12
4216602;São José;4218004;Tijucas;8;8;16;38
4208302;Itapema;4216602;São José;8;8;16;54
4215703;Santo Amaro da Imperatriz;4216602;São José;8;8;16;15
4209300;Lages;4216503;São Joaquim;8;8;16;63
4208302;Itapema;4216305;São João Batista;8;8;16;29
4119103;Piên;4215802;São Bento do Sul;8;8;16;19
4209904;Lontras;4214805;Rio do Sul;8;8;16;10
4209102;Joinville;4213203;Pomerode;8;8;16;60
4202107;Barra Velha;4212809;Piçarras;8;8;16;14
3304557;Rio de Janeiro;4211306;Navegantes;8;8;16;690
4202404;Blumenau;4210605;Massaranduba;8;8;16;38
4208906;Jaraguá do Sul;4210605;Massaranduba;8;8;16;16
4207304;Imbituba;4209409;Laguna;8;8;16;33
4202404;Blumenau;4209300;Lages;8;8;16;155
4208906;Jaraguá do Sul;4209300;Lages;8;8;16;191
3118601;Contagem;4209102;Joinville;8;8;16;845
3552403;Sumaré;4209102;Joinville;8;8;16;414
4203204;Camboriú;4209102;Joinville;8;8;16;84
4104808;Cascavel;4209003;Joaçaba;8;8;16;308
4101804;Araucária;4208203;Itajaí;8;8;16;163
4128203;União da Vitória;4207908;Irineópolis;8;8;16;35
3550308;São Paulo;4207502;Indaial;8;8;16;440
4201406;Araranguá;4207502;Indaial;8;8;16;228
4205704;Garopaba;4207304;Imbituba;8;8;16;20
4202008;Balneário Camboriú;4207106;Ilhota;8;8;16;17
4106902;Curitiba;4203204;Camboriú;8;8;16;186
2611606;Recife;4202404;Blumenau;8;8;16;2472
3304557;Rio de Janeiro;4202305;Biguaçu;8;8;16;734
4106902;Curitiba;4128104;Umuarama;8;8;16;454
3106200;Belo Horizonte;4125506;São José dos Pinhais;8;8;16;808
3513801;Diadema;4125506;São José dos Pinhais;8;8;16;328
4107652;Fazenda Rio Grande;4125506;São José dos Pinhais;8;8;16;18
3518800;Guarulhos;4119152;Pinhais;8;8;16;344
4101804;Araucária;4118204;Paranaguá;8;8;16;85
4101200;Antonina;4116208;Morretes;8;8;16;16
3505708;Barueri;4115200;Maringá;8;8;16;517
4109401;Guarapuava;4115200;Maringá;8;8;16;223
3518800;Guarulhos;4113700;Londrina;8;8;16;470
3547304;Santana de Parnaíba;4113700;Londrina;8;8;16;434
4101804;Araucária;4113205;Lapa;8;8;16;37
4105508;Cianorte;4112405;Japurá;8;8;16;22
3534708;Ourinhos;4111803;Jacarezinho;8;8;16;22
4108304;Foz do Iguaçu;4108809;Guaíra;8;8;16;159
3534708;Ourinhos;4106902;Curitiba;8;8;16;278
3538006;Pindamonhangaba;4106902;Curitiba;8;8;16;472
4106209;Contenda;4106902;Curitiba;8;8;16;36
4104006;Campina Grande do Sul;4105805;Colombo;8;8;16;20
4104600;Capitão Leônidas Marques;4104808;Cascavel;8;8;16;61
4102307;Balsa Nova;4104204;Campo Largo;8;8;16;18
3550308;São Paulo;4100400;Almirante Tamandaré;8;8;16;324
3505807;Bastos;3555000;Tupã;8;8;16;20
3548500;Santos;3554102;Taubaté;8;8;16;127
3550308;São Paulo;3553807;Taquarituba;8;8;16;265
3524303;Jaboticabal;3553708;Taquaritinga;8;8;16;33
3546306;Santa Cruz das Palmeiras;3553302;Tambaú;8;8;16;14
3549904;São José dos Campos;3552502;Suzano;8;8;16;58
3536505;Paulínia;3552403;Sumaré;8;8;16;13
3501608;Americana;3552205;Sorocaba;8;8;16;84
3522406;Itapeva;3552205;Sorocaba;8;8;16;152
3549904;São José dos Campos;3550704;São Sebastião;8;8;16;77
1709500;Gurupi;3550308;São Paulo;8;8;16;1343
2600054;Abreu e Lima;3550308;São Paulo;8;8;16;2088
2900702;Alagoinhas;3550308;São Paulo;8;8;16;1511
3129806;Ibirité;3550308;São Paulo;8;8;16;479
3139003;Machado;3550308;São Paulo;8;8;16;231
3303807;Parati;3550308;São Paulo;8;8;16;202
3510807;Casa Branca;3550308;São Paulo;8;8;16;213
3539103;Pirapora do Bom Jesus;3550308;São Paulo;8;8;16;46
3501608;Americana;3549805;São José do Rio Preto;8;8;16;303
3526902;Limeira;3549805;São José do Rio Preto;8;8;16;285
3151800;Poços de Caldas;3549706;São José do Rio Pardo;8;8;16;41
3524105;Ituverava;3549409;São Joaquim da Barra;8;8;16;29
3529302;Matão;3548906;São Carlos;8;8;16;70
1501402;Belém;3548708;São Bernardo do Campo;8;8;16;2477
3205002;Serra;3548708;São Bernardo do Campo;8;8;16;747
3205200;Vila Velha;3548500;Santos;8;8;16;719
3543402;Ribeirão Preto;3548500;Santos;8;8;16;337
3547304;Santana de Parnaíba;3548500;Santos;8;8;16;76
3515186;Espírito Santo do Pinhal;3548104;Santo Antônio do Jardim;8;8;16;10
2611606;Recife;3547304;Santana de Parnaíba;8;8;16;2063
3531308;Monte Alto;3543402;Ribeirão Preto;8;8;16;73
3520301;Iguape;3542602;Registro;8;8;16;39
3503307;Araras;3539301;Pirassununga;8;8;16;39
3106200;Belo Horizonte;3538709;Piracicaba;8;8;16;489
3514403;Dracena;3534609;Osvaldo Cruz;8;8;16;76
3512209;Conchal;3530706;Mogi Guaçu;8;8;16;23
3515186;Espírito Santo do Pinhal;3530706;Mogi Guaçu;8;8;16;26
3512407;Cordeirópolis;3526902;Limeira;8;8;16;11
3501608;Americana;3525904;Jundiaí;8;8;16;66
3508405;Cabreúva;3525904;Jundiaí;8;8;16;27
3516200;Franca;3525300;Jaú;8;8;16;226
3304557;Rio de Janeiro;3524006;Itupeva;8;8;16;389
3507605;Bragança Paulista;3523404;Itatiba;8;8;16;30
3504503;Avaré;3522406;Itapeva;8;8;16;97
3521705;Itaberá;3522406;Itapeva;8;8;16;28
3522307;Itapetininga;3522406;Itapeva;8;8;16;96
3509502;Campinas;3522307;Itapetininga;8;8;16;126
3304557;Rio de Janeiro;3520509;Indaiatuba;8;8;16;408
3205101;Viana;3518800;Guarulhos;8;8;16;693
3502804;Araçatuba;3518206;Guararapes;8;8;16;20
3505906;Batatais;3516200;Franca;8;8;16;45
3304557;Rio de Janeiro;3515004;Embu;8;8;16;375
3506003;Bauru;3514502;Duartina;8;8;16;34
3503802;Artur Nogueira;3512803;Cosmópolis;8;8;16;8
3170206;Uberlândia;3506003;Bauru;8;8;16;390
3501004;Altinópolis;3505906;Batatais;8;8;16;29
3306107;Valença;3306305;Volta Redonda;8;8;16;48
3302908;Miguel Pereira;3306206;Vassouras;8;8;16;21
3303302;Niterói;3305802;Teresópolis;8;8;16;51
3304557;Rio de Janeiro;3305604;Silva Jardim;8;8;16;93
3301009;Campos dos Goytacazes;3304755;São Francisco de Itabapoana;8;8;16;62
3300803;Cachoeiras de Macacu;3304557;Rio de Janeiro;8;8;16;78
3106200;Belo Horizonte;3303500;Nova Iguaçu;8;8;16;320
3136702;Juiz de Fora;3301702;Duque de Caxias;8;8;16;112
2704302;Maceió;3205309;Vitória;8;8;16;1262
3201209;Cachoeiro de Itapemirim;3203403;Mimoso do Sul;8;8;16;39
3202801;Itapemirim;3203320;Marataízes;8;8;16;5
2931350;Teixeira de Freitas;3203205;Linhares;8;8;16;203
3106200;Belo Horizonte;3203205;Linhares;8;8;16;419
3201209;Cachoeiro de Itapemirim;3203205;Linhares;8;8;16;197
3124203;Espera Feliz;3202009;Dores do Rio Preto;8;8;16;11
3139607;Mantena;3200904;Barra de São Francisco;8;8;16;14
3111408;Campo Florido;3170107;Uberaba;8;8;16;69
3152105;Ponte Nova;3169901;Ubá;8;8;16;76
3169000;Tocantins;3169901;Ubá;8;8;16;10
3114105;Carmo de Minas;3163706;São Lourenço;8;8;16;11
3157336;Santa Cruz de Minas;3162500;São João del Rei;8;8;16;6
3118601;Contagem;3152501;Pouso Alegre;8;8;16;318
3104007;Araxá;3149804;Perdizes;8;8;16;45
3137601;Lagoa Santa;3149309;Pedro Leopoldo;8;8;16;18
3128709;Guaxupé;3144102;Muzambinho;8;8;16;21
2911709;Guanambi;3143302;Montes Claros;8;8;16;294
3108602;Brasília de Minas;3143302;Montes Claros;8;8;16;82
3106705;Betim;3138203;Lavras;8;8;16;164
3108008;Bom Sucesso;3138203;Lavras;8;8;16;34
3111200;Campo Belo;3138203;Lavras;8;8;16;46
3106705;Betim;3136702;Juiz de Fora;8;8;16;218
3106200;Belo Horizonte;3135100;Janaúba;8;8;16;459
3118601;Contagem;3124104;Esmeraldas;8;8;16;29
3101607;Alfenas;3111606;Campos Gerais;8;8;16;28
2919207;Lauro de Freitas;3106200;Belo Horizonte;8;8;16;970
2933307;Vitória da Conquista;3106200;Belo Horizonte;8;8;16;644
3101607;Alfenas;3106200;Belo Horizonte;8;8;16;266
3105400;Barão de Cocais;3106200;Belo Horizonte;8;8;16;49
3101607;Alfenas;3104304;Areado;8;8;16;20
2927408;Salvador;2933208;Vera Cruz;8;8;16;19
2908408;Conceição do Coité;2933000;Valente;8;8;16;28
2914802;Itabuna;2931350;Teixeira de Freitas;8;8;16;309
2927408;Salvador;2929503;São Sebastião do Passé;8;8;16;53
2602902;Cabo de Santo Agostinho;2927408;Salvador;8;8;16;639
2908507;Conceição do Jacuípe;2927408;Salvador;8;8;16;79
2905008;Caculé;2919405;Licínio de Almeida;8;8;16;33
2905602;Camacan;2914802;Itabuna;8;8;16;74
2607901;Jaboatão dos Guararapes;2910800;Feira de Santana;8;8;16;627
2800308;Aracaju;2807105;Simão Dias;8;8;16;80
2800308;Aracaju;2804508;Nossa Senhora da Glória;8;8;16;82
2802106;Estância;2803500;Lagarto;8;8;16;51
2700300;Arapiraca;2708006;Santana do Ipanema;8;8;16;74
2609600;Olinda;2704302;Maceió;8;8;16;204
2601102;Araripina;2615607;Trindade;8;8;16;34
2601201;Arcoverde;2613909;Serra Talhada;8;8;16;147
2609907;Ouricuri;2612208;Salgueiro;8;8;16;108
2601201;Arcoverde;2610905;Pesqueira;8;8;16;39
2601409;Barreiros;2610004;Palmares;8;8;16;43
2601102;Araripina;2609907;Ouricuri;8;8;16;54
2408102;Natal;2609600;Olinda;8;8;16;244
2211001;Teresina;2607901;Jaboatão dos Guararapes;8;8;16;916
2603454;Camaragibe;2607901;Jaboatão dos Guararapes;8;8;16;11
2304400;Fortaleza;2607208;Ipojuca;8;8;16;638
2600054;Abreu e Lima;2606804;Igarassu;8;8;16;6
2501807;Bayeux;2504009;Campina Grande;8;8;16;107
2403251;Parnamirim;2412203;São José de Mipibu;8;8;16;19
2405801;João Câmara;2408102;Natal;8;8;16;70
2402204;Canguaretama;2404200;Goianinha;8;8;16;7
2310308;Parambu;2313302;Tauá;8;8;16;46
2304400;Fortaleza;2311405;Quixeramobim;8;8;16;178
2304400;Fortaleza;2308708;Morada Nova;8;8;16;152
2302206;Beberibe;2303501;Cascavel;8;8;16;13
2203909;Floriano;2211209;Uruçuí;8;8;16;175
2201903;Bom Jesus;2211001;Teresina;8;8;16;473
2207801;Paulistana;2208007;Picos;8;8;16;130
2201903;Bom Jesus;2203909;Floriano;8;8;16;291
2103208;Chapadinha;2105401;Itapecuru Mirim;8;8;16;110
1709302;Guaraí;1721000;Palmas;8;8;16;165
1709500;Gurupi;1716109;Paraíso do Tocantins;8;8;16;172
1501782;Breu Branco;1508100;Tucuruí;8;8;16;41
1503093;Goianésia do Pará;1507953;Tailândia;8;8;16;101
1504802;Monte Alegre;1506807;Santarém;8;8;16;92
1501808;Breves;1505809;Portel;8;8;16;49
1500800;Ananindeua;1504422;Marituba;8;8;16;4
1502152;Canaã dos Carajás;1504208;Marabá;8;8;16;152
1100023;Ariquemes;1100130;Machadinho d'Oeste;8;8;16;118
1100304;Vilhena;5300108;Brasília;7;9;16;1345
3522505;Itapevi;5300108;Brasília;7;9;16;863
3524709;Jaguariúna;5300108;Brasília;7;9;16;770
3513009;Cotia;5208707;Goiânia;7;9;16;807
5103502;Diamantino;5106224;Nova Mutum;7;9;16;74
3304557;Rio de Janeiro;5008305;Três Lagoas;7;9;16;919
3550308;São Paulo;5007208;Rio Brilhante;7;9;16;849
4302808;Caçapava do Sul;4319604;São Sepé;7;9;16;38
4309209;Gravataí;4318705;São Leopoldo;7;9;16;25
4202909;Brusque;4314902;Porto Alegre;7;9;16;394
4301057;Arroio do Sal;4314902;Porto Alegre;7;9;16;137
4310207;Ijuí;4311155;Jóia;7;9;16;34
4303004;Cachoeira do Sul;4304606;Canoas;7;9;16;167
4204301;Concórdia;4217501;Seara;7;9;16;30
4208005;Itá;4217501;Seara;7;9;16;15
4204558;Correia Pinto;4209300;Lages;7;9;16;24
4208302;Itapema;4209102;Joinville;7;9;16;93
4205407;Florianópolis;4207304;Imbituba;7;9;16;69
4204301;Concórdia;4205407;Florianópolis;7;9;16;348
4113700;Londrina;4126504;Sertanópolis;7;9;16;29
4124053;Santa Terezinha de Itaipu;4125704;São Miguel do Iguaçu;7;9;16;23
4113700;Londrina;4120507;Primeiro de Maio;7;9;16;51
4113700;Londrina;4118402;Paranavaí;7;9;16;134
4106456;Coronel Domingos Soares;4117602;Palmas;7;9;16;31
4114609;Marechal Cândido Rondon;4115853;Mercedes;7;9;16;16
4105508;Cianorte;4113700;Londrina;7;9;16;153
2408102;Natal;4106902;Curitiba;7;9;16;2553
4105508;Cianorte;4106902;Curitiba;7;9;16;384
3506102;Bebedouro;3556800;Viradouro;7;9;16;26
2918001;Jequié;3550308;São Paulo;7;9;16;1269
3304144;Queimados;3550308;São Paulo;7;9;16;329
3505906;Batatais;3550308;São Paulo;7;9;16;321
3537404;Pereira Barreto;3550308;São Paulo;7;9;16;560
3506508;Birigui;3549805;São José do Rio Preto;7;9;16;112
3304557;Rio de Janeiro;3543907;Rio Claro;7;9;16;447
3304557;Rio de Janeiro;3529005;Marília;7;9;16;695
3505708;Barueri;3529005;Marília;7;9;16;349
3525904;Jundiaí;3527306;Louveira;7;9;16;13
3520509;Indaiatuba;3526902;Limeira;7;9;16;61
2905701;Camaçari;3505708;Barueri;7;9;16;1465
3301009;Campos dos Goytacazes;3304524;Rio das Ostras;7;9;16;99
3170206;Uberlândia;3205309;Vitória;7;9;16;842
3204906;São Mateus;3205200;Vila Velha;7;9;16;182
3203056;Jaguaré;3204906;São Mateus;7;9;16;26
3157807;Santa Luzia;3171204;Vespasiano;7;9;16;11
3106200;Belo Horizonte;3169901;Ubá;7;9;16;168
3138203;Lavras;3169307;Três Corações;7;9;16;53
3156700;Sabará;3157807;Santa Luzia;7;9;16;12
3136306;João Pinheiro;3151206;Pirapora;7;9;16;146
3143302;Montes Claros;3148004;Patos de Minas;7;9;16;344
3106200;Belo Horizonte;3136306;João Pinheiro;7;9;16;336
2607208;Ipojuca;3106200;Belo Horizonte;7;9;16;1563
2911709;Guanambi;2927408;Salvador;7;9;16;491
2804409;Neópolis;2805703;Propriá;7;9;16;30
2800670;Boquim;2802106;Estância;7;9;16;19
2307650;Maracanaú;2611606;Recife;7;9;16;623
2304400;Fortaleza;2310258;Paraipaba;7;9;16;77
1100114;Jaru;1100205;Porto Velho;7;9;16;234
5008305;Três Lagoas;5300108;Brasília;6;10;16;687
4209102;Joinville;4304606;Canoas;6;10;16;459
4204202;Chapecó;4216909;São Lourenço do Oeste;6;10;16;85
4207007;Içara;4216602;São José;6;10;16;140
3550308;São Paulo;4111803;Jacarezinho;6;10;16;350
3509502;Campinas;3554003;Tatuí;6;10;16;95
3503208;Araraquara;3553708;Taquaritinga;6;10;16;55
3525300;Jaú;3548906;São Carlos;6;10;16;75
3524402;Jacareí;3530607;Moji das Cruzes;6;10;16;36
3201902;Domingos Martins;3205309;Vitória;6;10;16;39
2408003;Mossoró;2507507;João Pessoa;6;10;16;353
2905701;Camaçari;5300108;Brasília;5;11;16;1078
3151800;Poços de Caldas;5300108;Brasília;5;11;16;677
4305702;Condor;4313904;Panambi;5;11;16;8
3534401;Osasco;4216602;São José;5;11;16;485
4115200;Maringá;4122404;Rolândia;5;11;16;59
3536000;Parapuã;3550308;São Paulo;5;11;16;468
3534401;Osasco;3541000;Praia Grande;5;11;16;65
4309209;Gravataí;5300108;Brasília;4;12;16;1602
3541406;Presidente Prudente;4314902;Porto Alegre;4;12;16;878
3547502;Santa Rita do Passa Quatro;3548906;São Carlos;4;12;16;55
2927408;Salvador;3303906;Petrópolis;4;12;16;1158
2910800;Feira de Santana;2927507;Santa Bárbara;4;12;16;36
3303401;Nova Friburgo;5300108;Brasília;3;13;16;925
4315602;Rio Grande;5300108;Brasília;3;13;16;1865
4306908;Encruzilhada do Sul;4309308;Guaíba;3;13;16;126
4204202;Chapecó;4217501;Seara;3;13;16;31
2304400;Fortaleza;2804805;Nossa Senhora do Socorro;3;13;16;797
2211001;Teresina;2611101;Petrolina;3;13;16;527
4106902;Curitiba;5004601;Itaquiraí;2;14;16;548
3106705;Betim;3169356;Três Marias;2;14;16;225
3528858;Marapoama;3533502;Novo Horizonte;1;15;16;25
3136306;João Pinheiro;5300108;Brasília;7;8;15;284
3536505;Paulínia;5220454;Senador Canedo;7;8;15;702
3550308;São Paulo;5220454;Senador Canedo;7;8;15;813
4202404;Blumenau;5208707;Goiânia;7;8;15;1136
3170107;Uberaba;5205109;Catalão;7;8;15;175
5103502;Diamantino;5107958;Tangará da Serra;7;8;15;115
5107040;Primavera do Leste;5107792;Santo Antônio do Leste;7;8;15;111
5101407;Aripuanã;5103254;Colniza;7;8;15;84
3506508;Birigui;5008305;Três Lagoas;7;8;15;157
5003306;Coxim;5007935;Sonora;7;8;15;95
5002704;Campo Grande;5005004;Jardim;7;8;15;200
4106902;Curitiba;4322400;Uruguaiana;7;8;15;882
4317103;Santana do Livramento;4322400;Uruguaiana;7;8;15;194
4302402;Bom Retiro do Sul;4321451;Teutônia;7;8;15;22
3304557;Rio de Janeiro;4320008;Sapucaia do Sul;7;8;15;1068
4317707;Santo Antônio das Missões;4318903;São Luiz Gonzaga;7;8;15;29
4303103;Cachoeirinha;4318705;São Leopoldo;7;8;15;21
4304630;Capão da Canoa;4318705;São Leopoldo;7;8;15;107
4307609;Estância Velha;4318705;São Leopoldo;7;8;15;13
4312401;Montenegro;4318705;São Leopoldo;7;8;15;36
4313508;Osório;4317608;Santo Antônio da Patrulha;7;8;15;25
3550308;São Paulo;4317509;Santo Ângelo;7;8;15;896
4313037;Nova Esperança do Sul;4317400;Santiago;7;8;15;24
1500800;Ananindeua;4314902;Porto Alegre;7;8;15;3183
4207304;Imbituba;4314902;Porto Alegre;7;8;15;313
4301107;Arroio dos Ratos;4314902;Porto Alegre;7;8;15;51
4311403;Lajeado;4313409;Novo Hamburgo;7;8;15;92
4305207;Cerro Largo;4309506;Guarani das Missões;7;8;15;17
4304606;Canoas;4309308;Guaíba;7;8;15;27
4304705;Carazinho;4308508;Frederico Westphalen;7;8;15;120
4306403;Dois Irmãos;4307609;Estância Velha;7;8;15;11
3550308;São Paulo;4306106;Cruz Alta;7;8;15;864
3505708;Barueri;4305108;Caxias do Sul;7;8;15;747
4301057;Arroio do Sal;4305108;Caxias do Sul;7;8;15;131
4304630;Capão da Canoa;4305108;Caxias do Sul;7;8;15;128
3509502;Campinas;4304606;Canoas;7;8;15;868
4210803;Meleiro;4218806;Turvo;7;8;15;12
4204608;Criciúma;4217709;Sombrio;7;8;15;55
4209102;Joinville;4214805;Rio do Sul;7;8;15;129
4204202;Chapecó;4212908;Pinhalzinho;7;8;15;47
4203808;Canoinhas;4212205;Papanduva;7;8;15;33
4205506;Fraiburgo;4211058;Monte Carlo;7;8;15;23
4204202;Chapecó;4210506;Maravilha;7;8;15;67
4203006;Caçador;4209300;Lages;7;8;15;134
4205407;Florianópolis;4206009;Governador Celso Ramos;7;8;15;31
4203006;Caçador;4204301;Concórdia;7;8;15;103
3550308;São Paulo;4203006;Caçador;7;8;15;558
3550308;São Paulo;4201406;Araranguá;7;8;15;646
4113700;Londrina;4128104;Umuarama;7;8;15;226
4109401;Guarapuava;4127965;Turvo;7;8;15;39
3550308;São Paulo;4126306;Sengés;7;8;15;290
3106705;Betim;4125506;São José dos Pinhais;7;8;15;790
4115200;Maringá;4125506;São José dos Pinhais;7;8;15;360
4119509;Piraquara;4125506;São José dos Pinhais;7;8;15;16
4105409;Chopinzinho;4124806;São João;7;8;15;20
4106902;Curitiba;4122404;Rolândia;7;8;15;318
4104808;Cascavel;4121406;Realeza;7;8;15;92
4107546;Espigão Alto do Iguaçu;4120903;Quedas do Iguaçu;7;8;15;8
4106902;Curitiba;4120804;Quatro Barras;7;8;15;23
4110508;Ipiranga;4119905;Ponta Grossa;7;8;15;43
4119152;Pinhais;4119509;Piraquara;7;8;15;13
3509502;Campinas;4115200;Maringá;7;8;15;500
4104808;Cascavel;4108809;Guaíra;7;8;15;123
2704302;Maceió;4106902;Curitiba;7;8;15;2179
4101507;Arapongas;4103701;Cambé;7;8;15;21
3550308;São Paulo;4101101;Andirá;7;8;15;374
3550308;São Paulo;3556909;Vista Alegre do Alto;7;8;15;344
3106200;Belo Horizonte;3554102;Taubaté;7;8;15;380
3549805;São José do Rio Preto;3553401;Tanabi;7;8;15;34
3509502;Campinas;3552809;Taboão da Serra;7;8;15;82
3545803;Santa Bárbara d'Oeste;3552403;Sumaré;7;8;15;17
1501402;Belém;3552205;Sorocaba;7;8;15;2447
3304557;Rio de Janeiro;3551702;Sertãozinho;7;8;15;530
3531902;Morro Agudo;3551702;Sertãozinho;7;8;15;46
1100122;Ji-Paraná;3550308;São Paulo;7;8;15;2058
1501303;Barcarena;3550308;São Paulo;7;8;15;2457
2101400;Balsas;3550308;São Paulo;7;8;15;1788
2312908;Sobral;3550308;São Paulo;7;8;15;2294
3120904;Curvelo;3550308;São Paulo;7;8;15;584
3502705;Apiaí;3550308;São Paulo;7;8;15;244
3514502;Duartina;3550308;São Paulo;7;8;15;311
3530102;Mirandópolis;3550308;São Paulo;7;8;15;529
3533502;Novo Horizonte;3550308;São Paulo;7;8;15;355
3535507;Paraguaçu Paulista;3550308;São Paulo;7;8;15;425
3535804;Paranapanema;3550308;São Paulo;7;8;15;217
2927408;Salvador;3549904;São José dos Campos;7;8;15;1348
3306305;Volta Redonda;3549904;São José dos Campos;7;8;15;198
3527207;Lorena;3549904;São José dos Campos;7;8;15;97
3516200;Franca;3549805;São José do Rio Preto;7;8;15;209
3510807;Casa Branca;3549102;São João da Boa Vista;7;8;15;35
3530706;Mogi Guaçu;3549102;São João da Boa Vista;7;8;15;43
3118601;Contagem;3548708;São Bernardo do Campo;7;8;15;490
3518701;Guarujá;3548708;São Bernardo do Campo;7;8;15;41
3530607;Moji das Cruzes;3548500;Santos;7;8;15;41
1302603;Manaus;3547809;Santo André;7;8;15;2625
3513009;Cotia;3547809;Santo André;7;8;15;40
3509205;Cajamar;3534401;Osasco;7;8;15;22
3524105;Ituverava;3534302;Orlândia;7;8;15;42
3505500;Barretos;3533908;Olímpia;7;8;15;40
3106200;Belo Horizonte;3529401;Mauá;7;8;15;486
3516408;Franco da Rocha;3525904;Jundiaí;7;8;15;24
3510609;Carapicuíba;3522505;Itapevi;7;8;15;11
3505708;Barueri;3520509;Indaiatuba;7;8;15;60
3506003;Bauru;3519600;Ibitinga;7;8;15;69
3304557;Rio de Janeiro;3518701;Guarujá;7;8;15;328
3151800;Poços de Caldas;3509502;Campinas;7;8;15;136
3304557;Rio de Janeiro;3507605;Bragança Paulista;7;8;15;338
3501608;Americana;3506003;Bauru;7;8;15;185
3502804;Araçatuba;3505708;Barueri;7;8;15;442
3501608;Americana;3503208;Araraquara;7;8;15;137
3303955;Pinheiral;3306305;Volta Redonda;7;8;15;10
3306008;Três Rios;3306305;Volta Redonda;7;8;15;101
3300209;Araruama;3305208;São Pedro da Aldeia;7;8;15;25
2918407;Juazeiro;3304557;Rio de Janeiro;7;8;15;1508
3113404;Caratinga;3304557;Rio de Janeiro;7;8;15;357
3300100;Angra dos Reis;3304201;Resende;7;8;15;48
3300308;Barra do Piraí;3300407;Barra Mansa;7;8;15;39
3200607;Aracruz;3205200;Vila Velha;7;8;15;59
3118601;Contagem;3201308;Cariacica;7;8;15;382
1100205;Porto Velho;3170206;Uberlândia;7;8;15;1958
3122306;Divinópolis;3167202;Sete Lagoas;7;8;15;105
3147907;Passos;3162203;São João Batista do Glória;7;8;15;15
3105905;Barroso;3152709;Prados;7;8;15;18
3139003;Machado;3152501;Pouso Alegre;7;8;15;60
3136702;Juiz de Fora;3152105;Ponte Nova;7;8;15;156
3131208;Ipanema;3151909;Pocrane;7;8;15;20
3108404;Botelhos;3151800;Poços de Caldas;7;8;15;22
3109907;Caetanópolis;3147402;Paraopeba;7;8;15;4
3106200;Belo Horizonte;3140704;Mateus Leme;7;8;15;48
3136702;Juiz de Fora;3138401;Leopoldina;7;8;15;71
3131307;Ipatinga;3136207;João Monlevade;7;8;15;76
3106200;Belo Horizonte;3134202;Ituiutaba;7;8;15;588
3106200;Belo Horizonte;3132404;Itajubá;7;8;15;317
2304400;Fortaleza;3118601;Contagem;7;8;15;1873
3101904;Alpinópolis;3112802;Capitólio;7;8;15;45
3104205;Arcos;3106200;Belo Horizonte;7;8;15;170
2913606;Ilhéus;2933307;Vitória da Conquista;7;8;15;186
2925303;Porto Seguro;2927705;Santa Cruz Cabrália;7;8;15;17
2906873;Capim Grosso;2917508;Jacobina;7;8;15;53
2902708;Barra;2913200;Ibotirama;7;8;15;132
2802908;Itabaiana;2803500;Lagarto;7;8;15;41
2600104;Afogados da Ingazeira;2613909;Serra Talhada;7;8;15;78
2610004;Palmares;2611606;Recife;7;8;15;96
2504009;Campina Grande;2607901;Jaboatão dos Guararapes;7;8;15;138
2304400;Fortaleza;2501807;Bayeux;7;8;15;544
1501402;Belém;2408102;Natal;7;8;15;1537
2404507;Guamaré;2407203;Macau;7;8;15;34
2402600;Ceará-Mirim;2405801;João Câmara;7;8;15;46
2400208;Açu;2402006;Caicó;7;8;15;101
2307304;Juazeiro do Norte;2312908;Sobral;7;8;15;411
2304400;Fortaleza;2312205;Santa Quitéria;7;8;15;190
2304103;Crateús;2309300;Nova Russas;7;8;15;53
2210607;São Raimundo Nonato;2211001;Teresina;7;8;15;429
2208007;Picos;2210607;São Raimundo Nonato;7;8;15;251
2202208;Campo Maior;2208403;Piripiri;7;8;15;78
2111300;São Luís;2111508;São Mateus do Maranhão;7;8;15;169
1702109;Araguaína;1709302;Guaraí;7;8;15;190
1500602;Altamira;1508100;Tucuruí;7;8;15;286
1504208;Marabá;1505064;Novo Repartimento;7;8;15;157
1100304;Vilhena;1302603;Manaus;7;8;15;1072
1100064;Colorado do Oeste;1100304;Vilhena;7;8;15;50
1508100;Tucuruí;5300108;Brasília;6;9;15;1347
2312908;Sobral;5300108;Brasília;6;9;15;1560
3305802;Teresópolis;5300108;Brasília;6;9;15;908
3519071;Hortolândia;5300108;Brasília;6;9;15;784
5002704;Campo Grande;5007208;Rio Brilhante;6;9;15;152
4305108;Caxias do Sul;5002704;Campo Grande;6;9;15;1038
4312658;Não-Me-Toque;4323200;Victor Graeff;6;9;15;13
4312955;Nova Boa Vista;4320107;Sarandi;6;9;15;8
3550308;São Paulo;4319901;Sapiranga;6;9;15;780
3545803;Santa Bárbara d'Oeste;4314902;Porto Alegre;6;9;15;883
4203006;Caçador;4314100;Passo Fundo;6;9;15;206
4205407;Florianópolis;4304606;Canoas;6;9;15;362
4209300;Lages;4219309;Videira;6;9;15;120
3304557;Rio de Janeiro;4218707;Tubarão;6;9;15;831
4113700;Londrina;4202404;Blumenau;6;9;15;453
4115002;Marilena;4117107;Nova Londrina;6;9;15;7
4102406;Bandeirantes;4113700;Londrina;6;9;15;83
3550308;São Paulo;4108601;Goioerê;6;9;15;649
3202405;Guarapari;3550308;São Paulo;6;9;15;699
3300233;Armação dos Búzios;3550308;São Paulo;6;9;15;492
3546603;Santa Fé do Sul;3550308;São Paulo;6;9;15;580
3520509;Indaiatuba;3548807;São Caetano do Sul;6;9;15;90
3509502;Campinas;3539301;Pirassununga;6;9;15;106
3506508;Birigui;3527108;Lins;6;9;15;72
3302502;Magé;3303302;Niterói;6;9;15;27
3118601;Contagem;3205200;Vila Velha;6;9;15;390
3130200;Igaratinga;3147105;Pará de Minas;6;9;15;15
3100203;Abaeté;3106200;Belo Horizonte;6;9;15;175
2610905;Pesqueira;2611200;Poção;6;9;15;18
2503704;Cajazeiras;2510808;Patos;6;9;15;145
2105302;Imperatriz;2109908;Santa Inês;6;9;15;290
1100122;Ji-Paraná;5300108;Brasília;5;10;15;1577
2602902;Cabo de Santo Agostinho;5300108;Brasília;5;10;15;1596
2609600;Olinda;5300108;Brasília;5;10;15;1623
3154606;Ribeirão das Neves;5300108;Brasília;5;10;15;604
5003702;Dourados;5103403;Cuiabá;5;10;15;752
2800308;Aracaju;4314902;Porto Alegre;5;10;15;2477
4305108;Caxias do Sul;4312401;Montenegro;5;10;15;64
4204202;Chapecó;4214201;Quilombo;5;10;15;44
3534401;Osasco;3551009;São Vicente;5;10;15;58
3500402;Águas da Prata;3550308;São Paulo;5;10;15;190
3511102;Catanduva;3533908;Olímpia;5;10;15;45
3106705;Betim;3157807;Santa Luzia;5;10;15;41
1302603;Manaus;2211001;Teresina;5;10;15;1921
4314100;Passo Fundo;4322400;Uruguaiana;4;11;15;480
4320305;Selbach;4321006;Tapera;4;11;15;8
3513801;Diadema;4314902;Porto Alegre;4;11;15;826
3529005;Marília;4314902;Porto Alegre;4;11;15;875
3554102;Taubaté;4314902;Porto Alegre;4;11;15;942
3534401;Osasco;4313409;Novo Hamburgo;4;11;15;795
3534401;Osasco;4204608;Criciúma;4;11;15;620
3534401;Osasco;3541406;Presidente Prudente;4;11;15;502
3551009;São Vicente;5300108;Brasília;3;12;15;916
4109401;Guarapuava;5300108;Brasília;3;12;15;1130
3548807;São Caetano do Sul;5103403;Cuiabá;3;12;15;1375
3136702;Juiz de Fora;3548807;São Caetano do Sul;3;12;15;387
3304904;São Gonçalo;3548807;São Caetano do Sul;3;12;15;368
3305109;São João de Meriti;3548807;São Caetano do Sul;3;12;15;337
2507507;João Pessoa;3534401;Osasco;3;12;15;2153
3304904;São Gonçalo;3534401;Osasco;3;12;15;388
1200401;Rio Branco;4101507;Arapongas;2;13;15;2193
2612505;Santa Cruz do Capibaribe;2704302;Maceió;2;13;15;192
1302603;Manaus;4101507;Arapongas;1;14;15;2397
5107602;Rondonópolis;5218805;Rio Verde;7;7;14;423
5211503;Itumbiara;5218508;Quirinópolis;7;7;14;127
2909307;Correntina;5218300;Posse;7;7;14;204
5208707;Goiânia;5217401;Pires do Rio;7;7;14;123
3170206;Uberlândia;5211909;Jataí;7;7;14;381
5208707;Goiânia;5210406;Itaberaí;7;7;14;92
3550308;São Paulo;5208905;Goiás;7;7;14;933
5208707;Goiânia;5208905;Goiás;7;7;14;125
1500800;Ananindeua;5208707;Goiânia;7;7;14;1698
1505536;Parauapebas;5208707;Goiânia;7;7;14;1184
5107958;Tangará da Serra;5208707;Goiânia;7;7;14;900
5200134;Acreúna;5208707;Goiânia;7;7;14;140
4314902;Porto Alegre;5201405;Aparecida de Goiânia;7;7;14;1482
5101803;Barra do Garças;5108402;Várzea Grande;7;7;14;419
5103700;Feliz Natal;5107925;Sorriso;7;7;14;92
5107040;Primavera do Leste;5107925;Sorriso;7;7;14;364
5102637;Campo Novo do Parecis;5107875;Sapezal;7;7;14;120
5101803;Barra do Garças;5107040;Primavera do Leste;7;7;14;225
5103403;Cuiabá;5106752;Pontes e Lacerda;7;7;14;349
5100201;Água Boa;5106257;Nova Xavantina;7;7;14;75
5103205;Colíder;5106216;Nova Canaã do Norte;7;7;14;34
1501402;Belém;5103403;Cuiabá;7;7;14;1762
2927408;Salvador;5103403;Cuiabá;7;7;14;1903
3536505;Paulínia;5103403;Cuiabá;7;7;14;1263
5100201;Água Boa;5102702;Canarana;7;7;14;57
5004700;Ivinhema;5006200;Nova Andradina;7;7;14;43
5005707;Naviraí;5006200;Nova Andradina;7;7;14;120
3550308;São Paulo;5005608;Miranda;7;7;14;1096
5001102;Aquidauana;5005608;Miranda;7;7;14;66
5000856;Angélica;5004700;Ivinhema;7;7;14;18
5003702;Dourados;5003801;Fátima do Sul;7;7;14;34
3550308;São Paulo;5003306;Coxim;7;7;14;1047
5002902;Cassilândia;5002951;Chapadão do Sul;7;7;14;100
3550308;São Paulo;5002902;Cassilândia;7;7;14;739
2408102;Natal;5002704;Campo Grande;7;7;14;2541
2927408;Salvador;5002704;Campo Grande;7;7;14;1849
3170206;Uberlândia;5002704;Campo Grande;7;7;14;684
3550308;São Paulo;5002407;Caarapó;7;7;14;852
3550308;São Paulo;5001102;Aquidauana;7;7;14;1027
4314902;Porto Alegre;4322806;Veranópolis;7;7;14;128
4304606;Canoas;4322400;Uruguaiana;7;7;14;569
4316402;Rosário do Sul;4322400;Uruguaiana;7;7;14;212
4313508;Osório;4321501;Torres;7;7;14;77
4312500;Mostardas;4321352;Tavares;7;7;14;26
4303509;Camaquã;4321105;Tapes;7;7;14;41
4314902;Porto Alegre;4321105;Tapes;7;7;14;72
4304705;Carazinho;4320107;Sarandi;7;7;14;41
4303103;Cachoeirinha;4320008;Sapucaia do Sul;7;7;14;12
4314902;Porto Alegre;4319802;São Vicente do Sul;7;7;14;340
4308102;Feliz;4319505;São Sebastião do Caí;7;7;14;17
4314803;Portão;4319505;São Sebastião do Caí;7;7;14;18
4106902;Curitiba;4318705;São Leopoldo;7;7;14;510
4305108;Caxias do Sul;4318200;São Francisco de Paula;7;7;14;65
4317400;Santiago;4318101;São Francisco de Assis;7;7;14;48
4314902;Porto Alegre;4317400;Santiago;7;7;14;370
4300406;Alegrete;4317103;Santana do Livramento;7;7;14;122
4302808;Caçapava do Sul;4316907;Santa Maria;7;7;14;95
3505708;Barueri;4315602;Rio Grande;7;7;14;1065
4208203;Itajaí;4315602;Rio Grande;7;7;14;652
4304663;Capão do Leão;4314902;Porto Alegre;7;7;14;227
4304804;Carlos Barbosa;4314902;Porto Alegre;7;7;14;89
4309407;Guaporé;4314902;Porto Alegre;7;7;14;150
4310330;Imbé;4313508;Osório;7;7;14;15
4209102;Joinville;4313409;Novo Hamburgo;7;7;14;435
4304606;Canoas;4313375;Nova Santa Rita;7;7;14;10
4302105;Bento Gonçalves;4311403;Lajeado;7;7;14;59
4302402;Bom Retiro do Sul;4311403;Lajeado;7;7;14;21
4309407;Guaporé;4311403;Lajeado;7;7;14;67
4301503;Augusto Pestana;4311155;Jóia;7;7;14;19
4300604;Alvorada;4309209;Gravataí;7;7;14;11
4304606;Canoas;4307807;Estrela;7;7;14;88
4302709;Butiá;4305355;Charqueadas;7;7;14;37
3301702;Duque de Caxias;4305108;Caxias do Sul;7;7;14;1027
4106902;Curitiba;4302105;Bento Gonçalves;7;7;14;464
3550308;São Paulo;4300604;Alvorada;7;7;14;816
3550308;São Paulo;4219309;Videira;7;7;14;576
4211702;Orleans;4218707;Tubarão;7;7;14;32
4216404;São João do Sul;4217709;Sombrio;7;7;14;20
4128708;Vitorino;4216909;São Lourenço do Oeste;7;7;14;15
4214805;Rio do Sul;4216602;São José;7;7;14;99
4106902;Curitiba;4216206;São Francisco do Sul;7;7;14;116
4204806;Curitibanos;4216057;São Cristovão do Sul;7;7;14;16
4213351;Ponte Alta do Norte;4216057;São Cristovão do Sul;7;7;14;12
4204202;Chapecó;4216008;São Carlos;7;7;14;40
3304557;Rio de Janeiro;4215802;São Bento do Sul;7;7;14;709
4208203;Itajaí;4214805;Rio do Sul;7;7;14;91
4207502;Indaial;4213203;Pomerode;7;7;14;18
4208203;Itajaí;4212502;Penha;7;7;14;18
3304557;Rio de Janeiro;4211900;Palhoça;7;7;14;748
4204608;Criciúma;4209409;Laguna;7;7;14;58
2304400;Fortaleza;4209102;Joinville;7;7;14;2675
2607901;Jaboatão dos Guararapes;4209102;Joinville;7;7;14;2400
3543907;Rio Claro;4209102;Joinville;7;7;14;448
3547304;Santana de Parnaíba;4209102;Joinville;7;7;14;368
3548708;São Bernardo do Campo;4209102;Joinville;7;7;14;362
4202057;Balneário Barra do Sul;4209102;Joinville;7;7;14;27
4205803;Garuva;4208450;Itapoá;7;7;14;22
1302603;Manaus;4208203;Itajaí;7;7;14;2840
3106200;Belo Horizonte;4208203;Itajaí;7;7;14;906
3547809;Santo André;4208203;Itajaí;7;7;14;425
4201703;Ascurra;4207502;Indaial;7;7;14;18
4207205;Imaruí;4207304;Imbituba;7;7;14;18
3550308;São Paulo;4206504;Guaramirim;7;7;14;389
2313500;Trairi;4205407;Florianópolis;7;7;14;2827
4200408;Água Doce;4205407;Florianópolis;7;7;14;306
4201208;Antônio Carlos;4205407;Florianópolis;7;7;14;30
4204251;Cocal do Sul;4204608;Criciúma;7;7;14;9
4203600;Campos Novos;4203907;Capinzal;7;7;14;40
3509502;Campinas;4202404;Blumenau;7;7;14;490
4115200;Maringá;4202404;Blumenau;7;7;14;479
4125506;São José dos Pinhais;4202404;Blumenau;7;7;14;157
3550308;São Paulo;4202305;Biguaçu;7;7;14;470
3550308;São Paulo;4128203;União da Vitória;7;7;14;531
4110706;Irati;4128203;União da Vitória;7;7;14;102
4104303;Campo Mourão;4128104;Umuarama;7;7;14;101
4115200;Maringá;4127700;Toledo;7;7;14;233
4106902;Curitiba;4127502;Tibagi;7;7;14;153
3552205;Sorocaba;4125506;São José dos Pinhais;7;7;14;283
3550308;São Paulo;4120804;Quatro Barras;7;7;14;308
4112009;Jaguariaíva;4119905;Ponta Grossa;7;7;14;104
4106902;Curitiba;4119103;Piên;7;7;14;75
4105409;Chopinzinho;4118501;Pato Branco;7;7;14;44
4106902;Curitiba;4118402;Paranavaí;7;7;14;416
3505708;Barueri;4118204;Paranaguá;7;7;14;284
4108304;Foz do Iguaçu;4118204;Paranaguá;7;7;14;597
3543402;Ribeirão Preto;4115200;Maringá;7;7;14;489
4111506;Ivaiporã;4112504;Jardim Alegre;7;7;14;8
4106902;Curitiba;4108403;Francisco Beltrão;7;7;14;382
3538709;Piracicaba;4106902;Curitiba;7;7;14;339
4101804;Araucária;4104808;Cascavel;7;7;14;417
3304557;Rio de Janeiro;4101408;Apucarana;7;7;14;838
3556107;Valentim Gentil;3557105;Votuporanga;7;7;14;14
3529005;Marília;3556602;Vera Cruz;7;7;14;13
3509601;Campo Limpo Paulista;3556503;Várzea Paulista;7;7;14;5
3510807;Casa Branca;3556404;Vargem Grande do Sul;7;7;14;21
3550308;São Paulo;3556404;Vargem Grande do Sul;7;7;14;203
3520509;Indaiatuba;3556206;Valinhos;7;7;14;29
3550308;São Paulo;3554508;Tietê;7;7;14;125
3554003;Tatuí;3554508;Tietê;7;7;14;30
3529302;Matão;3553708;Taquaritinga;7;7;14;23
3513009;Cotia;3552809;Taboão da Serra;7;7;14;15
3543402;Ribeirão Preto;3552403;Sumaré;7;7;14;193
3548708;São Bernardo do Campo;3552403;Sumaré;7;7;14;122
3548500;Santos;3552205;Sorocaba;7;7;14;126
3500501;Águas de Lindóia;3552106;Socorro;7;7;14;17
3533908;Olímpia;3551900;Severínia;7;7;14;13
3527603;Luís Antônio;3550902;São Simão;7;7;14;18
2100055;Açailândia;3550308;São Paulo;7;7;14;2070
2405801;João Câmara;3550308;São Paulo;7;7;14;2266
2408805;Parazinho;3550308;São Paulo;7;7;14;2295
2606804;Igarassu;3550308;São Paulo;7;7;14;2091
2707701;Rio Largo;3550308;São Paulo;7;7;14;1893
2804805;Nossa Senhora do Socorro;3550308;São Paulo;7;7;14;1698
2922003;Mucuri;3550308;São Paulo;7;7;14;946
3134400;Iturama;3550308;São Paulo;7;7;14;562
3171204;Vespasiano;3550308;São Paulo;7;7;14;516
3204906;São Mateus;3550308;São Paulo;7;7;14;869
3500303;Aguaí;3550308;São Paulo;7;7;14;180
3509254;Cajati;3550308;São Paulo;7;7;14;192
3509452;Campina do Monte Alegre;3550308;São Paulo;7;7;14;186
3512308;Conchas;3550308;São Paulo;7;7;14;155
3519055;Holambra;3550308;São Paulo;7;7;14;120
3520301;Iguape;3550308;São Paulo;7;7;14;149
3539202;Pirapozinho;3550308;São Paulo;7;7;14;515
3543402;Ribeirão Preto;3549904;São José dos Campos;7;7;14;298
3527108;Lins;3549805;São José do Rio Preto;7;7;14;103
3529302;Matão;3549805;São José do Rio Preto;7;7;14;135
3516200;Franca;3549409;São Joaquim da Barra;7;7;14;49
3517703;Guará;3549409;São Joaquim da Barra;7;7;14;19
3500303;Aguaí;3549102;São João da Boa Vista;7;7;14;20
3540705;Porto Ferreira;3548906;São Carlos;7;7;14;47
3205002;Serra;3548500;Santos;7;7;14;737
3537602;Peruíbe;3548500;Santos;7;7;14;80
3530607;Moji das Cruzes;3547809;Santo André;7;7;14;36
3541406;Presidente Prudente;3547700;Santo Anastácio;7;7;14;32
3205309;Vitória;3547304;Santana de Parnaíba;7;7;14;756
3526704;Leme;3543907;Rio Claro;7;7;14;29
3507803;Brodowski;3543402;Ribeirão Preto;7;7;14;23
3524105;Ituverava;3543402;Ribeirão Preto;7;7;14;90
3541406;Presidente Prudente;3543402;Ribeirão Preto;7;7;14;390
3524600;Jacupiranga;3542602;Registro;7;7;14;23
3535507;Paraguaçu Paulista;3542206;Rancharia;7;7;14;35
3500105;Adamantina;3541406;Presidente Prudente;7;7;14;59
3518602;Guariba;3540903;Pradópolis;7;7;14;17
3526704;Leme;3540705;Porto Ferreira;7;7;14;38
3527207;Lorena;3538501;Piquete;7;7;14;16
3509700;Campos do Jordão;3538006;Pindamonhangaba;7;7;14;26
3518800;Guarulhos;3538006;Pindamonhangaba;7;7;14;126
3527108;Lins;3537305;Penápolis;7;7;14;41
3519071;Hortolândia;3536505;Paulínia;7;7;14;13
3504503;Avaré;3534708;Ourinhos;7;7;14;100
3507506;Botucatu;3534708;Ourinhos;7;7;14;150
3506102;Bebedouro;3533908;Olímpia;7;7;14;44
3517802;Guaraçaí;3530102;Mirandópolis;7;7;14;16
3170206;Uberlândia;3529005;Marília;7;7;14;406
3513405;Cruzeiro;3527207;Lorena;7;7;14;21
3525300;Jaú;3526803;Lençóis Paulista;7;7;14;45
3501905;Amparo;3524709;Jaguariúna;7;7;14;23
3508504;Caçapava;3524402;Jacareí;7;7;14;34
3501905;Amparo;3522604;Itapira;7;7;14;30
3508009;Buri;3522406;Itapeva;7;7;14;36
3515004;Embu;3522208;Itapecerica da Serra;7;7;14;8
1302603;Manaus;3520509;Indaiatuba;7;7;14;2541
1501402;Belém;3518800;Guarulhos;7;7;14;2447
2507507;João Pessoa;3518800;Guarulhos;7;7;14;2132
2905701;Camaçari;3518800;Guarulhos;7;7;14;1441
2910800;Feira de Santana;3518800;Guarulhos;7;7;14;1444
3201209;Cachoeiro de Itapemirim;3518800;Guarulhos;7;7;14;625
3147907;Passos;3516200;Franca;7;7;14;83
3511102;Catanduva;3515509;Fernandópolis;7;7;14;164
3118601;Contagem;3513801;Diadema;7;7;14;489
3509502;Campinas;3512803;Cosmópolis;7;7;14;31
3503307;Araras;3512209;Conchal;7;7;14;21
3106705;Betim;3509502;Campinas;7;7;14;437
3304557;Rio de Janeiro;3509205;Cajamar;7;7;14;373
3505708;Barueri;3509205;Cajamar;7;7;14;17
3505302;Barra Bonita;3507506;Botucatu;7;7;14;44
3500709;Agudos;3506003;Bauru;7;7;14;18
3170107;Uberaba;3505708;Barueri;7;7;14;430
3503208;Araraquara;3505708;Barueri;7;7;14;232
3304557;Rio de Janeiro;3504107;Atibaia;7;7;14;337
3106200;Belo Horizonte;3503208;Araraquara;7;7;14;479
3170206;Uberlândia;3503208;Araraquara;7;7;14;319
3300308;Barra do Piraí;3306008;Três Rios;7;7;14;75
3302403;Macaé;3305505;Saquarema;7;7;14;80
3304300;Rio Bonito;3305505;Saquarema;7;7;14;23
3303500;Nova Iguaçu;3304904;São Gonçalo;7;7;14;42
1301209;Coari;3304557;Rio de Janeiro;7;7;14;2850
1500800;Ananindeua;3304557;Rio de Janeiro;7;7;14;2432
1709500;Gurupi;3304557;Rio de Janeiro;7;7;14;1364
2105302;Imperatriz;3304557;Rio de Janeiro;7;7;14;1965
2303709;Caucaia;3304557;Rio de Janeiro;7;7;14;2166
2304285;Eusébio;3304557;Rio de Janeiro;7;7;14;2153
2921005;Mata de São João;3304557;Rio de Janeiro;7;7;14;1247
3157807;Santa Luzia;3304557;Rio de Janeiro;7;7;14;350
3303401;Nova Friburgo;3303906;Petrópolis;7;7;14;71
3302858;Mesquita;3303500;Nova Iguaçu;7;7;14;5
3300704;Cabo Frio;3302205;Itaperuna;7;7;14;193
3301009;Campos dos Goytacazes;3301702;Duque de Caxias;7;7;14;231
3202108;Ecoporanga;3205309;Vitória;7;7;14;219
3203346;Marechal Floriano;3205309;Vitória;7;7;14;43
3202207;Fundão;3205200;Vila Velha;7;7;14;45
3204708;São Gabriel da Palha;3205176;Vila Valério;7;7;14;19
3201308;Cariacica;3205101;Viana;7;7;14;21
2611606;Recife;3205002;Serra;7;7;14;1436
3204054;Pedro Canário;3204906;São Mateus;7;7;14;85
3201001;Boa Esperança;3203908;Nova Venécia;7;7;14;22
3200201;Alegre;3202306;Guaçuí;7;7;14;12
3201506;Colatina;3202256;Governador Lindenberg;7;7;14;37
3201308;Cariacica;3201902;Domingos Martins;7;7;14;25
3200904;Barra de São Francisco;3201506;Colatina;7;7;14;93
3106200;Belo Horizonte;3171303;Viçosa;7;7;14;148
3106200;Belo Horizonte;3170800;Várzea da Palma;7;7;14;268
3136702;Juiz de Fora;3170701;Varginha;7;7;14;216
3145000;Nova Ponte;3170206;Uberlândia;7;7;14;67
3156908;Sacramento;3170107;Uberaba;7;7;14;51
3136207;João Monlevade;3168705;Timóteo;7;7;14;61
3148103;Patrocínio;3166808;Serra do Salitre;7;7;14;35
3129806;Ibirité;3165537;Sarzedo;7;7;14;9
3108602;Brasília de Minas;3161106;São Francisco;7;7;14;51
3113404;Caratinga;3159357;Santa Rita de Minas;7;7;14;10
3104007;Araxá;3156908;Sacramento;7;7;14;60
3136702;Juiz de Fora;3155801;Rio Pomba;7;7;14;56
3125101;Extrema;3152501;Pouso Alegre;7;7;14;81
3135100;Janaúba;3152204;Porteirinha;7;7;14;36
3107406;Bom Despacho;3152006;Pompéu;7;7;14;66
3140506;Martinho Campos;3152006;Pompéu;7;7;14;34
3119302;Coromandel;3148004;Patos de Minas;7;7;14;75
3101904;Alpinópolis;3147907;Passos;7;7;14;31
3123601;Elói Mendes;3147204;Paraguaçu;7;7;14;19
3139706;Maravilhas;3146909;Papagaios;7;7;14;11
3114501;Carmópolis de Minas;3145604;Oliveira;7;7;14;29
3138203;Lavras;3144607;Nepomuceno;7;7;14;24
3107406;Bom Despacho;3140506;Martinho Campos;7;7;14;44
3106200;Belo Horizonte;3140001;Mariana;7;7;14;79
3132404;Itajubá;3139904;Maria da Fé;7;7;14;15
3113305;Carangola;3139508;Manhumirim;7;7;14;42
3107406;Bom Despacho;3138807;Luz;7;7;14;46
3105608;Barbacena;3138203;Lavras;7;7;14;125
3127701;Governador Valadares;3136702;Juiz de Fora;7;7;14;354
3106002;Bela Vista de Minas;3136207;João Monlevade;7;7;14;9
3106200;Belo Horizonte;3134608;Jaboticatubas;7;7;14;49
3106200;Belo Horizonte;3133709;Itatiaiuçu;7;7;14;57
3122306;Divinópolis;3133501;Itapecerica;7;7;14;43
3118601;Contagem;3130101;Igarapé;7;7;14;30
3110509;Camanducaia;3125101;Extrema;7;7;14;21
3106200;Belo Horizonte;3117504;Conceição do Mato Dentro;7;7;14;113
3114501;Carmópolis de Minas;3116605;Cláudio;7;7;14;17
3104601;Astolfo Dutra;3115300;Cataguases;7;7;14;21
3111309;Campo do Meio;3111606;Campos Gerais;7;7;14;16
2913606;Ilhéus;3106200;Belo Horizonte;7;7;14;756
2903904;Bom Jesus da Lapa;2928109;Santa Maria da Vitória;7;7;14;92
2211001;Teresina;2927408;Salvador;7;7;14;989
2914703;Itaberaba;2927408;Salvador;7;7;14;203
2914703;Itaberaba;2927200;Ruy Barbosa;7;7;14;36
2704302;Maceió;2919207;Lauro de Freitas;7;7;14;454
2304400;Fortaleza;2918407;Juazeiro;7;7;14;667
2611606;Recife;2918407;Juazeiro;7;7;14;630
2913606;Ilhéus;2914901;Itacaré;7;7;14;58
2304400;Fortaleza;2914802;Itabuna;7;7;14;1222
2911907;Iaçu;2914703;Itaberaba;7;7;14;29
2903201;Barreiras;2913200;Ibotirama;7;7;14;192
2611101;Petrolina;2910800;Feira de Santana;7;7;14;371
2908408;Conceição do Coité;2910800;Feira de Santana;7;7;14;91
2908507;Conceição do Jacuípe;2910800;Feira de Santana;7;7;14;22
2903904;Bom Jesus da Lapa;2905206;Caetité;7;7;14;129
2803500;Lagarto;2807402;Tobias Barreto;7;7;14;44
2800308;Aracaju;2803203;Itaporanga d'Ajuda;7;7;14;26
2802106;Estância;2803005;Itabaianinha;7;7;14;34
2704302;Maceió;2706901;Pilar;7;7;14;23
2700409;Atalaia;2704302;Maceió;7;7;14;33
2604007;Carpina;2614501;Surubim;7;7;14;55
2613503;São José do Belmonte;2613909;Serra Talhada;7;7;14;52
2610004;Palmares;2611804;Ribeirão;7;7;14;30
2307304;Juazeiro do Norte;2611606;Recife;7;7;14;492
2609907;Ouricuri;2611606;Recife;7;7;14;571
2610608;Paudalho;2611606;Recife;7;7;14;37
2604106;Caruaru;2609600;Olinda;7;7;14;124
2111300;São Luís;2607901;Jaboatão dos Guararapes;7;7;14;1183
2403251;Parnamirim;2607901;Jaboatão dos Guararapes;7;7;14;245
2604106;Caruaru;2605004;Cupira;7;7;14;38
2504009;Campina Grande;2516201;Sousa;7;7;14;267
2403251;Parnamirim;2507507;João Pessoa;7;7;14;148
2408102;Natal;2412203;São José de Mipibu;7;7;14;30
2304400;Fortaleza;2407104;Macaíba;7;7;14;421
2402006;Caicó;2403251;Parnamirim;7;7;14;215
2304400;Fortaleza;2313302;Tauá;7;7;14;317
2307601;Limoeiro do Norte;2313104;Tabuleiro do Norte;7;7;14;12
2211001;Teresina;2312908;Sobral;7;7;14;313
2304103;Crateús;2312908;Sobral;7;7;14;170
2304400;Fortaleza;2310704;Pentecoste;7;7;14;81
2306108;Irauçuba;2306306;Itapagé;7;7;14;23
2101202;Bacabal;2304400;Fortaleza;7;7;14;691
2202703;Cocal;2207702;Parnaíba;7;7;14;72
2103000;Caxias;2112209;Timon;7;7;14;59
2100055;Açailândia;2111300;São Luís;7;7;14;449
2103307;Codó;2111300;São Luís;7;7;14;218
2105302;Imperatriz;2109007;Porto Franco;7;7;14;94
2104800;Grajaú;2105302;Imperatriz;7;7;14;148
1702109;Araguaína;1716109;Paraíso do Tocantins;7;7;14;337
1707108;Divinópolis do Tocantins;1716109;Paraíso do Tocantins;7;7;14;53
1600303;Macapá;1600535;Porto Grande;7;7;14;77
1600303;Macapá;1600501;Oiapoque;7;7;14;418
1506302;Salvaterra;1507904;Soure;7;7;14;4
1506138;Redenção;1506708;Santana do Araguaia;7;7;14;151
1504208;Marabá;1504422;Marituba;7;7;14;452
1503705;Itupiranga;1504208;Marabá;7;7;14;41
1503093;Goianésia do Pará;1503804;Jacundá;7;7;14;64
1302603;Manaus;1502400;Castanhal;7;7;14;1364
1400100;Boa Vista;1400472;Rorainópolis;7;7;14;216
1100122;Ji-Paraná;1200401;Rio Branco;7;7;14;658
1100023;Ariquemes;1101401;Monte Negro;7;7;14;52
1100023;Ariquemes;1100403;Alto Paraíso;7;7;14;38
1100106;Guajará-Mirim;1100304;Vilhena;7;7;14;600
1100015;Alta Floresta d'Oeste;1100288;Rolim de Moura;7;7;14;36
1100122;Ji-Paraná;1100254;Presidente Médici;7;7;14;27
2607208;Ipojuca;5300108;Brasília;6;8;14;1586
3171204;Vespasiano;5300108;Brasília;6;8;14;610
3539806;Poá;5300108;Brasília;6;8;14;870
5107925;Sorriso;5300108;Brasília;6;8;14;907
3550308;São Paulo;5219308;Santa Helena de Goiás;6;8;14;775
5106224;Nova Mutum;5107958;Tangará da Serra;6;8;14;174
4306106;Cruz Alta;4322202;Tupanciretã;6;8;14;55
4310207;Ijuí;4318903;São Luiz Gonzaga;6;8;14;102
3556206;Valinhos;4314902;Porto Alegre;6;8;14;878
4310009;Ibirubá;4314902;Porto Alegre;6;8;14;240
4311304;Lagoa Vermelha;4314902;Porto Alegre;6;8;14;207
4303004;Cachoeira do Sul;4311403;Lajeado;6;8;14;106
4207502;Indaial;4307906;Farroupilha;6;8;14;328
1302603;Manaus;4305108;Caxias do Sul;6;8;14;2993
4125506;São José dos Pinhais;4304606;Canoas;6;8;14;520
4204806;Curitibanos;4219309;Videira;6;8;14;62
4101804;Araucária;4209102;Joinville;6;8;14;94
3548807;São Caetano do Sul;4208203;Itajaí;6;8;14;426
4201406;Araranguá;4205407;Florianópolis;6;8;14;178
4106902;Curitiba;4204301;Concórdia;6;8;14;333
4113700;Londrina;4202008;Balneário Camboriú;6;8;14;475
4102901;Bituruna;4128203;União da Vitória;6;8;14;43
3534708;Ourinhos;4124103;Santo Antônio da Platina;6;8;14;41
4101408;Apucarana;4122404;Rolândia;6;8;14;29
4101507;Arapongas;4119905;Ponta Grossa;6;8;14;227
3529005;Marília;4113700;Londrina;6;8;14;171
4101507;Arapongas;4106902;Curitiba;6;8;14;310
3505500;Barretos;3551702;Sertãozinho;6;8;14;89
3538709;Piracicaba;3551702;Sertãozinho;6;8;14;182
1505502;Paragominas;3550308;São Paulo;6;8;14;2283
2910727;Eunápolis;3550308;São Paulo;6;8;14;1070
3147105;Pará de Minas;3550308;São Paulo;6;8;14;468
3163706;São Lourenço;3550308;São Paulo;6;8;14;237
3300209;Araruama;3550308;São Paulo;6;8;14;446
3302205;Itaperuna;3550308;São Paulo;6;8;14;556
3505708;Barueri;3548906;São Carlos;6;8;14;196
3547502;Santa Rita do Passa Quatro;3547601;Santa Rosa de Viterbo;6;8;14;29
3521101;Ipeúna;3543907;Rio Claro;6;8;14;16
3147907;Passos;3543402;Ribeirão Preto;6;8;14;131
3529302;Matão;3543402;Ribeirão Preto;6;8;14;80
3524402;Jacareí;3538006;Pindamonhangaba;6;8;14;66
3515004;Embu;3534401;Osasco;6;8;14;14
3519071;Hortolândia;3534401;Osasco;6;8;14;87
3519071;Hortolândia;3531803;Monte Mor;6;8;14;14
3509502;Campinas;3530607;Moji das Cruzes;6;8;14;114
3505708;Barueri;3526902;Limeira;6;8;14;118
3500709;Agudos;3526803;Lençóis Paulista;6;8;14;23
3304557;Rio de Janeiro;3305406;Sapucaia;6;8;14;104
2611606;Recife;3303302;Niterói;6;8;14;1821
3301009;Campos dos Goytacazes;3302056;Italva;6;8;14;56
3200904;Barra de São Francisco;3205309;Vitória;6;8;14;176
3203130;João Neiva;3205309;Vitória;6;8;14;56
3204104;Pinheiros;3205309;Vitória;6;8;14;204
3204708;São Gabriel da Palha;3204906;São Mateus;6;8;14;77
3109402;Buritizeiro;3170800;Várzea da Palma;6;8;14;35
2704302;Maceió;3170206;Uberlândia;6;8;14;1648
3101904;Alpinópolis;3162948;São José da Barra;6;8;14;18
3138203;Lavras;3162500;São João del Rei;6;8;14;75
3126109;Formiga;3151503;Piumhi;6;8;14;56
3135050;Jaíba;3143302;Montes Claros;6;8;14;158
3132107;Itacarambi;3135100;Janaúba;6;8;14;112
2917508;Jacobina;2918407;Juazeiro;6;8;14;196
2607901;Jaboatão dos Guararapes;2905701;Camaçari;6;8;14;618
2903201;Barreiras;2903904;Bom Jesus da Lapa;6;8;14;210
2601409;Barreiros;2614204;Sirinhaém;6;8;14;26
2208007;Picos;2611101;Petrolina;6;8;14;267
1302603;Manaus;2408102;Natal;6;8;14;2755
2301109;Aracati;2408003;Mossoró;6;8;14;81
2305407;Icó;2305506;Iguatu;6;8;14;53
1721000;Palmas;2105302;Imperatriz;6;8;14;546
1501402;Belém;1508001;Tomé-Açu;6;8;14;115
1501402;Belém;1505106;Óbidos;6;8;14;787
1500305;Afuá;1501402;Belém;6;8;14;251
1500602;Altamira;1500800;Ananindeua;6;8;14;474
1301704;Humaitá;1302603;Manaus;6;8;14;596
1709500;Gurupi;5300108;Brasília;5;9;14;470
3536505;Paulínia;5300108;Brasília;5;9;14;774
4101408;Apucarana;5300108;Brasília;5;9;14;941
4204301;Concórdia;5300108;Brasília;5;9;14;1342
3550308;São Paulo;4322608;Venâncio Aires;5;9;14;841
4310405;Independência;4321808;Três de Maio;5;9;14;11
4304309;Cândido Godói;4317202;Santa Rosa;5;9;14;30
3304557;Rio de Janeiro;4316808;Santa Cruz do Sul;5;9;14;1147
3304557;Rio de Janeiro;4309209;Gravataí;5;9;14;1065
4115804;Medianeira;4116059;Missal;5;9;14;27
3516200;Franca;4113700;Londrina;5;9;14;487
3511102;Catanduva;3556909;Vista Alegre do Alto;5;9;14;37
2928901;São Desidério;3550308;São Paulo;5;9;14;1260
3511409;Cerqueira César;3550308;São Paulo;5;9;14;265
3546009;Santa Branca;3550308;São Paulo;5;9;14;83
3106705;Betim;3548807;São Caetano do Sul;5;9;14;470
3505708;Barueri;3541000;Praia Grande;5;9;14;73
2211001;Teresina;3534401;Osasco;5;9;14;2077
3118601;Contagem;3170107;Uberaba;5;9;14;402
2906501;Candeias;2910800;Feira de Santana;5;9;14;62
1600303;Macapá;2304400;Fortaleza;5;9;14;1456
2919207;Lauro de Freitas;5300108;Brasília;4;10;14;1072
2925303;Porto Seguro;5300108;Brasília;4;10;14;945
3168606;Teófilo Otoni;5300108;Brasília;4;10;14;727
3524402;Jacareí;5300108;Brasília;4;10;14;859
3525300;Jaú;5300108;Brasília;4;10;14;719
3534708;Ourinhos;5300108;Brasília;4;10;14;823
4128104;Umuarama;5300108;Brasília;4;10;14;1059
3534401;Osasco;5201108;Anápolis;4;10;14;833
4106902;Curitiba;4316808;Santa Cruz do Sul;4;10;14;561
3530607;Moji das Cruzes;4314902;Porto Alegre;4;10;14;859
3534401;Osasco;4119905;Ponta Grossa;4;10;14;380
4104303;Campo Mourão;4112959;Juranda;4;10;14;62
3149309;Pedro Leopoldo;3550308;São Paulo;4;10;14;518
3518404;Guaratinguetá;5300108;Brasília;3;11;14;832
4105508;Cianorte;4118907;Pérola;3;11;14;112
3529302;Matão;4211058;Monte Carlo;2;12;14;671
2507507;João Pessoa;3516200;Franca;2;12;14;1947
3519402;Ibirá;3528858;Marapoama;1;13;14;23
2510808;Patos;5300108;Brasília;6;7;13;1484
3104007;Araxá;5300108;Brasília;6;7;13;431
3306008;Três Rios;5300108;Brasília;6;7;13;861
5205513;Cocalzinho de Goiás;5300108;Brasília;6;7;13;91
5215231;Novo Gama;5221858;Valparaíso de Goiás;6;7;13;6
5200134;Acreúna;5218805;Rio Verde;6;7;13;74
5213756;Montividiu;5218805;Rio Verde;6;7;13;46
5201108;Anápolis;5217302;Pirenópolis;6;7;13;50
5208707;Goiânia;5210208;Iporá;6;7;13;199
3547304;Santana de Parnaíba;5208707;Goiânia;6;7;13;790
5201108;Anápolis;5205109;Catalão;6;7;13;230
3505708;Barueri;5201108;Anápolis;6;7;13;828
5200100;Abadiânia;5201108;Anápolis;6;7;13;29
3550308;São Paulo;5200258;Águas Lindas de Goiás;6;7;13;892
3304557;Rio de Janeiro;5108402;Várzea Grande;6;7;13;1624
5107909;Sinop;5107958;Tangará da Serra;6;7;13;373
5104526;Ipiranga do Norte;5107925;Sorriso;6;7;13;55
5103205;Colíder;5106422;Peixoto de Azevedo;6;7;13;81
5103403;Cuiabá;5105622;Mirassol d'Oeste;6;7;13;215
5104542;Itanhangá;5105259;Lucas do Rio Verde;6;7;13;130
5103403;Cuiabá;5103502;Diamantino;6;7;13;132
3550308;São Paulo;5102678;Campo Verde;6;7;13;1298
5004403;Inocência;5006309;Paranaíba;6;7;13;78
4104808;Cascavel;5003702;Dourados;6;7;13;332
4314902;Porto Alegre;5003702;Dourados;6;7;13;948
3506003;Bauru;5002704;Campo Grande;6;7;13;622
3550308;São Paulo;4323002;Viamão;6;7;13;821
4314902;Porto Alegre;4321907;Três Passos;6;7;13;397
4305108;Caxias do Sul;4321204;Taquara;6;7;13;66
4300059;Água Santa;4320909;Tapejara;6;7;13;12
4316808;Santa Cruz do Sul;4320701;Sobradinho;6;7;13;67
4304507;Canguçu;4318804;São Lourenço do Sul;6;7;13;64
4311700;Machadinho;4318606;São José do Ouro;6;7;13;24
4311403;Lajeado;4318408;São Jerônimo;6;7;13;65
4316808;Santa Cruz do Sul;4317202;Santa Rosa;6;7;13;288
4307500;Espumoso;4316451;Salto do Jacuí;6;7;13;54
4209003;Joaçaba;4314902;Porto Alegre;6;7;13;324
4304507;Canguçu;4314902;Porto Alegre;6;7;13;208
4304689;Capela de Santana;4314902;Porto Alegre;6;7;13;41
4306908;Encruzilhada do Sul;4314902;Porto Alegre;6;7;13;140
4308508;Frederico Westphalen;4314902;Porto Alegre;6;7;13;364
4314209;Pedro Osório;4314902;Porto Alegre;6;7;13;255
4311403;Lajeado;4314407;Pelotas;6;7;13;256
4312658;Não-Me-Toque;4314100;Passo Fundo;6;7;13;47
4310108;Igrejinha;4314050;Parobé;6;7;13;7
4303806;Campinas do Sul;4310900;Jacutinga;6;7;13;9
4300208;Ajuricaba;4310207;Ijuí;6;7;13;22
4306007;Crissiumal;4309605;Horizontina;6;7;13;25
4300109;Agudo;4308003;Faxinal do Soturno;6;7;13;21
4302352;Bom Princípio;4307906;Farroupilha;6;7;13;29
4305108;Caxias do Sul;4307005;Erechim;6;7;13;202
2611606;Recife;4305108;Caxias do Sul;6;7;13;2762
3170206;Uberlândia;4305108;Caxias do Sul;6;7;13;1168
3304557;Rio de Janeiro;4303103;Cachoeirinha;6;7;13;1074
4209300;Lages;4218707;Tubarão;6;7;13;147
4203006;Caçador;4209706;Lebon Régis;6;7;13;42
4205902;Gaspar;4209102;Joinville;6;7;13;73
4207502;Indaial;4209102;Joinville;6;7;13;78
4203006;Caçador;4209003;Joaçaba;6;7;13;59
4204608;Criciúma;4208203;Itajaí;6;7;13;201
4207007;Içara;4208203;Itajaí;6;7;13;205
1302603;Manaus;4205407;Florianópolis;6;7;13;2912
3550308;São Paulo;4201257;Apiúna;6;7;13;461
4119905;Ponta Grossa;4128203;União da Vitória;6;7;13;163
4108601;Goioerê;4128104;Umuarama;6;7;13;59
4108809;Guaíra;4128104;Umuarama;6;7;13;102
4104808;Cascavel;4125704;São Miguel do Iguaçu;6;7;13;91
4101804;Araucária;4125605;São Mateus do Sul;6;7;13;102
3550308;São Paulo;4124103;Santo Antônio da Platina;6;7;13;356
4111803;Jacarezinho;4121802;Ribeirão Claro;6;7;13;27
3304557;Rio de Janeiro;4119152;Pinhais;6;7;13;655
4115200;Maringá;4115804;Medianeira;6;7;13;299
2304400;Fortaleza;4115200;Maringá;6;7;13;2538
4106407;Cornélio Procópio;4115200;Maringá;6;7;13;132
4101804;Araucária;4109401;Guarapuava;6;7;13;208
4101408;Apucarana;4107603;Faxinal;6;7;13;52
2507507;João Pessoa;4106902;Curitiba;6;7;13;2447
3170107;Uberaba;4106902;Curitiba;6;7;13;645
3513801;Diadema;4106902;Curitiba;6;7;13;330
3515004;Embu;4106902;Curitiba;6;7;13;314
3556206;Valinhos;4106902;Curitiba;6;7;13;356
4104303;Campo Mourão;4105508;Cianorte;6;7;13;47
4104808;Cascavel;4105300;Céu Azul;6;7;13;45
4104808;Cascavel;4105003;Catanduvas;6;7;13;42
3534401;Osasco;3554003;Tatuí;6;7;13;110
3550308;São Paulo;3553500;Tapiraí;6;7;13;94
3534401;Osasco;3550605;São Roque;6;7;13;35
1100049;Cacoal;3550308;São Paulo;6;7;13;1990
3140001;Mariana;3550308;São Paulo;6;7;13;488
3140803;Matias Barbosa;3550308;São Paulo;6;7;13;391
3500550;Águas de Santa Bárbara;3550308;São Paulo;6;7;13;277
3516606;Gália;3550308;São Paulo;6;7;13;331
3521804;Itaí;3550308;São Paulo;6;7;13;250
3537909;Pilar do Sul;3550308;São Paulo;6;7;13;110
3545001;Salesópolis;3550308;São Paulo;6;7;13;83
3549409;São Joaquim da Barra;3550308;São Paulo;6;7;13;360
3522307;Itapetininga;3550209;São Miguel Arcanjo;6;7;13;33
2304400;Fortaleza;3549904;São José dos Campos;6;7;13;2266
3539301;Pirassununga;3549102;São João da Boa Vista;6;7;13;65
3519600;Ibitinga;3548906;São Carlos;6;7;13;102
2611606;Recife;3548807;São Caetano do Sul;6;7;13;2058
3501608;Americana;3548708;São Bernardo do Campo;6;7;13;133
1302603;Manaus;3547304;Santana de Parnaíba;6;7;13;2588
1501402;Belém;3547304;Santana de Parnaíba;6;7;13;2445
3504008;Assis;3546405;Santa Cruz do Rio Pardo;6;7;13;87
3538808;Piraju;3546405;Santa Cruz do Rio Pardo;6;7;13;41
3510401;Capivari;3545803;Santa Bárbara d'Oeste;6;7;13;28
3520509;Indaiatuba;3545803;Santa Bárbara d'Oeste;6;7;13;42
3304557;Rio de Janeiro;3545209;Salto;6;7;13;413
3541307;Presidente Epitácio;3541505;Presidente Venceslau;6;7;13;24
3531100;Mongaguá;3541000;Praia Grande;6;7;13;25
3515707;Ferraz de Vasconcelos;3539806;Poá;6;7;13;3
3512803;Cosmópolis;3538709;Piracicaba;6;7;13;48
3520442;Ilha Solteira;3537404;Pereira Barreto;6;7;13;33
3516408;Franco da Rocha;3534401;Osasco;6;7;13;24
3106200;Belo Horizonte;3530607;Moji das Cruzes;6;7;13;462
3502804;Araçatuba;3529005;Marília;6;7;13;122
3118601;Contagem;3525904;Jundiaí;6;7;13;460
3505203;Bariri;3525300;Jaú;6;7;13;28
3503802;Artur Nogueira;3524709;Jaguariúna;6;7;13;24
3505708;Barueri;3524402;Jacareí;6;7;13;97
3304557;Rio de Janeiro;3523909;Itu;6;7;13;415
3507506;Botucatu;3523503;Itatinga;6;7;13;31
3504107;Atibaia;3523404;Itatiba;6;7;13;32
3509502;Campinas;3522505;Itapevi;6;7;13;72
3502804;Araçatuba;3520442;Ilha Solteira;6;7;13;128
3505203;Bariri;3519600;Ibitinga;6;7;13;37
3503208;Araraquara;3519303;Ibaté;6;7;13;26
3117306;Conceição das Alagoas;3517406;Guaíra;6;7;13;45
3503802;Artur Nogueira;3515152;Engenheiro Coelho;6;7;13;10
2905701;Camaçari;3509502;Campinas;6;7;13;1425
3152501;Pouso Alegre;3509502;Campinas;6;7;13;136
3205309;Vitória;3509502;Campinas;6;7;13;746
3301702;Duque de Caxias;3509502;Campinas;6;7;13;384
3503208;Araraquara;3506003;Bauru;6;7;13;112
3201308;Cariacica;3505708;Barueri;6;7;13;743
3304201;Resende;3505708;Barueri;6;7;13;270
3305109;São João de Meriti;3505708;Barueri;6;7;13;365
3503307;Araras;3505708;Barueri;6;7;13;137
3106200;Belo Horizonte;3504107;Atibaia;6;7;13;441
3300704;Cabo Frio;3304904;São Gonçalo;6;7;13;103
3300258;Arraial do Cabo;3304557;Rio de Janeiro;6;7;13;127
3300605;Bom Jesus do Itabapoana;3304557;Rio de Janeiro;6;7;13;252
3304508;Rio das Flores;3304557;Rio de Janeiro;6;7;13;86
3303302;Niterói;3304201;Resende;6;7;13;145
3302270;Japeri;3303500;Nova Iguaçu;6;7;13;22
2304400;Fortaleza;3303302;Niterói;6;7;13;2161
3301702;Duque de Caxias;3301900;Itaboraí;6;7;13;47
3131307;Ipatinga;3205309;Vitória;6;7;13;249
3200805;Baixo Guandu;3205309;Vitória;6;7;13;107
3201407;Castelo;3205309;Vitória;6;7;13;107
3204559;Santa Maria de Jetibá;3204609;Santa Teresa;6;7;13;19
3204500;Santa Leopoldina;3204559;Santa Maria de Jetibá;6;7;13;24
3135100;Janaúba;3171030;Verdelândia;6;7;13;37
3148004;Patos de Minas;3171006;Vazante;6;7;13;81
3148004;Patos de Minas;3170750;Varjão de MInas;6;7;13;55
3104502;Arinos;3170404;Unaí;6;7;13;102
3136306;João Pinheiro;3170404;Unaí;6;7;13;168
3148004;Patos de Minas;3170404;Unaí;6;7;13;245
3148004;Patos de Minas;3170107;Uberaba;6;7;13;196
3104700;Ataléia;3168606;Teófilo Otoni;6;7;13;47
3133303;Itaobim;3168606;Teófilo Otoni;6;7;13;144
3106200;Belo Horizonte;3168309;Taquaraçu de Minas;6;7;13;40
3106705;Betim;3167202;Sete Lagoas;6;7;13;58
3134202;Ituiutaba;3159803;Santa Vitória;6;7;13;71
3122306;Divinópolis;3147907;Passos;6;7;13;191
3106200;Belo Horizonte;3147402;Paraopeba;6;7;13;83
3118304;Conselheiro Lafaiete;3136702;Juiz de Fora;6;7;13;131
3106200;Belo Horizonte;3135050;Jaíba;6;7;13;508
3104007;Araxá;3122306;Divinópolis;6;7;13;224
2922003;Mucuri;2931350;Teixeira de Freitas;6;7;13;51
2607901;Jaboatão dos Guararapes;2930709;Simões Filho;6;7;13;631
2914604;Irecê;2918407;Juazeiro;6;7;13;254
2915809;Itambé;2916401;Itapetinga;6;7;13;40
2900702;Alagoinhas;2910503;Entre Rios;6;7;13;42
2304400;Fortaleza;2905701;Camaçari;6;7;13;988
2611606;Recife;2905701;Camaçari;6;7;13;624
2304400;Fortaleza;2610707;Paulista;6;7;13;611
2601201;Arcoverde;2604106;Caruaru;6;7;13;120
2504009;Campina Grande;2506301;Guarabira;6;7;13;60
2404507;Guamaré;2408102;Natal;6;7;13;142
2401008;Apodi;2408003;Mossoró;6;7;13;87
2404408;Grossos;2408003;Mossoró;6;7;13;31
2307601;Limoeiro do Norte;2308708;Morada Nova;6;7;13;33
2307650;Maracanaú;2307700;Maranguape;6;7;13;6
2304400;Fortaleza;2305407;Icó;6;7;13;295
1504208;Marabá;2304400;Fortaleza;6;7;13;1188
2211001;Teresina;2304285;Eusébio;6;7;13;501
2201903;Bom Jesus;2211209;Uruçuí;6;7;13;204
2103307;Codó;2211001;Teresina;6;7;13;143
2208007;Picos;2210003;São João do Piauí;6;7;13;167
1501402;Belém;1502939;Dom Eliseu;6;7;13;338
1501709;Bragança;1502400;Castanhal;6;7;13;129
1100049;Cacoal;1302603;Manaus;6;7;13;932
1100205;Porto Velho;1100403;Alto Paraíso;6;7;13;122
1100155;Ouro Preto do Oeste;1100205;Porto Velho;6;7;13;278
2918001;Jequié;5300108;Brasília;5;8;13;866
3515004;Embu;5300108;Brasília;5;8;13;876
3524808;Jales;5300108;Brasília;5;8;13;571
4301602;Bagé;5300108;Brasília;5;8;13;1855
5003207;Corumbá;5300108;Brasília;5;8;13;1110
5006606;Ponta Porã;5300108;Brasília;5;8;13;1128
5221403;Trindade;5300108;Brasília;5;8;13;195
5103403;Cuiabá;5106505;Poconé;5;8;13;96
4314100;Passo Fundo;4322202;Tupanciretã;5;8;13;169
4313425;Novo Machado;4322103;Tucunduva;5;8;13;11
4316600;Sananduva;4320909;Tapejara;5;8;13;24
4315503;Restinga Seca;4319604;São Sepé;5;8;13;45
4315602;Rio Grande;4318705;São Leopoldo;5;8;13;277
4304606;Canoas;4318408;São Jerônimo;5;8;13;52
4303103;Cachoeirinha;4316808;Santa Cruz do Sul;5;8;13;130
2910800;Feira de Santana;4314902;Porto Alegre;5;8;13;2259
3205200;Vila Velha;4314902;Porto Alegre;5;8;13;1471
3552502;Suzano;4314902;Porto Alegre;5;8;13;854
4300802;Antônio Prado;4305108;Caxias do Sul;5;8;13;35
4300406;Alegrete;4301602;Bagé;5;8;13;232
3509502;Campinas;4208906;Jaraguá do Sul;5;8;13;444
4122305;Rio Negro;4208104;Itaiópolis;5;8;13;28
3548807;São Caetano do Sul;3552502;Suzano;5;8;13;27
3169901;Ubá;3550308;São Paulo;5;8;13;467
3304110;Porto Real;3550308;São Paulo;5;8;13;274
3508009;Buri;3550308;São Paulo;5;8;13;199
3522802;Itaporanga;3550308;São Paulo;5;8;13;290
3148004;Patos de Minas;3543907;Rio Claro;5;8;13;437
2905701;Camaçari;3534401;Osasco;5;8;13;1463
3205200;Vila Velha;3534401;Osasco;5;8;13;739
2927408;Salvador;3530607;Moji das Cruzes;5;8;13;1396
3505708;Barueri;3518701;Guarujá;5;8;13;79
3509007;Caieiras;3516309;Francisco Morato;5;8;13;12
3300456;Belford Roxo;3505708;Barueri;5;8;13;364
3303401;Nova Friburgo;3304904;São Gonçalo;5;8;13;74
2800605;Barra dos Coqueiros;3304557;Rio de Janeiro;5;8;13;1467
3201308;Cariacica;3301702;Duque de Caxias;5;8;13;403
2304400;Fortaleza;3205200;Vila Velha;5;8;13;1842
2927408;Salvador;3201209;Cachoeiro de Itapemirim;5;8;13;907
3120904;Curvelo;3151206;Pirapora;5;8;13;166
3106200;Belo Horizonte;3140506;Martinho Campos;5;8;13;147
2307007;Jaguaruana;2311801;Russas;5;8;13;24
1505536;Parauapebas;2105302;Imperatriz;5;8;13;273
2103307;Codó;2103604;Coroatá;5;8;13;42
2606002;Garanhuns;5300108;Brasília;4;9;13;1429
2918407;Juazeiro;5300108;Brasília;4;9;13;1051
3117876;Confins;5300108;Brasília;4;9;13;600
3143104;Monte Carmelo;5300108;Brasília;4;9;13;326
3170701;Varginha;5300108;Brasília;4;9;13;687
3201506;Colatina;5300108;Brasília;4;9;13;892
3534401;Osasco;5201405;Aparecida de Goiânia;4;9;13;791
3304904;São Gonçalo;4314902;Porto Alegre;4;9;13;1107
3550308;São Paulo;4306403;Dois Irmãos;4;9;13;779
3548807;São Caetano do Sul;4205407;Florianópolis;4;9;13;480
4105300;Céu Azul;4115804;Medianeira;4;9;13;30
3534401;Osasco;3554102;Taubaté;4;9;13;138
3534401;Osasco;3548906;São Carlos;4;9;13;203
3541000;Praia Grande;3548807;São Caetano do Sul;4;9;13;47
1721000;Palmas;3534401;Osasco;4;9;13;1466
3106705;Betim;3534401;Osasco;4;9;13;475
3127701;Governador Valadares;3534401;Osasco;4;9;13;712
3516200;Franca;3518800;Guarulhos;4;9;13;332
3106200;Belo Horizonte;3501608;Americana;4;9;13;464
2910727;Eunápolis;3205200;Vila Velha;4;9;13;447
3143302;Montes Claros;3154606;Ribeirão das Neves;4;9;13;337
3511102;Catanduva;5300108;Brasília;3;10;13;602
3541000;Praia Grande;5300108;Brasília;3;10;13;923
4218707;Tubarão;5300108;Brasília;3;10;13;1409
4316808;Santa Cruz do Sul;5300108;Brasília;3;10;13;1621
3547502;Santa Rita do Passa Quatro;3550902;São Simão;3;10;13;27
3301009;Campos dos Goytacazes;3548807;São Caetano do Sul;3;10;13;569
3518701;Guarujá;3548807;São Caetano do Sul;3;10;13;48
3538709;Piracicaba;3539301;Pirassununga;3;10;13;85
3556453;Vargem Grande Paulista;5002704;Campo Grande;2;11;13;878
3303500;Nova Iguaçu;4314902;Porto Alegre;2;11;13;1084
1302603;Manaus;4113700;Londrina;2;11;13;2396
3529005;Marília;3534401;Osasco;2;11;13;352
2507507;João Pessoa;2933307;Vitória da Conquista;2;11;13;1060
2704302;Maceió;2933307;Vitória da Conquista;2;11;13;793
3532207;Narandiba;4110904;Itaguajé;1;12;13;51
3545605;Santa Adélia;3547403;Santa Rita d'Oeste;1;12;13;245
3514924;Elisiário;3528858;Marapoama;1;12;13;10
2101400;Balsas;5300108;Brasília;6;6;12;939
2109106;Presidente Dutra;5300108;Brasília;6;6;12;1216
2304285;Eusébio;5300108;Brasília;6;6;12;1651
2909307;Correntina;5300108;Brasília;6;6;12;444
5200308;Alexânia;5300108;Brasília;6;6;12;69
5201108;Anápolis;5221601;Uruaçu;6;6;12;200
5201405;Aparecida de Goiânia;5221403;Trindade;6;6;12;31
3304557;Rio de Janeiro;5218805;Rio Verde;6;6;12;1000
4204004;Catanduvas;5218805;Rio Verde;6;6;12;1030
5201405;Aparecida de Goiânia;5218805;Rio Verde;6;6;12;208
5205406;Ceres;5218003;Porangatu;6;6;12;209
5208707;Goiânia;5217609;Planaltina;6;6;12;228
5205109;Catalão;5217401;Pires do Rio;6;6;12;104
5215306;Orizona;5217401;Pires do Rio;6;6;12;29
5208707;Goiânia;5217302;Pirenópolis;6;6;12;98
5208707;Goiânia;5215702;Palmeiras de Goiás;6;6;12;69
5211503;Itumbiara;5213806;Morrinhos;6;6;12;75
3170107;Uberaba;5211503;Itumbiara;6;6;12;206
5204508;Caldas Novas;5211503;Itumbiara;6;6;12;100
3170107;Uberaba;5208707;Goiânia;6;6;12;368
3205309;Vitória;5208707;Goiânia;6;6;12;1044
5107040;Primavera do Leste;5208707;Goiânia;6;6;12;554
5204508;Caldas Novas;5205109;Catalão;6;6;12;85
1302603;Manaus;5201405;Aparecida de Goiânia;6;6;12;1884
2611606;Recife;5201405;Aparecida de Goiânia;6;6;12;1782
5002704;Campo Grande;5201405;Aparecida de Goiânia;6;6;12;705
3106200;Belo Horizonte;5201108;Anápolis;6;6;12;667
5105259;Lucas do Rio Verde;5108402;Várzea Grande;6;6;12;288
5106232;Nova Olímpia;5107958;Tangará da Serra;6;6;12;29
5107925;Sorriso;5107958;Tangará da Serra;6;6;12;296
5100250;Alta Floresta;5107925;Sorriso;6;6;12;296
5105101;Juara;5107909;Sinop;6;6;12;229
5105580;Marcelândia;5107909;Sinop;6;6;12;146
2919553;Luís Eduardo magalhães;5107602;Rondonópolis;6;6;12;1052
3541406;Presidente Prudente;5107602;Rondonópolis;6;6;12;725
4108304;Foz do Iguaçu;5107602;Rondonópolis;6;6;12;1007
5103502;Diamantino;5107305;São José do Rio Claro;6;6;12;113
5103403;Cuiabá;5107065;Querência;6;6;12;531
5105622;Mirassol d'Oeste;5106752;Pontes e Lacerda;6;6;12;141
5101704;Barra do Bugres;5106232;Nova Olímpia;6;6;12;29
4118204;Paranaguá;5105259;Lucas do Rio Verde;6;6;12;1612
3550308;São Paulo;5105150;Juína;6;6;12;1921
5103254;Colniza;5105150;Juína;6;6;12;221
3550308;São Paulo;5105101;Juara;6;6;12;1836
5103403;Cuiabá;5105101;Juara;6;6;12;499
5007935;Sonora;5104609;Itiquira;6;6;12;78
2611606;Recife;5103403;Cuiabá;6;6;12;2385
3506003;Bauru;5103403;Cuiabá;6;6;12;1074
4118204;Paranaguá;5103403;Cuiabá;6;6;12;1388
3200607;Aracruz;5008305;Três Lagoas;6;6;12;1195
5001904;Bataguassu;5007554;Santa Rita do Pardo;6;6;12;61
5002704;Campo Grande;5007406;Rio Verde de Mato Grosso;6;6;12;168
5003702;Dourados;5005251;Laguna Carapã;6;6;12;51
5003454;Deodápolis;5004700;Ivinhema;6;6;12;38
3550308;São Paulo;5003256;Costa Rica;6;6;12;904
4108304;Foz do Iguaçu;5003207;Corumbá;6;6;12;792
1501402;Belém;5002704;Campo Grande;6;6;12;2197
3550308;São Paulo;5002100;Bela Vista;6;6;12;1043
4314076;Passo do Sobrado;4322525;Vale Verde;6;6;12;10
4209300;Lages;4322509;Vacaria;6;6;12;98
4208203;Itajaí;4322400;Uruguaiana;6;6;12;855
4316808;Santa Cruz do Sul;4322400;Uruguaiana;6;6;12;449
4305355;Charqueadas;4322004;Triunfo;6;6;12;9
4304630;Capão da Canoa;4321501;Torres;6;6;12;54
4305108;Caxias do Sul;4321501;Torres;6;6;12;134
4314159;Paverama;4321451;Teutônia;6;6;12;14
4314902;Porto Alegre;4321451;Teutônia;6;6;12;89
4314902;Porto Alegre;4321352;Tavares;6;6;12;137
4311403;Lajeado;4321303;Taquari;6;6;12;44
4318705;São Leopoldo;4321204;Taquara;6;6;12;37
4301404;Arvorezinha;4320800;Soledade;6;6;12;37
4314902;Porto Alegre;4320800;Soledade;6;6;12;189
4304903;Casca;4320404;Serafina Corrêa;6;6;12;17
4309407;Guaporé;4320404;Serafina Corrêa;6;6;12;15
4311809;Marau;4320404;Serafina Corrêa;6;6;12;39
4305306;Chapada;4320107;Sarandi;6;6;12;19
4314050;Parobé;4319901;Sapiranga;6;6;12;17
4316907;Santa Maria;4319604;São Sepé;6;6;12;57
4301651;Barão;4319356;São Pedro da Serra;6;6;12;5
4305207;Cerro Largo;4319307;São Paulo das Missões;6;6;12;25
4314902;Porto Alegre;4319000;São Marcos;6;6;12;121
4314902;Porto Alegre;4318903;São Luiz Gonzaga;6;6;12;414
4316600;Sananduva;4318424;São João da Urtiga;6;6;12;15
4300406;Alegrete;4318309;São Gabriel;6;6;12;153
4317103;Santana do Livramento;4318309;São Gabriel;6;6;12;129
4317400;Santiago;4318002;São Borja;6;6;12;127
3550308;São Paulo;4317202;Santa Rosa;6;6;12;888
4300406;Alegrete;4316907;Santa Maria;6;6;12;188
4310603;Itaqui;4316907;Santa Maria;6;6;12;268
4316402;Rosário do Sul;4316907;Santa Maria;6;6;12;126
4304630;Capão da Canoa;4316808;Santa Cruz do Sul;6;6;12;231
4314100;Passo Fundo;4316600;Sananduva;6;6;12;67
4314902;Porto Alegre;4316501;Salvador do Sul;6;6;12;75
4118204;Paranaguá;4315602;Rio Grande;6;6;12;793
4313409;Novo Hamburgo;4315602;Rio Grande;6;6;12;283
4314902;Porto Alegre;4315305;Quaraí;6;6;12;505
3201308;Cariacica;4314902;Porto Alegre;6;6;12;1473
4301008;Arroio do Meio;4314902;Porto Alegre;6;6;12;102
4302709;Butiá;4314902;Porto Alegre;6;6;12;74
4304671;Capivari do Sul;4314902;Porto Alegre;6;6;12;67
4307500;Espumoso;4314902;Porto Alegre;6;6;12;216
4309902;Ibiraiaras;4314902;Porto Alegre;6;6;12;191
4310801;Ivoti;4314902;Porto Alegre;6;6;12;51
4304507;Canguçu;4314605;Piratini;6;6;12;40
4115200;Maringá;4314100;Passo Fundo;6;6;12;536
4312906;Nova Bassano;4313300;Nova Prata;6;6;12;11
4306403;Dois Irmãos;4313201;Nova Petrópolis;6;6;12;23
4307906;Farroupilha;4313201;Nova Petrópolis;6;6;12;28
4204202;Chapecó;4312708;Nonoai;6;6;12;31
4302709;Butiá;4312252;Minas do Leão;6;6;12;8
4311403;Lajeado;4312054;Marques de Souza;6;6;12;13
4304200;Candelária;4311403;Lajeado;6;6;12;82
4304630;Capão da Canoa;4309209;Gravataí;6;6;12;93
4305108;Caxias do Sul;4309209;Gravataí;6;6;12;88
4201406;Araranguá;4307906;Farroupilha;6;6;12;182
4106902;Curitiba;4307708;Esteio;6;6;12;520
3550308;São Paulo;4306767;Eldorado do Sul;6;6;12;851
3525904;Jundiaí;4305108;Caxias do Sul;6;6;12;776
4115200;Maringá;4305108;Caxias do Sul;6;6;12;639
4216602;São José;4305108;Caxias do Sul;6;6;12;297
4216602;São José;4304606;Canoas;6;6;12;352
4106902;Curitiba;4303905;Campo Bom;6;6;12;499
4300851;Arambaré;4303509;Camaquã;6;6;12;29
4125506;São José dos Pinhais;4303103;Cachoeirinha;6;6;12;522
4200101;Abelardo Luz;4219507;Xanxerê;6;6;12;34
4205308;Faxinal dos Guedes;4219507;Xanxerê;6;6;12;15
4213401;Ponte Serrada;4219507;Xanxerê;6;6;12;39
4211702;Orleans;4219002;Urussanga;6;6;12;21
4202404;Blumenau;4218707;Tubarão;6;6;12;170
4200200;Agrolândia;4218608;Trombudo Central;6;6;12;12
4209003;Joaçaba;4218509;Treze Tílias;6;6;12;21
4213203;Pomerode;4218202;Timbó;6;6;12;15
4203709;Canelinha;4218004;Tijucas;6;6;12;15
4208203;Itajaí;4218004;Tijucas;6;6;12;35
4211504;Nova Trento;4218004;Tijucas;6;6;12;30
4203709;Canelinha;4216305;São João Batista;6;6;12;6
4208401;Itapiranga;4216255;São João do Oeste;6;6;12;14
3505708;Barueri;4216206;São Francisco do Sul;6;6;12;353
3548500;Santos;4216206;São Francisco do Sul;6;6;12;348
4201703;Ascurra;4215109;Rodeio;6;6;12;5
4210100;Mafra;4215000;Rio Negrinho;6;6;12;34
4204202;Chapecó;4214805;Rio do Sul;6;6;12;299
4208906;Jaraguá do Sul;4214805;Rio do Sul;6;6;12;99
4213203;Pomerode;4214706;Rio dos Cedros;6;6;12;10
4203907;Capinzal;4213104;Piratuba;6;6;12;18
4211306;Navegantes;4212809;Piçarras;6;6;12;14
4208203;Itajaí;4211900;Palhoça;6;6;12;78
4204558;Correia Pinto;4211751;Otacílio Costa;6;6;12;26
4202909;Brusque;4211504;Nova Trento;6;6;12;22
4207007;Içara;4211207;Morro da Fumaça;6;6;12;11
4209300;Lages;4210100;Mafra;6;6;12;191
3518800;Guarulhos;4209300;Lages;6;6;12;606
2611606;Recife;4209102;Joinville;6;6;12;2405
3205309;Vitória;4209102;Joinville;6;6;12;1069
4119152;Pinhais;4209102;Joinville;6;6;12;98
4203006;Caçador;4209102;Joinville;6;6;12;230
4205407;Florianópolis;4209003;Joaçaba;6;6;12;305
4207502;Indaial;4208906;Jaraguá do Sul;6;6;12;49
2304400;Fortaleza;4208203;Itajaí;6;6;12;2737
3118601;Contagem;4208203;Itajaí;6;6;12;899
3522505;Itapevi;4208203;Itajaí;6;6;12;416
4113700;Londrina;4208203;Itajaí;6;6;12;467
4119152;Pinhais;4208203;Itajaí;6;6;12;171
4207106;Ilhota;4208203;Itajaí;6;6;12;9
2611606;Recife;4205407;Florianópolis;6;6;12;2500
4204202;Chapecó;4204608;Criciúma;6;6;12;358
3518800;Guarulhos;4204301;Concórdia;6;6;12;677
4125605;São Mateus do Sul;4203808;Canoinhas;6;6;12;41
4104204;Campo Largo;4203303;Campo Alegre;6;6;12;85
4106407;Cornélio Procópio;4128401;Uraí;6;6;12;14
4100509;Altônia;4128104;Umuarama;6;6;12;60
4101804;Araucária;4128104;Umuarama;6;6;12;451
4117909;Palotina;4128104;Umuarama;6;6;12;80
4125506;São José dos Pinhais;4127601;Tijucas do Sul;6;6;12;43
4113700;Londrina;4127106;Telêmaco Borba;6;6;12;128
4105508;Cianorte;4126801;Tapejara;6;6;12;29
4108304;Foz do Iguaçu;4125704;São Miguel do Iguaçu;6;6;12;31
3118601;Contagem;4125506;São José dos Pinhais;6;6;12;799
4100509;Altônia;4125357;São Jorge do Patrocínio;6;6;12;16
4106407;Cornélio Procópio;4124103;Santo Antônio da Platina;6;6;12;58
4117800;Palmital;4123857;Santa Maria do Oeste;6;6;12;35
4113700;Londrina;4122701;Sabáudia;6;6;12;41
4111258;Itaperuçu;4122206;Rio Branco do Sul;6;6;12;6
4115200;Maringá;4120408;Presidente Castelo Branco;6;6;12;28
4110102;Imbituva;4119905;Ponta Grossa;6;6;12;46
4117800;Palmital;4119608;Pitanga;6;6;12;47
3550308;São Paulo;4119509;Piraquara;6;6;12;312
4113700;Londrina;4119152;Pinhais;6;6;12;308
4100509;Altônia;4118907;Pérola;6;6;12;22
4104303;Campo Mourão;4118402;Paranavaí;6;6;12;105
4113700;Londrina;4118204;Paranaguá;6;6;12;362
4116208;Morretes;4118204;Paranaguá;6;6;12;30
4108403;Francisco Beltrão;4117602;Palmas;6;6;12;117
3504008;Assis;4115200;Maringá;6;6;12;173
3506003;Bauru;4115200;Maringá;6;6;12;314
4107900;Floresta;4115200;Maringá;6;6;12;24
4109807;Ibiporã;4115200;Maringá;6;6;12;92
3550308;São Paulo;4114609;Marechal Cândido Rondon;6;6;12;755
4107652;Fazenda Rio Grande;4114302;Mandirituba;6;6;12;14
4109708;Ibaiti;4113700;Londrina;6;6;12;117
4112702;Jataizinho;4113700;Londrina;6;6;12;18
4108205;Formosa do Oeste;4112751;Jesuítas;6;6;12;13
4104907;Castro;4112009;Jaguariaíva;6;6;12;67
4106902;Curitiba;4111506;Ivaiporã;6;6;12;280
4109401;Guarapuava;4111506;Ivaiporã;6;6;12;130
4110102;Imbituva;4110706;Irati;6;6;12;28
4108304;Foz do Iguaçu;4109401;Guarapuava;6;6;12;306
4104808;Cascavel;4108601;Goioerê;6;6;12;94
3518800;Guarulhos;4108304;Foz do Iguaçu;6;6;12;824
4101804;Araucária;4107652;Fazenda Rio Grande;6;6;12;12
3201308;Cariacica;4106902;Curitiba;6;6;12;1045
3504107;Atibaia;4106902;Curitiba;6;6;12;375
3522505;Itapevi;4106902;Curitiba;6;6;12;314
3523206;Itararé;4106902;Curitiba;6;6;12;148
3543907;Rio Claro;4106902;Curitiba;6;6;12;377
3552403;Sumaré;4106902;Curitiba;6;6;12;353
3552502;Suzano;4106902;Curitiba;6;6;12;364
4102406;Bandeirantes;4106407;Cornélio Procópio;6;6;12;31
3549805;São José do Rio Preto;4105508;Cianorte;6;6;12;451
4101606;Arapoti;4104907;Castro;6;6;12;73
3170206;Uberlândia;4104808;Cascavel;6;6;12;843
3550308;São Paulo;4102604;Barracão;6;6;12;747
4101101;Andirá;4102406;Bandeirantes;6;6;12;16
3505708;Barueri;4101804;Araucária;6;6;12;341
3509502;Campinas;3557006;Votorantim;6;6;12;77
3549706;São José do Rio Pardo;3556404;Vargem Grande do Sul;6;6;12;26
3550803;São Sebastião da Grama;3556404;Vargem Grande do Sul;6;6;12;15
3530102;Mirandópolis;3556305;Valparaíso;6;6;12;26
3519071;Hortolândia;3556206;Valinhos;6;6;12;26
3548708;São Bernardo do Campo;3556206;Valinhos;6;6;12;93
3534609;Osvaldo Cruz;3555000;Tupã;6;6;12;38
3541406;Presidente Prudente;3555000;Tupã;6;6;12;90
3523909;Itu;3554508;Tietê;6;6;12;47
3541406;Presidente Prudente;3554300;Teodoro Sampaio;6;6;12;93
3550308;São Paulo;3554300;Teodoro Sampaio;6;6;12;585
3106705;Betim;3554102;Taubaté;6;6;12;365
3509700;Campos do Jordão;3554102;Taubaté;6;6;12;31
3547809;Santo André;3554102;Taubaté;6;6;12;121
3511607;Cesário Lange;3554003;Tatuí;6;6;12;17
3531308;Monte Alto;3553708;Taquaritinga;6;6;12;19
3128709;Guaxupé;3553609;Tapiratiba;6;6;12;18
3515400;Fartura;3553005;Taguaí;6;6;12;13
3106200;Belo Horizonte;3552809;Taboão da Serra;6;6;12;497
3522505;Itapevi;3552809;Taboão da Serra;6;6;12;18
3543402;Ribeirão Preto;3552809;Taboão da Serra;6;6;12;289
3503901;Arujá;3552502;Suzano;6;6;12;17
3505708;Barueri;3552502;Suzano;6;6;12;58
2611606;Recife;3552205;Sorocaba;6;6;12;2100
3528403;Mairinque;3552205;Sorocaba;6;6;12;33
3500501;Águas de Lindóia;3551603;Serra Negra;6;6;12;17
3509403;Cajuru;3551504;Serrana;6;6;12;31
3548708;São Bernardo do Campo;3551009;São Vicente;6;6;12;30
3550308;São Paulo;3550407;São Pedro;6;6;12;179
1506138;Redenção;3550308;São Paulo;6;6;12;1762
2304285;Eusébio;3550308;São Paulo;6;6;12;2327
2612505;Santa Cruz do Capibaribe;3550308;São Paulo;6;6;12;2015
2910057;Dias d'Ávila;3550308;São Paulo;6;6;12;1474
3104205;Arcos;3550308;São Paulo;6;6;12;388
3111200;Campo Belo;3550308;São Paulo;6;6;12;336
3127107;Frutal;3550308;São Paulo;6;6;12;457
3129509;Ibiá;3550308;São Paulo;6;6;12;466
3304003;Piraí;3550308;São Paulo;6;6;12;302
3505203;Bariri;3550308;São Paulo;6;6;12;275
3506300;Bernardino de Campos;3550308;São Paulo;6;6;12;296
3514908;Elias Fausto;3550308;São Paulo;6;6;12;100
3539004;Pirangi;3550308;São Paulo;6;6;12;349
3544004;Rio das Pedras;3550308;São Paulo;6;6;12;132
3544301;Roseira;3550308;São Paulo;6;6;12;160
3526803;Lençóis Paulista;3550100;São Manuel;6;6;12;29
3304201;Resende;3549904;São José dos Campos;6;6;12;165
3547304;Santana de Parnaíba;3549904;São José dos Campos;6;6;12;109
3533908;Olímpia;3549805;São José do Rio Preto;6;6;12;52
3540804;Potirendaba;3549805;São José do Rio Preto;6;6;12;24
3548500;Santos;3549805;São José do Rio Preto;6;6;12;467
3508702;Caconde;3549706;São José do Rio Pardo;6;6;12;26
3510807;Casa Branca;3549706;São José do Rio Pardo;6;6;12;28
3543402;Ribeirão Preto;3549409;São Joaquim da Barra;6;6;12;62
3525904;Jundiaí;3548500;Santos;6;6;12;97
3509700;Campos do Jordão;3548203;Santo Antônio do Pinhal;6;6;12;15
3102605;Andradas;3548104;Santo Antônio do Jardim;6;6;12;13
3530805;Moji-Mirim;3548005;Santo Antônio de Posse;6;6;12;20
3205002;Serra;3547304;Santana de Parnaíba;6;6;12;762
3543402;Ribeirão Preto;3547304;Santana de Parnaíba;6;6;12;269
3538709;Piracicaba;3547007;Santa Maria da Serra;6;6;12;57
3503901;Arujá;3546801;Santa Isabel;6;6;12;13
3524808;Jales;3546603;Santa Fé do Sul;6;6;12;45
3510401;Capivari;3544004;Rio das Pedras;6;6;12;20
3526704;Leme;3543402;Ribeirão Preto;6;6;12;122
3516200;Franca;3542701;Restinga;6;6;12;11
3541307;Presidente Epitácio;3541406;Presidente Prudente;6;6;12;83
3514601;Dumont;3540903;Pradópolis;6;6;12;17
3503208;Araraquara;3540705;Porto Ferreira;6;6;12;72
3513702;Descalvado;3540705;Porto Ferreira;6;6;12;15
3118601;Contagem;3538709;Piracicaba;6;6;12;479
3526407;Laranjal Paulista;3537503;Pereiras;6;6;12;15
3509502;Campinas;3537107;Pedreira;6;6;12;24
3106705;Betim;3536505;Paulínia;6;6;12;433
3501608;Americana;3536505;Paulínia;6;6;12;19
3512803;Cosmópolis;3536505;Paulínia;6;6;12;13
3514403;Dracena;3535408;Panorama;6;6;12;34
3170107;Uberaba;3534302;Orlândia;6;6;12;108
3505906;Batatais;3534302;Orlândia;6;6;12;34
3526902;Limeira;3530805;Moji-Mirim;6;6;12;46
3518305;Guararema;3530607;Moji das Cruzes;6;6;12;21
3525706;José Bonifácio;3530300;Mirassol;6;6;12;31
3304557;Rio de Janeiro;3527207;Lorena;6;6;12;188
3514403;Dracena;3526001;Junqueirópolis;6;6;12;12
2602902;Cabo de Santo Agostinho;3525904;Jundiaí;6;6;12;2021
3514106;Dois Córregos;3525300;Jaú;6;6;12;22
3509254;Cajati;3524600;Jacupiranga;6;6;12;13
3506102;Bebedouro;3524303;Jaboticabal;6;6;12;43
3514908;Elias Fausto;3520509;Indaiatuba;6;6;12;15
3518800;Guarulhos;3520509;Indaiatuba;6;6;12;79
3510500;Caraguatatuba;3520400;Ilhabela;6;6;12;21
2211001;Teresina;3518800;Guarulhos;6;6;12;2063
2602902;Cabo de Santo Agostinho;3518800;Guarulhos;6;6;12;2023
2919207;Lauro de Freitas;3518800;Guarulhos;6;6;12;1425
3136702;Juiz de Fora;3518800;Guarulhos;6;6;12;377
3304201;Resende;3518800;Guarulhos;6;6;12;238
3510609;Carapicuíba;3518800;Guarulhos;6;6;12;30
3513504;Cubatão;3518701;Guarujá;6;6;12;17
3508603;Cachoeira Paulista;3518404;Guaratinguetá;6;6;12;24
3516200;Franca;3517406;Guaíra;6;6;12;98
3145208;Nova Serrana;3516200;Franca;6;6;12;263
3164704;São Sebastião do Paraíso;3516200;Franca;6;6;12;61
3506508;Birigui;3516200;Franca;6;6;12;319
3101409;Albertina;3515186;Espírito Santo do Pinhal;6;6;12;13
3505708;Barueri;3515004;Embu;6;6;12;15
3304557;Rio de Janeiro;3513405;Cruzeiro;6;6;12;178
3509502;Campinas;3513009;Cotia;6;6;12;79
1721000;Palmas;3509502;Campinas;6;6;12;1394
2607901;Jaboatão dos Guararapes;3509502;Campinas;6;6;12;2021
3509007;Caieiras;3509205;Cajamar;6;6;12;14
3505708;Barueri;3509007;Caieiras;6;6;12;21
3304557;Rio de Janeiro;3508504;Caçapava;6;6;12;251
3304557;Rio de Janeiro;3507506;Botucatu;6;6;12;531
3503208;Araraquara;3507506;Botucatu;6;6;12;124
3505302;Barra Bonita;3506003;Bauru;6;6;12;57
2611101;Petrolina;3505708;Barueri;6;6;12;1691
3167202;Sete Lagoas;3505708;Barueri;6;6;12;524
3501608;Americana;3503307;Araras;6;6;12;42
3300704;Cabo Frio;3305802;Teresópolis;6;6;12;109
3302007;Itaguaí;3305554;Seropédica;6;6;12;13
3300209;Araruama;3304904;São Gonçalo;6;6;12;75
3302403;Macaé;3304904;São Gonçalo;6;6;12;129
3301009;Campos dos Goytacazes;3304805;São Fidélis;6;6;12;47
2207702;Parnaíba;3304557;Rio de Janeiro;6;6;12;2217
2307650;Maracanaú;3304557;Rio de Janeiro;6;6;12;2152
2929503;São Sebastião do Passé;3304557;Rio de Janeiro;6;6;12;1242
3104007;Araxá;3304557;Rio de Janeiro;6;6;12;522
3135407;Jeceaba;3304557;Rio de Janeiro;6;6;12;270
3136207;João Monlevade;3304557;Rio de Janeiro;6;6;12;340
3138203;Lavras;3304557;Rio de Janeiro;6;6;12;255
3138401;Leopoldina;3304557;Rio de Janeiro;6;6;12;160
3148004;Patos de Minas;3304557;Rio de Janeiro;6;6;12;578
3202405;Guarapari;3304557;Rio de Janeiro;6;6;12;370
3303609;Paracambi;3304557;Rio de Janeiro;6;6;12;56
3303401;Nova Friburgo;3304524;Rio das Ostras;6;6;12;67
3300209;Araruama;3304300;Rio Bonito;6;6;12;35
3301702;Duque de Caxias;3304201;Resende;6;6;12;120
3300308;Barra do Piraí;3304003;Piraí;6;6;12;19
3302007;Itaguaí;3303609;Paracambi;6;6;12;26
3301009;Campos dos Goytacazes;3303401;Nova Friburgo;6;6;12;141
3205309;Vitória;3303302;Niterói;6;6;12;407
3300233;Armação dos Búzios;3303302;Niterói;6;6;12;123
3300100;Angra dos Reis;3302601;Mangaratiba;6;6;12;26
3300209;Araruama;3302403;Macaé;6;6;12;75
3302205;Itaperuna;3302304;Laje do Muriaé;6;6;12;25
2304400;Fortaleza;3301702;Duque de Caxias;6;6;12;2153
3300100;Angra dos Reis;3301702;Duque de Caxias;6;6;12;101
3118601;Contagem;3205309;Vitória;6;6;12;396
3170206;Uberlândia;3205200;Vila Velha;6;6;12;837
3201407;Castelo;3205069;Venda Nova do Imigrante;6;6;12;32
3201704;Conceição do Castelo;3205069;Venda Nova do Imigrante;6;6;12;12
2922003;Mucuri;3205002;Serra;6;6;12;249
2931350;Teixeira de Freitas;3205002;Serra;6;6;12;292
3127701;Governador Valadares;3205002;Serra;6;6;12;228
3202207;Fundão;3205002;Serra;6;6;12;24
3202405;Guarapari;3204203;Piúma;6;6;12;28
3200607;Aracruz;3203130;João Neiva;6;6;12;15
3103405;Araçuaí;3171600;Virgem da Lapa;6;6;12;34
3111200;Campo Belo;3170701;Varginha;6;6;12;69
3147204;Paraguaçu;3170701;Varginha;6;6;12;35
3106200;Belo Horizonte;3170404;Unaí;6;6;12;501
2111300;São Luís;3170206;Uberlândia;6;6;12;1857
2607901;Jaboatão dos Guararapes;3170206;Uberlândia;6;6;12;1809
2903201;Barreiras;3170206;Uberlândia;6;6;12;814
2933307;Vitória da Conquista;3170206;Uberlândia;6;6;12;893
3147006;Paracatu;3170206;Uberlândia;6;6;12;232
3118700;Coqueiral;3169406;Três Pontas;6;6;12;21
3162005;São Gonçalo do Sapucaí;3169307;Três Corações;6;6;12;46
3103405;Araçuaí;3168606;Teófilo Otoni;6;6;12;121
3145307;Novo Cruzeiro;3168606;Teófilo Otoni;6;6;12;58
3162708;São João do Paraíso;3168002;Taiobeiras;6;6;12;59
3141108;Matozinhos;3167202;Sete Lagoas;6;6;12;21
3104908;Baependi;3165206;São Thomé das Letras;6;6;12;27
3133006;Itamonte;3163706;São Lourenço;6;6;12;24
3133105;Itanhandu;3163706;São Lourenço;6;6;12;21
3152501;Pouso Alegre;3163706;São Lourenço;6;6;12;96
3106903;Bicas;3162906;São João Nepomuceno;6;6;12;20
3105905;Barroso;3162500;São João del Rei;6;6;12;34
3145604;Oliveira;3161205;São Francisco de Paula;6;6;12;13
3136207;João Monlevade;3161007;São Domingos do Prata;6;6;12;22
3106200;Belo Horizonte;3158003;Santa Maria de Itabira;6;6;12;104
3104007;Araxá;3157708;Santa Juliana;6;6;12;68
3118601;Contagem;3156700;Sabará;6;6;12;28
3118403;Conselheiro Pena;3154309;Resplendor;6;6;12;34
3148004;Patos de Minas;3153400;Presidente Olegário;6;6;12;20
3136702;Juiz de Fora;3152501;Pouso Alegre;6;6;12;274
3111002;Campestre;3151800;Poços de Caldas;6;6;12;32
3139003;Machado;3151701;Poço Fundo;6;6;12;13
3128006;Guanhães;3148608;Peçanha;6;6;12;45
3126109;Formiga;3147907;Passos;6;6;12;128
3113305;Carangola;3143906;Muriaé;6;6;12;49
3142106;Miradouro;3143906;Muriaé;6;6;12;21
3106705;Betim;3143302;Montes Claros;6;6;12;359
3115300;Cataguases;3142205;Miraí;6;6;12;21
3106200;Belo Horizonte;3139409;Manhuaçu;6;6;12;203
3113305;Carangola;3139409;Manhuaçu;6;6;12;55
3135209;Januária;3139300;Manga;6;6;12;90
3136702;Juiz de Fora;3138203;Lavras;6;6;12;183
3104205;Arcos;3137205;Lagoa da Prata;6;6;12;31
3107406;Bom Despacho;3137205;Lagoa da Prata;6;6;12;43
3127701;Governador Valadares;3133204;Itanhomi;6;6;12;42
3131307;Ipatinga;3131703;Itabira;6;6;12;76
3128006;Guanhães;3131307;Ipatinga;6;6;12;90
3131158;Ipaba;3131307;Ipatinga;6;6;12;14
3127008;Fronteira;3127107;Frutal;6;6;12;29
3120904;Curvelo;3121605;Diamantina;6;6;12;109
1302603;Manaus;3118601;Contagem;6;6;12;2462
3109006;Brumadinho;3118601;Contagem;6;6;12;28
3114402;Carmo do Rio Claro;3117108;Conceição da Aparecida;6;6;12;16
3111200;Campo Belo;3112000;Candeias;6;6;12;14
2607901;Jaboatão dos Guararapes;3106705;Betim;6;6;12;1608
1200401;Rio Branco;3106200;Belo Horizonte;6;6;12;2674
2504009;Campina Grande;3106200;Belo Horizonte;6;6;12;1627
2905701;Camaçari;3106200;Belo Horizonte;6;6;12;986
2931350;Teixeira de Freitas;3106200;Belo Horizonte;6;6;12;514
3105608;Barbacena;3105905;Barroso;6;6;12;19
2901205;Anagé;2933307;Vitória da Conquista;6;6;12;39
2903904;Bom Jesus da Lapa;2933307;Vitória da Conquista;6;6;12;323
2910727;Eunápolis;2933307;Vitória da Conquista;6;6;12;214
2930709;Simões Filho;2933307;Vitória da Conquista;6;6;12;348
2913606;Ilhéus;2932507;Una;6;6;12;55
2918407;Juazeiro;2930774;Sobradinho;6;6;12;34
2901353;Andorinha;2930105;Senhor do Bonfim;6;6;12;41
2906006;Campo Formoso;2930105;Senhor do Bonfim;6;6;12;15
2910800;Feira de Santana;2930105;Senhor do Bonfim;6;6;12;245
2919306;Lençóis;2929909;Seabra;6;6;12;42
2906501;Candeias;2929503;São Sebastião do Passé;6;6;12;18
1721000;Palmas;2927408;Salvador;6;6;12;1108
2408003;Mossoró;2927408;Salvador;6;6;12;872
2910602;Esplanada;2927408;Salvador;6;6;12;142
2925006;Planalto;2925105;Poções;6;6;12;26
2906808;Cansanção;2921500;Monte Santo;6;6;12;31
2905701;Camaçari;2921005;Mata de São João;6;6;12;18
2917607;Jaguaquara;2920502;Maracás;6;6;12;50
2914604;Irecê;2919157;Lapão;6;6;12;5
2909901;Curaçá;2918407;Juazeiro;6;6;12;87
2914604;Irecê;2917508;Jacobina;6;6;12;151
2906808;Cansanção;2917003;Itiúba;6;6;12;34
2910727;Eunápolis;2915601;Itamaraju;6;6;12;74
2903201;Barreiras;2914604;Irecê;6;6;12;354
2805505;Poço Verde;2911857;Heliópolis;6;6;12;16
2704302;Maceió;2910800;Feira de Santana;6;6;12;455
2908200;Conceição da Feira;2910800;Feira de Santana;6;6;12;24
2908507;Conceição do Jacuípe;2908903;Coração de Maria;6;6;12;12
2800308;Aracaju;2807600;Umbaúba;6;6;12;82
2800308;Aracaju;2803005;Itabaianinha;6;6;12;87
2704302;Maceió;2707305;Porto Calvo;6;6;12;76
2702306;Coruripe;2704302;Maceió;6;6;12;71
2600104;Afogados da Ingazeira;2614600;Tabira;6;6;12;23
2601201;Arcoverde;2614105;Sertânia;6;6;12;52
2604106;Caruaru;2613107;São Caitano;6;6;12;17
2608800;Lajedo;2613008;São Bento do Una;6;6;12;17
2611101;Petrolina;2612604;Santa Maria da Boa Vista;6;6;12;98
2605202;Escada;2611804;Ribeirão;6;6;12;24
2510808;Patos;2611606;Recife;6;6;12;285
2607901;Jaboatão dos Guararapes;2611101;Petrolina;6;6;12;617
2608750;Lagoa Grande;2611101;Petrolina;6;6;12;45
2604106;Caruaru;2610905;Pesqueira;6;6;12;82
2607208;Ipojuca;2607901;Jaboatão dos Guararapes;6;6;12;31
2503209;Cabedelo;2607208;Ipojuca;6;6;12;151
2601904;Bezerros;2606408;Gravatá;6;6;12;26
2602605;Brejo da Madre de Deus;2604106;Caruaru;6;6;12;44
2510808;Patos;2516201;Sousa;6;6;12;114
2506301;Guarabira;2516003;Solânea;6;6;12;25
2503704;Cajazeiras;2514503;São José de Piranhas;6;6;12;27
2508901;Mamanguape;2512903;Rio Tinto;6;6;12;13
2304400;Fortaleza;2510808;Patos;6;6;12;386
2402006;Caicó;2510808;Patos;6;6;12;65
2506905;Itabaiana;2507507;João Pessoa;6;6;12;53
2501302;Aroeiras;2504009;Campina Grande;6;6;12;43
2500700;São João do Rio do Peixe;2503704;Cajazeiras;6;6;12;24
2407104;Macaíba;2412005;São Gonçalo do Amarante;6;6;12;8
2401008;Apodi;2409407;Pau dos Ferros;6;6;12;55
2407807;Monte Alegre;2408102;Natal;6;6;12;29
2403103;Currais Novos;2408003;Mossoró;6;6;12;151
2305506;Iguatu;2314003;Várzea Alegre;6;6;12;49
2304400;Fortaleza;2313401;Tianguá;6;6;12;273
2305506;Iguatu;2313302;Tauá;6;6;12;117
2306405;Itapipoca;2312908;Sobral;6;6;12;89
2304400;Fortaleza;2312700;Senador Pompeu;6;6;12;222
2301109;Aracati;2311801;Russas;6;6;12;47
2304400;Fortaleza;2307007;Jaguaruana;6;6;12;145
2300309;Acopiara;2305506;Iguatu;6;6;12;33
2112209;Timon;2304400;Fortaleza;6;6;12;503
2208007;Picos;2304400;Fortaleza;6;6;12;491
2300200;Acaraú;2304400;Fortaleza;6;6;12;197
2302602;Camocim;2304400;Fortaleza;6;6;12;277
2302800;Canindé;2304400;Fortaleza;6;6;12;108
2200400;Altos;2208403;Piripiri;6;6;12;114
2207702;Parnaíba;2208403;Piripiri;6;6;12;155
2205201;Jaicós;2208007;Picos;6;6;12;46
2101509;Barão de Grajaú;2203909;Floriano;6;6;12;11
1505536;Parauapebas;2111300;São Luís;6;6;12;734
2101202;Bacabal;2105708;Lago da Pedra;6;6;12;61
2105302;Imperatriz;2105500;João Lisboa;6;6;12;8
2101400;Balsas;2105302;Imperatriz;6;6;12;268
2102325;Buriticupu;2105302;Imperatriz;6;6;12;173
2103000;Caxias;2103406;Coelho Neto;6;6;12;73
1713205;Miracema do Tocantins;1713304;Miranorte;6;6;12;21
1707009;Dianópolis;1709500;Gurupi;6;6;12;239
1302603;Manaus;1600600;Santana;6;6;12;1044
1500503;Almeirim;1600279;Laranjal do Jari;6;6;12;76
1507300;São Félix do Xingu;1508084;Tucumã;6;6;12;84
1506138;Redenção;1507300;São Félix do Xingu;6;6;12;258
1504208;Marabá;1507151;São Domingos do Araguaia;6;6;12;44
1502400;Castanhal;1506500;Santa Isabel do Pará;6;6;12;28
1505437;Ourilândia do Norte;1506138;Redenção;6;6;12;183
1502939;Dom Eliseu;1505502;Paragominas;6;6;12;146
1503606;Itaituba;1505031;Novo Progresso;6;6;12;329
1400100;Boa Vista;1400308;Mucajaí;6;6;12;55
1200203;Cruzeiro do Sul;1200609;Tarauacá;6;6;12;215
1200401;Rio Branco;1200500;Sena Madureira;6;6;12;137
1100320;São Miguel do Guaporé;1101500;Seringueiras;6;6;12;34
1100304;Vilhena;1100924;Chupinguaia;6;6;12;85
1100049;Cacoal;1100189;Pimenta Bueno;6;6;12;39
1100098;Espigão d'Oeste;1100189;Pimenta Bueno;6;6;12;30
1100106;Guajará-Mirim;1100189;Pimenta Bueno;6;6;12;454
1100106;Guajará-Mirim;1100114;Jaru;6;6;12;301
1100049;Cacoal;1100106;Guajará-Mirim;6;6;12;428
1100049;Cacoal;1100098;Espigão d'Oeste;6;6;12;49
1100056;Cerejeiras;1100064;Colorado do Oeste;6;6;12;34
1100023;Ariquemes;5300108;Brasília;5;7;12;1724
1506138;Redenção;5300108;Brasília;5;7;12;890
2203909;Floriano;5300108;Brasília;5;7;12;1122
2208007;Picos;5300108;Brasília;5;7;12;1181
2600054;Abreu e Lima;5300108;Brasília;5;7;12;1628
2804805;Nossa Senhora do Socorro;5300108;Brasília;5;7;12;1268
3103504;Araguari;5300108;Brasília;5;7;12;315
3301900;Itaboraí;5300108;Brasília;5;7;12;946
3522208;Itapecerica da Serra;5300108;Brasília;5;7;12;883
3545209;Salto;5300108;Brasília;5;7;12;821
3554003;Tatuí;5300108;Brasília;5;7;12;834
4103701;Cambé;5300108;Brasília;5;7;12;906
5208608;Goianésia;5300108;Brasília;5;7;12;139
4106902;Curitiba;5218805;Rio Verde;5;7;12;865
5107248;Santa Carmem;5107909;Sinop;5;7;12;30
5105259;Lucas do Rio Verde;5107602;Rondonópolis;5;7;12;394
3550308;São Paulo;5103502;Diamantino;5;7;12;1490
1721000;Palmas;5103403;Cuiabá;5;7;12;1002
2304400;Fortaleza;5103403;Cuiabá;5;7;12;2261
3550308;São Paulo;5102637;Campo Novo do Parecis;5;7;12;1668
3543402;Ribeirão Preto;5002704;Campo Grande;5;7;12;722
4104808;Cascavel;5002704;Campo Grande;5;7;12;516
4304606;Canoas;4322608;Venâncio Aires;5;7;12;104
4316907;Santa Maria;4322202;Tupanciretã;5;7;12;68
4314902;Porto Alegre;4321436;Terra de Areia;5;7;12;121
4314902;Porto Alegre;4321006;Tapera;5;7;12;228
4310603;Itaqui;4317400;Santiago;5;7;12;162
4313904;Panambi;4316907;Santa Maria;5;7;12;161
1100205;Porto Velho;4314902;Porto Alegre;5;7;12;2618
3524709;Jaguariúna;4314902;Porto Alegre;5;7;12;904
4307559;Estação;4310462;Ipiranga do Sul;5;7;12;17
4307906;Farroupilha;4309209;Gravataí;5;7;12;86
2927408;Salvador;4305108;Caxias do Sul;5;7;12;2138
4209508;Laurentino;4214805;Rio do Sul;5;7;12;12
4214003;Presidente Getúlio;4214805;Rio do Sul;5;7;12;21
4211405;Nova Erechim;4212908;Pinhalzinho;5;7;12;10
4202800;Braço do Norte;4211702;Orleans;5;7;12;16
4204301;Concórdia;4208005;Itá;5;7;12;34
4106902;Curitiba;4203006;Caçador;5;7;12;233
2927408;Salvador;4202404;Blumenau;5;7;12;1844
4115804;Medianeira;4124053;Santa Terezinha de Itaipu;5;7;12;38
4106407;Cornélio Procópio;4123907;Santa Mariana;5;7;12;15
4109401;Guarapuava;4118204;Paranaguá;5;7;12;292
4105706;Clevelândia;4115309;Mariópolis;5;7;12;10
4101408;Apucarana;4114203;Mandaguari;5;7;12;26
1100205;Porto Velho;4113700;Londrina;5;7;12;2036
3170107;Uberaba;4113700;Londrina;5;7;12;512
4110201;Inácio Martins;4110706;Irati;5;7;12;46
3534401;Osasco;3556701;Vinhedo;5;7;12;59
1302603;Manaus;3552403;Sumaré;5;7;12;2515
2304400;Fortaleza;3552205;Sorocaba;5;7;12;2350
2927408;Salvador;3552205;Sorocaba;5;7;12;1465
3516200;Franca;3552205;Sorocaba;5;7;12;326
3537107;Pedreira;3551603;Serra Negra;5;7;12;25
2606200;Goiana;3550308;São Paulo;5;7;12;2114
3115300;Cataguases;3550308;São Paulo;5;7;12;475
3146107;Ouro Preto;3550308;São Paulo;5;7;12;480
3149804;Perdizes;3550308;São Paulo;5;7;12;480
3508603;Cachoeira Paulista;3550308;São Paulo;5;7;12;200
3529203;Martinópolis;3550308;São Paulo;5;7;12;488
3535309;Palmital;3550308;São Paulo;5;7;12;375
3526704;Leme;3548906;São Carlos;5;7;12;55
3304557;Rio de Janeiro;3530706;Mogi Guaçu;5;7;12;385
3506102;Bebedouro;3529302;Matão;5;7;12;75
3518404;Guaratinguetá;3524402;Jacareí;5;7;12;97
3518404;Guaratinguetá;3518800;Guarulhos;5;7;12;158
3110608;Cambuí;3507605;Bragança Paulista;5;7;12;61
2610707;Paulista;3304557;Rio de Janeiro;5;7;12;1849
3136702;Juiz de Fora;3205200;Vila Velha;5;7;12;348
3201209;Cachoeiro de Itapemirim;3205069;Venda Nova do Imigrante;5;7;12;54
2927408;Salvador;3201308;Cariacica;5;7;12;829
3106200;Belo Horizonte;3201209;Cachoeiro de Itapemirim;5;7;12;317
3111101;Campina Verde;3170206;Uberlândia;5;7;12;146
3134400;Iturama;3170206;Uberlândia;5;7;12;224
3133501;Itapecerica;3160405;Santo Antônio do Monte;5;7;12;46
3118601;Contagem;3151800;Poços de Caldas;5;7;12;325
3106200;Belo Horizonte;3151404;Pitangui;5;7;12;98
2903201;Barreiras;2910800;Feira de Santana;5;7;12;654
2303709;Caucaia;2611606;Recife;5;7;12;637
2601904;Bezerros;2611606;Recife;5;7;12;96
2606002;Garanhuns;2611101;Petrolina;5;7;12;442
2403103;Currais Novos;2408904;Parelhas;5;7;12;50
2408102;Natal;2408904;Parelhas;5;7;12;183
2201150;Baixa Grande do Ribeiro;2211209;Uruçuí;5;7;12;101
2210003;São João do Piauí;2210805;Simplício Mendes;5;7;12;68
1702109;Araguaína;2111300;São Luís;5;7;12;680
1702109;Araguaína;1721208;Tocantinópolis;5;7;12;127
1501402;Belém;1507904;Soure;5;7;12;73
1200401;Rio Branco;1501402;Belém;5;7;12;2369
3157807;Santa Luzia;5300108;Brasília;4;8;12;622
3202405;Guarapari;5300108;Brasília;4;8;12;961
3300209;Araruama;5300108;Brasília;4;8;12;993
3300407;Barra Mansa;5300108;Brasília;4;8;12;848
3306107;Valença;5300108;Brasília;4;8;12;843
3504107;Atibaia;5300108;Brasília;4;8;12;823
3506508;Birigui;5300108;Brasília;4;8;12;663
3523909;Itu;5300108;Brasília;4;8;12;830
3530706;Mogi Guaçu;5300108;Brasília;4;8;12;729
3538006;Pindamonhangaba;5300108;Brasília;4;8;12;832
4202008;Balneário Camboriú;5300108;Brasília;4;8;12;1240
4303103;Cachoeirinha;5300108;Brasília;4;8;12;1606
4305108;Caxias do Sul;5103403;Cuiabá;4;8;12;1604
5002704;Campo Grande;5003256;Costa Rica;4;8;12;265
4316808;Santa Cruz do Sul;4321451;Teutônia;4;8;12;68
4306403;Dois Irmãos;4316956;Santa Maria do Herval;4;8;12;13
3523909;Itu;4314902;Porto Alegre;4;8;12;834
4113908;Mallet;4122008;Rio Azul;4;8;12;16
2704302;Maceió;4113700;Londrina;4;8;12;2142
3506003;Bauru;3548807;São Caetano do Sul;4;8;12;292
3507605;Bragança Paulista;3534401;Osasco;4;8;12;70
3119302;Coromandel;3170206;Uberlândia;4;8;12;122
3147105;Pará de Minas;3170206;Uberlândia;4;8;12;400
3147105;Pará de Minas;3163102;São José da Varginha;4;8;12;17
3101003;Águas Vermelhas;3106200;Belo Horizonte;4;8;12;529
2206407;Monsenhor Gil;2211001;Teresina;4;8;12;56
1100023;Ariquemes;1200401;Rio Branco;4;8;12;528
3507605;Bragança Paulista;5300108;Brasília;3;9;12;804
3520509;Indaiatuba;5300108;Brasília;3;9;12;810
4118501;Pato Branco;5300108;Brasília;3;9;12;1267
4211603;Nova Veneza;5300108;Brasília;3;9;12;1431
3306305;Volta Redonda;4314902;Porto Alegre;3;9;12;1067
3501608;Americana;4314902;Porto Alegre;3;9;12;887
3550308;São Paulo;4208401;Itapiranga;3;9;12;792
3548807;São Caetano do Sul;3552809;Taboão da Serra;3;9;12;21
1715705;Palmeirante;3550308;São Paulo;3;9;12;1752
3502804;Araçatuba;3534401;Osasco;3;9;12;451
3503208;Araraquara;3534401;Osasco;3;9;12;239
3518701;Guarujá;3534401;Osasco;3;9;12;71
3524402;Jacareí;3534401;Osasco;3;9;12;89
3304557;Rio de Janeiro;3510609;Carapicuíba;3;9;12;371
3112000;Candeias;3126109;Formiga;3;9;12;37
4303004;Cachoeira do Sul;4314100;Passo Fundo;2;10;12;200
3529302;Matão;4209706;Lebon Régis;2;10;12;631
4118907;Pérola;4202909;Brusque;2;10;12;592
1501402;Belém;4113700;Londrina;2;10;12;2439
3303500;Nova Iguaçu;3534401;Osasco;2;10;12;349
3505708;Barueri;5006200;Nova Andradina;1;11;12;690
1200401;Rio Branco;4107256;Douradina;1;11;12;2060
2304400;Fortaleza;3516200;Franca;1;11;12;2059
1503606;Itaituba;5300108;Brasília;5;6;11;1536
1505502;Paragominas;5300108;Brasília;5;6;11;1416
2903904;Bom Jesus da Lapa;5300108;Brasília;5;6;11;560
2911709;Guanambi;5300108;Brasília;5;6;11;573
2914604;Irecê;5300108;Brasília;5;6;11;811
3114204;Carmo do Cajuru;5300108;Brasília;5;6;11;593
3148103;Patrocínio;5300108;Brasília;5;6;11;362
3164704;São Sebastião do Paraíso;5300108;Brasília;5;6;11;576
3205101;Viana;5300108;Brasília;5;6;11;946
4303905;Campo Bom;5300108;Brasília;5;6;11;1575
4322509;Vacaria;5300108;Brasília;5;6;11;1446
5210109;Ipameri;5300108;Brasília;5;6;11;214
5201108;Anápolis;5221403;Trindade;5;6;11;71
5210109;Ipameri;5217401;Pires do Rio;5;6;11;51
3550308;São Paulo;5214606;Niquelândia;5;6;11;1037
5208004;Formosa;5212501;Luziânia;5;6;11;103
5204300;Caçu;5211909;Jataí;5;6;11;95
5211503;Itumbiara;5211909;Jataí;5;6;11;265
3505708;Barueri;5211503;Itumbiara;5;6;11;622
5203500;Bom Jesus de Goiás;5211503;Itumbiara;5;6;11;59
5208707;Goiânia;5209200;Guapó;5;6;11;30
3543907;Rio Claro;5208707;Goiânia;5;6;11;659
3548708;São Bernardo do Campo;5208707;Goiânia;5;6;11;831
2304400;Fortaleza;5201405;Aparecida de Goiânia;5;6;11;1824
5200308;Alexânia;5201108;Anápolis;5;6;11;54
5106224;Nova Mutum;5107768;Santa Rita do Trivelato;5;6;11;89
3304557;Rio de Janeiro;5107602;Rondonópolis;5;6;11;1433
4104808;Cascavel;5107602;Rondonópolis;5;6;11;953
5107040;Primavera do Leste;5107065;Querência;5;6;11;400
5101902;Brasnorte;5105150;Juína;5;6;11;118
3205309;Vitória;5103403;Cuiabá;5;6;11;1794
3547304;Santana de Parnaíba;5103403;Cuiabá;5;6;11;1333
3550308;São Paulo;5103106;Cocalinho;5;6;11;1132
3550308;São Paulo;5005400;Maracaju;5;6;11;919
5003207;Corumbá;5005202;Ladário;5;6;11;4
3548708;São Bernardo do Campo;5002704;Campo Grande;5;6;11;926
3541406;Presidente Prudente;5001904;Bataguassu;5;6;11;118
3550308;São Paulo;5000609;Amambaí;5;6;11;885
3304557;Rio de Janeiro;4323002;Viamão;5;6;11;1077
4304200;Candelária;4322707;Vera Cruz;5;6;11;31
4201406;Araranguá;4322608;Venâncio Aires;5;6;11;271
4317202;Santa Rosa;4322103;Tucunduva;5;6;11;24
4318408;São Jerônimo;4322004;Triunfo;5;6;11;5
4306007;Crissiumal;4321907;Três Passos;5;6;11;16
3550308;São Paulo;4321303;Taquari;5;6;11;839
4316808;Santa Cruz do Sul;4320677;Sinimbu;5;6;11;22
4314100;Passo Fundo;4320107;Sarandi;5;6;11;62
4314902;Porto Alegre;4320107;Sarandi;5;6;11;290
4301800;Barracão;4318606;São José do Ouro;5;6;11;17
4302709;Butiá;4318408;São Jerônimo;5;6;11;29
4303608;Cambará do Sul;4318200;São Francisco de Paula;5;6;11;61
4316907;Santa Maria;4318002;São Borja;5;6;11;244
4317707;Santo Antônio das Missões;4318002;São Borja;5;6;11;78
1200401;Rio Branco;4314902;Porto Alegre;5;6;11;2683
1400100;Boa Vista;4314902;Porto Alegre;5;6;11;3742
2933307;Vitória da Conquista;4314902;Porto Alegre;5;6;11;1929
3143302;Montes Claros;4314902;Porto Alegre;5;6;11;1621
3513504;Cubatão;4314902;Porto Alegre;5;6;11;816
3533403;Nova Odessa;4314902;Porto Alegre;5;6;11;886
3556701;Vinhedo;4314902;Porto Alegre;5;6;11;873
4304200;Candelária;4314902;Porto Alegre;5;6;11;161
4311007;Jaguarão;4314902;Porto Alegre;5;6;11;345
4306403;Dois Irmãos;4314803;Portão;5;6;11;20
4307609;Estância Velha;4314803;Portão;5;6;11;9
4307500;Espumoso;4314100;Passo Fundo;5;6;11;68
4304705;Carazinho;4313706;Palmeira das Missões;5;6;11;68
4310009;Ibirubá;4312658;Não-Me-Toque;5;6;11;32
4306106;Cruz Alta;4310009;Ibirubá;5;6;11;49
3550308;São Paulo;4309100;Gramado;5;6;11;753
4304606;Canoas;4309100;Gramado;5;6;11;63
4304630;Capão da Canoa;4307906;Farroupilha;5;6;11;139
4304705;Carazinho;4305306;Chapada;5;6;11;39
3552809;Taboão da Serra;4305108;Caxias do Sul;5;6;11;745
3550308;São Paulo;4304705;Carazinho;5;6;11;782
2927408;Salvador;4304606;Canoas;5;6;11;2202
4300109;Agudo;4304200;Candelária;5;6;11;41
4205407;Florianópolis;4219309;Videira;5;6;11;270
4207577;Iomerê;4219309;Videira;5;6;11;9
4122305;Rio Negro;4215802;São Bento do Sul;5;6;11;46
4213708;Pouso Redondo;4214805;Rio do Sul;5;6;11;32
4204806;Curitibanos;4213351;Ponte Alta do Norte;5;6;11;19
4201406;Araranguá;4211207;Morro da Fumaça;5;6;11;43
3550308;São Paulo;4210100;Mafra;5;6;11;419
4208906;Jaraguá do Sul;4210100;Mafra;5;6;11;85
4201406;Araranguá;4209102;Joinville;5;6;11;302
4204004;Catanduvas;4209003;Joaçaba;5;6;11;16
4208302;Itapema;4208906;Jaraguá do Sul;5;6;11;81
3513504;Cubatão;4208203;Itajaí;5;6;11;407
4201257;Apiúna;4207502;Indaial;5;6;11;22
4202008;Balneário Camboriú;4207502;Indaial;5;6;11;55
4201406;Araranguá;4207007;Içara;5;6;11;31
4205407;Florianópolis;4207007;Içara;5;6;11;146
3550308;São Paulo;4205902;Gaspar;5;6;11;428
4203006;Caçador;4205407;Florianópolis;5;6;11;268
4113700;Londrina;4204608;Criciúma;5;6;11;618
3550308;São Paulo;4203808;Canoinhas;5;6;11;467
3505708;Barueri;4202008;Balneário Camboriú;5;6;11;424
4101606;Arapoti;4128500;Wenceslau Braz;5;6;11;32
4113908;Mallet;4128203;União da Vitória;5;6;11;55
3304557;Rio de Janeiro;4128104;Umuarama;5;6;11;1027
4106407;Cornélio Procópio;4126405;Sertaneja;5;6;11;24
4106902;Curitiba;4126256;Sarandi;5;6;11;345
3509502;Campinas;4125506;São José dos Pinhais;5;6;11;361
4106902;Curitiba;4124103;Santo Antônio da Platina;5;6;11;251
4104600;Capitão Leônidas Marques;4123824;Santa Lúcia;5;6;11;9
4119905;Ponta Grossa;4121703;Reserva;5;6;11;86
4106902;Curitiba;4120606;Prudentópolis;5;6;11;177
4119905;Ponta Grossa;4120606;Prudentópolis;5;6;11;88
3509502;Campinas;4119905;Ponta Grossa;5;6;11;395
4118501;Pato Branco;4119905;Ponta Grossa;5;6;11;282
4113908;Mallet;4118709;Paulo Frontin;5;6;11;18
4108304;Foz do Iguaçu;4118501;Pato Branco;5;6;11;199
4101200;Antonina;4118204;Paranaguá;5;6;11;28
4113700;Londrina;4115754;Mauá da Serra;5;6;11;67
3502804;Araçatuba;4113700;Londrina;5;6;11;240
3503208;Araraquara;4113700;Londrina;5;6;11;347
3547809;Santo André;4113700;Londrina;5;6;11;475
4100806;Alvorada do Sul;4113700;Londrina;5;6;11;58
4103602;Cambará;4111803;Jacarezinho;5;6;11;13
4104303;Campo Mourão;4111506;Ivaiporã;5;6;11;71
4104303;Campo Mourão;4107504;Engenheiro Beltrão;5;6;11;30
3205200;Vila Velha;4106902;Curitiba;5;6;11;1046
3305109;São João de Meriti;4106902;Curitiba;5;6;11;658
1100205;Porto Velho;4104808;Cascavel;5;6;11;2052
3304557;Rio de Janeiro;3556701;Vinhedo;5;6;11;381
3509502;Campinas;3556503;Várzea Paulista;5;6;11;42
3505708;Barueri;3556206;Valinhos;5;6;11;61
3535408;Panorama;3555109;Tupi Paulista;5;6;11;30
3505708;Barueri;3554102;Taubaté;5;6;11;145
3549805;São José do Rio Preto;3553708;Taquaritinga;5;6;11;111
3550308;São Paulo;3553104;Taiaçu;5;6;11;339
3526902;Limeira;3552403;Sumaré;5;6;11;31
1507300;São Félix do Xingu;3550308;São Paulo;5;6;11;1948
1716109;Paraíso do Tocantins;3550308;São Paulo;5;6;11;1509
2305506;Iguatu;3550308;São Paulo;5;6;11;2043
3102605;Andradas;3550308;São Paulo;5;6;11;176
3102803;Andrelândia;3550308;São Paulo;5;6;11;317
3133758;Itaú de Minas;3550308;São Paulo;5;6;11;323
3501152;Alumínio;3550308;São Paulo;5;6;11;64
3506607;Biritiba-Mirim;3550308;São Paulo;5;6;11;63
3519204;Iacri;3550308;São Paulo;5;6;11;455
3520103;Igarapava;3550308;São Paulo;5;6;11;415
3521705;Itaberá;3550308;São Paulo;5;6;11;255
3525508;Joanópolis;3550308;São Paulo;5;6;11;89
3526100;Juquiá;3550308;São Paulo;5;6;11;128
3527603;Luís Antônio;3550308;São Paulo;5;6;11;256
3547700;Santo Anastácio;3550308;São Paulo;5;6;11;540
3509502;Campinas;3549706;São José do Rio Pardo;5;6;11;145
3106200;Belo Horizonte;3548906;São Carlos;5;6;11;465
3501608;Americana;3548906;São Carlos;5;6;11;98
3513702;Descalvado;3548906;São Carlos;5;6;11;31
3513009;Cotia;3548807;São Caetano do Sul;5;6;11;36
3152501;Pouso Alegre;3548708;São Bernardo do Campo;5;6;11;178
3167202;Sete Lagoas;3548708;São Bernardo do Campo;5;6;11;529
2111300;São Luís;3548500;Santos;5;6;11;2372
3302403;Macaé;3548500;Santos;5;6;11;482
3506359;Bertioga;3548500;Santos;5;6;11;21
3519055;Holambra;3548005;Santo Antônio de Posse;5;6;11;14
3543402;Ribeirão Preto;3547809;Santo André;5;6;11;304
3506003;Bauru;3547304;Santana de Parnaíba;5;6;11;252
3513009;Cotia;3547304;Santana de Parnaíba;5;6;11;18
3506300;Bernardino de Campos;3546405;Santa Cruz do Rio Pardo;5;6;11;21
3533403;Nova Odessa;3545803;Santa Bárbara d'Oeste;5;6;11;11
3537909;Pilar do Sul;3545308;Salto de Pirapora;5;6;11;23
3543402;Ribeirão Preto;3543907;Rio Claro;5;6;11;141
3205309;Vitória;3543402;Ribeirão Preto;5;6;11;782
3514601;Dumont;3543402;Ribeirão Preto;5;6;11;21
3300407;Barra Mansa;3541901;Queluz;5;6;11;59
3304557;Rio de Janeiro;3539301;Pirassununga;5;6;11;443
3536505;Paulínia;3538709;Piracicaba;5;6;11;50
3507605;Bragança Paulista;3538204;Pinhalzinho;5;6;11;19
3530607;Moji das Cruzes;3538006;Pindamonhangaba;5;6;11;103
3537800;Piedade;3537909;Pilar do Sul;5;6;11;31
3500105;Adamantina;3534906;Pacaembu;5;6;11;22
3151800;Poços de Caldas;3530706;Mogi Guaçu;5;6;11;74
3525904;Jundiaí;3530706;Mogi Guaçu;5;6;11;94
3502804;Araçatuba;3530102;Mirandópolis;5;6;11;68
3509502;Campinas;3529302;Matão;5;6;11;200
3519600;Ibitinga;3529302;Matão;5;6;11;49
3170206;Uberlândia;3525904;Jundiaí;5;6;11;493
3519600;Ibitinga;3525300;Jaú;5;6;11;64
3510500;Caraguatatuba;3524402;Jacareí;5;6;11;60
3513801;Diadema;3524402;Jacareí;5;6;11;80
3503208;Araraquara;3519600;Ibitinga;5;6;11;69
3506003;Bauru;3519105;Iacanga;5;6;11;50
3170107;Uberaba;3516200;Franca;5;6;11;103
3505708;Barueri;3513504;Cubatão;5;6;11;63
3509502;Campinas;3510401;Capivari;5;6;11;47
3170107;Uberaba;3509502;Campinas;5;6;11;360
3170701;Varginha;3509502;Campinas;5;6;11;229
2927408;Salvador;3506003;Bauru;5;6;11;1484
3151800;Poços de Caldas;3505708;Barueri;5;6;11;196
3501608;Americana;3505708;Barueri;5;6;11;97
3170206;Uberlândia;3503000;Aramina;5;6;11;139
3302007;Itaguaí;3305109;São João de Meriti;5;6;11;45
1100304;Vilhena;3304557;Rio de Janeiro;5;6;11;2020
1200203;Cruzeiro do Sul;3304557;Rio de Janeiro;5;6;11;3361
2312908;Sobral;3304557;Rio de Janeiro;5;6;11;2144
2704708;Marechal Deodoro;3304557;Rio de Janeiro;5;6;11;1630
3147907;Passos;3304557;Rio de Janeiro;5;6;11;419
3301207;Carmo;3304557;Rio de Janeiro;5;6;11;124
3300456;Belford Roxo;3303302;Niterói;5;6;11;33
3301306;Casimiro de Abreu;3302403;Macaé;5;6;11;34
3300100;Angra dos Reis;3302007;Itaguaí;5;6;11;50
3201308;Cariacica;3301009;Campos dos Goytacazes;5;6;11;192
3300605;Bom Jesus do Itabapoana;3301009;Campos dos Goytacazes;5;6;11;82
3200102;Afonso Cláudio;3205309;Vitória;5;6;11;88
3203007;Iúna;3205069;Venda Nova do Imigrante;5;6;11;41
2304400;Fortaleza;3205002;Serra;5;6;11;1819
3201506;Colatina;3204658;São Domingos do Norte;5;6;11;45
3200904;Barra de São Francisco;3202108;Ecoporanga;5;6;11;48
3200607;Aracruz;3201308;Cariacica;5;6;11;52
2611606;Recife;3201209;Cachoeiro de Itapemirim;5;6;11;1537
3143906;Muriaé;3201209;Cachoeiro de Itapemirim;5;6;11;133
3139409;Manhuaçu;3170701;Varginha;5;6;11;372
3152501;Pouso Alegre;3170206;Uberlândia;5;6;11;442
3118601;Contagem;3168705;Timóteo;5;6;11;156
3100906;Águas Formosas;3168606;Teófilo Otoni;5;6;11;101
3144805;Nova Lima;3167202;Sete Lagoas;5;6;11;76
3159605;Santa Rita do Sapucaí;3163706;São Lourenço;5;6;11;72
3118304;Conselheiro Lafaiete;3162500;São João del Rei;5;6;11;71
3103405;Araçuaí;3157005;Salinas;5;6;11;83
3141603;Mercês;3155801;Rio Pomba;5;6;11;19
3117900;Congonhal;3152501;Pouso Alegre;5;6;11;11
3118601;Contagem;3149309;Pedro Leopoldo;5;6;11;34
3118601;Contagem;3148004;Patos de Minas;5;6;11;296
3137536;Lagoa Grande;3148004;Patos de Minas;5;6;11;82
3104205;Arcos;3146503;Pains;5;6;11;15
3106200;Belo Horizonte;3145604;Oliveira;5;6;11;127
3139409;Manhuaçu;3140902;Matipó;5;6;11;29
3127701;Governador Valadares;3139607;Mantena;5;6;11;99
3127388;Goianá;3136702;Juiz de Fora;5;6;11;28
3101706;Almenara;3135803;Jequitinhonha;5;6;11;47
3123908;Entre Rios de Minas;3135407;Jeceaba;5;6;11;17
3114204;Carmo do Cajuru;3133808;Itaúna;5;6;11;21
3107109;Boa Esperança;3130507;Ilicínea;5;6;11;33
3106200;Belo Horizonte;3109402;Buritizeiro;5;6;11;301
2913606;Ilhéus;2931350;Teixeira de Freitas;5;6;11;312
2919207;Lauro de Freitas;2930709;Simões Filho;5;6;11;14
2916401;Itapetinga;2927408;Salvador;5;6;11;319
2922300;Muritiba;2927408;Salvador;5;6;11;71
2924009;Paulo Afonso;2926608;Ribeira do Pombal;5;6;11;158
2922730;Nova Fátima;2926301;Riachão do Jacuípe;5;6;11;38
2924058;Pé de Serra;2926301;Riachão do Jacuípe;5;6;11;30
2914802;Itabuna;2925303;Porto Seguro;5;6;11;182
2903904;Bom Jesus da Lapa;2923704;Paratinga;5;6;11;64
2910057;Dias d'Ávila;2921005;Mata de São João;5;6;11;9
2916401;Itapetinga;2919702;Macarani;5;6;11;37
2910800;Feira de Santana;2914000;Ipirá;5;6;11;86
2909802;Cruz das Almas;2911600;Governador Mangabeira;5;6;11;13
2907301;Castro Alves;2909802;Cruz das Almas;5;6;11;41
2408003;Mossoró;2907509;Catu;5;6;11;801
2905008;Caculé;2905206;Caetité;5;6;11;55
2802908;Itabaiana;2804805;Nossa Senhora do Socorro;5;6;11;41
2800209;Aquidabã;2800308;Aracaju;5;6;11;70
2704302;Maceió;2705705;Olho d'Água das Flores;5;6;11;170
2603009;Cabrobó;2612604;Santa Maria da Boa Vista;5;6;11;69
2601409;Barreiros;2611606;Recife;5;6;11;82
2507507;João Pessoa;2611101;Petrolina;5;6;11;665
2602902;Cabo de Santo Agostinho;2610707;Paulista;5;6;11;41
2307650;Maracanaú;2607901;Jaboatão dos Guararapes;5;6;11;615
2600054;Abreu e Lima;2607901;Jaboatão dos Guararapes;5;6;11;28
2600302;Agrestina;2604106;Caruaru;5;6;11;20
2509701;Monteiro;2516300;Sumé;5;6;11;39
2408003;Mossoró;2412005;São Gonçalo do Amarante;5;6;11;233
2408003;Mossoró;2409407;Pau dos Ferros;5;6;11;142
2408102;Natal;2408201;Nísia Floresta;5;6;11;31
2312304;São Benedito;2313401;Tianguá;5;6;11;38
2311306;Quixadá;2311801;Russas;5;6;11;119
2300200;Acaraú;2306553;Itarema;5;6;11;20
2304202;Crato;2305506;Iguatu;5;6;11;96
2304400;Fortaleza;2304954;Guaiúba;5;6;11;32
1100205;Porto Velho;2304400;Fortaleza;5;6;11;2879
2101202;Bacabal;2211001;Teresina;5;6;11;237
2109908;Santa Inês;2211001;Teresina;5;6;11;324
2207009;Oeiras;2211001;Teresina;5;6;11;223
2210003;São João do Piauí;2211001;Teresina;5;6;11;366
1505502;Paragominas;2100055;Açailândia;5;6;11;215
1702109;Araguaína;1702208;Araguatins;5;6;11;171
1501402;Belém;1508407;Xinguara;5;6;11;653
1504455;Medicilândia;1508159;Uruará;5;6;11;102
1506195;Rurópolis;1506807;Santarém;5;6;11;181
1501402;Belém;1506138;Redenção;5;6;11;753
1500404;Alenquer;1501402;Belém;5;6;11;702
1100205;Porto Velho;1400100;Boa Vista;5;6;11;1337
1302603;Manaus;1303304;Novo Aripuanã;5;6;11;227
1100106;Guajará-Mirim;1302603;Manaus;5;6;11;1033
1501303;Barcarena;5300108;Brasília;4;7;11;1583
2100055;Açailândia;5300108;Brasília;4;7;11;1201
2305506;Iguatu;5300108;Brasília;4;7;11;1383
2307650;Maracanaú;5300108;Brasília;4;7;11;1642
3147907;Passos;5300108;Brasília;4;7;11;560
3300456;Belford Roxo;5300108;Brasília;4;7;11;915
3503307;Araras;5300108;Brasília;4;7;11;727
3524303;Jaboticabal;5300108;Brasília;4;7;11;604
3539301;Pirassununga;5300108;Brasília;4;7;11;688
3543303;Ribeirão Pires;5300108;Brasília;4;7;11;888
3556701;Vinhedo;5300108;Brasília;4;7;11;806
4101804;Araucária;5300108;Brasília;4;7;11;1095
4127700;Toledo;5300108;Brasília;4;7;11;1177
4300604;Alvorada;5300108;Brasília;4;7;11;1610
4307005;Erechim;5300108;Brasília;4;7;11;1396
5211909;Jataí;5300108;Brasília;4;7;11;468
5208707;Goiânia;5219902;São Francisco de Goiás;4;7;11;84
4305108;Caxias do Sul;5208707;Goiânia;4;7;11;1396
3118601;Contagem;5201405;Aparecida de Goiânia;4;7;11;654
4101507;Arapongas;5107602;Rondonópolis;4;7;11;850
5103403;Cuiabá;5104609;Itiquira;4;7;11;276
5002902;Cassilândia;5003256;Costa Rica;4;7;11;166
4204202;Chapecó;4320107;Sarandi;4;7;11;97
4307005;Erechim;4319703;São Valentim;4;7;11;26
4302501;Bossoroca;4318903;São Luiz Gonzaga;4;7;11;37
4303103;Cachoeirinha;4316907;Santa Maria;4;7;11;264
3550308;São Paulo;4316501;Salvador do Sul;4;7;11;789
4314902;Porto Alegre;4316451;Salto do Jacuí;4;7;11;224
4311403;Lajeado;4315701;Rio Pardo;4;7;11;62
3543907;Rio Claro;4314902;Porto Alegre;4;7;11;913
4303103;Cachoeirinha;4307906;Farroupilha;4;7;11;83
3106200;Belo Horizonte;4303905;Campo Bom;4;7;11;1267
4106902;Curitiba;4213203;Pomerode;4;7;11;145
4104808;Cascavel;4209102;Joinville;4;7;11;480
4115804;Medianeira;4126355;Serranópolis do Iguaçu;4;7;11;11
4113700;Londrina;4123907;Santa Mariana;4;7;11;67
4104303;Campo Mourão;4119608;Pitanga;4;7;11;103
4105508;Cianorte;4107801;Floraí;4;7;11;49
3303906;Petrópolis;4106902;Curitiba;4;7;11;685
4104501;Capanema;4104808;Cascavel;4;7;11;89
3550308;São Paulo;4102406;Bandeirantes;4;7;11;386
3550308;São Paulo;4102000;Assis Chateaubriand;4;7;11;700
3534401;Osasco;3556206;Valinhos;4;7;11;66
3548807;São Caetano do Sul;3554102;Taubaté;4;7;11;122
1302603;Manaus;3552205;Sorocaba;4;7;11;2564
3545803;Santa Bárbara d'Oeste;3552205;Sorocaba;4;7;11;81
3304524;Rio das Ostras;3550308;São Paulo;4;7;11;495
3510005;Cândido Mota;3550308;São Paulo;4;7;11;393
3524907;Jambeiro;3550308;São Paulo;4;7;11;108
3546306;Santa Cruz das Palmeiras;3549102;São João da Boa Vista;4;7;11;48
3306305;Volta Redonda;3548807;São Caetano do Sul;4;7;11;279
3530607;Moji das Cruzes;3548807;São Caetano do Sul;4;7;11;39
3513504;Cubatão;3548708;São Bernardo do Campo;4;7;11;25
2933307;Vitória da Conquista;3534401;Osasco;4;7;11;1127
3506102;Bebedouro;3526902;Limeira;4;7;11;215
3511508;Cerquilho;3526407;Laranjal Paulista;4;7;11;16
3509502;Campinas;3518701;Guarujá;4;7;11;141
3509502;Campinas;3509700;Campos do Jordão;4;7;11;153
3304557;Rio de Janeiro;3507001;Boituva;4;7;11;453
3503208;Araraquara;3505500;Barretos;4;7;11;143
3300704;Cabo Frio;3305109;São João de Meriti;4;7;11;134
3153400;Presidente Olegário;3170206;Uberlândia;4;7;11;202
2931350;Teixeira de Freitas;3168606;Teófilo Otoni;4;7;11;192
3136306;João Pinheiro;3167202;Sete Lagoas;4;7;11;278
2307304;Juazeiro do Norte;2611101;Petrolina;4;7;11;266
2305506;Iguatu;2312908;Sobral;4;7;11;318
2105302;Imperatriz;2111201;São José de Ribamar;4;7;11;502
2700300;Arapiraca;5300108;Brasília;3;8;11;1363
3105608;Barbacena;5300108;Brasília;3;8;11;747
3152501;Pouso Alegre;5300108;Brasília;3;8;11;741
3168705;Timóteo;5300108;Brasília;3;8;11;708
3203205;Linhares;5300108;Brasília;3;8;11;939
3300100;Angra dos Reis;5300108;Brasília;3;8;11;882
3552502;Suzano;5300108;Brasília;3;8;11;874
4118204;Paranaguá;5300108;Brasília;3;8;11;1084
4211900;Palhoça;5300108;Brasília;3;8;11;1314
4317509;Santo Ângelo;5300108;Brasília;3;8;11;1554
4323002;Viamão;5300108;Brasília;3;8;11;1617
4314407;Pelotas;4316808;Santa Cruz do Sul;3;8;11;222
3503208;Araraquara;4314902;Porto Alegre;3;8;11;958
3552403;Sumaré;4314902;Porto Alegre;3;8;11;881
4312401;Montenegro;4314100;Passo Fundo;3;8;11;180
4214607;Rio do Oeste;4214805;Rio do Sul;3;8;11;19
2111300;São Luís;4113700;Londrina;3;8;11;2394
3549904;São José dos Campos;4113700;Londrina;3;8;11;539
4104303;Campo Mourão;4112207;Janiópolis;3;8;11;41
3509502;Campinas;3553708;Taquaritinga;3;8;11;224
3532900;Nova Europa;3552700;Tabatinga;3;8;11;15
3534708;Ourinhos;3550506;São Pedro do Turvo;3;8;11;31
3541901;Queluz;3550308;São Paulo;3;8;11;228
3542305;Redenção da Serra;3550308;São Paulo;3;8;11;121
3143302;Montes Claros;3548807;São Caetano do Sul;3;8;11;808
3538709;Piracicaba;3546306;Santa Cruz das Palmeiras;3;8;11;110
3507506;Botucatu;3545209;Salto;3;8;11;123
3539301;Pirassununga;3543402;Ribeirão Preto;3;8;11;102
2800308;Aracaju;3534401;Osasco;3;8;11;1694
3170107;Uberaba;3534401;Osasco;3;8;11;435
3118601;Contagem;3141108;Matozinhos;3;8;11;40
5205059;Castelândia;5213004;Maurilândia;2;9;11;20
3143104;Monte Carmelo;5208707;Goiânia;2;9;11;295
4314100;Passo Fundo;4318002;São Borja;2;9;11;355
4314100;Passo Fundo;4317103;Santana do Livramento;2;9;11;411
3516200;Franca;4106902;Curitiba;2;9;11;573
3534401;Osasco;4104808;Cascavel;2;9;11;688
3503703;Ariranha;3535705;Paraíso;2;9;11;19
1100205;Porto Velho;4107256;Douradina;1;10;11;1921
3509502;Campinas;3537909;Pilar do Sul;1;10;11;121
3503703;Ariranha;3535101;Palmares Paulista;1;10;11;12
3503703;Ariranha;3522703;Itápolis;1;10;11;45
3155603;Rio Pardo de Minas;3304557;Rio de Janeiro;1;10;11;808
3151800;Poços de Caldas;3203700;Muniz Freire;1;10;11;557
3140506;Martinho Campos;3151404;Pitangui;1;10;11;52
2804805;Nossa Senhora do Socorro;2910057;Dias d'Ávila;1;10;11;232
1502707;Conceição do Araguaia;5300108;Brasília;5;5;10;849
1718204;Porto Nacional;5300108;Brasília;5;5;10;567
2509701;Monteiro;5300108;Brasília;5;5;10;1434
2909802;Cruz das Almas;5300108;Brasília;5;5;10;1004
3130101;Igarapé;5300108;Brasília;5;5;10;612
3133105;Itanhandu;5300108;Brasília;5;5;10;789
3135100;Janaúba;5300108;Brasília;5;5;10;491
4107652;Fazenda Rio Grande;5300108;Brasília;5;5;10;1101
4318804;São Lourenço do Sul;5300108;Brasília;5;5;10;1778
5100250;Alta Floresta;5300108;Brasília;5;5;10;1084
5204904;Campos Belos;5300108;Brasília;5;5;10;334
5205497;Cidade Ocidental;5300108;Brasília;5;5;10;30
5209903;Iaciara;5300108;Brasília;5;5;10;235
5217302;Pirenópolis;5300108;Brasília;5;5;10;111
5217401;Pires do Rio;5300108;Brasília;5;5;10;169
5218003;Porangatu;5300108;Brasília;5;5;10;295
5218300;Posse;5300108;Brasília;5;5;10;253
5205497;Cidade Ocidental;5221858;Valparaíso de Goiás;5;5;10;6
5201108;Anápolis;5220603;Silvânia;5;5;10;53
3170107;Uberaba;5220454;Senador Canedo;5;5;10;359
5208707;Goiânia;5220207;São Miguel do Araguaia;5;5;10;390
3170206;Uberlândia;5219308;Santa Helena de Goiás;5;5;10;276
4113700;Londrina;5218805;Rio Verde;5;5;10;610
5208707;Goiânia;5217708;Pontalina;5;5;10;93
5204508;Caldas Novas;5217401;Pires do Rio;5;5;10;59
5208707;Goiânia;5215231;Novo Gama;5;5;10;151
3550308;São Paulo;5213806;Morrinhos;5;5;10;708
5100607;Alto Taquari;5213103;Mineiros;5;5;10;83
3106200;Belo Horizonte;5212501;Luziânia;5;5;10;588
5201108;Anápolis;5212501;Luziânia;5;5;10;108
5208608;Goianésia;5211800;Jaraguá;5;5;10;55
3115805;Centralina;5211503;Itumbiara;5;5;10;21
5203906;Buriti Alegre;5211503;Itumbiara;5;5;10;36
5204409;Caiapônia;5210208;Iporá;5;5;10;94
5204508;Caldas Novas;5210109;Ipameri;5;5;10;49
5208707;Goiânia;5210109;Ipameri;5;5;10;165
3550308;São Paulo;5209101;Goiatuba;5;5;10;690
1200401;Rio Branco;5208707;Goiânia;5;5;10;2086
1502707;Conceição do Araguaia;5208707;Goiânia;5;5;10;934
1709302;Guaraí;5208707;Goiânia;5;5;10;868
3147006;Paracatu;5208707;Goiânia;5;5;10;259
3170404;Unaí;5208707;Goiânia;5;5;10;254
3525904;Jundiaí;5208707;Goiânia;5;5;10;763
4125506;São José dos Pinhais;5208707;Goiânia;5;5;10;979
5201306;Anicuns;5208707;Goiânia;5;5;10;76
5206206;Cristalina;5208707;Goiânia;5;5;10;170
5207808;Firminópolis;5208707;Goiânia;5;5;10;110
5205406;Ceres;5208608;Goianésia;5;5;10;55
5204003;Cabeceiras;5208004;Formosa;5;5;10;52
3170206;Uberlândia;5205901;Corumbaíba;5;5;10;90
3304557;Rio de Janeiro;5205109;Catalão;5;5;10;725
3509502;Campinas;5201405;Aparecida de Goiânia;5;5;10;715
5100250;Alta Floresta;5108956;Nova Monte Verde;5;5;10;158
5100805;Apiacás;5108956;Nova Monte Verde;5;5;10;54
5106224;Nova Mutum;5108402;Várzea Grande;5;5;10;201
5106505;Poconé;5108402;Várzea Grande;5;5;10;83
5107602;Rondonópolis;5107958;Tangará da Serra;5;5;10;364
5103403;Cuiabá;5107701;Rosário Oeste;5;5;10;91
5105200;Juscimeira;5107602;Rondonópolis;5;5;10;48
5106307;Paranatinga;5107602;Rondonópolis;5;5;10;228
5106224;Nova Mutum;5107305;São José do Rio Claro;5;5;10;83
5102504;Cáceres;5107107;São José dos Quatro Marcos;5;5;10;70
3550308;São Paulo;5107065;Querência;5;5;10;1393
5101803;Barra do Garças;5107065;Querência;5;5;10;370
5100201;Água Boa;5107040;Primavera do Leste;5;5;10;283
5105259;Lucas do Rio Verde;5107040;Primavera do Leste;5;5;10;319
3550308;São Paulo;5106752;Pontes e Lacerda;5;5;10;1677
5106182;Nova Lacerda;5106752;Pontes e Lacerda;5;5;10;92
5100250;Alta Floresta;5106299;Paranaíta;5;5;10;49
5103403;Cuiabá;5105903;Nobres;5;5;10;97
5101258;Araputanga;5105622;Mirassol d'Oeste;5;5;10;40
5105150;Juína;5105176;Juruena;5;5;10;126
5102850;Castanheira;5105150;Juína;5;5;10;31
5100250;Alta Floresta;5104104;Guarantã do Norte;5;5;10;128
5101605;Barão de Melgaço;5103403;Cuiabá;5;5;10;71
5102702;Canarana;5103403;Cuiabá;5;5;10;466
5101803;Barra do Garças;5102702;Canarana;5;5;10;252
4106902;Curitiba;5100607;Alto Taquari;5;5;10;949
5100300;Alto Araguaia;5100409;Alto Garças;5;5;10;52
3106200;Belo Horizonte;5008305;Três Lagoas;5;5;10;811
3518800;Guarulhos;5008305;Três Lagoas;5;5;10;619
3541406;Presidente Prudente;5008305;Três Lagoas;5;5;10;155
3549805;São José do Rio Preto;5008305;Três Lagoas;5;5;10;244
5001904;Bataguassu;5008305;Três Lagoas;5;5;10;129
5007695;São Gabriel do Oeste;5007935;Sonora;5;5;10;205
5002951;Chapadão do Sul;5007695;São Gabriel do Oeste;5;5;10;214
4106902;Curitiba;5007208;Rio Brilhante;5;5;10;683
5006002;Nova Alvorada do Sul;5007208;Rio Brilhante;5;5;10;41
5002704;Campo Grande;5005806;Nioaque;5;5;10;148
5002407;Caarapó;5005707;Naviraí;5;5;10;77
5002704;Campo Grande;5005707;Naviraí;5;5;10;291
4115200;Maringá;5005681;Mundo Novo;5;5;10;247
5004106;Guia Lopes da Laguna;5005004;Jardim;5;5;10;12
5003801;Fátima do Sul;5004007;Glória de Dourados;5;5;10;26
5002704;Campo Grande;5003801;Fátima do Sul;5;5;10;218
3541406;Presidente Prudente;5003702;Dourados;5;5;10;351
5002605;Camapuã;5002951;Chapadão do Sul;5;5;10;171
3205309;Vitória;5002704;Campo Grande;5;5;10;1498
4125506;São José dos Pinhais;5002704;Campo Grande;5;5;10;811
4208203;Itajaí;5002704;Campo Grande;5;5;10;958
4209102;Joinville;5002704;Campo Grande;5;5;10;895
3550308;São Paulo;5002605;Camapuã;5;5;10;910
3550308;São Paulo;5002209;Bonito;5;5;10;1072
3541307;Presidente Epitácio;5001904;Bataguassu;5;5;10;36
4313508;Osório;4323804;Xangri-lá;5;5;10;21
4321451;Teutônia;4323770;Westfália;5;5;10;5
4318705;São Leopoldo;4323002;Viamão;5;5;10;37
4307005;Erechim;4322905;Viadutos;5;5;10;26
4302105;Bento Gonçalves;4322806;Veranópolis;5;5;10;25
4316907;Santa Maria;4322608;Venâncio Aires;5;5;10;158
4302303;Bom Jesus;4322509;Vacaria;5;5;10;53
4312708;Nonoai;4321956;Trindade do Sul;5;5;10;21
4314902;Porto Alegre;4321667;Três Cachoeiras;5;5;10;140
4217709;Sombrio;4321501;Torres;5;5;10;28
4301008;Arroio do Meio;4321451;Teutônia;5;5;10;14
4312401;Montenegro;4321303;Taquari;5;5;10;38
4303905;Campo Bom;4321204;Taquara;5;5;10;27
4304408;Canela;4321204;Taquara;5;5;10;35
4308904;Getúlio Vargas;4320909;Tapejara;5;5;10;32
4309803;Ibiaçá;4320909;Tapejara;5;5;10;16
4311304;Lagoa Vermelha;4320909;Tapejara;5;5;10;50
4311809;Marau;4320909;Tapejara;5;5;10;46
4300109;Agudo;4320701;Sobradinho;5;5;10;32
4314100;Passo Fundo;4320404;Serafina Corrêa;5;5;10;68
4313490;Novo Barreiro;4320107;Sarandi;5;5;10;19
4309209;Gravataí;4320008;Sapucaia do Sul;5;5;10;19
4314902;Porto Alegre;4319604;São Sepé;5;5;10;231
4305108;Caxias do Sul;4319505;São Sebastião do Caí;5;5;10;51
4318705;São Leopoldo;4319505;São Sebastião do Caí;5;5;10;29
4316501;Salvador do Sul;4319356;São Pedro da Serra;5;5;10;2
3550308;São Paulo;4319000;São Marcos;5;5;10;724
4305207;Cerro Largo;4318903;São Luiz Gonzaga;5;5;10;35
4318002;São Borja;4318903;São Luiz Gonzaga;5;5;10;106
4209102;Joinville;4318705;São Leopoldo;5;5;10;443
4303509;Camaquã;4318705;São Leopoldo;5;5;10;136
4304408;Canela;4318200;São Francisco de Paula;5;5;10;25
4317509;Santo Ângelo;4317905;Santo Cristo;5;5;10;66
4305405;Chiapetta;4317806;Santo Augusto;5;5;10;18
4314902;Porto Alegre;4317806;Santo Augusto;5;5;10;354
4309209;Gravataí;4317608;Santo Antônio da Patrulha;5;5;10;47
4316006;Rolante;4317608;Santo Antônio da Patrulha;5;5;10;19
4306106;Cruz Alta;4317509;Santo Ângelo;5;5;10;76
4311106;Jaguari;4317400;Santiago;5;5;10;31
4315602;Rio Grande;4317301;Santa Vitória do Palmar;5;5;10;195
4309605;Horizontina;4317202;Santa Rosa;5;5;10;31
4302808;Caçapava do Sul;4317004;Santana da Boa Vista;5;5;10;53
4310207;Ijuí;4316907;Santa Maria;5;5;10;145
4208203;Itajaí;4316808;Santa Cruz do Sul;5;5;10;468
4303509;Camaquã;4316808;Santa Cruz do Sul;5;5;10;137
4314076;Passo do Sobrado;4316808;Santa Cruz do Sul;5;5;10;15
4311403;Lajeado;4316758;Santa Clara do Sul;5;5;10;9
4314902;Porto Alegre;4316709;Santa Bárbara do Sul;5;5;10;276
4311304;Lagoa Vermelha;4316600;Sananduva;5;5;10;40
4314050;Parobé;4316006;Rolante;5;5;10;25
1721000;Palmas;4314902;Porto Alegre;5;5;10;2195
2903201;Barreiras;4314902;Porto Alegre;5;5;10;2054
2905701;Camaçari;4314902;Porto Alegre;5;5;10;2250
3522208;Itapecerica da Serra;4314902;Porto Alegre;5;5;10;812
3522505;Itapevi;4314902;Porto Alegre;5;5;10;824
4105805;Colombo;4314902;Porto Alegre;5;5;10;563
4109807;Ibiporã;4314902;Porto Alegre;5;5;10;752
4118501;Pato Branco;4314902;Porto Alegre;5;5;10;446
4201406;Araranguá;4314902;Porto Alegre;5;5;10;205
4202305;Biguaçu;4314902;Porto Alegre;5;5;10;370
4301909;Barra do Ribeiro;4314902;Porto Alegre;5;5;10;29
4304903;Casca;4314902;Porto Alegre;5;5;10;181
4305439;Chuí;4314902;Porto Alegre;5;5;10;459
4307559;Estação;4314902;Porto Alegre;5;5;10;258
4308805;General Câmara;4314902;Porto Alegre;5;5;10;58
4311106;Jaguari;4314902;Porto Alegre;5;5;10;349
4314407;Pelotas;4314506;Pinheiro Machado;5;5;10;96
3106200;Belo Horizonte;4314407;Pelotas;5;5;10;1513
4106902;Curitiba;4314407;Pelotas;5;5;10;753
4313409;Novo Hamburgo;4314407;Pelotas;5;5;10;254
3106200;Belo Horizonte;4314100;Passo Fundo;5;5;10;1223
4307906;Farroupilha;4314100;Passo Fundo;5;5;10;150
4309407;Guaporé;4314100;Passo Fundo;5;5;10;81
4312138;Mato Castelhano;4314100;Passo Fundo;5;5;10;20
4303905;Campo Bom;4314050;Parobé;5;5;10;22
4300109;Agudo;4314027;Paraíso do Sul;5;5;10;9
4304705;Carazinho;4313904;Panambi;5;5;10;70
4306106;Cruz Alta;4313904;Panambi;5;5;10;42
4308508;Frederico Westphalen;4313706;Palmeira das Missões;5;5;10;61
4305801;Constantina;4313466;Novo Xingu;5;5;10;6
3106200;Belo Horizonte;4313409;Novo Hamburgo;5;5;10;1272
4202404;Blumenau;4313409;Novo Hamburgo;5;5;10;361
4216305;São João Batista;4313409;Novo Hamburgo;5;5;10;345
3550308;São Paulo;4313375;Nova Santa Rita;5;5;10;813
4308201;Flores da Cunha;4313086;Nova Pádua;5;5;10;12
4300406;Alegrete;4311759;Manoel Viana;5;5;10;37
4302709;Butiá;4311403;Lajeado;5;5;10;75
4307708;Esteio;4311403;Lajeado;5;5;10;95
4310207;Ijuí;4311403;Lajeado;5;5;10;216
4309902;Ibiraiaras;4311304;Lagoa Vermelha;5;5;10;21
4305108;Caxias do Sul;4311122;Jaquirana;5;5;10;85
4304705;Carazinho;4310009;Ibirubá;5;5;10;48
4304903;Casca;4309407;Guaporé;5;5;10;32
4106902;Curitiba;4309209;Gravataí;5;5;10;524
4304630;Capão da Canoa;4309100;Gramado;5;5;10;93
3550308;São Paulo;4308201;Flores da Cunha;5;5;10;735
4300802;Antônio Prado;4308201;Flores da Cunha;5;5;10;21
3550308;São Paulo;4307807;Estrela;5;5;10;820
3304557;Rio de Janeiro;4307708;Esteio;5;5;10;1071
4101804;Araucária;4307708;Esteio;5;5;10;501
4301552;Áurea;4307005;Erechim;5;5;10;24
4301701;Barão de Cotegipe;4307005;Erechim;5;5;10;10
4300703;Anta Gorda;4306809;Encantado;5;5;10;30
4300471;Almirante Tamandaré do Sul;4305306;Chapada;5;5;10;17
4303707;Campina das Missões;4305207;Cerro Largo;5;5;10;21
2304400;Fortaleza;4305108;Caxias do Sul;5;5;10;3037
3118601;Contagem;4305108;Caxias do Sul;5;5;10;1220
3513009;Cotia;4305108;Caxias do Sul;5;5;10;736
3520509;Indaiatuba;4305108;Caxias do Sul;5;5;10;768
3552205;Sorocaba;4305108;Caxias do Sul;5;5;10;719
4125506;São José dos Pinhais;4305108;Caxias do Sul;5;5;10;444
4204202;Chapecó;4305108;Caxias do Sul;5;5;10;267
4204608;Criciúma;4305108;Caxias do Sul;5;5;10;182
4302303;Bom Jesus;4305108;Caxias do Sul;5;5;10;90
4303608;Cambará do Sul;4305108;Caxias do Sul;5;5;10;101
4304705;Carazinho;4305108;Caxias do Sul;5;5;10;183
4301651;Barão;4304804;Carlos Barbosa;5;5;10;9
4106902;Curitiba;4304705;Carazinho;5;5;10;463
3550308;São Paulo;4304408;Canela;5;5;10;743
3550308;São Paulo;4303509;Camaquã;5;5;10;928
4205407;Florianópolis;4219507;Xanxerê;5;5;10;397
4203600;Campos Novos;4219309;Videira;5;5;10;47
4204202;Chapecó;4219309;Videira;5;5;10;147
4218509;Treze Tílias;4219309;Videira;5;5;10;25
4204251;Cocal do Sul;4219002;Urussanga;5;5;10;11
4211900;Palhoça;4218707;Tubarão;5;5;10;97
4217006;São Ludgero;4218707;Tubarão;5;5;10;22
4217709;Sombrio;4218707;Tubarão;5;5;10;91
3550308;São Paulo;4218301;Três Barras;5;5;10;454
3550308;São Paulo;4218202;Timbó;5;5;10;437
4208906;Jaraguá do Sul;4218202;Timbó;5;5;10;44
4202008;Balneário Camboriú;4218004;Tijucas;5;5;10;28
4202909;Brusque;4218004;Tijucas;5;5;10;32
4204608;Criciúma;4218004;Tijucas;5;5;10;175
4215307;Salete;4217808;Taió;5;5;10;16
4202073;Balneário Gaivota;4217709;Sombrio;5;5;10;6
4204301;Concórdia;4217204;São Miguel do Oeste;5;5;10;163
4206405;Guaraciaba;4217204;São Miguel do Oeste;5;5;10;12
4108403;Francisco Beltrão;4216909;São Lourenço do Oeste;5;5;10;37
4125506;São José dos Pinhais;4216602;São José;5;5;10;231
4209409;Laguna;4216602;São José;5;5;10;100
4202404;Blumenau;4215802;São Bento do Sul;5;5;10;82
4205407;Florianópolis;4215802;São Bento do Sul;5;5;10;171
4203006;Caçador;4215505;Santa Cecília;5;5;10;65
4213351;Ponte Alta do Norte;4215505;Santa Cecília;5;5;10;20
4202404;Blumenau;4215109;Rodeio;5;5;10;29
4200200;Agrolândia;4214805;Rio do Sul;5;5;10;29
4200309;Agronômica;4214805;Rio do Sul;5;5;10;13
4202008;Balneário Camboriú;4214805;Rio do Sul;5;5;10;96
4208203;Itajaí;4213500;Porto Belo;5;5;10;29
4208906;Jaraguá do Sul;4213203;Pomerode;5;5;10;30
4202404;Blumenau;4212502;Penha;5;5;10;44
4202404;Blumenau;4211900;Palhoça;5;5;10;84
4209607;Lauro Muller;4211702;Orleans;5;5;10;10
4202008;Balneário Camboriú;4211306;Navegantes;5;5;10;12
4205407;Florianópolis;4211306;Navegantes;5;5;10;81
4201406;Araranguá;4210407;Maracajá;5;5;10;12
4203808;Canoinhas;4210308;Major Vieira;5;5;10;20
4208203;Itajaí;4210100;Mafra;5;5;10;140
4205506;Fraiburgo;4209706;Lebon Régis;5;5;10;25
4204608;Criciúma;4209607;Lauro Muller;5;5;10;30
4205407;Florianópolis;4209409;Laguna;5;5;10;102
3525904;Jundiaí;4209102;Joinville;5;5;10;394
3547809;Santo André;4209102;Joinville;5;5;10;372
3304557;Rio de Janeiro;4209003;Joaçaba;5;5;10;935
4204202;Chapecó;4208906;Jaraguá do Sul;5;5;10;361
4207403;Imbuia;4208500;Ituporanga;5;5;10;20
4109609;Guaratuba;4208450;Itapoá;5;5;10;19
4203204;Camboriú;4208302;Itapema;5;5;10;9
4205902;Gaspar;4208302;Itapema;5;5;10;36
3201308;Cariacica;4208203;Itajaí;5;5;10;1093
3501608;Americana;4208203;Itajaí;5;5;10;485
3515004;Embu;4208203;Itajaí;5;5;10;409
3525904;Jundiaí;4208203;Itajaí;5;5;10;454
3549904;São José dos Campos;4208203;Itajaí;5;5;10;500
4115200;Maringá;4208203;Itajaí;5;5;10;498
4202107;Barra Velha;4208203;Itajaí;5;5;10;35
3550308;São Paulo;4207007;Içara;5;5;10;616
4202404;Blumenau;4206504;Guaramirim;5;5;10;53
4106902;Curitiba;4205506;Fraiburgo;5;5;10;238
3205309;Vitória;4205407;Florianópolis;5;5;10;1132
4104808;Cascavel;4205407;Florianópolis;5;5;10;564
4202503;Bom Jardim da Serra;4205407;Florianópolis;5;5;10;137
4202206;Benedito Novo;4205159;Doutor Pedrinho;5;5;10;14
3518800;Guarulhos;4204608;Criciúma;5;5;10;639
4115200;Maringá;4204608;Criciúma;5;5;10;628
4203956;Capivari de Baixo;4204608;Criciúma;5;5;10;48
4115200;Maringá;4204202;Chapecó;5;5;10;413
4119905;Ponta Grossa;4204202;Chapecó;5;5;10;328
4203600;Campos Novos;4204152;Celso Ramos;5;5;10;26
4115309;Mariópolis;4204004;Catanduvas;5;5;10;117
4122305;Rio Negro;4203808;Canoinhas;5;5;10;63
4202404;Blumenau;4203006;Caçador;5;5;10;201
2304400;Fortaleza;4202404;Blumenau;5;5;10;2748
4201703;Ascurra;4202404;Blumenau;5;5;10;32
4118501;Pato Branco;4128708;Vitorino;5;5;10;13
4106902;Curitiba;4128633;Doutor Ulysses;5;5;10;97
4124103;Santo Antônio da Platina;4128500;Wenceslau Braz;5;5;10;70
4118907;Pérola;4128104;Umuarama;5;5;10;38
4104808;Cascavel;4128005;Ubiratã;5;5;10;65
4112959;Juranda;4128005;Ubiratã;5;5;10;20
4102000;Assis Chateaubriand;4127700;Toledo;5;5;10;40
4127106;Telêmaco Borba;4127502;Tibagi;5;5;10;31
4115200;Maringá;4127106;Telêmaco Borba;5;5;10;164
4119905;Ponta Grossa;4127007;Teixeira Soares;5;5;10;42
4106605;Cruzeiro do Oeste;4126801;Tapejara;5;5;10;21
4114807;Marialva;4126256;Sarandi;5;5;10;10
4115606;Matelândia;4125704;São Miguel do Iguaçu;5;5;10;28
4106902;Curitiba;4125605;São Mateus do Sul;5;5;10;118
4110706;Irati;4125605;São Mateus do Sul;5;5;10;47
1302603;Manaus;4125506;São José dos Pinhais;5;5;10;2688
2304400;Fortaleza;4125506;São José dos Pinhais;5;5;10;2614
2611606;Recife;4125506;São José dos Pinhais;5;5;10;2361
3513009;Cotia;4125506;São José dos Pinhais;5;5;10;311
4104808;Cascavel;4125506;São José dos Pinhais;5;5;10;434
4105805;Colombo;4125506;São José dos Pinhais;5;5;10;32
4113700;Londrina;4124103;Santo Antônio da Platina;5;5;10;107
4121000;Querência do Norte;4123303;Santa Cruz de Monte Castelo;5;5;10;24
4108403;Francisco Beltrão;4121406;Realeza;5;5;10;60
4104808;Cascavel;4120903;Quedas do Iguaçu;5;5;10;78
4114609;Marechal Cândido Rondon;4120853;Quatro Pontes;5;5;10;8
4104006;Campina Grande do Sul;4120804;Quatro Barras;5;5;10;7
3106200;Belo Horizonte;4119905;Ponta Grossa;5;5;10;841
4108403;Francisco Beltrão;4119905;Ponta Grossa;5;5;10;312
4106902;Curitiba;4119400;Piraí do Sul;5;5;10;117
3505708;Barueri;4119152;Pinhais;5;5;10;315
4101804;Araucária;4119152;Pinhais;5;5;10;26
4107207;Dois Vizinhos;4118501;Pato Branco;5;5;10;67
4118006;Paraíso do Norte;4118402;Paranavaí;5;5;10;26
4104808;Cascavel;4118204;Paranaguá;5;5;10;496
4109609;Guaratuba;4118204;Paranaguá;5;5;10;41
4106902;Curitiba;4117909;Palotina;5;5;10;477
4114609;Marechal Cândido Rondon;4117909;Palotina;5;5;10;38
4105706;Clevelândia;4117602;Palmas;5;5;10;51
4114609;Marechal Cândido Rondon;4117222;Nova Santa Rosa;5;5;10;15
4115358;Maripá;4117222;Nova Santa Rosa;5;5;10;14
4106902;Curitiba;4116208;Morretes;5;5;10;46
3550308;São Paulo;4115804;Medianeira;5;5;10;767
2927408;Salvador;4115200;Maringá;5;5;10;1764
3205309;Vitória;4115200;Maringá;5;5;10;1227
3518800;Guarulhos;4115200;Maringá;5;5;10;549
4105904;Colorado;4115200;Maringá;5;5;10;66
4106605;Cruzeiro do Oeste;4115200;Maringá;5;5;10;123
4111506;Ivaiporã;4114500;Manoel Ribas;5;5;10;31
3550308;São Paulo;4114203;Mandaguari;5;5;10;516
3523909;Itu;4113700;Londrina;5;5;10;394
3548708;São Bernardo do Campo;4113700;Londrina;5;5;10;470
4107603;Faxinal;4113700;Londrina;5;5;10;81
3550308;São Paulo;4113304;Laranjeiras do Sul;5;5;10;615
4105508;Cianorte;4113007;Jussara;5;5;10;14
4109807;Ibiporã;4112702;Jataizinho;5;5;10;7
4103800;Cambira;4112108;Jandaia do Sul;5;5;10;5
4106902;Curitiba;4111803;Jacarezinho;5;5;10;263
4107900;Floresta;4111100;Itambé;5;5;10;12
4101804;Araucária;4110706;Irati;5;5;10;125
4106902;Curitiba;4110201;Inácio Martins;5;5;10;180
4106902;Curitiba;4109807;Ibiporã;5;5;10;301
4101002;Ampére;4108403;Francisco Beltrão;5;5;10;46
4104501;Capanema;4108403;Francisco Beltrão;5;5;10;87
4104808;Cascavel;4107207;Dois Vizinhos;5;5;10;96
2905701;Camaçari;4106902;Curitiba;5;5;10;1764
3136702;Juiz de Fora;4106902;Curitiba;5;5;10;718
3513504;Cubatão;4106902;Curitiba;5;5;10;334
3530706;Mogi Guaçu;4106902;Curitiba;5;5;10;416
3536505;Paulínia;4106902;Curitiba;5;5;10;365
3542602;Registro;4106902;Curitiba;5;5;10;174
4101903;Assaí;4106902;Curitiba;5;5;10;276
4102406;Bandeirantes;4106902;Curitiba;5;5;10;279
4105201;Cerro Azul;4106902;Curitiba;5;5;10;68
4103107;Bocaiúva do Sul;4105805;Colombo;5;5;10;14
3106200;Belo Horizonte;4104808;Cascavel;5;5;10;1094
3518800;Guarulhos;4104808;Cascavel;5;5;10;712
4104501;Capanema;4104600;Capitão Leônidas Marques;5;5;10;30
4101408;Apucarana;4103701;Cambé;5;5;10;34
3534708;Ourinhos;4103602;Cambará;5;5;10;19
3300407;Barra Mansa;4101804;Araucária;5;5;10;618
3511102;Catanduva;3557105;Votuporanga;5;5;10;130
3524808;Jales;3557105;Votuporanga;5;5;10;62
3505708;Barueri;3557006;Votorantim;5;5;10;53
3523404;Itatiba;3556701;Vinhedo;5;5;10;14
3502804;Araçatuba;3556305;Valparaíso;5;5;10;43
3543402;Ribeirão Preto;3556206;Valinhos;5;5;10;217
3549904;São José dos Campos;3556206;Valinhos;5;5;10;117
3510500;Caraguatatuba;3554102;Taubaté;5;5;10;69
3504008;Assis;3553955;Tarumã;5;5;10;16
3106200;Belo Horizonte;3552502;Suzano;5;5;10;467
3509502;Campinas;3552502;Suzano;5;5;10;104
3529401;Mauá;3552502;Suzano;5;5;10;21
2607901;Jaboatão dos Guararapes;3552403;Sumaré;5;5;10;2027
3505708;Barueri;3552403;Sumaré;5;5;10;86
3518800;Guarulhos;3552403;Sumaré;5;5;10;99
3547809;Santo André;3552403;Sumaré;5;5;10;119
1721000;Palmas;3552205;Sorocaba;5;5;10;1455
3526902;Limeira;3552205;Sorocaba;5;5;10;102
3529005;Marília;3552205;Sorocaba;5;5;10;286
3530607;Moji das Cruzes;3552205;Sorocaba;5;5;10;134
3143401;Monte Sião;3552106;Socorro;5;5;10;18
2611606;Recife;3551702;Sertãozinho;5;5;10;1949
3529302;Matão;3551702;Sertãozinho;5;5;10;66
3548807;São Caetano do Sul;3551702;Sertãozinho;5;5;10;312
3106200;Belo Horizonte;3551009;São Vicente;5;5;10;513
3547601;Santa Rosa de Viterbo;3550902;São Simão;5;5;10;19
3520400;Ilhabela;3550704;São Sebastião;5;5;10;8
3502754;Araçariguama;3550605;São Roque;5;5;10;13
3505708;Barueri;3550605;São Roque;5;5;10;27
1502707;Conceição do Araguaia;3550308;São Paulo;5;5;10;1724
2312403;São Gonçalo do Amarante;3550308;São Paulo;5;5;10;2340
2606002;Garanhuns;3550308;São Paulo;5;5;10;1915
2907509;Catu;3550308;São Paulo;5;5;10;1494
2924009;Paulo Afonso;3550308;São Paulo;5;5;10;1775
2930105;Senhor do Bonfim;3550308;São Paulo;5;5;10;1594
3117306;Conceição das Alagoas;3550308;São Paulo;5;5;10;449
3119401;Coronel Fabriciano;3550308;São Paulo;5;5;10;611
3126109;Formiga;3550308;São Paulo;5;5;10;374
3131901;Itabirito;3550308;São Paulo;5;5;10;468
3139409;Manhuaçu;3550308;São Paulo;5;5;10;597
3145000;Nova Ponte;3550308;São Paulo;5;5;10;511
3145901;Ouro Branco;3550308;São Paulo;5;5;10;458
3147303;Paraisópolis;3550308;São Paulo;5;5;10;150
3149903;Perdões;3550308;São Paulo;5;5;10;325
3200409;Anchieta;3550308;São Paulo;5;5;10;677
3303609;Paracambi;3550308;São Paulo;5;5;10;321
3503802;Artur Nogueira;3550308;São Paulo;5;5;10;131
3506805;Bocaina;3550308;São Paulo;5;5;10;253
3510302;Capela do Alto;3550308;São Paulo;5;5;10;112
3519303;Ibaté;3550308;São Paulo;5;5;10;232
3520905;Ipaussu;3550308;São Paulo;5;5;10;310
3525409;Jeriquara;3550308;São Paulo;5;5;10;382
3528007;Macatuba;3550308;São Paulo;5;5;10;245
3531902;Morro Agudo;3550308;São Paulo;5;5;10;353
3538105;Pindorama;3550308;São Paulo;5;5;10;356
3543006;Ribeirão Branco;3550308;São Paulo;5;5;10;225
3544251;Rosana;3550308;São Paulo;5;5;10;662
3546702;Santa Gertrudes;3550308;São Paulo;5;5;10;160
3547007;Santa Maria da Serra;3550308;São Paulo;5;5;10;195
2611606;Recife;3549904;São José dos Campos;5;5;10;1986
3125101;Extrema;3549904;São José dos Campos;5;5;10;58
3300407;Barra Mansa;3549904;São José dos Campos;5;5;10;187
3504107;Atibaia;3549904;São José dos Campos;5;5;10;69
3536505;Paulínia;3549904;São José dos Campos;5;5;10;138
3549805;São José do Rio Preto;3549904;São José dos Campos;5;5;10;443
1500800;Ananindeua;3549805;São José do Rio Preto;5;5;10;2154
3524303;Jaboticabal;3549805;São José do Rio Preto;5;5;10;123
3525300;Jaú;3549805;São José do Rio Preto;5;5;10;182
3533007;Nova Granada;3549805;São José do Rio Preto;5;5;10;33
3533502;Novo Horizonte;3549805;São José do Rio Preto;5;5;10;73
3548708;São Bernardo do Campo;3549805;São José do Rio Preto;5;5;10;436
3170107;Uberaba;3549409;São Joaquim da Barra;5;5;10;95
3516200;Franca;3549102;São João da Boa Vista;5;5;10;169
3539301;Pirassununga;3548906;São Carlos;5;5;10;47
3538006;Pindamonhangaba;3548807;São Caetano do Sul;5;5;10;136
2607208;Ipojuca;3548708;São Bernardo do Campo;5;5;10;2036
3136702;Juiz de Fora;3548708;São Bernardo do Campo;5;5;10;394
3201308;Cariacica;3548708;São Bernardo do Campo;5;5;10;728
3301702;Duque de Caxias;3548708;São Bernardo do Campo;5;5;10;348
3304201;Resende;3548708;São Bernardo do Campo;5;5;10;254
3508504;Caçapava;3548708;São Bernardo do Campo;5;5;10;112
3509502;Campinas;3548104;Santo Antônio do Jardim;5;5;10;95
3501905;Amparo;3548005;Santo Antônio de Posse;5;5;10;19
2611606;Recife;3547809;Santo André;5;5;10;2059
2927408;Salvador;3547809;Santo André;5;5;10;1423
3541000;Praia Grande;3547809;Santo André;5;5;10;42
3205200;Vila Velha;3547304;Santana de Parnaíba;5;5;10;746
3301702;Duque de Caxias;3547304;Santana de Parnaíba;5;5;10;375
3519071;Hortolândia;3545803;Santa Bárbara d'Oeste;5;5;10;23
3509502;Campinas;3545209;Salto;5;5;10;41
3501608;Americana;3543907;Rio Claro;5;5;10;44
2704302;Maceió;3543402;Ribeirão Preto;5;5;10;1760
3509403;Cajuru;3543402;Ribeirão Preto;5;5;10;53
3530508;Mococa;3543402;Ribeirão Preto;5;5;10;86
3541406;Presidente Prudente;3542206;Rancharia;5;5;10;53
3505609;Barrinha;3540903;Pradópolis;5;5;10;21
3526704;Leme;3539301;Pirassununga;5;5;10;20
3205002;Serra;3538709;Piracicaba;5;5;10;801
3503208;Araraquara;3538709;Piracicaba;5;5;10;120
3505302;Barra Bonita;3538709;Piracicaba;5;5;10;98
3518800;Guarulhos;3538709;Piracicaba;5;5;10;135
3523909;Itu;3538709;Piracicaba;5;5;10;69
3533403;Nova Odessa;3538709;Piracicaba;5;5;10;35
2906501;Candeias;3536505;Paulínia;5;5;10;1408
3170107;Uberaba;3536505;Paulínia;5;5;10;343
3525904;Jundiaí;3536505;Paulínia;5;5;10;53
3300407;Barra Mansa;3536406;Paulicéia;5;5;10;807
3509254;Cajati;3536208;Pariquera-Açu;5;5;10;25
2602902;Cabo de Santo Agostinho;3534401;Osasco;5;5;10;2044
3502754;Araçariguama;3534401;Osasco;5;5;10;29
3531803;Monte Mor;3534401;Osasco;5;5;10;84
3509502;Campinas;3533403;Nova Odessa;5;5;10;29
3523404;Itatiba;3532009;Morungaba;5;5;10;15
3518602;Guariba;3531308;Monte Alto;5;5;10;28
3524709;Jaguariúna;3530805;Moji-Mirim;5;5;10;31
3505708;Barueri;3530706;Mogi Guaçu;5;5;10;131
3524709;Jaguariúna;3530706;Mogi Guaçu;5;5;10;42
3518701;Guarujá;3530607;Moji das Cruzes;5;5;10;45
3104106;Arceburgo;3530508;Mococa;5;5;10;16
3525300;Jaú;3529807;Mineiros do Tietê;5;5;10;19
3518800;Guarulhos;3529401;Mauá;5;5;10;28
3106200;Belo Horizonte;3529005;Marília;5;5;10;663
3507506;Botucatu;3529005;Marília;5;5;10;172
3508801;Cafelândia;3527108;Lins;5;5;10;22
3503802;Artur Nogueira;3526902;Limeira;5;5;10;23
2611606;Recife;3525904;Jundiaí;5;5;10;2040
3205002;Serra;3525904;Jundiaí;5;5;10;749
3504107;Atibaia;3525201;Jarinu;5;5;10;18
3304557;Rio de Janeiro;3525003;Jandira;5;5;10;378
3519055;Holambra;3524709;Jaguariúna;5;5;10;11
3106200;Belo Horizonte;3524402;Jacareí;5;5;10;427
3517703;Guará;3524105;Ituverava;5;5;10;9
3505708;Barueri;3524006;Itupeva;5;5;10;44
3304557;Rio de Janeiro;3523404;Itatiba;5;5;10;367
3520509;Indaiatuba;3523404;Itatiba;5;5;10;42
3507159;Bom Sucesso de Itararé;3523206;Itararé;5;5;10;31
3106200;Belo Horizonte;3523107;Itaquaquecetuba;5;5;10;463
3503208;Araraquara;3522703;Itápolis;5;5;10;70
3134905;Jacutinga;3522604;Itapira;5;5;10;27
3502705;Apiaí;3522406;Itapeva;5;5;10;59
3511508;Cerquilho;3522307;Itapetininga;5;5;10;56
3520301;Iguape;3520426;Ilha Comprida;5;5;10;4
3503802;Artur Nogueira;3519055;Holambra;5;5;10;14
2408102;Natal;3518800;Guarulhos;5;5;10;2242
2504009;Campina Grande;3518800;Guarulhos;5;5;10;2077
2611101;Petrolina;3518800;Guarulhos;5;5;10;1672
2704302;Maceió;3518800;Guarulhos;5;5;10;1861
3506508;Birigui;3518800;Guarulhos;5;5;10;450
3506508;Birigui;3518206;Guararapes;5;5;10;31
3516606;Gália;3516705;Garça;5;5;10;13
3115102;Cássia;3516200;Franca;5;5;10;50
3148103;Patrocínio;3516200;Franca;5;5;10;182
3151800;Poços de Caldas;3515186;Espírito Santo do Pinhal;5;5;10;51
3205002;Serra;3513801;Diadema;5;5;10;748
3509502;Campinas;3513801;Diadema;5;5;10;98
3170107;Uberaba;3513504;Cubatão;5;5;10;484
3509700;Campos do Jordão;3513009;Cotia;5;5;10;168
3506508;Birigui;3512506;Coroados;5;5;10;8
3505500;Barretos;3512001;Colina;5;5;10;18
3505500;Barretos;3511102;Catanduva;5;5;10;78
3505708;Barueri;3509700;Campos do Jordão;5;5;10;160
3205200;Vila Velha;3509502;Campinas;5;5;10;737
3503802;Artur Nogueira;3509502;Campinas;5;5;10;38
3507001;Boituva;3509502;Campinas;5;5;10;76
3506508;Birigui;3508108;Buritama;5;5;10;33
3503406;Arealva;3506003;Bauru;5;5;10;39
3504503;Avaré;3506003;Bauru;5;5;10;85
2307650;Maracanaú;3505708;Barueri;5;5;10;2317
3302007;Itaguaí;3505708;Barueri;5;5;10;322
3304557;Rio de Janeiro;3505500;Barretos;5;5;10;616
3502804;Araçatuba;3503208;Araraquara;5;5;10;244
3118601;Contagem;3501608;Americana;5;5;10;455
3201308;Cariacica;3501608;Americana;5;5;10;754
3151800;Poços de Caldas;3500402;Águas da Prata;5;5;10;26
3301900;Itaboraí;3305505;Saquarema;5;5;10;42
3302700;Maricá;3305505;Saquarema;5;5;10;37
3300605;Bom Jesus do Itabapoana;3304706;Santo Antônio de Pádua;5;5;10;68
1600600;Santana;3304557;Rio de Janeiro;5;5;10;2646
2100055;Açailândia;3304557;Rio de Janeiro;5;5;10;2025
2501807;Bayeux;3304557;Rio de Janeiro;5;5;10;1927
2707701;Rio Largo;3304557;Rio de Janeiro;5;5;10;1654
2801504;Carmópolis;3304557;Rio de Janeiro;5;5;10;1490
2910057;Dias d'Ávila;3304557;Rio de Janeiro;5;5;10;1239
2910727;Eunápolis;3304557;Rio de Janeiro;5;5;10;810
3160702;Santos Dumont;3304557;Rio de Janeiro;5;5;10;158
3303302;Niterói;3304524;Rio das Ostras;5;5;10;127
3301702;Duque de Caxias;3304300;Rio Bonito;5;5;10;71
3302403;Macaé;3304300;Rio Bonito;5;5;10;84
3301702;Duque de Caxias;3304144;Queimados;5;5;10;28
3300803;Cachoeiras de Macacu;3303401;Nova Friburgo;5;5;10;20
3303203;Nilópolis;3303302;Niterói;5;5;10;35
3301702;Duque de Caxias;3303203;Nilópolis;5;5;10;13
3302858;Mesquita;3303203;Nilópolis;5;5;10;2
3300209;Araruama;3302700;Maricá;5;5;10;48
2800308;Aracaju;3302403;Macaé;5;5;10;1357
3300233;Armação dos Búzios;3302403;Macaé;5;5;10;40
3302205;Itaperuna;3302403;Macaé;5;5;10;135
3300159;Aperibé;3302106;Itaocara;5;5;10;11
3170206;Uberlândia;3301702;Duque de Caxias;5;5;10;659
3300704;Cabo Frio;3301306;Casimiro de Abreu;5;5;10;45
3205002;Serra;3301009;Campos dos Goytacazes;5;5;10;212
3106200;Belo Horizonte;3300407;Barra Mansa;5;5;10;292
3118601;Contagem;3300407;Barra Mansa;5;5;10;289
1302603;Manaus;3205309;Vitória;5;5;10;2749
1501402;Belém;3205309;Vitória;5;5;10;2242
2408102;Natal;3205309;Vitória;5;5;10;1677
2609600;Olinda;3205309;Vitória;5;5;10;1462
2931350;Teixeira de Freitas;3205309;Vitória;5;5;10;305
3139409;Manhuaçu;3205309;Vitória;5;5;10;184
3202454;Ibatiba;3205309;Vitória;5;5;10;126
3205010;Sooretama;3205309;Vitória;5;5;10;119
3205150;Vila Pavão;3205309;Vitória;5;5;10;184
3113404;Caratinga;3205200;Vila Velha;5;5;10;200
3139409;Manhuaçu;3205101;Viana;5;5;10;157
2607901;Jaboatão dos Guararapes;3205002;Serra;5;5;10;1433
3106705;Betim;3205002;Serra;5;5;10;406
3200904;Barra de São Francisco;3204906;São Mateus;5;5;10;109
3201209;Cachoeiro de Itapemirim;3203809;Muqui;5;5;10;30
3201506;Colatina;3203353;Marilândia;5;5;10;18
3201308;Cariacica;3203346;Marechal Floriano;5;5;10;30
2915601;Itamaraju;3203205;Linhares;5;5;10;263
3200904;Barra de São Francisco;3203205;Linhares;5;5;10;113
3200300;Alfredo Chaves;3202405;Guarapari;5;5;10;19
3201209;Cachoeiro de Itapemirim;3202108;Ecoporanga;5;5;10;277
2910727;Eunápolis;3200607;Aracruz;5;5;10;388
3124005;Ervália;3171303;Viçosa;5;5;10;27
3118601;Contagem;3171204;Vespasiano;5;5;10;29
3162955;São José da Lapa;3171204;Vespasiano;5;5;10;4
3143104;Monte Carmelo;3171006;Vazante;5;5;10;98
3147006;Paracatu;3171006;Vazante;5;5;10;85
3128709;Guaxupé;3170701;Varginha;5;5;10;138
3113404;Caratinga;3170578;Vargem Alegre;5;5;10;26
2507507;João Pessoa;3170206;Uberlândia;5;5;10;1890
3106705;Betim;3170206;Uberlândia;5;5;10;446
3118205;Conquista;3170107;Uberaba;5;5;10;45
3145000;Nova Ponte;3170107;Uberaba;5;5;10;71
3118304;Conselheiro Lafaiete;3169901;Ubá;5;5;10;100
3143302;Montes Claros;3169901;Ubá;5;5;10;491
3155801;Rio Pomba;3169901;Ubá;5;5;10;29
3156304;Rodeiro;3169901;Ubá;5;5;10;17
3106200;Belo Horizonte;3169307;Três Corações;5;5;10;234
3139201;Malacacheta;3168606;Teófilo Otoni;5;5;10;60
3152402;Poté;3168606;Teófilo Otoni;5;5;10;30
3157807;Santa Luzia;3167202;Sete Lagoas;5;5;10;55
3154002;Raul Soares;3164001;São Pedro dos Ferros;5;5;10;12
3104908;Baependi;3163706;São Lourenço;5;5;10;24
3106200;Belo Horizonte;3163706;São Lourenço;5;5;10;268
3155405;Rio Novo;3162906;São João Nepomuceno;5;5;10;15
3106200;Belo Horizonte;3162708;São João do Paraíso;5;5;10;550
3131703;Itabira;3161908;São Gonçalo do Rio Abaixo;5;5;10;25
3122306;Divinópolis;3161809;São Gonçalo do Pará;5;5;10;20
3135209;Januária;3161106;São Francisco;5;5;10;74
3154903;Rio Casca;3160108;Santo Antônio do Grama;5;5;10;11
3131505;Ipuiúna;3159209;Santa Rita de Caldas;5;5;10;17
3113404;Caratinga;3157252;Santa Bárbara do Leste;5;5;10;20
3131703;Itabira;3157203;Santa Bárbara;5;5;10;41
3106200;Belo Horizonte;3157005;Salinas;5;5;10;450
3136207;João Monlevade;3155702;Rio Piracicaba;5;5;10;13
3104007;Araxá;3155504;Rio Paranaíba;5;5;10;86
3114303;Carmo do Paranaíba;3155504;Rio Paranaíba;5;5;10;24
3106200;Belo Horizonte;3154804;Rio Acima;5;5;10;29
3144805;Nova Lima;3154804;Rio Acima;5;5;10;10
3101102;Aimorés;3154309;Resplendor;5;5;10;26
3134202;Ituiutaba;3152808;Prata;5;5;10;63
3140001;Mariana;3152105;Ponte Nova;5;5;10;53
3112802;Capitólio;3151503;Piumhi;5;5;10;19
3107406;Bom Despacho;3151404;Pitangui;5;5;10;42
3147105;Pará de Minas;3151404;Pitangui;5;5;10;35
3128402;Guarani;3151305;Piraúba;5;5;10;9
3127107;Frutal;3150703;Pirajuba;5;5;10;37
3126109;Formiga;3150505;Pimenta;5;5;10;39
3128907;Guimarânia;3148004;Patos de Minas;5;5;10;42
3129509;Ibiá;3148004;Patos de Minas;5;5;10;96
3137502;Lagoa Formosa;3148004;Patos de Minas;5;5;10;24
3101607;Alfenas;3147907;Passos;5;5;10;104
3117801;Conceição dos Ouros;3147303;Paraisópolis;5;5;10;16
3132404;Itajubá;3147303;Paraisópolis;5;5;10;35
3101607;Alfenas;3147204;Paraguaçu;5;5;10;28
3118601;Contagem;3147105;Pará de Minas;5;5;10;56
3145208;Nova Serrana;3147105;Pará de Minas;5;5;10;38
3106200;Belo Horizonte;3147006;Paracatu;5;5;10;432
3126109;Formiga;3146503;Pains;5;5;10;27
3108305;Borda da Mata;3146008;Ouro Fino;5;5;10;21
3138203;Lavras;3145604;Oliveira;5;5;10;61
3137205;Lagoa da Prata;3145208;Nova Serrana;5;5;10;60
3136207;João Monlevade;3144706;Nova Era;5;5;10;15
3113701;Carlos Chagas;3144300;Nanuque;5;5;10;47
3109501;Cabo Verde;3144102;Muzambinho;5;5;10;17
3101508;Além Paraíba;3143906;Muriaé;5;5;10;91
3139409;Manhuaçu;3143906;Muriaé;5;5;10;97
3142205;Miraí;3143906;Muriaé;5;5;10;32
3118809;Coração de Jesus;3143302;Montes Claros;5;5;10;53
3131307;Ipatinga;3143302;Montes Claros;5;5;10;335
3103504;Araguari;3143104;Monte Carmelo;5;5;10;75
3131604;Iraí de Minas;3143104;Monte Carmelo;5;5;10;29
3107406;Bom Despacho;3142403;Moema;5;5;10;20
3106200;Belo Horizonte;3141108;Matozinhos;5;5;10;39
3124203;Espera Feliz;3139508;Manhumirim;5;5;10;33
3127701;Governador Valadares;3139409;Manhuaçu;5;5;10;158
3138203;Lavras;3138708;Luminárias;5;5;10;33
3134400;Iturama;3138625;Limeira do Oeste;5;5;10;45
3107109;Boa Esperança;3138203;Lavras;5;5;10;60
3118601;Contagem;3138203;Lavras;5;5;10;173
3122306;Divinópolis;3138203;Lavras;5;5;10;119
3105103;Bambuí;3137205;Lagoa da Prata;5;5;10;47
2927408;Salvador;3136702;Juiz de Fora;5;5;10;1087
3128402;Guarani;3136702;Juiz de Fora;5;5;10;54
3106200;Belo Horizonte;3136652;Juatuba;5;5;10;38
3119401;Coronel Fabriciano;3136207;João Monlevade;5;5;10;66
3108305;Borda da Mata;3134905;Jacutinga;5;5;10;46
3111804;Canápolis;3134202;Ituiutaba;5;5;10;38
3107406;Bom Despacho;3133808;Itaúna;5;5;10;82
3108909;Brasópolis;3132404;Itajubá;5;5;10;16
3115508;Caxambu;3132404;Itajubá;5;5;10;72
3114501;Carmópolis de Minas;3132206;Itaguara;5;5;10;23
3118304;Conselheiro Lafaiete;3131901;Itabirito;5;5;10;41
3128006;Guanhães;3131703;Itabira;5;5;10;104
3108008;Bom Sucesso;3130002;Ibituruna;5;5;10;13
3106200;Belo Horizonte;3128709;Guaxupé;5;5;10;323
3106705;Betim;3127701;Governador Valadares;5;5;10;266
3118403;Conselheiro Pena;3127701;Governador Valadares;5;5;10;66
1302603;Manaus;3125101;Extrema;5;5;10;2566
3112109;Caparaó;3124203;Espera Feliz;5;5;10;14
3106705;Betim;3124104;Esmeraldas;5;5;10;25
3106705;Betim;3122306;Divinópolis;5;5;10;76
3113305;Carangola;3122009;Divino;5;5;10;18
3106200;Belo Horizonte;3119104;Corinto;5;5;10;177
2906501;Candeias;3118601;Contagem;5;5;10;983
3106200;Belo Horizonte;3115300;Cataguases;5;5;10;211
3105608;Barbacena;3113206;Carandaí;5;5;10;27
3100609;Água Boa;3112307;Capelinha;5;5;10;38
3106200;Belo Horizonte;3112307;Capelinha;5;5;10;290
3106200;Belo Horizonte;3108602;Brasília de Minas;5;5;10;412
3106200;Belo Horizonte;3107406;Bom Despacho;5;5;10;136
3106200;Belo Horizonte;3106309;Belo Oriente;5;5;10;175
1600303;Macapá;3106200;Belo Horizonte;5;5;10;2323
2105302;Imperatriz;3106200;Belo Horizonte;5;5;10;1630
2408003;Mossoró;3106200;Belo Horizonte;5;5;10;1761
2604106;Caruaru;3106200;Belo Horizonte;5;5;10;1521
2609600;Olinda;3106200;Belo Horizonte;5;5;10;1609
2914802;Itabuna;3106200;Belo Horizonte;5;5;10;745
3101706;Almenara;3106200;Belo Horizonte;5;5;10;535
3101631;Alfredo Vasconcelos;3105608;Barbacena;5;5;10;7
3101706;Almenara;3103405;Araçuaí;5;5;10;162
2925006;Planalto;2933307;Vitória da Conquista;5;5;10;42
2926103;Retirolândia;2933000;Valente;5;5;10;10
2928000;Santaluz;2933000;Valente;5;5;10;20
2918001;Jequié;2932903;Valença;5;5;10;116
2900801;Alcobaça;2931350;Teixeira de Freitas;5;5;10;53
2921104;Medeiros Neto;2931350;Teixeira de Freitas;5;5;10;56
2611101;Petrolina;2930105;Senhor do Bonfim;5;5;10;131
2917706;Jaguarari;2930105;Senhor do Bonfim;5;5;10;20
2913200;Ibotirama;2929909;Seabra;5;5;10;163
2927408;Salvador;2929107;São Felipe;5;5;10;69
2928109;Santa Maria da Vitória;2929057;São Félix do Coribe;5;5;10;7
2904902;Cachoeira;2929008;São Félix;5;5;10;7
2928109;Santa Maria da Vitória;2928208;Santana;5;5;10;45
2903201;Barreiras;2928109;Santa Maria da Vitória;5;5;10;150
2908408;Conceição do Coité;2928000;Santaluz;5;5;10;32
2504009;Campina Grande;2927408;Salvador;5;5;10;697
2610707;Paulista;2927408;Salvador;5;5;10;679
2700300;Arapiraca;2927408;Salvador;5;5;10;405
2903904;Bom Jesus da Lapa;2927408;Salvador;5;5;10;533
2916104;Itaparica;2927408;Salvador;5;5;10;22
2919926;Madre de Deus;2927408;Salvador;5;5;10;32
2926608;Ribeira do Pombal;2927408;Salvador;5;5;10;240
2907202;Casa Nova;2926004;Remanso;5;5;10;140
2915601;Itamaraju;2925303;Porto Seguro;5;5;10;78
2702405;Delmiro Gouveia;2924009;Paulo Afonso;5;5;10;37
2800308;Aracaju;2924009;Paulo Afonso;5;5;10;212
2807105;Simão Dias;2923803;Paripiranga;5;5;10;8
2911709;Guanambi;2923407;Palmas de Monte Alto;5;5;10;40
2904902;Cachoeira;2922300;Muritiba;5;5;10;8
2906501;Candeias;2919926;Madre de Deus;5;5;10;11
2906501;Candeias;2919207;Lauro de Freitas;5;5;10;34
2910800;Feira de Santana;2918407;Juazeiro;5;5;10;355
2904605;Brumado;2918001;Jequié;5;5;10;177
2913606;Ilhéus;2918001;Jequié;5;5;10;149
2916906;Itiruçu;2917607;Jaguaquara;5;5;10;21
2607208;Ipojuca;2914802;Itabuna;5;5;10;837
2912103;Ibicaraí;2914802;Itabuna;5;5;10;30
2913903;Ipiaú;2914802;Itabuna;5;5;10;90
2913101;Ibititá;2914604;Irecê;5;5;10;26
2905008;Caculé;2912004;Ibiassucê;5;5;10;28
2408102;Natal;2910800;Feira de Santana;5;5;10;820
2909802;Cruz das Almas;2910800;Feira de Santana;5;5;10;49
2900702;Alagoinhas;2905701;Camaçari;5;5;10;63
2611606;Recife;2804805;Nossa Senhora do Socorro;5;5;10;386
2800308;Aracaju;2801504;Carmópolis;5;5;10;29
2800308;Aracaju;2800506;Areia Branca;5;5;10;27
2604106;Caruaru;2800308;Aracaju;5;5;10;312
2701308;Cajueiro;2709400;Viçosa;5;5;10;10
2704302;Maceió;2708006;Santana do Ipanema;5;5;10;166
2607901;Jaboatão dos Guararapes;2704708;Marechal Deodoro;5;5;10;200
2504009;Campina Grande;2704302;Maceió;5;5;10;269
2700300;Arapiraca;2702405;Delmiro Gouveia;5;5;10;150
2604106;Caruaru;2616407;Vitória de Santo Antão;5;5;10;80
2601201;Arcoverde;2616001;Venturosa;5;5;10;26
2613602;São José do Egito;2614600;Tabira;5;5;10;30
2608107;João Alfredo;2614501;Surubim;5;5;10;18
2602902;Cabo de Santo Agostinho;2614204;Sirinhaém;5;5;10;36
2601706;Belo Jardim;2613008;São Bento do Una;5;5;10;23
2605004;Cupira;2612505;Santa Cruz do Capibaribe;5;5;10;78
2610905;Pesqueira;2612406;Sanharó;5;5;10;19
2609600;Olinda;2611101;Petrolina;5;5;10;634
2604007;Carpina;2610608;Paudalho;5;5;10;10
2607901;Jaboatão dos Guararapes;2610004;Palmares;5;5;10;88
2603009;Cabrobó;2609808;Orocó;5;5;10;35
2600054;Abreu e Lima;2609600;Olinda;5;5;10;11
2603108;Cachoeirinha;2608800;Lajedo;5;5;10;22
2501807;Bayeux;2607901;Jaboatão dos Guararapes;5;5;10;110
2605202;Escada;2607208;Ipojuca;5;5;10;18
2606200;Goiana;2606804;Igarassu;5;5;10;32
2604502;Chã Grande;2606408;Gravatá;5;5;10;12
2601904;Bezerros;2604106;Caruaru;5;5;10;23
2600500;Águas Belas;2601201;Arcoverde;5;5;10;75
2307304;Juazeiro do Norte;2601102;Araripina;5;5;10;134
2504306;Catolé do Rocha;2507507;João Pessoa;5;5;10;332
2506004;Esperança;2507507;João Pessoa;5;5;10;110
2304400;Fortaleza;2506301;Guarabira;5;5;10;479
2501906;Belém;2506301;Guarabira;5;5;10;12
2503209;Cabedelo;2504009;Campina Grande;5;5;10;117
2304400;Fortaleza;2503704;Cajazeiras;5;5;10;346
2409407;Pau dos Ferros;2412500;São Miguel;5;5;10;29
2408300;Nova Cruz;2411502;Santo Antônio;5;5;10;20
2408102;Natal;2411205;Santa Cruz;5;5;10;97
2307601;Limoeiro do Norte;2408003;Mossoró;5;5;10;82
2302602;Camocim;2312908;Sobral;5;5;10;100
2303709;Caucaia;2312908;Sobral;5;5;10;188
2304400;Fortaleza;2312304;São Benedito;5;5;10;259
2311504;Quixeré;2311801;Russas;5;5;10;16
2302107;Baturité;2311603;Redenção;5;5;10;22
2310209;Paracuru;2310258;Paraipaba;5;5;10;17
2304400;Fortaleza;2309706;Pacatuba;5;5;10;26
2303501;Cascavel;2309607;Pacajus;5;5;10;25
2307650;Maracanaú;2309607;Pacajus;5;5;10;40
2300200;Acaraú;2307809;Marco;5;5;10;25
2305506;Iguatu;2307700;Maranguape;5;5;10;281
2307304;Juazeiro do Norte;2307700;Maranguape;5;5;10;375
2300200;Acaraú;2307254;Jijoca de Jericoacoara;5;5;10;47
2302602;Camocim;2304707;Granja;5;5;10;24
2302404;Boa Viagem;2304400;Fortaleza;5;5;10;205
2302503;Brejo Santo;2304400;Fortaleza;5;5;10;414
2111300;São Luís;2304285;Eusébio;5;5;10;659
2302503;Brejo Santo;2304202;Crato;5;5;10;54
2200301;Alto Longá;2211001;Teresina;5;5;10;67
2203503;Elesbão Veloso;2211001;Teresina;5;5;10;143
2202307;Canto do Buriti;2210003;São João do Piauí;5;5;10;82
2201200;Barras;2208403;Piripiri;5;5;10;57
2200202;Água Branca;2208007;Picos;5;5;10;184
2205201;Jaicós;2207207;Padre Marcos;5;5;10;31
2202208;Campo Maior;2202604;Castelo do Piauí;5;5;10;86
2200400;Altos;2202208;Campo Maior;5;5;10;37
1501303;Barcarena;2111300;São Luís;5;5;10;501
1721000;Palmas;2111300;São Luís;5;5;10;982
2101251;Bacabeira;2111300;São Luís;5;5;10;50
2103000;Caxias;2111300;São Luís;5;5;10;277
2109106;Presidente Dutra;2111300;São Luís;5;5;10;308
2109601;Rosário;2111300;São Luís;5;5;10;42
2111102;São João dos Patos;2111300;São Luís;5;5;10;440
2108603;Pinheiro;2110500;São Bento;5;5;10;40
2104057;Estreito;2109007;Porto Franco;5;5;10;24
2105302;Imperatriz;2105427;Itinga do Maranhão;5;5;10;117
1502939;Dom Eliseu;2105302;Imperatriz;5;5;10;133
1501402;Belém;2100055;Açailândia;5;5;10;410
1502939;Dom Eliseu;2100055;Açailândia;5;5;10;72
1705508;Colinas do Tocantins;1721000;Palmas;5;5;10;254
1709302;Guaraí;1716703;Colméia;5;5;10;32
1708205;Formoso do Araguaia;1709500;Gurupi;5;5;10;53
1501402;Belém;1702109;Araguaína;5;5;10;644
1506161;Rio Maria;1508407;Xinguara;5;5;10;27
1508084;Tucumã;1508407;Xinguara;5;5;10;142
1503093;Goianésia do Pará;1508100;Tucuruí;5;5;10;73
1505502;Paragominas;1508001;Tomé-Açu;5;5;10;116
1501451;Belterra;1506807;Santarém;5;5;10;29
1504208;Marabá;1506807;Santarém;5;5;10;704
1505106;Óbidos;1506807;Santarém;5;5;10;110
1500800;Ananindeua;1506500;Santa Isabel do Pará;5;5;10;25
1502707;Conceição do Araguaia;1505536;Parauapebas;5;5;10;256
1501402;Belém;1505064;Novo Repartimento;5;5;10;361
1500800;Ananindeua;1504703;Moju;5;5;10;75
1500602;Altamira;1504208;Marabá;5;5;10;424
1503457;Ipixuna do Pará;1504059;Mãe do Rio;5;5;10;59
1501402;Belém;1503804;Jacundá;5;5;10;345
1502707;Conceição do Araguaia;1503044;Floresta do Araguaia;5;5;10;90
1501402;Belém;1502301;Capitão Poço;5;5;10;158
1502202;Capanema;1502301;Capitão Poço;5;5;10;53
1400100;Boa Vista;1501402;Belém;5;5;10;1441
1302603;Manaus;1500602;Altamira;5;5;10;866
1302603;Manaus;1302900;Maués;5;5;10;266
1100106;Guajará-Mirim;1200401;Rio Branco;5;5;10;289
1100049;Cacoal;1101203;Ministro Andreazza;5;5;10;38
1100023;Ariquemes;1101104;Itapuã do Oeste;5;5;10;80
1100452;Buritis;1100700;Campo Novo de Rondônia;5;5;10;48
1100254;Presidente Médici;1100346;Alvorada d'Oeste;5;5;10;52
1100106;Guajará-Mirim;1100338;Nova Mamoré;5;5;10;41
1100189;Pimenta Bueno;1100288;Rolim de Moura;5;5;10;52
1100122;Ji-Paraná;1100189;Pimenta Bueno;5;5;10;111
1100056;Cerejeiras;1100072;Corumbiara;5;5;10;25
1502400;Castanhal;5300108;Brasília;4;6;10;1605
1600600;Santana;5300108;Brasília;4;6;10;1780
2402006;Caicó;5300108;Brasília;4;6;10;1537
2924009;Paulo Afonso;5300108;Brasília;4;6;10;1237
2930709;Simões Filho;5300108;Brasília;4;6;10;1067
2931350;Teixeira de Freitas;5300108;Brasília;4;6;10;903
3118304;Conselheiro Lafaiete;5300108;Brasília;4;6;10;697
3137601;Lagoa Santa;5300108;Brasília;4;6;10;608
3204906;São Mateus;5300108;Brasília;4;6;10;927
3304524;Rio das Ostras;5300108;Brasília;4;6;10;983
3305554;Seropédica;5300108;Brasília;4;6;10;895
3501905;Amparo;5300108;Brasília;4;6;10;773
3505500;Barretos;5300108;Brasília;4;6;10;530
3509601;Campo Limpo Paulista;5300108;Brasília;4;6;10;828
3511409;Cerqueira César;5300108;Brasília;4;6;10;811
3522307;Itapetininga;5300108;Brasília;4;6;10;860
3526704;Leme;5300108;Brasília;4;6;10;709
3531308;Monte Alto;5300108;Brasília;4;6;10;609
3555000;Tupã;5300108;Brasília;4;6;10;736
3557006;Votorantim;5300108;Brasília;4;6;10;856
4119152;Pinhais;5300108;Brasília;4;6;10;1076
4203006;Caçador;5300108;Brasília;4;6;10;1266
4205902;Gaspar;5300108;Brasília;4;6;10;1237
4216206;São Francisco do Sul;5300108;Brasília;4;6;10;1163
4306403;Dois Irmãos;5300108;Brasília;4;6;10;1565
4322400;Uruguaiana;5300108;Brasília;4;6;10;1857
5220108;São Luís de Montes Belos;5300108;Brasília;4;6;10;275
3172004;Visconde do Rio Branco;5215702;Palmeiras de Goiás;4;6;10;895
3550308;São Paulo;5213756;Montividiu;4;6;10;844
5204409;Caiapônia;5211909;Jataí;4;6;10;107
4106902;Curitiba;5201108;Anápolis;4;6;10;1010
5103403;Cuiabá;5103601;Dom Aquino;4;6;10;130
5100250;Alta Floresta;5100805;Apiacás;4;6;10;156
5002704;Campo Grande;5004908;Jaraguari;4;6;10;41
5002407;Caarapó;5002704;Campo Grande;4;6;10;246
4303103;Cachoeirinha;4322400;Uruguaiana;4;6;10;577
4311205;Júlio de Castilhos;4322202;Tupanciretã;4;6;10;22
4318499;São José do Inhacorá;4321808;Três de Maio;4;6;10;12
4302006;Barros Cassal;4320800;Soledade;4;6;10;29
4316907;Santa Maria;4318705;São Leopoldo;4;6;10;258
4316907;Santa Maria;4317202;Santa Rosa;4;6;10;213
4315305;Quaraí;4317103;Santana do Livramento;4;6;10;106
4106902;Curitiba;4316907;Santa Maria;4;6;10;639
4301602;Bagé;4316808;Santa Cruz do Sul;4;6;10;242
4310009;Ibirubá;4316709;Santa Bárbara do Sul;4;6;10;34
1600303;Macapá;4314902;Porto Alegre;4;6;10;3333
3519071;Hortolândia;4314902;Porto Alegre;4;6;10;880
4313904;Panambi;4314100;Passo Fundo;4;6;10;108
4313201;Nova Petrópolis;4313409;Novo Hamburgo;4;6;10;35
4309902;Ibiraiaras;4313300;Nova Prata;4;6;10;46
4302105;Bento Gonçalves;4308201;Flores da Cunha;4;6;10;35
4209102;Joinville;4307906;Farroupilha;4;6;10;404
4304101;Campos Borges;4307500;Espumoso;4;6;10;23
3550308;São Paulo;4304804;Carlos Barbosa;4;6;10;776
4300604;Alvorada;4304606;Canoas;4;6;10;13
3550308;São Paulo;4219507;Xanxerê;4;6;10;667
4106902;Curitiba;4218251;Timbó Grande;4;6;10;189
4209300;Lages;4216800;São José do Cerrito;4;6;10;29
3505708;Barueri;4216602;São José;4;6;10;484
4204202;Chapecó;4211454;Nova Itaberaba;4;6;10;27
3548807;São Caetano do Sul;4209102;Joinville;4;6;10;373
4205407;Florianópolis;4208500;Ituporanga;4;6;10;109
4203956;Capivari de Baixo;4205407;Florianópolis;4;6;10;104
3301702;Duque de Caxias;4204301;Concórdia;4;6;10;980
4106803;Cruz Machado;4203808;Canoinhas;4;6;10;95
4119103;Piên;4203303;Campo Alegre;4;6;10;19
3304557;Rio de Janeiro;4202008;Balneário Camboriú;4;6;10;698
4105508;Cianorte;4202008;Balneário Camboriú;4;6;10;532
4108403;Francisco Beltrão;4124806;São João;4;6;10;44
4113304;Laranjeiras do Sul;4117057;Nova Laranjeiras;4;6;10;16
3550308;São Paulo;4116901;Nova Esperança;4;6;10;572
4107538;Entre Rios do Oeste;4114609;Marechal Cândido Rondon;4;6;10;24
3118601;Contagem;4113700;Londrina;4;6;10;807
4108809;Guaíra;4113700;Londrina;4;6;10;328
3201209;Cachoeiro de Itapemirim;4106902;Curitiba;4;6;10;958
3541406;Presidente Prudente;4104808;Cascavel;4;6;10;374
3518800;Guarulhos;3557105;Votuporanga;4;6;10;490
3304557;Rio de Janeiro;3556503;Várzea Paulista;4;6;10;366
3509502;Campinas;3556404;Vargem Grande do Sul;4;6;10;119
3550308;São Paulo;3555604;Uchoa;4;6;10;399
3509502;Campinas;3554508;Tietê;4;6;10;71
3109006;Brumadinho;3550308;São Paulo;4;6;10;460
3136207;João Monlevade;3550308;São Paulo;4;6;10;551
3137205;Lagoa da Prata;3550308;São Paulo;4;6;10;418
3154606;Ribeirão das Neves;3550308;São Paulo;4;6;10;502
3172004;Visconde do Rio Branco;3550308;São Paulo;4;6;10;484
3517703;Guará;3550308;São Paulo;4;6;10;376
3537008;Pedregulho;3550308;São Paulo;4;6;10;385
3545407;Salto Grande;3550308;São Paulo;4;6;10;350
3506003;Bauru;3550100;São Manuel;4;6;10;68
2304400;Fortaleza;3548807;São Caetano do Sul;4;6;10;2330
3516200;Franca;3548807;São Caetano do Sul;4;6;10;350
3526902;Limeira;3548708;São Bernardo do Campo;4;6;10;152
3513009;Cotia;3548500;Santos;4;6;10;66
3304557;Rio de Janeiro;3545803;Santa Bárbara d'Oeste;4;6;10;427
3534708;Ourinhos;3545407;Salto Grande;4;6;10;13
3513009;Cotia;3543402;Ribeirão Preto;4;6;10;287
3540705;Porto Ferreira;3543402;Ribeirão Preto;4;6;10;84
3507506;Botucatu;3538709;Piracicaba;4;6;10;83
3520905;Ipaussu;3534708;Ourinhos;4;6;10;29
3506359;Bertioga;3530607;Moji das Cruzes;4;6;10;30
3106200;Belo Horizonte;3524709;Jaguariúna;4;6;10;436
3515707;Ferraz de Vasconcelos;3523107;Itaquaquecetuba;4;6;10;7
3505708;Barueri;3522307;Itapetininga;4;6;10;120
3513009;Cotia;3519709;Ibiúna;4;6;10;32
3125101;Extrema;3518800;Guarulhos;4;6;10;69
3304557;Rio de Janeiro;3518404;Guaratinguetá;4;6;10;196
3509502;Campinas;3518404;Guaratinguetá;4;6;10;194
3118601;Contagem;3516200;Franca;4;6;10;352
3505500;Barretos;3516200;Franca;4;6;10;123
3506102;Bebedouro;3512001;Colina;4;6;10;25
3303906;Petrópolis;3505708;Barueri;4;6;10;388
3304557;Rio de Janeiro;3306206;Vassouras;4;6;10;67
3305109;São João de Meriti;3305505;Saquarema;4;6;10;94
2601201;Arcoverde;3304557;Rio de Janeiro;4;6;10;1709
3304409;Rio Claro;3304557;Rio de Janeiro;4;6;10;91
3300209;Araruama;3303302;Niterói;4;6;10;77
3301702;Duque de Caxias;3301850;Guapimirim;4;6;10;43
3136702;Juiz de Fora;3205309;Vitória;4;6;10;359
3201605;Conceição da Barra;3205309;Vitória;4;6;10;193
3202108;Ecoporanga;3203908;Nova Venécia;4;6;10;63
3170206;Uberlândia;3171006;Vazante;4;6;10;170
3120904;Curvelo;3170800;Várzea da Palma;4;6;10;132
3129103;Gurinhatã;3170206;Uberlândia;4;6;10;164
3163706;São Lourenço;3169307;Três Corações;4;6;10;55
2927408;Salvador;3168606;Teófilo Otoni;4;6;10;625
3119401;Coronel Fabriciano;3168606;Teófilo Otoni;4;6;10;219
3109402;Buritizeiro;3167202;Sete Lagoas;4;6;10;243
3138203;Lavras;3154705;Ribeirão Vermelho;4;6;10;12
3128709;Guaxupé;3143203;Monte Santo de Minas;4;6;10;37
3120706;Cruzeiro da Fortaleza;3128907;Guimarânia;4;6;10;17
3104007;Araxá;3118601;Contagem;4;6;10;302
2909802;Cruz das Almas;2932903;Valença;4;6;10;70
2911204;Gandu;2932903;Valença;4;6;10;60
2910800;Feira de Santana;2931350;Teixeira de Freitas;4;6;10;587
2408102;Natal;2800308;Aracaju;4;6;10;595
2602902;Cabo de Santo Agostinho;2704302;Maceió;4;6;10;170
2604502;Chã Grande;2611606;Recife;4;6;10;60
2507507;João Pessoa;2610707;Paulista;4;6;10;82
2211001;Teresina;2507507;João Pessoa;4;6;10;905
2503704;Cajazeiras;2504009;Campina Grande;4;6;10;298
2307650;Maracanaú;2408102;Natal;4;6;10;433
2307700;Maranguape;2311801;Russas;4;6;10;139
2301109;Aracati;2309607;Pacajus;4;6;10;91
2303709;Caucaia;2307304;Juazeiro do Norte;4;6;10;393
1400100;Boa Vista;2304400;Fortaleza;4;6;10;2562
2103000;Caxias;2304400;Fortaleza;4;6;10;545
1501402;Belém;1508308;Viseu;4;6;10;253
1506138;Redenção;1506583;Santa Maria das Barreiras;4;6;10;99
1302603;Manaus;1504208;Marabá;4;6;10;1235
1400100;Boa Vista;1400209;Caracaraí;4;6;10;126
1100122;Ji-Paraná;1101492;São Francisco do Guaporé;4;6;10;220
2303709;Caucaia;5300108;Brasília;3;7;10;1652
3119401;Coronel Fabriciano;5300108;Brasília;3;7;10;705
3146107;Ouro Preto;5300108;Brasília;3;7;10;694
3156700;Sabará;5300108;Brasília;3;7;10;633
3200607;Aracruz;5300108;Brasília;3;7;10;939
3504008;Assis;5300108;Brasília;3;7;10;807
3545803;Santa Bárbara d'Oeste;5300108;Brasília;3;7;10;771
3551702;Sertãozinho;5300108;Brasília;3;7;10;590
3557105;Votuporanga;5300108;Brasília;3;7;10;559
4209003;Joaçaba;5300108;Brasília;3;7;10;1318
4311304;Lagoa Vermelha;4320800;Soledade;3;7;10;122
4304606;Canoas;4319901;Sapiranga;3;7;10;35
4314100;Passo Fundo;4318309;São Gabriel;3;7;10;293
4307906;Farroupilha;4316907;Santa Maria;3;7;10;245
3303906;Petrópolis;4314902;Porto Alegre;3;7;10;1118
4311205;Júlio de Castilhos;4314472;Pinhal Grande;3;7;10;39
4303509;Camaquã;4314100;Passo Fundo;3;7;10;292
4308508;Frederico Westphalen;4314100;Passo Fundo;3;7;10;139
4308458;Fortaleza dos Valos;4310009;Ibirubá;3;7;10;23
3509502;Campinas;4307906;Farroupilha;3;7;10;809
4305108;Caxias do Sul;4306403;Dois Irmãos;3;7;10;47
3550308;São Paulo;4205456;Forquilhinha;3;7;10;625
4202701;Botuverá;4202909;Brusque;3;7;10;20
3550308;São Paulo;4118907;Pérola;3;7;10;717
3205309;Vitória;4113700;Londrina;3;7;10;1149
4103453;Cafelândia;4112751;Jesuítas;3;7;10;27
3509205;Cajamar;4106902;Curitiba;3;7;10;333
3543402;Ribeirão Preto;3553708;Taquaritinga;3;7;10;84
3534401;Osasco;3552502;Suzano;3;7;10;49
1506708;Santana do Araguaia;3550308;São Paulo;3;7;10;1627
3162104;São Gotardo;3550308;São Paulo;3;7;10;485
3533601;Nuporanga;3550308;São Paulo;3;7;10;341
3526902;Limeira;3549102;São João da Boa Vista;3;7;10;90
2408102;Natal;3548807;São Caetano do Sul;3;7;10;2258
3127701;Governador Valadares;3548807;São Caetano do Sul;3;7;10;703
3509403;Cajuru;3547502;Santa Rita do Passa Quatro;3;7;10;51
3539301;Pirassununga;3546306;Santa Cruz das Palmeiras;3;7;10;28
3526902;Limeira;3534401;Osasco;3;7;10;124
3529302;Matão;3532900;Nova Europa;3;7;10;26
3304557;Rio de Janeiro;3522406;Itapeva;3;7;10;583
3503208;Araraquara;3516853;Gavião Peixoto;3;7;10;34
3149309;Pedro Leopoldo;3304557;Rio de Janeiro;3;7;10;371
3131307;Ipatinga;3205200;Vila Velha;3;7;10;246
3148103;Patrocínio;3170107;Uberaba;3;7;10;132
3118601;Contagem;3168606;Teófilo Otoni;3;7;10;357
3106200;Belo Horizonte;3162104;São Gotardo;3;7;10;228
3143500;Morada Nova de Minas;3147105;Pará de Minas;3;7;10;164
2408102;Natal;2604106;Caruaru;3;7;10;285
4304606;Canoas;4316907;Santa Maria;2;8;10;256
3548906;São Carlos;4314902;Porto Alegre;2;8;10;941
4303004;Cachoeira do Sul;4309308;Guaíba;2;8;10;152
3516200;Franca;4305108;Caxias do Sul;2;8;10;1018
4119905;Ponta Grossa;4205407;Florianópolis;2;8;10;319
4104303;Campo Mourão;4114401;Mangueirinha;2;8;10;211
3509502;Campinas;3557105;Votuporanga;2;8;10;411
3303302;Niterói;3548807;São Caetano do Sul;2;8;10;362
3527603;Luís Antônio;3547502;Santa Rita do Passa Quatro;2;8;10;29
2800308;Aracaju;2933307;Vitória da Conquista;2;8;10;595
4208203;Itajaí;5218805;Rio Verde;1;9;10;1041
4204301;Concórdia;5105259;Lucas do Rio Verde;1;9;10;1627
4304606;Canoas;4306809;Encantado;1;9;10;103
3534401;Osasco;4304606;Canoas;1;9;10;818
4127700;Toledo;4204301;Concórdia;1;9;10;325
2611606;Recife;3516200;Franca;1;9;10;1866
1100049;Cacoal;5300108;Brasília;4;5;9;1516
1100114;Jaru;5300108;Brasília;4;5;9;1662
1200203;Cruzeiro do Sul;5300108;Brasília;4;5;9;2763
1301902;Itacoatiara;5300108;Brasília;4;5;9;1787
2101202;Bacabal;5300108;Brasília;4;5;9;1326
2109007;Porto Franco;5300108;Brasília;4;5;9;1048
2601201;Arcoverde;5300108;Brasília;4;5;9;1405
2706307;Palmeira dos Índios;5300108;Brasília;4;5;9;1385
2707701;Rio Largo;5300108;Brasília;4;5;9;1456
2802908;Itabaiana;5300108;Brasília;4;5;9;1250
3118007;Congonhas;5300108;Brasília;4;5;9;679
3126109;Formiga;5300108;Brasília;4;5;9;582
3147105;Pará de Minas;5300108;Brasília;4;5;9;573
3149309;Pedro Leopoldo;5300108;Brasília;4;5;9;593
3203403;Mimoso do Sul;5300108;Brasília;4;5;9;920
3302007;Itaguaí;5300108;Brasília;4;5;9;895
3305505;Saquarema;5300108;Brasília;4;5;9;982
3500709;Agudos;5300108;Brasília;4;5;9;748
3503901;Arujá;5300108;Brasília;4;5;9;857
3509007;Caieiras;5300108;Brasília;4;5;9;846
3512407;Cordeirópolis;5300108;Brasília;4;5;9;740
3515103;Embu-Guaçu;5300108;Brasília;4;5;9;896
3516705;Garça;5300108;Brasília;4;5;9;734
3525003;Jandira;5300108;Brasília;4;5;9;862
3530102;Mirandópolis;5300108;Brasília;4;5;9;683
3544004;Rio das Pedras;5300108;Brasília;4;5;9;779
3550902;São Simão;5300108;Brasília;4;5;9;629
3554508;Tietê;5300108;Brasília;4;5;9;808
3556453;Vargem Grande Paulista;5300108;Brasília;4;5;9;868
4122404;Rolândia;5300108;Brasília;4;5;9;912
4203808;Canoinhas;5300108;Brasília;4;5;9;1183
4211306;Navegantes;5300108;Brasília;4;5;9;1228
4216909;São Lourenço do Oeste;5300108;Brasília;4;5;9;1292
4218004;Tijucas;5300108;Brasília;4;5;9;1268
4219309;Videira;5300108;Brasília;4;5;9;1290
4300406;Alegrete;5300108;Brasília;4;5;9;1780
4303509;Camaquã;5300108;Brasília;4;5;9;1721
4309308;Guaíba;5300108;Brasília;4;5;9;1630
4320008;Sapucaia do Sul;5300108;Brasília;4;5;9;1595
5205406;Ceres;5300108;Brasília;4;5;9;192
5213806;Morrinhos;5300108;Brasília;4;5;9;248
5208707;Goiânia;5222005;Vianópolis;4;5;9;82
5205406;Ceres;5221601;Uruaçu;4;5;9;97
3550308;São Paulo;5218789;Rio Quente;4;5;9;690
5205497;Cidade Ocidental;5212501;Luziânia;4;5;9;20
5208806;Goianira;5210000;Inhumas;4;5;9;17
3534302;Orlândia;5209101;Goiatuba;4;5;9;339
3513504;Cubatão;5205109;Catalão;4;5;9;656
3548708;São Bernardo do Campo;5205109;Catalão;4;5;9;633
2111300;São Luís;5201108;Anápolis;4;5;9;1602
3304557;Rio de Janeiro;5107909;Sinop;4;5;9;1834
5100250;Alta Floresta;5107602;Rondonópolis;4;5;9;738
5103502;Diamantino;5105259;Lucas do Rio Verde;4;5;9;160
5101258;Araputanga;5105002;Jauru;4;5;9;54
5103403;Cuiabá;5104807;Jaciara;4;5;9;125
5101258;Araputanga;5103809;Figueirópolis d'Oeste;4;5;9;41
3509502;Campinas;5103403;Cuiabá;4;5;9;1281
5103205;Colíder;5103403;Cuiabá;4;5;9;528
4106902;Curitiba;5102637;Campo Novo do Parecis;4;5;9;1619
5002704;Campo Grande;5007307;Rio Negro;4;5;9;114
5003256;Costa Rica;5006309;Paranaíba;4;5;9;243
5003702;Dourados;5004700;Ivinhema;4;5;9;103
5001003;Aparecida do Taboado;5003256;Costa Rica;4;5;9;282
3549805;São José do Rio Preto;5001003;Aparecida do Taboado;4;5;9;196
3550308;São Paulo;5000856;Angélica;4;5;9;757
3550308;São Paulo;4322806;Veranópolis;4;5;9;749
4305108;Caxias do Sul;4322806;Veranópolis;4;5;9;44
4312906;Nova Bassano;4322806;Veranópolis;4;5;9;28
4306205;Cruzeiro do Sul;4322608;Venâncio Aires;4;5;9;19
3546405;Santa Cruz do Rio Pardo;4322400;Uruguaiana;4;5;9;1035
4301602;Bagé;4322400;Uruguaiana;4;5;9;336
4314902;Porto Alegre;4322202;Tupanciretã;4;5;9;281
4321204;Taquara;4321709;Três Coroas;4;5;9;15
4312658;Não-Me-Toque;4321469;Tio Hugo;4;5;9;25
3550308;São Paulo;4321204;Taquara;4;5;9;770
4308300;Fontoura Xavier;4320800;Soledade;4;5;9;26
4313706;Palmeira das Missões;4320107;Sarandi;4;5;9;40
4300604;Alvorada;4318705;São Leopoldo;4;5;9;26
4311403;Lajeado;4318705;São Leopoldo;4;5;9;93
4106902;Curitiba;4318002;São Borja;4;5;9;739
3304557;Rio de Janeiro;4317509;Santo Ângelo;4;5;9;1215
4309506;Guarani das Missões;4317509;Santo Ângelo;4;5;9;34
4304655;Capão do Cipó;4317400;Santiago;4;5;9;34
3518800;Guarulhos;4316808;Santa Cruz do Sul;4;5;9;889
4310108;Igrejinha;4316006;Rolante;4;5;9;22
4301602;Bagé;4315602;Rio Grande;4;5;9;198
2609600;Olinda;4314902;Porto Alegre;4;5;9;2851
4109401;Guarapuava;4314902;Porto Alegre;4;5;9;517
4204301;Concórdia;4314902;Porto Alegre;4;5;9;324
4300109;Agudo;4314902;Porto Alegre;4;5;9;201
4301305;Arroio Grande;4314902;Porto Alegre;4;5;9;301
4309001;Giruá;4314902;Porto Alegre;4;5;9;375
4312500;Mostardas;4314902;Porto Alegre;4;5;9;120
4312658;Não-Me-Toque;4314902;Porto Alegre;4;5;9;235
4312906;Nova Bassano;4314902;Porto Alegre;4;5;9;155
4314506;Pinheiro Machado;4314902;Porto Alegre;4;5;9;271
4306767;Eldorado do Sul;4314407;Pelotas;4;5;9;195
4113700;Londrina;4314100;Passo Fundo;4;5;9;562
4202008;Balneário Camboriú;4314100;Passo Fundo;4;5;9;389
4209003;Joaçaba;4314100;Passo Fundo;4;5;9;148
4313060;Nova Hartz;4314050;Parobé;4;5;9;8
4308508;Frederico Westphalen;4313805;Palmitinho;4;5;9;16
3550308;São Paulo;4313300;Nova Prata;4;5;9;740
4304630;Capão da Canoa;4313201;Nova Petrópolis;4;5;9;112
4302659;Brochier;4312401;Montenegro;4;5;9;18
4305355;Charqueadas;4311403;Lajeado;4;5;9;70
4305108;Caxias do Sul;4311304;Lagoa Vermelha;4;5;9;111
4304606;Canoas;4310207;Ijuí;4;5;9;318
4309100;Gramado;4310108;Igrejinha;4;5;9;23
4302105;Bento Gonçalves;4309407;Guaporé;4;5;9;53
4106902;Curitiba;4309308;Guaíba;4;5;9;553
3513801;Diadema;4309209;Gravataí;4;5;9;806
4125506;São José dos Pinhais;4309209;Gravataí;4;5;9;517
4307906;Farroupilha;4309100;Gramado;4;5;9;46
4305207;Cerro Largo;4309001;Giruá;4;5;9;40
4307005;Erechim;4308706;Gaurama;4;5;9;19
4307005;Erechim;4307559;Estação;4;5;9;31
3106705;Betim;4304606;Canoas;4;5;9;1279
4113700;Londrina;4304606;Canoas;4;5;9;733
4115200;Maringá;4304606;Canoas;4;5;9;721
4204608;Criciúma;4304606;Canoas;4;5;9;221
4303509;Camaquã;4304606;Canoas;4;5;9;119
2304400;Fortaleza;4303905;Campo Bom;4;5;9;3083
4204202;Chapecó;4303103;Cachoeirinha;4;5;9;346
4301602;Bagé;4302808;Caçapava do Sul;4;5;9;112
4203600;Campos Novos;4301800;Barracão;4;5;9;37
4217600;Siderópolis;4218350;Treviso;4;5;9;9
4205407;Florianópolis;4217204;São Miguel do Oeste;4;5;9;512
4205407;Florianópolis;4216206;São Francisco do Sul;4;5;9;144
4214508;Rio do Campo;4214805;Rio do Sul;4;5;9;61
4207502;Indaial;4214706;Rio dos Cedros;4;5;9;18
4206207;Gravatal;4213104;Piratuba;4;5;9;290
4210902;Modelo;4212908;Pinhalzinho;4;5;9;10
4204202;Chapecó;4211405;Nova Erechim;4;5;9;36
4202404;Blumenau;4210001;Luiz Alves;4;5;9;29
4202800;Braço do Norte;4209409;Laguna;4;5;9;40
3304557;Rio de Janeiro;4209300;Lages;4;5;9;874
3552809;Taboão da Serra;4209102;Joinville;4;5;9;362
4118501;Pato Branco;4209102;Joinville;4;5;9;379
4204806;Curitibanos;4209102;Joinville;4;5;9;206
3518800;Guarulhos;4208906;Jaraguá do Sul;4;5;9;419
4119905;Ponta Grossa;4208906;Jaraguá do Sul;4;5;9;187
3548708;São Bernardo do Campo;4208203;Itajaí;4;5;9;415
4119905;Ponta Grossa;4208203;Itajaí;4;5;9;246
4207502;Indaial;4208203;Itajaí;4;5;9;48
4105508;Cianorte;4207502;Indaial;4;5;9;487
4201505;Armazém;4206207;Gravatal;4;5;9;8
4108304;Foz do Iguaçu;4205407;Florianópolis;4;5;9;629
4201000;Anita Garibaldi;4203600;Campos Novos;4;5;9;31
4201406;Araranguá;4202008;Balneário Camboriú;4;5;9;232
4118600;Paula Freitas;4128203;União da Vitória;4;5;9;22
4119905;Ponta Grossa;4127700;Toledo;4;5;9;367
4123501;Santa Helena;4127700;Toledo;4;5;9;59
4125753;São Pedro do Iguaçu;4127700;Toledo;4;5;9;25
4125506;São José dos Pinhais;4127106;Telêmaco Borba;4;5;9;200
4102802;Bela Vista do Paraíso;4126504;Sertanópolis;4;5;9;17
4122404;Rolândia;4126504;Sertanópolis;4;5;9;44
4112009;Jaguariaíva;4126306;Sengés;4;5;9;29
4105508;Cianorte;4126108;São Tomé;4;5;9;14
3543402;Ribeirão Preto;4125506;São José dos Pinhais;4;5;9;505
3548807;São Caetano do Sul;4125506;São José dos Pinhais;4;5;9;337
3554102;Taubaté;4125506;São José dos Pinhais;4;5;9;456
3504008;Assis;4124103;Santo Antônio da Platina;4;5;9;78
4104303;Campo Mourão;4122503;Roncador;4;5;9;63
4111902;Jaguapitã;4122404;Rolândia;4;5;9;27
4118501;Pato Branco;4120903;Quedas do Iguaçu;4;5;9;90
4108304;Foz do Iguaçu;4119905;Ponta Grossa;4;5;9;440
4113205;Lapa;4119905;Ponta Grossa;4;5;9;86
4113304;Laranjeiras do Sul;4118501;Pato Branco;4;5;9;89
4101408;Apucarana;4118402;Paranavaí;4;5;9;114
4101804;Araucária;4117701;Palmeira;4;5;9;63
2611606;Recife;4115200;Maringá;4;5;9;2378
4111100;Itambé;4115200;Maringá;4;5;9;26
3552205;Sorocaba;4113700;Londrina;4;5;9;375
4104303;Campo Mourão;4113700;Londrina;4;5;9;151
4101507;Arapongas;4112108;Jandaia do Sul;4;5;9;29
4105508;Cianorte;4112108;Jandaia do Sul;4;5;9;98
4105805;Colombo;4107652;Fazenda Rio Grande;4;5;9;45
3550308;São Paulo;4107108;Diamante do Norte;4;5;9;650
2211001;Teresina;4106902;Curitiba;4;5;9;2335
3304201;Resende;4106902;Curitiba;4;5;9;580
3530607;Moji das Cruzes;4106902;Curitiba;4;5;9;373
3545209;Salto;4106902;Curitiba;4;5;9;318
3554003;Tatuí;4106902;Curitiba;4;5;9;273
4101507;Arapongas;4102109;Astorga;4;5;9;30
3550308;São Paulo;3556354;Vargem;4;5;9;88
3106200;Belo Horizonte;3556206;Valinhos;4;5;9;457
3527306;Louveira;3556206;Valinhos;4;5;9;12
3548807;São Caetano do Sul;3556206;Valinhos;4;5;9;83
3540606;Porto Feliz;3554508;Tietê;4;5;9;23
3510302;Capela do Alto;3554003;Tatuí;4;5;9;18
3522406;Itapeva;3553807;Taquarituba;4;5;9;61
3511102;Catanduva;3553708;Taquaritinga;4;5;9;56
3147907;Passos;3553609;Tapiratiba;4;5;9;85
3547502;Santa Rita do Passa Quatro;3553302;Tambaú;4;5;9;21
3525904;Jundiaí;3552403;Sumaré;4;5;9;54
2211001;Teresina;3552205;Sorocaba;4;5;9;2086
2403251;Parnamirim;3552205;Sorocaba;4;5;9;2282
3538204;Pinhalzinho;3552106;Socorro;4;5;9;22
3503208;Araraquara;3551702;Sertãozinho;4;5;9;74
3509502;Campinas;3551009;São Vicente;4;5;9;132
3522109;Itanhaém;3551009;São Vicente;4;5;9;43
1501501;Benevides;3550308;São Paulo;4;5;9;2470
2604007;Carpina;3550308;São Paulo;4;5;9;2075
2904605;Brumado;3550308;São Paulo;4;5;9;1157
3115508;Caxambu;3550308;São Paulo;4;5;9;254
3119302;Coromandel;3550308;São Paulo;4;5;9;577
3142809;Monte Alegre de Minas;3550308;São Paulo;4;5;9;575
3156700;Sabará;3550308;São Paulo;4;5;9;506
3301108;Cantagalo;3550308;São Paulo;4;5;9;473
3504206;Auriflama;3550308;São Paulo;4;5;9;513
3512209;Conchal;3550308;São Paulo;4;5;9;156
3512506;Coroados;3550308;São Paulo;4;5;9;447
3520442;Ilha Solteira;3550308;São Paulo;4;5;9;592
3531407;Monte Aprazível;3550308;São Paulo;4;5;9;444
3537503;Pereiras;3550308;São Paulo;4;5;9;149
3539400;Piratininga;3550308;São Paulo;4;5;9;287
3540002;Pompéia;3550308;São Paulo;4;5;9;396
3543808;Rinópolis;3550308;São Paulo;4;5;9;464
3548609;São Bento do Sapucaí;3550308;São Paulo;4;5;9;142
3525300;Jaú;3549904;São José dos Campos;4;5;9;293
3524709;Jaguariúna;3549706;São José do Rio Pardo;4;5;9;123
3543402;Ribeirão Preto;3549102;São João da Boa Vista;4;5;9;135
3205309;Vitória;3548807;São Caetano do Sul;4;5;9;733
3302403;Macaé;3548807;São Caetano do Sul;4;5;9;494
3503208;Araraquara;3548708;São Bernardo do Campo;4;5;9;268
3515004;Embu;3548708;São Bernardo do Campo;4;5;9;28
3530706;Mogi Guaçu;3548708;São Bernardo do Campo;4;5;9;158
3529401;Mauá;3548500;Santos;4;5;9;28
3515509;Fernandópolis;3546603;Santa Fé do Sul;4;5;9;77
3523909;Itu;3545803;Santa Bárbara d'Oeste;4;5;9;60
3519071;Hortolândia;3545209;Salto;4;5;9;39
3538709;Piracicaba;3545209;Salto;4;5;9;62
3503307;Araras;3543402;Ribeirão Preto;4;5;9;140
3534609;Osvaldo Cruz;3541406;Presidente Prudente;4;5;9;65
3506003;Bauru;3539400;Piratininga;4;5;9;10
3505708;Barueri;3536505;Paulínia;4;5;9;88
3506003;Bauru;3534708;Ourinhos;4;5;9;110
2930709;Simões Filho;3534401;Osasco;4;5;9;1450
3507506;Botucatu;3534401;Osasco;4;5;9;183
3509007;Caieiras;3534401;Osasco;4;5;9;20
3509601;Campo Limpo Paulista;3534401;Osasco;4;5;9;36
3522109;Itanhaém;3534401;Osasco;4;5;9;72
3527306;Louveira;3534401;Osasco;4;5;9;54
3505708;Barueri;3530805;Moji-Mirim;4;5;9;120
3501608;Americana;3530706;Mogi Guaçu;4;5;9;61
3170206;Uberlândia;3529302;Matão;4;5;9;299
3505500;Barretos;3529302;Matão;4;5;9;117
3133006;Itamonte;3527207;Lorena;4;5;9;54
3509502;Campinas;3527108;Lins;4;5;9;313
3522505;Itapevi;3525904;Jundiaí;4;5;9;41
3509502;Campinas;3524303;Jaboticabal;4;5;9;224
3506003;Bauru;3522307;Itapetininga;4;5;9;173
3505708;Barueri;3519071;Hortolândia;4;5;9;81
3504107;Atibaia;3518800;Guarulhos;4;5;9;35
3515004;Embu;3518800;Guarulhos;4;5;9;38
3506102;Bebedouro;3517406;Guaíra;4;5;9;73
3509502;Campinas;3516408;Franco da Rocha;4;5;9;58
2611606;Recife;3513009;Cotia;4;5;9;2077
3503901;Arujá;3509502;Campinas;4;5;9;93
3170701;Varginha;3507605;Bragança Paulista;4;5;9;198
2611606;Recife;3506003;Bauru;4;5;9;2110
3504008;Assis;3506003;Bauru;4;5;9;145
3170701;Varginha;3505708;Barueri;4;5;9;268
3300407;Barra Mansa;3306008;Três Rios;4;5;9;112
3303609;Paracambi;3305554;Seropédica;4;5;9;17
1500602;Altamira;3304557;Rio de Janeiro;4;5;9;2352
2311306;Quixadá;3304557;Rio de Janeiro;4;5;9;2026
2606002;Garanhuns;3304557;Rio de Janeiro;4;5;9;1689
2606804;Igarassu;3304557;Rio de Janeiro;4;5;9;1855
2612208;Salgueiro;3304557;Rio de Janeiro;4;5;9;1682
2920601;Maragogipe;3304557;Rio de Janeiro;4;5;9;1197
2932903;Valença;3304557;Rio de Janeiro;4;5;9;1133
3103504;Araguari;3304557;Rio de Janeiro;4;5;9;686
3105400;Barão de Cocais;3304557;Rio de Janeiro;4;5;9;327
3131703;Itabira;3304557;Rio de Janeiro;4;5;9;360
3303856;Paty do Alferes;3304557;Rio de Janeiro;4;5;9;52
3300233;Armação dos Búzios;3304524;Rio das Ostras;4;5;9;29
3302205;Itaperuna;3303401;Nova Friburgo;4;5;9;146
3201100;Bom Jesus do Norte;3205309;Vitória;4;5;9;172
3203007;Iúna;3205309;Vitória;4;5;9;128
3204054;Pedro Canário;3205309;Vitória;4;5;9;246
3204559;Santa Maria de Jetibá;3205309;Vitória;4;5;9;51
3204559;Santa Maria de Jetibá;3205200;Vila Velha;4;5;9;51
3205002;Serra;3205101;Viana;4;5;9;41
3201308;Cariacica;3205069;Venda Nova do Imigrante;4;5;9;73
3204104;Pinheiros;3204906;São Mateus;4;5;9;53
3200904;Barra de São Francisco;3204658;São Domingos do Norte;4;5;9;52
3202702;Itaguaçu;3204609;Santa Teresa;4;5;9;32
3201209;Cachoeiro de Itapemirim;3204203;Piúma;4;5;9;36
3203205;Linhares;3203908;Nova Venécia;4;5;9;80
3201209;Cachoeiro de Itapemirim;3202702;Itaguaçu;4;5;9;116
3139409;Manhuaçu;3201506;Colatina;4;5;9;170
2304400;Fortaleza;3201209;Cachoeiro de Itapemirim;4;5;9;1904
3200136;Águia Branca;3200904;Barra de São Francisco;4;5;9;31
3161502;São Geraldo;3172004;Visconde do Rio Branco;4;5;9;10
2211001;Teresina;3170206;Uberlândia;4;5;9;1627
2408102;Natal;3170206;Uberlândia;4;5;9;1968
3157708;Santa Juliana;3170206;Uberlândia;4;5;9;90
3167202;Sete Lagoas;3170206;Uberlândia;4;5;9;430
3115508;Caxambu;3165206;São Thomé das Letras;4;5;9;25
3149309;Pedro Leopoldo;3162955;São José da Lapa;4;5;9;13
3143302;Montes Claros;3162708;São João do Paraíso;4;5;9;254
3139409;Manhuaçu;3162559;São João do Manhuaçu;4;5;9;20
3129509;Ibiá;3162104;São Gotardo;4;5;9;53
3122306;Divinópolis;3152501;Pouso Alegre;4;5;9;252
3114006;Carmo da Mata;3145604;Oliveira;4;5;9;16
3128709;Guaxupé;3145109;Nova Resende;4;5;9;37
3135100;Janaúba;3145059;Nova Porteirinha;4;5;9;4
3120904;Curvelo;3143609;Morro da Garça;4;5;9;27
3106200;Belo Horizonte;3143500;Morada Nova de Minas;4;5;9;210
3135100;Janaúba;3140852;Matias Cardoso;4;5;9;119
3118601;Contagem;3137601;Lagoa Santa;4;5;9;38
3106200;Belo Horizonte;3137205;Lagoa da Prata;4;5;9;163
3113305;Carangola;3136702;Juiz de Fora;4;5;9;176
3113404;Caratinga;3136702;Juiz de Fora;4;5;9;245
3106200;Belo Horizonte;3135605;Jequitaí;4;5;9;304
3118601;Contagem;3133808;Itaúna;4;5;9;56
3106200;Belo Horizonte;3131109;Inimutaba;4;5;9;136
3104007;Araxá;3126109;Formiga;4;5;9;186
3106200;Belo Horizonte;3123809;Engenheiro Navarro;4;5;9;291
3118601;Contagem;3119401;Coronel Fabriciano;4;5;9;160
2611606;Recife;3118601;Contagem;4;5;9;1603
3101607;Alfenas;3102001;Alterosa;4;5;9;26
2913903;Ipiaú;2932903;Valença;4;5;9;104
2925600;Presidente Dutra;2932408;Uibaí;4;5;9;17
2919207;Lauro de Freitas;2929503;São Sebastião do Passé;4;5;9;45
2909307;Correntina;2928109;Santa Maria da Vitória;4;5;9;45
2915205;Itagibá;2927408;Salvador;4;5;9;207
2913606;Ilhéus;2925303;Porto Seguro;4;5;9;181
2911709;Guanambi;2916401;Itapetinga;4;5;9;293
2903904;Bom Jesus da Lapa;2909307;Correntina;4;5;9;137
1501402;Belém;2704302;Maceió;4;5;9;1655
2700300;Arapiraca;2702603;Feira Grande;4;5;9;15
2304400;Fortaleza;2700300;Arapiraca;4;5;9;693
2615300;Timbaúba;2616407;Vitória de Santo Antão;4;5;9;68
2615300;Timbaúba;2616308;Vicência;4;5;9;17
2604007;Carpina;2609501;Nazaré da Mata;4;5;9;11
2601201;Arcoverde;2606002;Garanhuns;4;5;9;74
2506301;Guarabira;2515302;Sapé;4;5;9;38
2507507;João Pessoa;2511202;Pedras de Fogo;4;5;9;35
2307304;Juazeiro do Norte;2507507;João Pessoa;4;5;9;492
2402006;Caicó;2507507;João Pessoa;4;5;9;263
2111300;São Luís;2504009;Campina Grande;4;5;9;1053
2407104;Macaíba;2411205;Santa Cruz;4;5;9;85
2211001;Teresina;2408102;Natal;4;5;9;839
2402204;Canguaretama;2408102;Natal;4;5;9;64
2405702;Jardim do Seridó;2408102;Natal;4;5;9;189
2307304;Juazeiro do Norte;2408003;Mossoró;4;5;9;314
2304400;Fortaleza;2400208;Açu;4;5;9;267
2310209;Paracuru;2312403;São Gonçalo do Amarante;4;5;9;21
2304400;Fortaleza;2310852;Pindoretama;4;5;9;39
2300903;Apuiarés;2310704;Pentecoste;4;5;9;25
2304285;Eusébio;2307650;Maracanaú;4;5;9;21
2109908;Santa Inês;2304400;Fortaleza;4;5;9;767
2207900;Pedro II;2211001;Teresina;4;5;9;166
2111300;São Luís;2114007;Zé Doca;4;5;9;193
2105401;Itapecuru Mirim;2112704;Vargem Grande;4;5;9;49
1600303;Macapá;2111300;São Luís;4;5;9;815
2107506;Paço do Lumiar;2111201;São José de Ribamar;4;5;9;7
2100055;Açailândia;2109908;Santa Inês;4;5;9;257
1707009;Dianópolis;1721000;Palmas;4;5;9;217
1600154;Pedra Branca do Amaparí;1600600;Santana;4;5;9;122
1501402;Belém;1507607;São Miguel do Guamá;4;5;9;110
1501402;Belém;1507409;São Francisco do Pará;4;5;9;75
1501402;Belém;1504406;Marapanim;4;5;9;110
1501402;Belém;1503309;Igarapé-Miri;4;5;9;88
1501402;Belém;1502707;Conceição do Araguaia;4;5;9;765
1500701;Anajás;1501402;Belém;4;5;9;171
1500800;Ananindeua;1501303;Barcarena;4;5;9;32
1300805;Borba;1302603;Manaus;4;5;9;152
1100056;Cerejeiras;1100122;Ji-Paraná;4;5;9;275
1303809;São Gabriel da Cachoeira;5300108;Brasília;3;6;9;2654
2112209;Timon;5300108;Brasília;3;6;9;1296
2610707;Paulista;5300108;Brasília;3;6;9;1628
2910727;Eunápolis;5300108;Brasília;3;6;9;895
2921005;Mata de São João;5300108;Brasília;3;6;9;1086
3136207;João Monlevade;5300108;Brasília;3;6;9;679
3171303;Viçosa;5300108;Brasília;3;6;9;774
3300308;Barra do Piraí;5300108;Brasília;3;6;9;862
3300704;Cabo Frio;5300108;Brasília;3;6;9;1010
3302502;Magé;5300108;Brasília;3;6;9;923
3302858;Mesquita;5300108;Brasília;3;6;9;915
3504503;Avaré;5300108;Brasília;3;6;9;814
3515509;Fernandópolis;5300108;Brasília;3;6;9;555
3522406;Itapeva;5300108;Brasília;3;6;9;910
3523107;Itaquaquecetuba;5300108;Brasília;3;6;9;866
3527108;Lins;5300108;Brasília;3;6;9;681
3549102;São João da Boa Vista;5300108;Brasília;3;6;9;692
4104303;Campo Mourão;5300108;Brasília;3;6;9;1035
4108403;Francisco Beltrão;5300108;Brasília;3;6;9;1271
4118402;Paranavaí;5300108;Brasília;3;6;9;946
4202909;Brusque;5300108;Brasília;3;6;9;1254
4214805;Rio do Sul;5300108;Brasília;3;6;9;1279
4215802;São Bento do Sul;5300108;Brasília;3;6;9;1168
4317103;Santana do Livramento;5300108;Brasília;3;6;9;1872
5219308;Santa Helena de Goiás;5221551;Turvelândia;3;6;9;32
3550308;São Paulo;5216403;Paraúna;3;6;9;850
2101400;Balsas;5208707;Goiânia;3;6;9;1071
4202404;Blumenau;5201108;Anápolis;3;6;9;1178
3550308;São Paulo;5103205;Colíder;3;6;9;1733
3509502;Campinas;5008305;Três Lagoas;3;6;9;545
4319604;São Sepé;4323457;Vila Nova do Sul;3;6;9;34
4314100;Passo Fundo;4321907;Três Passos;3;6;9;177
4306734;Doutor Maurício Cardoso;4321808;Três de Maio;3;6;9;29
4317509;Santo Ângelo;4319158;São Miguel das Missões;3;6;9;40
4318408;São Jerônimo;4318705;São Leopoldo;3;6;9;60
4310207;Ijuí;4317806;Santo Augusto;3;6;9;62
4315057;Porto Mauá;4317202;Santa Rosa;3;6;9;39
3505708;Barueri;4316907;Santa Maria;3;6;9;947
2504009;Campina Grande;4314902;Porto Alegre;3;6;9;2881
2602902;Cabo de Santo Agostinho;4314902;Porto Alegre;3;6;9;2818
3524402;Jacareí;4314902;Porto Alegre;3;6;9;894
3529401;Mauá;4314902;Porto Alegre;3;6;9;835
4302105;Bento Gonçalves;4314100;Passo Fundo;3;6;9;133
4202909;Brusque;4307906;Farroupilha;3;6;9;332
4303905;Campo Bom;4304606;Canoas;3;6;9;29
3534401;Osasco;4302105;Bento Gonçalves;3;6;9;768
3304557;Rio de Janeiro;4300604;Alvorada;3;6;9;1075
4203808;Canoinhas;4218251;Timbó Grande;3;6;9;52
3550308;São Paulo;4217501;Seara;3;6;9;675
4204202;Chapecó;4216701;São José do Cedro;3;6;9;116
4106902;Curitiba;4215505;Santa Cecília;3;6;9;206
3106200;Belo Horizonte;4208906;Jaraguá do Sul;3;6;9;882
4108403;Francisco Beltrão;4204202;Chapecó;3;6;9;121
4203808;Canoinhas;4204202;Chapecó;3;6;9;240
4104808;Cascavel;4123501;Santa Helena;3;6;9;87
3548807;São Caetano do Sul;4113700;Londrina;3;6;9;471
4103602;Cambará;4113700;Londrina;3;6;9;114
4106605;Cruzeiro do Oeste;4108403;Francisco Beltrão;3;6;9;255
3513504;Cubatão;3552403;Sumaré;3;6;9;147
3534401;Osasco;3552403;Sumaré;3;6;9;93
3143104;Monte Carmelo;3550308;São Paulo;3;6;9;552
3518107;Guarantã;3550308;São Paulo;3;6;9;356
3521606;Irapuru;3550308;São Paulo;3;6;9;528
3303906;Petrópolis;3548807;São Caetano do Sul;3;6;9;361
3504107;Atibaia;3527306;Louveira;3;6;9;42
3509502;Campinas;3522406;Itapeva;3;6;9;221
2914802;Itabuna;3505708;Barueri;3;6;9;1225
3300100;Angra dos Reis;3303302;Niterói;3;6;9;122
3118601;Contagem;3302403;Macaé;3;6;9;351
2910727;Eunápolis;3205002;Serra;3;6;9;423
3145372;Novorizonte;3157005;Salinas;3;6;9;23
3133303;Itaobim;3134004;Itinga;3;6;9;22
3106200;Belo Horizonte;3132503;Itamarandiba;3;6;9;256
3105608;Barbacena;3118601;Contagem;3;6;9;145
2910800;Feira de Santana;2929503;São Sebastião do Passé;3;6;9;57
2611606;Recife;2918001;Jequié;3;6;9;836
2507507;João Pessoa;2612505;Santa Cruz do Capibaribe;3;6;9;171
2108603;Pinheiro;2211001;Teresina;3;6;9;385
2207702;Parnaíba;2208007;Picos;3;6;9;466
4313706;Palmeira das Missões;4321808;Três de Maio;2;7;9;93
4305207;Cerro Largo;4317202;Santa Rosa;2;7;9;42
3502804;Araçatuba;4314902;Porto Alegre;2;7;9;980
4300406;Alegrete;4314100;Passo Fundo;2;7;9;373
2927408;Salvador;4313409;Novo Hamburgo;2;7;9;2181
4118204;Paranaguá;4118501;Pato Branco;2;7;9;415
3503703;Ariranha;3538105;Pindorama;2;7;9;12
1600303;Macapá;3534401;Osasco;2;7;9;2645
2910800;Feira de Santana;3534401;Osasco;2;7;9;1465
3513009;Cotia;3513801;Diadema;2;7;9;32
3147105;Pará de Minas;3152006;Pompéu;2;7;9;77
3120904;Curvelo;3136306;João Pinheiro;2;7;9;215
4204301;Concórdia;5203906;Buriti Alegre;1;8;9;1056
4203907;Capinzal;4208203;Itajaí;1;8;9;288
1100205;Porto Velho;4109708;Ibaiti;1;8;9;2139
3550308;São Paulo;4101903;Assaí;1;8;9;430
3528858;Marapoama;3540804;Potirendaba;1;8;9;35
3511607;Cesário Lange;3540606;Porto Feliz;1;8;9;44
3303906;Petrópolis;3534401;Osasco;1;8;9;380
3517901;Guaraci;3532207;Narandiba;1;8;9;338
2927408;Salvador;3523503;Itatinga;1;8;9;1506
2408102;Natal;3516200;Franca;1;8;9;2039
3108008;Bom Sucesso;3304557;Rio de Janeiro;1;8;9;255
3202405;Guarapari;3301009;Campos dos Goytacazes;1;8;9;150
3137601;Lagoa Santa;3205309;Vitória;1;8;9;380
1100106;Guajará-Mirim;5300108;Brasília;4;4;8;1926
1100155;Ouro Preto do Oeste;5300108;Brasília;4;4;8;1624
1100189;Pimenta Bueno;5300108;Brasília;4;4;8;1485
1100288;Rolim de Moura;5300108;Brasília;4;4;8;1529
1200609;Tarauacá;5300108;Brasília;4;4;8;2558
1304062;Tabatinga;5300108;Brasília;4;4;8;2638
1304203;Tefé;5300108;Brasília;4;4;8;2230
1502103;Cametá;5300108;Brasília;4;4;8;1514
1504422;Marituba;5300108;Brasília;4;4;8;1599
1705508;Colinas do Tocantins;5300108;Brasília;4;4;8;859
1707009;Dianópolis;5300108;Brasília;4;4;8;475
1708205;Formoso do Araguaia;5300108;Brasília;4;4;8;476
1713205;Miracema do Tocantins;5300108;Brasília;4;4;8;694
2301901;Barbalha;5300108;Brasília;4;4;8;1306
2304103;Crateús;5300108;Brasília;4;4;8;1403
2305233;Horizonte;5300108;Brasília;4;4;8;1630
2305407;Icó;5300108;Brasília;4;4;8;1411
2311801;Russas;5300108;Brasília;4;4;8;1594
2312700;Senador Pompeu;5300108;Brasília;4;4;8;1443
2400208;Açu;5300108;Brasília;4;4;8;1619
2403103;Currais Novos;5300108;Brasília;4;4;8;1599
2501807;Bayeux;5300108;Brasília;4;4;8;1672
2600104;Afogados da Ingazeira;5300108;Brasília;4;4;8;1403
2606200;Goiana;5300108;Brasília;4;4;8;1640
2615300;Timbaúba;5300108;Brasília;4;4;8;1616
2706703;Penedo;5300108;Brasília;4;4;8;1352
2708402;São José da Tapera;5300108;Brasília;4;4;8;1312
2803203;Itaporanga d'Ajuda;5300108;Brasília;4;4;8;1245
2804508;Nossa Senhora da Glória;5300108;Brasília;4;4;8;1273
2804607;Nossa Senhora das Dores;5300108;Brasília;4;4;8;1280
2805703;Propriá;5300108;Brasília;4;4;8;1324
2913903;Ipiaú;5300108;Brasília;4;4;8;898
2914703;Itaberaba;5300108;Brasília;4;4;8;887
2926608;Ribeira do Pombal;5300108;Brasília;4;4;8;1136
2928109;Santa Maria da Vitória;5300108;Brasília;4;4;8;479
2929909;Seabra;5300108;Brasília;4;4;8;755
3100203;Abaeté;5300108;Brasília;4;4;8;456
3104502;Arinos;5300108;Brasília;4;4;8;195
3105103;Bambuí;5300108;Brasília;4;4;8;510
3117702;Conceição do Rio Verde;5300108;Brasília;4;4;8;740
3119302;Coromandel;5300108;Brasília;4;4;8;304
3125101;Extrema;5300108;Brasília;4;4;8;799
3134400;Iturama;5300108;Brasília;4;4;8;499
3140001;Mariana;5300108;Brasília;4;4;8;703
3147600;Passa Quatro;5300108;Brasília;4;4;8;797
3304110;Porto Real;5300108;Brasília;4;4;8;828
3524006;Itupeva;5300108;Brasília;4;4;8;818
4105508;Cianorte;5300108;Brasília;4;4;8;1009
4124103;Santo Antônio da Platina;5300108;Brasília;4;4;8;863
4126256;Sarandi;5300108;Brasília;4;4;8;949
4205001;Dionísio Cerqueira;5300108;Brasília;4;4;8;1320
4205456;Forquilhinha;5300108;Brasília;4;4;8;1443
4307609;Estância Velha;5300108;Brasília;4;4;8;1575
4308607;Garibaldi;5300108;Brasília;4;4;8;1543
4319000;São Marcos;5300108;Brasília;4;4;8;1499
5005400;Maracaju;5300108;Brasília;4;4;8;1018
5103502;Diamantino;5300108;Brasília;4;4;8;922
5105259;Lucas do Rio Verde;5300108;Brasília;4;4;8;902
5200803;Alvorada do Norte;5300108;Brasília;4;4;8;211
5210406;Itaberaí;5300108;Brasília;4;4;8;206
5211206;Itapuranga;5300108;Brasília;4;4;8;220
5213087;Minaçu;5300108;Brasília;4;4;8;255
5214507;Nerópolis;5300108;Brasília;4;4;8;154
5214606;Niquelândia;5300108;Brasília;4;4;8;160
5215702;Palmeiras de Goiás;5300108;Brasília;4;4;8;242
5216403;Paraúna;5300108;Brasília;4;4;8;302
5218904;Rubiataba;5300108;Brasília;4;4;8;215
5219308;Santa Helena de Goiás;5300108;Brasília;4;4;8;363
5219738;Santo Antônio de Goiás;5300108;Brasília;4;4;8;167
5220603;Silvânia;5222005;Vianópolis;4;4;8;13
5201405;Aparecida de Goiânia;5221858;Valparaíso de Goiás;4;4;8;160
3550308;São Paulo;5221601;Uruaçu;4;4;8;1049
5218003;Porangatu;5221601;Uruaçu;4;4;8;120
3550308;São Paulo;5220603;Silvânia;4;4;8;803
5208707;Goiânia;5220603;Silvânia;4;4;8;72
5103403;Cuiabá;5220454;Senador Canedo;4;4;8;756
5218508;Quirinópolis;5220405;São Simão;4;4;8;61
5216403;Paraúna;5220108;São Luís de Montes Belos;4;4;8;46
5100300;Alto Araguaia;5219407;Santa Rita do Araguaia;4;4;8;4
5211909;Jataí;5219308;Santa Helena de Goiás;4;4;8;118
5208707;Goiânia;5219001;Sanclerlândia;4;4;8;123
5208707;Goiânia;5218904;Rubiataba;4;4;8;181
3106200;Belo Horizonte;5218805;Rio Verde;4;4;8;778
3170107;Uberaba;5218805;Rio Verde;4;4;8;388
4104808;Cascavel;5218805;Rio Verde;4;4;8;838
5201108;Anápolis;5218805;Rio Verde;4;4;8;266
5211909;Jataí;5218508;Quirinópolis;4;4;8;145
5201108;Anápolis;5218003;Porangatu;4;4;8;320
3550308;São Paulo;5217609;Planaltina;4;4;8;915
5208004;Formosa;5217609;Planaltina;4;4;8;32
3550308;São Paulo;5215702;Palmeiras de Goiás;4;4;8;838
3550308;São Paulo;5215504;Ouvidor;4;4;8;613
3550308;São Paulo;5214002;Mozarlândia;4;4;8;1078
3550308;São Paulo;5213087;Minaçu;4;4;8;1134
3304557;Rio de Janeiro;5212501;Luziânia;4;4;8;893
5201405;Aparecida de Goiânia;5212501;Luziânia;4;4;8;154
5209101;Goiatuba;5212105;Joviânia;4;4;8;34
5107602;Rondonópolis;5211909;Jataí;4;4;8;354
5201108;Anápolis;5211909;Jataí;4;4;8;339
5201108;Anápolis;5211800;Jaraguá;4;4;8;75
3304557;Rio de Janeiro;5211503;Itumbiara;4;4;8;812
5201405;Aparecida de Goiânia;5211503;Itumbiara;4;4;8;175
5204250;Cachoeira Dourada;5211503;Itumbiara;4;4;8;25
5208707;Goiânia;5210901;Itapaci;4;4;8;197
5201108;Anápolis;5210406;Itaberaí;4;4;8;99
5210000;Inhumas;5210406;Itaberaí;4;4;8;49
3170206;Uberlândia;5209101;Goiatuba;4;4;8;153
3550308;São Paulo;5208806;Goianira;4;4;8;846
1600303;Macapá;5208707;Goiânia;4;4;8;1864
2408102;Natal;5208707;Goiânia;4;4;8;1897
2607901;Jaboatão dos Guararapes;5208707;Goiânia;4;4;8;1769
2919207;Lauro de Freitas;5208707;Goiânia;4;4;8;1233
3502804;Araçatuba;5208707;Goiânia;4;4;8;518
4104808;Cascavel;5208707;Goiânia;4;4;8;1021
4202909;Brusque;5208707;Goiânia;4;4;8;1152
4208203;Itajaí;5208707;Goiânia;4;4;8;1136
5200258;Águas Lindas de Goiás;5208707;Goiânia;4;4;8;148
5203500;Bom Jesus de Goiás;5208707;Goiânia;4;4;8;176
5205497;Cidade Ocidental;5208707;Goiânia;4;4;8;160
3550308;São Paulo;5208608;Goianésia;4;4;8;962
3106200;Belo Horizonte;5208004;Formosa;4;4;8;604
5206206;Cristalina;5208004;Formosa;4;4;8;148
3550308;São Paulo;5205901;Corumbaíba;4;4;8;644
3550308;São Paulo;5205471;Chapadão do Céu;4;4;8;860
3170206;Uberlândia;5203500;Bom Jesus de Goiás;4;4;8;178
1100205;Porto Velho;5201405;Aparecida de Goiânia;4;4;8;1770
3170107;Uberaba;5201405;Aparecida de Goiânia;4;4;8;355
3518800;Guarulhos;5201405;Aparecida de Goiânia;4;4;8;790
1502707;Conceição do Araguaia;5201108;Anápolis;4;4;8;893
2304400;Fortaleza;5201108;Anápolis;4;4;8;1764
3518800;Guarulhos;5201108;Anápolis;4;4;8;830
5106158;Nova Bandeirantes;5108956;Nova Monte Verde;4;4;8;45
5106778;Porto Alegre do Norte;5108600;Vila Rica;4;4;8;111
5102637;Campo Novo do Parecis;5108402;Várzea Grande;4;4;8;287
5107925;Sorriso;5108402;Várzea Grande;4;4;8;347
5107909;Sinop;5108055;Terra Nova do Norte;4;4;8;151
5107925;Sorriso;5108006;Tapurah;4;4;8;91
5002704;Campo Grande;5107958;Tangará da Serra;4;4;8;713
5102504;Cáceres;5107958;Tangará da Serra;4;4;8;157
5102686;Campos de Júlio;5107958;Tangará da Serra;4;4;8;196
5105101;Juara;5107958;Tangará da Serra;4;4;8;371
5105101;Juara;5107941;Tabaporã;4;4;8;77
4106902;Curitiba;5107925;Sorriso;4;4;8;1601
5103205;Colíder;5107925;Sorriso;4;4;8;193
5107602;Rondonópolis;5107925;Sorriso;4;4;8;445
5104104;Guarantã do Norte;5107909;Sinop;4;4;8;219
5104526;Ipiranga do Norte;5107909;Sinop;4;4;8;83
5107040;Primavera do Leste;5107909;Sinop;4;4;8;425
5102686;Campos de Júlio;5107875;Sapezal;4;4;8;109
3170107;Uberaba;5107602;Rondonópolis;4;4;8;815
3543402;Ribeirão Preto;5107602;Rondonópolis;4;4;8;910
4101804;Araucária;5107602;Rondonópolis;4;4;8;1168
5104203;Guiratinga;5107602;Rondonópolis;4;4;8;98
1100122;Ji-Paraná;5107578;Rondolândia;4;4;8;49
5105259;Lucas do Rio Verde;5107305;São José do Rio Claro;4;4;8;98
5105234;Lambari d'Oeste;5107206;Rio Branco;4;4;8;15
3550308;São Paulo;5107180;Ribeirão Cascalheira;4;4;8;1318
5106257;Nova Xavantina;5107180;Ribeirão Cascalheira;4;4;8;203
5106224;Nova Mutum;5107040;Primavera do Leste;4;4;8;264
5101258;Araputanga;5106752;Pontes e Lacerda;4;4;8;106
3550308;São Paulo;5106307;Paranatinga;4;4;8;1306
5103403;Cuiabá;5106307;Paranatinga;4;4;8;253
5101803;Barra do Garças;5106257;Nova Xavantina;4;4;8;126
3550308;São Paulo;5105622;Mirassol d'Oeste;4;4;8;1535
5103205;Colíder;5105580;Marcelândia;4;4;8;115
5104104;Guarantã do Norte;5105259;Lucas do Rio Verde;4;4;8;359
5104807;Jaciara;5105200;Juscimeira;4;4;8;15
5100250;Alta Floresta;5105101;Juara;4;4;8;219
5102702;Canarana;5103858;Gaúcha do Norte;4;4;8;94
1100023;Ariquemes;5103403;Cuiabá;4;4;8;963
3543402;Ribeirão Preto;5103403;Cuiabá;4;4;8;1096
3548500;Santos;5103403;Cuiabá;4;4;8;1414
3552403;Sumaré;5103403;Cuiabá;4;4;8;1258
5008305;Três Lagoas;5103403;Cuiabá;4;4;8;747
5101704;Barra do Bugres;5103403;Cuiabá;4;4;8;129
5102678;Campo Verde;5103007;Chapada dos Guimarães;4;4;8;63
3550308;São Paulo;5102702;Canarana;4;4;8;1282
4118204;Paranaguá;5102678;Campo Verde;4;4;8;1332
5101902;Brasnorte;5102637;Campo Novo do Parecis;4;4;8;168
3304557;Rio de Janeiro;5102504;Cáceres;4;4;8;1747
3550308;São Paulo;5101704;Barra do Bugres;4;4;8;1502
3550308;São Paulo;5101407;Aripuanã;4;4;8;2071
3550308;São Paulo;5100607;Alto Taquari;4;4;8;966
3205002;Serra;5008305;Três Lagoas;4;4;8;1190
3501608;Americana;5008305;Três Lagoas;4;4;8;510
5002308;Brasilândia;5008305;Três Lagoas;4;4;8;62
5002902;Cassilândia;5008305;Três Lagoas;4;4;8;180
5002704;Campo Grande;5007935;Sonora;4;4;8;317
5003702;Dourados;5007901;Sidrolândia;4;4;8;147
3550308;São Paulo;5007802;Selvíria;4;4;8;621
5003306;Coxim;5007695;São Gabriel do Oeste;4;4;8;111
5002704;Campo Grande;5007505;Rochedo;4;4;8;57
3557105;Votuporanga;5006309;Paranaíba;4;4;8;155
5002902;Cassilândia;5006309;Paranaíba;4;4;8;81
5001904;Bataguassu;5006200;Nova Andradina;4;4;8;113
4101408;Apucarana;5005707;Naviraí;4;4;8;289
4128104;Umuarama;5005707;Naviraí;4;4;8;121
5004304;Iguatemi;5005707;Naviraí;4;4;8;82
4108809;Guaíra;5005681;Mundo Novo;4;4;8;19
5002100;Bela Vista;5005004;Jardim;4;4;8;75
5002209;Bonito;5005004;Jardim;4;4;8;52
3550308;São Paulo;5004908;Jaraguari;4;4;8;907
4128104;Umuarama;5004601;Itaquiraí;4;4;8;94
4128104;Umuarama;5004304;Iguatemi;4;4;8;128
5003702;Dourados;5004007;Glória de Dourados;4;4;8;58
3550308;São Paulo;5003751;Eldorado;4;4;8;778
3304557;Rio de Janeiro;5003702;Dourados;4;4;8;1195
4113700;Londrina;5003702;Dourados;4;4;8;395
5003504;Douradina;5003702;Dourados;4;4;8;28
4106902;Curitiba;5003207;Corumbá;4;4;8;1144
1100122;Ji-Paraná;5002704;Campo Grande;4;4;8;1284
2611606;Recife;5002704;Campo Grande;4;4;8;2419
3118601;Contagem;5002704;Campo Grande;4;4;8;1103
3502101;Andradina;5002704;Campo Grande;4;4;8;344
5000609;Amambaí;5002704;Campo Grande;4;4;8;306
5002159;Bodoquena;5002704;Campo Grande;4;4;8;215
3546603;Santa Fé do Sul;5001003;Aparecida do Taboado;4;4;8;18
3550308;São Paulo;5001003;Aparecida do Taboado;4;4;8;615
3550308;São Paulo;5000807;Anaurilândia;4;4;8;654
4304606;Canoas;4323804;Xangri-lá;4;4;8;109
4321600;Tramandaí;4323804;Xangri-lá;4;4;8;22
4301859;Barra do Guarita;4323705;Vista Gaúcha;4;4;8;12
4321402;Tenente Portela;4323705;Vista Gaúcha;4;4;8;10
4320909;Tapejara;4323358;Vila Lângaro;4;4;8;13
4305959;Cotiporã;4322806;Veranópolis;4;4;8;16
4307807;Estrela;4322608;Venâncio Aires;4;4;8;25
4321303;Taquari;4322608;Venâncio Aires;4;4;8;39
3518800;Guarulhos;4322509;Vacaria;4;4;8;701
3304557;Rio de Janeiro;4322400;Uruguaiana;4;4;8;1506
4315305;Quaraí;4322400;Uruguaiana;4;4;8;88
4322103;Tucunduva;4322301;Tuparendi;4;4;8;12
4302352;Bom Princípio;4322251;Tupandi;4;4;8;7
4309555;Harmonia;4322251;Tupandi;4;4;8;8
4316501;Salvador do Sul;4322251;Tupandi;4;4;8;10
4309605;Horizontina;4322103;Tucunduva;4;4;8;13
3304557;Rio de Janeiro;4322004;Triunfo;4;4;8;1110
4304606;Canoas;4322004;Triunfo;4;4;8;50
4309704;Humaitá;4321907;Três Passos;4;4;8;12
4310207;Ijuí;4321907;Três Passos;4;4;8;103
4321402;Tenente Portela;4321907;Três Passos;4;4;8;21
4321477;Tiradentes do Sul;4321907;Três Passos;4;4;8;16
4321808;Três de Maio;4321907;Três Passos;4;4;8;44
4310207;Ijuí;4321808;Três de Maio;4;4;8;78
4314902;Porto Alegre;4321808;Três de Maio;4;4;8;397
4317509;Santo Ângelo;4321808;Três de Maio;4;4;8;61
4309100;Gramado;4321709;Três Coroas;4;4;8;18
4321501;Torres;4321667;Três Cachoeiras;4;4;8;19
4307005;Erechim;4321634;Três Arroios;4;4;8;20
4305454;Cidreira;4321600;Tramandaí;4;4;8;21
4309100;Gramado;4321600;Tramandaí;4;4;8;97
4309209;Gravataí;4321600;Tramandaí;4;4;8;81
4309407;Guaporé;4321600;Tramandaí;4;4;8;210
4317608;Santo Antônio da Patrulha;4321600;Tramandaí;4;4;8;40
3304557;Rio de Janeiro;4321501;Torres;4;4;8;944
4301057;Arroio do Sal;4321501;Torres;4;4;8;26
4307906;Farroupilha;4321451;Teutônia;4;4;8;52
4312401;Montenegro;4321451;Teutônia;4;4;8;38
4316808;Santa Cruz do Sul;4321303;Taquari;4;4;8;55
4318200;São Francisco de Paula;4321204;Taquara;4;4;8;29
4319901;Sapiranga;4321204;Taquara;4;4;8;22
4314902;Porto Alegre;4320909;Tapejara;4;4;8;234
4311403;Lajeado;4320800;Soledade;4;4;8;84
4308904;Getúlio Vargas;4320503;Sertão;4;4;8;11
4309001;Giruá;4320321;Senador Salgado Filho;4;4;8;19
4306403;Dois Irmãos;4319901;Sapiranga;4;4;8;10
4310108;Igrejinha;4319901;Sapiranga;4;4;8;22
4302352;Bom Princípio;4319505;São Sebastião do Caí;4;4;8;11
4309555;Harmonia;4319505;São Sebastião do Caí;4;4;8;6
4314902;Porto Alegre;4319406;São Pedro do Sul;4;4;8;293
4303301;Caibaté;4318903;São Luiz Gonzaga;4;4;8;32
4316808;Santa Cruz do Sul;4318903;São Luiz Gonzaga;4;4;8;290
4317202;Santa Rosa;4318903;São Luiz Gonzaga;4;4;8;77
4306056;Cristal;4318804;São Lourenço do Sul;4;4;8;35
4315602;Rio Grande;4318804;São Lourenço do Sul;4;4;8;86
3518800;Guarulhos;4318705;São Leopoldo;4;4;8;823
4305108;Caxias do Sul;4318622;São José dos Ausentes;4;4;8;118
4316600;Sananduva;4318606;São José do Ouro;4;4;8;29
4301107;Arroio dos Ratos;4318408;São Jerônimo;4;4;8;13
4308805;General Câmara;4318408;São Jerônimo;4;4;8;8
4317400;Santiago;4318309;São Gabriel;4;4;8;137
3550308;São Paulo;4318002;São Borja;4;4;8;1053
4300406;Alegrete;4318002;São Borja;4;4;8;128
4303707;Campina das Missões;4317905;Santo Cristo;4;4;8;25
4305108;Caxias do Sul;4317509;Santo Ângelo;4;4;8;319
4313904;Panambi;4317509;Santo Ângelo;4;4;8;76
4300406;Alegrete;4317400;Santiago;4;4;8;109
4311007;Jaguarão;4317301;Santa Vitória do Palmar;4;4;8;108
4314407;Pelotas;4317103;Santana do Livramento;4;4;8;314
4204202;Chapecó;4316907;Santa Maria;4;4;8;309
4306106;Cruz Alta;4316907;Santa Maria;4;4;8;119
4308003;Faxinal do Soturno;4316907;Santa Maria;4;4;8;39
4310538;Itaara;4316907;Santa Maria;4;4;8;11
4307906;Farroupilha;4316808;Santa Cruz do Sul;4;4;8;119
4312401;Montenegro;4316808;Santa Cruz do Sul;4;4;8;90
4305108;Caxias do Sul;4316600;Sananduva;4;4;8;148
4309803;Ibiaçá;4316600;Sananduva;4;4;8;13
4314902;Porto Alegre;4316600;Sananduva;4;4;8;241
4309555;Harmonia;4316501;Salvador do Sul;4;4;8;15
4306601;Dom Pedrito;4316402;Rosário do Sul;4;4;8;83
4313953;Pantano Grande;4315701;Rio Pardo;4;4;8;31
3548708;São Bernardo do Campo;4315602;Rio Grande;4;4;8;1057
4312401;Montenegro;4315602;Rio Grande;4;4;8;275
4314902;Porto Alegre;4315503;Restinga Seca;4;4;8;212
4314902;Porto Alegre;4315206;Putinga;4;4;8;149
4311403;Lajeado;4315156;Progresso;4;4;8;35
1506807;Santarém;4314902;Porto Alegre;4;4;8;3068
2307650;Maracanaú;4314902;Porto Alegre;4;4;8;3112
2914802;Itabuna;4314902;Porto Alegre;4;4;8;2010
4203006;Caçador;4314902;Porto Alegre;4;4;8;361
4205704;Garopaba;4314902;Porto Alegre;4;4;8;331
4208302;Itapema;4314902;Porto Alegre;4;4;8;409
4300802;Antônio Prado;4314902;Porto Alegre;4;4;8;133
4305900;Coronel Bicaco;4314902;Porto Alegre;4;4;8;352
4305959;Cotiporã;4314902;Porto Alegre;4;4;8;127
4306205;Cruzeiro do Sul;4314902;Porto Alegre;4;4;8;100
4308102;Feliz;4314902;Porto Alegre;4;4;8;67
4309605;Horizontina;4314902;Porto Alegre;4;4;8;400
4310439;Ipê;4314902;Porto Alegre;4;4;8;139
4311205;Júlio de Castilhos;4314902;Porto Alegre;4;4;8;256
4311502;Lavras do Sul;4314902;Porto Alegre;4;4;8;274
4312708;Nonoai;4314902;Porto Alegre;4;4;8;334
3516200;Franca;4314803;Portão;4;4;8;1076
4314407;Pelotas;4314605;Piratini;4;4;8;76
4301602;Bagé;4314506;Pinheiro Machado;4;4;8;74
2611606;Recife;4314407;Pelotas;4;4;8;3033
4305124;Cerrito;4314209;Pedro Osório;4;4;8;5
3518800;Guarulhos;4314100;Passo Fundo;4;4;8;775
4219309;Videira;4314100;Passo Fundo;4;4;8;184
4306403;Dois Irmãos;4314100;Passo Fundo;4;4;8;196
4307708;Esteio;4314100;Passo Fundo;4;4;8;214
4304903;Casca;4314001;Paraí;4;4;8;19
4302808;Caçapava do Sul;4313953;Pantano Grande;4;4;8;109
4313706;Palmeira das Missões;4313904;Panambi;4;4;8;45
4313490;Novo Barreiro;4313706;Palmeira das Missões;4;4;8;21
3550308;São Paulo;4313508;Osório;4;4;8;769
4305454;Cidreira;4313508;Osório;4;4;8;31
4307906;Farroupilha;4313508;Osório;4;4;8;126
4309209;Gravataí;4313508;Osório;4;4;8;70
2304400;Fortaleza;4313409;Novo Hamburgo;4;4;8;3087
4303004;Cachoeira do Sul;4313409;Novo Hamburgo;4;4;8;176
4309308;Guaíba;4313409;Novo Hamburgo;4;4;8;51
3518800;Guarulhos;4313375;Nova Santa Rita;4;4;8;838
4300208;Ajuricaba;4313334;Nova Ramada;4;4;8;21
4307906;Farroupilha;4313300;Nova Prata;4;4;8;56
4302352;Bom Princípio;4313201;Nova Petrópolis;4;4;8;26
4304408;Canela;4313201;Nova Petrópolis;4;4;8;30
4311700;Machadinho;4312203;Maximiliano de Almeida;4;4;8;15
4307005;Erechim;4311908;Marcelino Ramos;4;4;8;37
4304705;Carazinho;4311809;Marau;4;4;8;60
4310603;Itaqui;4311718;Maçambara;4;4;8;46
4106902;Curitiba;4311403;Lajeado;4;4;8;514
4209300;Lages;4311403;Lajeado;4;4;8;243
4304705;Carazinho;4311403;Lajeado;4;4;8;146
4307005;Erechim;4311403;Lajeado;4;4;8;201
4308607;Garibaldi;4311403;Lajeado;4;4;8;52
4309100;Gramado;4311403;Lajeado;4;4;8;109
4305439;Chuí;4311007;Jaguarão;4;4;8;126
4303905;Campo Bom;4310801;Ivoti;4;4;8;14
4306809;Encantado;4310306;Ilópolis;4;4;8;40
4305108;Caxias do Sul;4310207;Ijuí;4;4;8;283
4305871;Coronel Barros;4310207;Ijuí;4;4;8;14
4307005;Erechim;4310207;Ijuí;4;4;8;181
4301602;Bagé;4309654;Hulha Negra;4;4;8;23
4306734;Doutor Maurício Cardoso;4309605;Horizontina;4;4;8;14
3505708;Barueri;4309209;Gravataí;4;4;8;810
3547809;Santo André;4309209;Gravataí;4;4;8;813
4209102;Joinville;4309209;Gravataí;4;4;8;453
4303509;Camaquã;4309209;Gravataí;4;4;8;127
3304557;Rio de Janeiro;4308607;Garibaldi;4;4;8;1054
4307906;Farroupilha;4308102;Feliz;4;4;8;25
4202404;Blumenau;4307906;Farroupilha;4;4;8;333
4204202;Chapecó;4307906;Farroupilha;4;4;8;265
4217709;Sombrio;4307906;Farroupilha;4;4;8;164
4302402;Bom Retiro do Sul;4307807;Estrela;4;4;8;12
4305108;Caxias do Sul;4307807;Estrela;4;4;8;86
4303905;Campo Bom;4307609;Estância Velha;4;4;8;12
4306973;Erebango;4307559;Estação;4;4;8;7
3534401;Osasco;4307005;Erechim;4;4;8;699
4209003;Joaçaba;4307005;Erechim;4;4;8;90
4306759;Doutor Ricardo;4306809;Encantado;4;4;8;18
4216602;São José;4306767;Eldorado do Sul;4;4;8;394
4303509;Camaquã;4306502;Dom Feliciano;4;4;8;32
3550308;São Paulo;4305355;Charqueadas;4;4;8;840
3513801;Diadema;4305108;Caxias do Sul;4;4;8;745
3515004;Embu;4305108;Caxias do Sul;4;4;8;736
3552403;Sumaré;4305108;Caxias do Sul;4;4;8;794
3556701;Vinhedo;4305108;Caxias do Sul;4;4;8;787
4209300;Lages;4305108;Caxias do Sul;4;4;8;171
4303905;Campo Bom;4305108;Caxias do Sul;4;4;8;59
4204202;Chapecó;4304705;Carazinho;4;4;8;132
3550308;São Paulo;4304663;Capão do Leão;4;4;8;1044
4303103;Cachoeirinha;4304630;Capão da Canoa;4;4;8;106
3106200;Belo Horizonte;4304606;Canoas;4;4;8;1294
3522208;Itapecerica da Serra;4304606;Canoas;4;4;8;798
4205902;Gaspar;4304606;Canoas;4;4;8;392
2927408;Salvador;4303905;Campo Bom;4;4;8;2176
3304557;Rio de Janeiro;4303905;Campo Bom;4;4;8;1050
3518800;Guarulhos;4303905;Campo Bom;4;4;8;811
3548708;São Bernardo do Campo;4303103;Cachoeirinha;4;4;8;811
4208203;Itajaí;4303103;Cachoeirinha;4;4;8;402
3550308;São Paulo;4303004;Cachoeira do Sul;4;4;8;916
4301107;Arroio dos Ratos;4302709;Butiá;4;4;8;23
4101507;Arapongas;4302105;Bento Gonçalves;4;4;8;637
4215802;São Bento do Sul;4302105;Bento Gonçalves;4;4;8;382
4209003;Joaçaba;4219507;Xanxerê;4;4;8;92
4203907;Capinzal;4219309;Videira;4;4;8;59
4214805;Rio do Sul;4219200;Vidal Ramos;4;4;8;30
4204608;Criciúma;4218806;Turvo;4;4;8;41
4205456;Forquilhinha;4218806;Turvo;4;4;8;28
4208708;Jacinto Machado;4218806;Turvo;4;4;8;11
4208401;Itapiranga;4218756;Tunápolis;4;4;8;23
4201505;Armazém;4218707;Tubarão;4;4;8;25
4202909;Brusque;4218707;Tubarão;4;4;8;155
4204202;Chapecó;4218707;Tubarão;4;4;8;381
4208906;Jaraguá do Sul;4218707;Tubarão;4;4;8;222
4213708;Pouso Redondo;4218608;Trombudo Central;4;4;8;13
4202206;Benedito Novo;4218202;Timbó;4;4;8;13
4209102;Joinville;4218202;Timbó;4;4;8;74
4106902;Curitiba;4218004;Tijucas;4;4;8;210
4211900;Palhoça;4218004;Tijucas;4;4;8;46
4203006;Caçador;4217907;Tangará;4;4;8;37
4105508;Cianorte;4217709;Sombrio;4;4;8;664
4208708;Jacinto Machado;4217709;Sombrio;4;4;8;15
4213807;Praia Grande;4217709;Sombrio;4;4;8;30
4206504;Guaramirim;4217402;Schroeder;4;4;8;10
4108403;Francisco Beltrão;4217204;São Miguel do Oeste;4;4;8;84
4205001;Dionísio Cerqueira;4217204;São Miguel do Oeste;4;4;8;48
4202800;Braço do Norte;4217006;São Ludgero;4;4;8;6
4206603;Guarujá do Sul;4216701;São José do Cedro;4;4;8;8
3515004;Embu;4216602;São José;4;4;8;471
4115200;Maringá;4216602;São José;4;4;8;557
4208906;Jaraguá do Sul;4216602;São José;4;4;8;128
4202008;Balneário Camboriú;4216305;São João Batista;4;4;8;36
3547304;Santana de Parnaíba;4216206;São Francisco do Sul;4;4;8;357
4212106;Palmitos;4216008;São Carlos;4;4;8;13
4214508;Rio do Campo;4215679;Santa Terezinha;4;4;8;23
4201604;Arroio Trinta;4215406;Salto Veloso;4;4;8;7
4207502;Indaial;4215109;Rodeio;4;4;8;14
4119103;Piên;4215000;Rio Negrinho;4;4;8;19
4208906;Jaraguá do Sul;4215000;Rio Negrinho;4;4;8;51
3518800;Guarulhos;4214805;Rio do Sul;4;4;8;515
4208302;Itapema;4214805;Rio do Sul;4;4;8;97
4102901;Bituruna;4213609;Porto União;4;4;8;53
4118600;Paula Freitas;4213609;Porto União;4;4;8;13
4205407;Florianópolis;4213500;Porto Belo;4;4;8;49
3550308;São Paulo;4213203;Pomerode;4;4;8;423
4210506;Maravilha;4212908;Pinhalzinho;4;4;8;20
4209102;Joinville;4212809;Piçarras;4;4;8;54
4202107;Barra Velha;4212502;Penha;4;4;8;20
4211108;Monte Castelo;4212205;Papanduva;4;4;8;13
4203105;Caibi;4212106;Palmitos;4;4;8;13
4203501;Campo Erê;4212007;Palma Sola;4;4;8;21
4106902;Curitiba;4211900;Palhoça;4;4;8;251
4207304;Imbituba;4211900;Palhoça;4;4;8;59
4208302;Itapema;4211900;Palhoça;4;4;8;63
4203709;Canelinha;4211504;Nova Trento;4;4;8;14
4208302;Itapema;4211504;Nova Trento;4;4;8;36
4202909;Brusque;4211306;Navegantes;4;4;8;33
4208302;Itapema;4211306;Navegantes;4;4;8;24
4203600;Campos Novos;4211058;Monte Carlo;4;4;8;32
4113205;Lapa;4210100;Mafra;4;4;8;43
4205407;Florianópolis;4210100;Mafra;4;4;8;209
4204301;Concórdia;4209854;Lindóia do Sul;4;4;8;19
4204251;Cocal do Sul;4209607;Lauro Muller;4;4;8;24
4203956;Capivari de Baixo;4209409;Laguna;4;4;8;13
4125506;São José dos Pinhais;4209300;Lages;4;4;8;275
4206900;Ibirama;4209151;José Boiteux;4;4;8;15
2927408;Salvador;4209102;Joinville;4;4;8;1775
3170206;Uberlândia;4209102;Joinville;4;4;8;819
3520509;Indaiatuba;4209102;Joinville;4;4;8;388
3552205;Sorocaba;4209102;Joinville;4;4;8;338
4105805;Colombo;4209102;Joinville;4;4;8;120
4127700;Toledo;4209102;Joinville;4;4;8;516
4202305;Biguaçu;4209102;Joinville;4;4;8;136
4203303;Campo Alegre;4209102;Joinville;4;4;8;42
4207007;Içara;4209102;Joinville;4;4;8;274
2304400;Fortaleza;4208906;Jaraguá do Sul;4;4;8;2702
4106902;Curitiba;4208500;Ituporanga;4;4;8;221
4202404;Blumenau;4208500;Ituporanga;4;4;8;73
4106902;Curitiba;4208450;Itapoá;4;4;8;99
1100205;Porto Velho;4208203;Itajaí;4;4;8;2463
3513801;Diadema;4208203;Itajaí;4;4;8;417
3547304;Santana de Parnaíba;4208203;Itajaí;4;4;8;427
4105805;Colombo;4208203;Itajaí;4;4;8;193
4119509;Piraquara;4208203;Itajaí;4;4;8;169
4205001;Dionísio Cerqueira;4208203;Itajaí;4;4;8;489
4204301;Concórdia;4207700;Ipumirim;4;4;8;20
4204905;Descanso;4207650;Iporã do Oeste;4;4;8;18
3304557;Rio de Janeiro;4207304;Imbituba;4;4;8;789
3518800;Guarulhos;4207007;Içara;4;4;8;641
4205407;Florianópolis;4206900;Ibirama;4;4;8;116
3304557;Rio de Janeiro;4206504;Guaramirim;4;4;8;690
4106902;Curitiba;4206504;Guaramirim;4;4;8;119
4202305;Biguaçu;4206009;Governador Celso Ramos;4;4;8;23
4106902;Curitiba;4205902;Gaspar;4;4;8;169
4115200;Maringá;4205902;Gaspar;4;4;8;485
4109609;Guaratuba;4205803;Garuva;4;4;8;22
3550308;São Paulo;4205506;Fraiburgo;4;4;8;561
4203907;Capinzal;4205506;Fraiburgo;4;4;8;77
4201406;Araranguá;4205456;Forquilhinha;4;4;8;22
3547304;Santana de Parnaíba;4205407;Florianópolis;4;4;8;485
3547809;Santo André;4205407;Florianópolis;4;4;8;478
4203808;Canoinhas;4205407;Florianópolis;4;4;8;242
4204806;Curitibanos;4205407;Florianópolis;4;4;8;209
4108304;Foz do Iguaçu;4205001;Dionísio Cerqueira;4;4;8;121
3106200;Belo Horizonte;4204608;Criciúma;4;4;8;1097
3550308;São Paulo;4204558;Correia Pinto;4;4;8;565
4202909;Brusque;4204301;Concórdia;4;4;8;308
4203600;Campos Novos;4204301;Concórdia;4;4;8;83
4203907;Capinzal;4204301;Concórdia;4;4;8;43
3106200;Belo Horizonte;4204202;Chapecó;4;4;8;1154
3505708;Barueri;4204202;Chapecó;4;4;8;689
4101804;Araucária;4204202;Chapecó;4;4;8;360
4125506;São José dos Pinhais;4204202;Chapecó;4;4;8;381
4128203;União da Vitória;4203808;Canoinhas;4;4;8;74
4106902;Curitiba;4203303;Campo Alegre;4;4;8;84
4128203;União da Vitória;4203154;Calmon;4;4;8;36
4200705;Alfredo Wagner;4202602;Bom Retiro;4;4;8;19
4202404;Blumenau;4202453;Bombinhas;4;4;8;58
2607901;Jaboatão dos Guararapes;4202404;Blumenau;4;4;8;2468
3513009;Cotia;4202404;Blumenau;4;4;8;427
3522505;Itapevi;4202404;Blumenau;4;4;8;431
3547304;Santana de Parnaíba;4202404;Blumenau;4;4;8;442
4202206;Benedito Novo;4202404;Blumenau;4;4;8;35
3106200;Belo Horizonte;4202008;Balneário Camboriú;4;4;8;907
4201257;Apiúna;4201703;Ascurra;4;4;8;9
3550308;São Paulo;4201307;Araquari;4;4;8;368
4109906;Icaraíma;4128104;Umuarama;4;4;8;60
4111555;Ivaté;4128104;Umuarama;4;4;8;37
4127700;Toledo;4128104;Umuarama;4;4;8;118
4119608;Pitanga;4127965;Turvo;4;4;8;38
4127700;Toledo;4127957;Tupãssi;4;4;8;29
4108304;Foz do Iguaçu;4127700;Toledo;4;4;8;115
4108809;Guaíra;4127700;Toledo;4;4;8;84
4113700;Londrina;4127700;Toledo;4;4;8;306
4118402;Paranavaí;4127304;Terra Rica;4;4;8;46
4115200;Maringá;4127205;Terra Boa;4;4;8;64
4112009;Jaguariaíva;4127106;Telêmaco Borba;4;4;8;100
4125001;São João do Ivaí;4125803;São Pedro do Ivaí;4;4;8;13
4116059;Missal;4125704;São Miguel do Iguaçu;4;4;8;29
3550308;São Paulo;4125605;São Mateus do Sul;4;4;8;443
3201308;Cariacica;4125506;São José dos Pinhais;4;4;8;1041
3304201;Resende;4125506;São José dos Pinhais;4;4;8;577
4108304;Foz do Iguaçu;4125506;São José dos Pinhais;4;4;8;534
4118501;Pato Branco;4125506;São José dos Pinhais;4;4;8;359
4107207;Dois Vizinhos;4124806;São João;4;4;8;35
4111209;Itapejara d'Oeste;4124806;São João;4;4;8;18
4118006;Paraíso do Norte;4124608;São Carlos do Ivaí;4;4;8;13
4106100;Conselheiro Mairinck;4124103;Santo Antônio da Platina;4;4;8;37
4120705;Quatiguá;4124103;Santo Antônio da Platina;4;4;8;36
4121901;Ribeirão do Pinhal;4124103;Santo Antônio da Platina;4;4;8;28
4109401;Guarapuava;4123857;Santa Maria do Oeste;4;4;8;65
4108809;Guaíra;4123501;Santa Helena;4;4;8;87
4116059;Missal;4123501;Santa Helena;4;4;8;24
4110409;Indianópolis;4122602;Rondon;4;4;8;10
4115200;Maringá;4122602;Rondon;4;4;8;85
4102406;Bandeirantes;4122404;Rolândia;4;4;8;105
4104808;Cascavel;4122404;Rolândia;4;4;8;281
4109807;Ibiporã;4122404;Rolândia;4;4;8;33
4108452;Foz do Jordão;4121752;Reserva do Iguaçu;4;4;8;23
4113700;Londrina;4121703;Reserva;4;4;8;153
4104501;Capanema;4121406;Realeza;4;4;8;28
4118501;Pato Branco;4121406;Realeza;4;4;8;102
4108403;Francisco Beltrão;4120903;Quedas do Iguaçu;4;4;8;72
4112801;Joaquim Távora;4120705;Quatiguá;4;4;8;8
4108957;Guamiranga;4120606;Prudentópolis;4;4;8;23
4110102;Imbituva;4120606;Prudentópolis;4;4;8;43
4111407;Ivaí;4120606;Prudentópolis;4;4;8;29
4113700;Londrina;4120002;Porecatu;4;4;8;64
3170107;Uberaba;4119905;Ponta Grossa;4;4;8;634
3531803;Monte Mor;4119905;Ponta Grossa;4;4;8;372
4101606;Arapoti;4119905;Ponta Grossa;4;4;8;110
4104204;Campo Largo;4119905;Ponta Grossa;4;4;8;75
4119152;Pinhais;4119905;Ponta Grossa;4;4;8;105
4101408;Apucarana;4119608;Pitanga;4;4;8;137
4111506;Ivaiporã;4119608;Pitanga;4;4;8;58
4114500;Manoel Ribas;4119608;Pitanga;4;4;8;29
4117271;Nova Tebas;4119608;Pitanga;4;4;8;41
4104006;Campina Grande do Sul;4119152;Pinhais;4;4;8;21
4115200;Maringá;4119152;Pinhais;4;4;8;353
3541406;Presidente Prudente;4118402;Paranavaí;4;4;8;151
3205002;Serra;4118204;Paranaguá;4;4;8;1012
3205309;Vitória;4118204;Paranaguá;4;4;8;1005
4105904;Colorado;4118105;Paranacity;4;4;8;21
4116901;Nova Esperança;4118105;Paranacity;4;4;8;29
4108320;Francisco Alves;4117909;Palotina;4;4;8;26
3550308;São Paulo;4117701;Palmeira;4;4;8;389
4106902;Curitiba;4117602;Palmas;4;4;8;292
4107207;Dois Vizinhos;4117255;Nova Prata do Iguaçu;4;4;8;31
4107108;Diamante do Norte;4117107;Nova Londrina;4;4;8;18
4100608;Alto Paraná;4116901;Nova Esperança;4;4;8;13
4106308;Corbélia;4116703;Nova Aurora;4;4;8;29
1100205;Porto Velho;4115200;Maringá;4;4;8;2001
2919553;Luís Eduardo magalhães;4115200;Maringá;4;4;8;1392
3502804;Araçatuba;4115200;Maringá;4;4;8;286
3526902;Limeira;4115200;Maringá;4;4;8;472
3529005;Marília;4115200;Maringá;4;4;8;242
3538709;Piracicaba;4115200;Maringá;4;4;8;443
3547809;Santo André;4115200;Maringá;4;4;8;553
4100608;Alto Paraná;4115200;Maringá;4;4;8;52
4107306;Doutor Camargo;4115200;Maringá;4;4;8;33
4113700;Londrina;4114807;Marialva;4;4;8;68
4100301;Agudos do Sul;4114302;Mandirituba;4;4;8;24
3151800;Poços de Caldas;4113700;Londrina;4;4;8;499
3525300;Jaú;4113700;Londrina;4;4;8;286
4102109;Astorga;4113700;Londrina;4;4;8;53
4111803;Jacarezinho;4113700;Londrina;4;4;8;117
4104428;Candói;4113304;Laranjeiras do Sul;4;4;8;41
4106209;Contenda;4113205;Lapa;4;4;8;21
3523206;Itararé;4112009;Jaguariaíva;4;4;8;40
4106902;Curitiba;4112009;Jaguariaíva;4;4;8;135
4110508;Ipiranga;4111407;Ivaí;4;4;8;28
4104808;Cascavel;4110706;Irati;4;4;8;289
4106407;Cornélio Procópio;4109807;Ibiporã;4;4;8;41
3550308;São Paulo;4109708;Ibaiti;4;4;8;361
4101606;Arapoti;4109708;Ibaiti;4;4;8;50
4106407;Cornélio Procópio;4109708;Ibaiti;4;4;8;89
4104428;Candói;4109401;Guarapuava;4;4;8;77
3518800;Guarulhos;4108403;Francisco Beltrão;4;4;8;707
4102604;Barracão;4108403;Francisco Beltrão;4;4;8;60
4107009;Curiúva;4107751;Figueira;4;4;8;21
3550308;São Paulo;4107652;Fazenda Rio Grande;4;4;8;345
4106571;Cruzeiro do Iguaçu;4107207;Dois Vizinhos;4;4;8;15
1100122;Ji-Paraná;4106902;Curitiba;4;4;8;2013
2611101;Petrolina;4106902;Curitiba;4;4;8;1973
3302403;Macaé;4106902;Curitiba;4;4;8;810
3502705;Apiaí;4106902;Curitiba;4;4;8;112
3503208;Araraquara;4106902;Curitiba;4;4;8;419
3507506;Botucatu;4106902;Curitiba;4;4;8;296
3507605;Bragança Paulista;4106902;Curitiba;4;4;8;388
3519071;Hortolândia;4106902;Curitiba;4;4;8;352
3523107;Itaquaquecetuba;4106902;Curitiba;4;4;8;365
3523909;Itu;4106902;Curitiba;4;4;8;311
3539806;Poá;4106902;Curitiba;4;4;8;363
3554102;Taubaté;4106902;Curitiba;4;4;8;458
3556701;Vinhedo;4106902;Curitiba;4;4;8;353
4106407;Cornélio Procópio;4106902;Curitiba;4;4;8;284
3550308;São Paulo;4106605;Cruzeiro do Oeste;4;4;8;655
4105508;Cianorte;4106605;Cruzeiro do Oeste;4;4;8;50
3550308;São Paulo;4106506;Coronel Vivida;4;4;8;640
4103701;Cambé;4106407;Cornélio Procópio;4;4;8;64
4101804;Araucária;4106209;Contenda;4;4;8;17
4100400;Almirante Tamandaré;4105805;Colombo;4;4;8;10
4101408;Apucarana;4105508;Cianorte;4;4;8;117
4104808;Cascavel;4105508;Cianorte;4;4;8;167
3525904;Jundiaí;4104808;Cascavel;4;4;8;686
4101408;Apucarana;4104808;Cascavel;4;4;8;253
4101507;Arapongas;4104808;Cascavel;4;4;8;264
4104055;Campo Bonito;4104808;Cascavel;4;4;8;48
4103008;Boa Esperança;4104303;Campo Mourão;4;4;8;46
3304557;Rio de Janeiro;4104204;Campo Largo;4;4;8;686
4101101;Andirá;4103602;Cambará;4;4;8;16
3106705;Betim;4101804;Araucária;4;4;8;807
3513504;Cubatão;4101804;Araucária;4;4;8;351
3552205;Sorocaba;4101804;Araucária;4;4;8;300
3530706;Mogi Guaçu;3557303;Estiva Gerbi;4;4;8;10
3546405;Santa Cruz do Rio Pardo;3557204;Chavantes;4;4;8;17
3550308;São Paulo;3557204;Chavantes;4;4;8;321
3510708;Cardoso;3557105;Votuporanga;4;4;8;40
3537404;Pereira Barreto;3557105;Votuporanga;4;4;8;117
3534401;Osasco;3557006;Votorantim;4;4;8;62
3520509;Indaiatuba;3556701;Vinhedo;4;4;8;28
3552205;Sorocaba;3556701;Vinhedo;4;4;8;74
3516309;Francisco Morato;3556503;Várzea Paulista;4;4;8;12
3519709;Ibiúna;3556453;Vargem Grande Paulista;4;4;8;21
3534401;Osasco;3556453;Vargem Grande Paulista;4;4;8;25
3550605;São Roque;3556453;Vargem Grande Paulista;4;4;8;14
3151800;Poços de Caldas;3556404;Vargem Grande do Sul;4;4;8;37
3518206;Guararapes;3556305;Valparaíso;4;4;8;24
3518800;Guarulhos;3556206;Valinhos;4;4;8;68
3530805;Moji-Mirim;3556206;Valinhos;4;4;8;60
3552403;Sumaré;3556206;Valinhos;4;4;8;32
3504008;Assis;3555000;Tupã;4;4;8;81
3514403;Dracena;3555000;Tupã;4;4;8;113
3538006;Pindamonhangaba;3554805;Tremembé;4;4;8;10
3507902;Brotas;3554706;Torrinha;4;4;8;16
3550308;São Paulo;3554706;Torrinha;4;4;8;208
3530201;Mirante do Paranapanema;3554300;Teodoro Sampaio;4;4;8;40
3539202;Pirapozinho;3554300;Teodoro Sampaio;4;4;8;77
3513801;Diadema;3554102;Taubaté;4;4;8;131
3550001;São Luís do Paraitinga;3554102;Taubaté;4;4;8;37
3505708;Barueri;3554003;Tatuí;4;4;8;101
3520509;Indaiatuba;3554003;Tatuí;4;4;8;68
3521002;Iperó;3554003;Tatuí;4;4;8;16
3535507;Paraguaçu Paulista;3553955;Tarumã;4;4;8;37
3550308;São Paulo;3553955;Tarumã;4;4;8;417
3550308;São Paulo;3553609;Tapiratiba;4;4;8;242
3537800;Piedade;3553500;Tapiraí;4;4;8;29
3537909;Pilar do Sul;3553500;Tapiraí;4;4;8;27
3547601;Santa Rosa de Viterbo;3553302;Tambaú;4;4;8;27
3548500;Santos;3552809;Taboão da Serra;4;4;8;55
3552205;Sorocaba;3552809;Taboão da Serra;4;4;8;75
3543303;Ribeirão Pires;3552502;Suzano;4;4;8;21
3118601;Contagem;3552403;Sumaré;4;4;8;456
3549904;São José dos Campos;3552403;Sumaré;4;4;8;148
3170206;Uberlândia;3552205;Sorocaba;4;4;8;513
3501152;Alumínio;3552205;Sorocaba;4;4;8;25
3513801;Diadema;3552205;Sorocaba;4;4;8;93
3549904;São José dos Campos;3552205;Sorocaba;4;4;8;168
3504107;Atibaia;3552106;Socorro;4;4;8;58
3505708;Barueri;3551702;Sertãozinho;4;4;8;288
3509502;Campinas;3551702;Sertãozinho;4;4;8;218
3549805;São José do Rio Preto;3551702;Sertãozinho;4;4;8;150
3143401;Monte Sião;3551603;Serra Negra;4;4;8;24
3513108;Cravinhos;3551504;Serrana;4;4;8;20
3550308;São Paulo;3551108;Sarapuí;4;4;8;120
3543402;Ribeirão Preto;3551009;São Vicente;4;4;8;339
3548807;São Caetano do Sul;3551009;São Vicente;4;4;8;40
3126109;Formiga;3550902;São Simão;4;4;8;247
3151800;Poços de Caldas;3550803;São Sebastião da Grama;4;4;8;29
3501152;Alumínio;3550605;São Roque;4;4;8;13
3513009;Cotia;3550605;São Roque;4;4;8;24
3537800;Piedade;3550605;São Roque;4;4;8;36
1100924;Chupinguaia;3550308;São Paulo;4;4;8;1868
1505437;Ourilândia do Norte;3550308;São Paulo;4;4;8;1919
2104057;Estreito;3550308;São Paulo;4;4;8;1892
2208007;Picos;3550308;São Paulo;4;4;8;1902
2301000;Aquiraz;3550308;São Paulo;4;4;8;2328
2301109;Aracati;3550308;São Paulo;4;4;8;2283
2401107;Areia Branca;3550308;São Paulo;4;4;8;2266
2704708;Marechal Deodoro;3550308;São Paulo;4;4;8;1869
2917508;Jacobina;3550308;São Paulo;4;4;8;1501
2929503;São Sebastião do Passé;3550308;São Paulo;4;4;8;1472
2932903;Valença;3550308;São Paulo;4;4;8;1362
3107109;Boa Esperança;3550308;São Paulo;4;4;8;304
3121100;Delfim Moreira;3550308;São Paulo;4;4;8;188
3123601;Elói Mendes;3550308;São Paulo;4;4;8;252
3124807;Estrela do Sul;3550308;São Paulo;4;4;8;553
3133501;Itapecerica;3550308;São Paulo;4;4;8;384
3133600;Itapeva;3550308;São Paulo;4;4;8;107
3135100;Janaúba;3550308;São Paulo;4;4;8;930
3140704;Mateus Leme;3550308;São Paulo;4;4;8;464
3141108;Matozinhos;3550308;São Paulo;4;4;8;522
3143203;Monte Santo de Minas;3550308;São Paulo;4;4;8;277
3151503;Piumhi;3550308;São Paulo;4;4;8;359
3152105;Ponte Nova;3550308;São Paulo;4;4;8;521
3169109;Toledo;3550308;São Paulo;4;4;8;107
3506706;Boa Esperança do Sul;3550308;São Paulo;4;4;8;255
3511607;Cesário Lange;3550308;São Paulo;4;4;8;141
3512704;Corumbataí;3550308;São Paulo;4;4;8;187
3513603;Cunha;3550308;São Paulo;4;4;8;184
3514304;Dourado;3550308;São Paulo;4;4;8;241
3517000;Getulina;3550308;São Paulo;4;4;8;390
3517208;Guaiçara;3550308;São Paulo;4;4;8;390
3518206;Guararapes;3550308;São Paulo;4;4;8;483
3518503;Guareí;3550308;São Paulo;4;4;8;159
3518602;Guariba;3550308;São Paulo;4;4;8;300
3523602;Itirapina;3550308;São Paulo;4;4;8;195
3525706;José Bonifácio;3550308;São Paulo;4;4;8;421
3527256;Lourdes;3550308;São Paulo;4;4;8;468
3529906;Miracatu;3550308;São Paulo;4;4;8;108
3535408;Panorama;3550308;São Paulo;4;4;8;582
3536208;Pariquera-Açu;3550308;São Paulo;4;4;8;172
3540507;Porangaba;3550308;São Paulo;4;4;8;159
3540903;Pradópolis;3550308;São Paulo;4;4;8;292
3541208;Presidente Bernardes;3550308;São Paulo;4;4;8;530
3543709;Rincão;3550308;São Paulo;4;4;8;270
3544103;Rio Grande da Serra;3550308;São Paulo;4;4;8;27
3545605;Santa Adélia;3550308;São Paulo;4;4;8;344
3537909;Pilar do Sul;3550209;São Miguel Arcanjo;4;4;8;30
3106705;Betim;3549904;São José dos Campos;4;4;8;398
3170206;Uberlândia;3549904;São José dos Campos;4;4;8;533
3205002;Serra;3549904;São José dos Campos;4;4;8;659
3501608;Americana;3549904;São José dos Campos;4;4;8;157
3507506;Botucatu;3549904;São José dos Campos;4;4;8;264
3513801;Diadema;3549904;São José dos Campos;4;4;8;92
3535606;Paraibuna;3549904;São José dos Campos;4;4;8;31
3543907;Rio Claro;3549904;São José dos Campos;4;4;8;193
3127107;Frutal;3549805;São José do Rio Preto;4;4;8;90
3134400;Iturama;3549805;São José do Rio Preto;4;4;8;146
3504206;Auriflama;3549805;São José do Rio Preto;4;4;8;121
3517505;Guapiaçu;3549805;São José do Rio Preto;4;4;8;19
3519600;Ibitinga;3549805;São José do Rio Preto;4;4;8;118
3536505;Paulínia;3549805;São José do Rio Preto;4;4;8;318
3547809;Santo André;3549805;São José do Rio Preto;4;4;8;434
3513900;Divinolândia;3549706;São José do Rio Pardo;4;4;8;17
3539301;Pirassununga;3549706;São José do Rio Pardo;4;4;8;73
3540705;Porto Ferreira;3549706;São José do Rio Pardo;4;4;8;67
3517406;Guaíra;3549409;São Joaquim da Barra;4;4;8;55
3521309;Ipuã;3549409;São Joaquim da Barra;4;4;8;23
3102605;Andradas;3549102;São João da Boa Vista;4;4;8;27
3501707;Américo Brasiliense;3548906;São Carlos;4;4;8;39
3503307;Araras;3548906;São Carlos;4;4;8;65
3507506;Botucatu;3548906;São Carlos;4;4;8;110
3518800;Guarulhos;3548906;São Carlos;4;4;8;209
3526902;Limeira;3548906;São Carlos;4;4;8;79
3131703;Itabira;3548807;São Caetano do Sul;4;4;8;553
3138203;Lavras;3548807;São Caetano do Sul;4;4;8;308
3304201;Resende;3548807;São Caetano do Sul;4;4;8;247
3502804;Araçatuba;3548807;São Caetano do Sul;4;4;8;474
3511102;Catanduva;3548807;São Caetano do Sul;4;4;8;367
3523909;Itu;3548807;São Caetano do Sul;4;4;8;83
3526902;Limeira;3548807;São Caetano do Sul;4;4;8;143
3529005;Marília;3548807;São Caetano do Sul;4;4;8;376
3530706;Mogi Guaçu;3548807;São Caetano do Sul;4;4;8;147
3539806;Poá;3548807;São Caetano do Sul;4;4;8;24
3543303;Ribeirão Pires;3548807;São Caetano do Sul;4;4;8;17
3545209;Salto;3548807;São Caetano do Sul;4;4;8;86
3545803;Santa Bárbara d'Oeste;3548807;São Caetano do Sul;4;4;8;128
3547304;Santana de Parnaíba;3548807;São Caetano do Sul;4;4;8;40
2704302;Maceió;3548708;São Bernardo do Campo;4;4;8;1886
3132404;Itajubá;3548708;São Bernardo do Campo;4;4;8;183
3170206;Uberlândia;3548708;São Bernardo do Campo;4;4;8;559
3304110;Porto Real;3548708;São Bernardo do Campo;4;4;8;272
3507605;Bragança Paulista;3548708;São Bernardo do Campo;4;4;8;86
3523404;Itatiba;3548708;São Bernardo do Campo;4;4;8;83
3536505;Paulínia;3548708;São Bernardo do Campo;4;4;8;121
3543907;Rio Claro;3548708;São Bernardo do Campo;4;4;8;176
3547304;Santana de Parnaíba;3548708;São Bernardo do Campo;4;4;8;46
2906501;Candeias;3548500;Santos;4;4;8;1461
3151800;Poços de Caldas;3548500;Santos;4;4;8;236
3501608;Americana;3548500;Santos;4;4;8;162
3515186;Espírito Santo do Pinhal;3548500;Santos;4;4;8;193
3531100;Mongaguá;3548500;Santos;4;4;8;35
3524709;Jaguariúna;3548005;Santo Antônio de Posse;4;4;8;13
3501608;Americana;3547809;Santo André;4;4;8;130
3506003;Bauru;3547809;Santo André;4;4;8;297
3509403;Cajuru;3547601;Santa Rosa de Viterbo;4;4;8;23
3543402;Ribeirão Preto;3547601;Santa Rosa de Viterbo;4;4;8;57
3539301;Pirassununga;3547502;Santa Rita do Passa Quatro;4;4;8;33
3546306;Santa Cruz das Palmeiras;3547502;Santa Rita do Passa Quatro;4;4;8;27
2111300;São Luís;3547304;Santana de Parnaíba;4;4;8;2328
2211001;Teresina;3547304;Santana de Parnaíba;4;4;8;2070
2704302;Maceió;3547304;Santana de Parnaíba;4;4;8;1882
3170206;Uberlândia;3547304;Santana de Parnaíba;4;4;8;521
3201308;Cariacica;3547304;Santana de Parnaíba;4;4;8;743
3525904;Jundiaí;3547304;Santana de Parnaíba;4;4;8;29
3512407;Cordeirópolis;3546702;Santa Gertrudes;4;4;8;8
3504503;Avaré;3546405;Santa Cruz do Rio Pardo;4;4;8;75
3540705;Porto Ferreira;3546306;Santa Cruz das Palmeiras;4;4;8;24
3505708;Barueri;3545803;Santa Bárbara d'Oeste;4;4;8;100
3543402;Ribeirão Preto;3545803;Santa Bárbara d'Oeste;4;4;8;182
3543907;Rio Claro;3545803;Santa Bárbara d'Oeste;4;4;8;41
3510401;Capivari;3545209;Salto;4;4;8;32
3522307;Itapetininga;3545209;Salto;4;4;8;89
3524006;Itupeva;3545209;Salto;4;4;8;24
3525904;Jundiaí;3545209;Salto;4;4;8;39
3534401;Osasco;3545209;Salto;4;4;8;63
3543907;Rio Claro;3545159;Saltinho;4;4;8;51
3543303;Ribeirão Pires;3544103;Rio Grande da Serra;4;4;8;5
3106200;Belo Horizonte;3543907;Rio Claro;4;4;8;459
3525904;Jundiaí;3543907;Rio Claro;4;4;8;109
3539301;Pirassununga;3543907;Rio Claro;4;4;8;46
3104007;Araxá;3543402;Ribeirão Preto;4;4;8;194
3504107;Atibaia;3543402;Ribeirão Preto;4;4;8;254
3517406;Guaíra;3543402;Ribeirão Preto;4;4;8;107
3519071;Hortolândia;3543402;Ribeirão Preto;4;4;8;198
3530607;Moji das Cruzes;3543402;Ribeirão Preto;4;4;8;315
3530706;Mogi Guaçu;3543402;Ribeirão Preto;4;4;8;157
3534302;Orlândia;3543402;Ribeirão Preto;4;4;8;49
3539509;Pitangueiras;3543402;Ribeirão Preto;4;4;8;47
3522406;Itapeva;3543006;Ribeirão Branco;4;4;8;30
3526100;Juquiá;3542602;Registro;4;4;8;31
3529906;Miracatu;3542602;Registro;4;4;8;50
3510401;Capivari;3542107;Rafard;4;4;8;5
3529005;Marília;3542008;Quintana;4;4;8;41
3500808;Alfredo Marcondes;3541406;Presidente Prudente;4;4;8;20
3502101;Andradina;3541406;Presidente Prudente;4;4;8;133
3511102;Catanduva;3541406;Presidente Prudente;4;4;8;271
3534708;Ourinhos;3541406;Presidente Prudente;4;4;8;181
3538907;Pirajuí;3541109;Presidente Alves;4;4;8;11
3513504;Cubatão;3541000;Praia Grande;4;4;8;12
3513801;Diadema;3541000;Praia Grande;4;4;8;42
3524303;Jaboticabal;3540903;Pradópolis;4;4;8;27
3516200;Franca;3540705;Porto Ferreira;4;4;8;146
3510401;Capivari;3540606;Porto Feliz;4;4;8;24
3512308;Conchas;3540507;Porangaba;4;4;8;21
3531902;Morro Agudo;3540200;Pontal;4;4;8;32
2304400;Fortaleza;3539806;Poá;4;4;8;2314
3513702;Descalvado;3539301;Pirassununga;4;4;8;22
3521804;Itaí;3538808;Piraju;4;4;8;39
3511508;Cerquilho;3538709;Piracicaba;4;4;8;47
3514106;Dois Córregos;3538709;Piracicaba;4;4;8;87
3516200;Franca;3538709;Piracicaba;4;4;8;246
3521408;Iracemápolis;3538709;Piracicaba;4;4;8;23
3524402;Jacareí;3538709;Piracicaba;4;4;8;186
3530706;Mogi Guaçu;3538709;Piracicaba;4;4;8;86
3106200;Belo Horizonte;3538006;Pindamonhangaba;4;4;8;367
3502507;Aparecida;3538006;Pindamonhangaba;4;4;8;25
3513405;Cruzeiro;3538006;Pindamonhangaba;4;4;8;64
2905701;Camaçari;3536505;Paulínia;4;4;8;1420
3170206;Uberlândia;3536505;Paulínia;4;4;8;442
3301702;Duque de Caxias;3536505;Paulínia;4;4;8;394
3524709;Jaguariúna;3536505;Paulínia;4;4;8;18
3534401;Osasco;3536505;Paulínia;4;4;8;93
3521804;Itaí;3535804;Paranapanema;4;4;8;34
3528809;Maracaí;3535507;Paraguaçu Paulista;4;4;8;23
3533007;Nova Granada;3535002;Palestina;4;4;8;24
3515509;Fernandópolis;3534757;Ouroeste;4;4;8;36
3125101;Extrema;3534401;Osasco;4;4;8;89
3511508;Cerquilho;3534401;Osasco;4;4;8;105
3526803;Lençóis Paulista;3534401;Osasco;4;4;8;231
3503208;Araraquara;3532900;Nova Europa;4;4;8;40
3516200;Franca;3531902;Morro Agudo;4;4;8;71
3510401;Capivari;3531803;Monte Mor;4;4;8;20
3501608;Americana;3530805;Moji-Mirim;4;4;8;51
3503307;Araras;3530805;Moji-Mirim;4;4;8;42
3512209;Conchal;3530805;Moji-Mirim;4;4;8;23
3519055;Holambra;3530805;Moji-Mirim;4;4;8;24
3500303;Aguaí;3530706;Mogi Guaçu;4;4;8;30
3501905;Amparo;3530706;Mogi Guaçu;4;4;8;46
3503802;Artur Nogueira;3530706;Mogi Guaçu;4;4;8;36
3205002;Serra;3530607;Moji das Cruzes;4;4;8;704
3510500;Caraguatatuba;3530607;Moji das Cruzes;4;4;8;75
3517406;Guaíra;3529708;Miguelópolis;4;4;8;33
3524105;Ituverava;3529708;Miguelópolis;4;4;8;28
3511102;Catanduva;3529302;Matão;4;4;8;79
3522703;Itápolis;3529302;Matão;4;4;8;43
3504503;Avaré;3528601;Manduri;4;4;8;41
3507605;Bragança Paulista;3528502;Mairiporã;4;4;8;42
3518800;Guarulhos;3528502;Mairiporã;4;4;8;13
3501152;Alumínio;3528403;Mairinque;4;4;8;8
3523404;Itatiba;3527306;Louveira;4;4;8;14
3502804;Araçatuba;3527108;Lins;4;4;8;87
3512803;Cosmópolis;3526902;Limeira;4;4;8;22
3504503;Avaré;3526803;Lençóis Paulista;4;4;8;56
3509502;Campinas;3526803;Lençóis Paulista;4;4;8;184
3304557;Rio de Janeiro;3526704;Leme;4;4;8;434
3106705;Betim;3525904;Jundiaí;4;4;8;450
3505708;Barueri;3525300;Jaú;4;4;8;223
3106200;Belo Horizonte;3525003;Jandira;4;4;8;498
3513009;Cotia;3525003;Jandira;4;4;8;9
3519071;Hortolândia;3524709;Jaguariúna;4;4;8;29
3514809;Eldorado;3524600;Jacupiranga;4;4;8;22
3507001;Boituva;3523909;Itu;4;4;8;38
3501905;Amparo;3523404;Itatiba;4;4;8;35
3510203;Capão Bonito;3523206;Itararé;4;4;8;101
3118601;Contagem;3522505;Itapevi;4;4;8;494
3502754;Araçariguama;3522505;Itapevi;4;4;8;17
1500503;Almeirim;3522406;Itapeva;4;4;8;2512
3507506;Botucatu;3522307;Itapetininga;4;4;8;87
3518503;Guareí;3522307;Itapetininga;4;4;8;27
3505708;Barueri;3522208;Itapecerica da Serra;4;4;8;23
3507001;Boituva;3521002;Iperó;4;4;8;8
3106200;Belo Horizonte;3520509;Indaiatuba;4;4;8;484
3510401;Capivari;3520509;Indaiatuba;4;4;8;29
3170206;Uberlândia;3520103;Igarapava;4;4;8;138
3516200;Franca;3520103;Igarapava;4;4;8;66
3513801;Diadema;3519071;Hortolândia;4;4;8;110
2105302;Imperatriz;3518800;Guarulhos;4;4;8;1985
2307304;Juazeiro do Norte;3518800;Guarulhos;4;4;8;1929
2403251;Parnamirim;3518800;Guarulhos;4;4;8;2231
2914802;Itabuna;3518800;Guarulhos;4;4;8;1200
3143302;Montes Claros;3518800;Guarulhos;4;4;8;789
3170701;Varginha;3518800;Guarulhos;4;4;8;244
3205309;Vitória;3518800;Guarulhos;4;4;8;724
3301009;Campos dos Goytacazes;3518800;Guarulhos;4;4;8;562
3303500;Nova Iguaçu;3518800;Guarulhos;4;4;8;324
3306305;Volta Redonda;3518800;Guarulhos;4;4;8;271
3503208;Araraquara;3518800;Guarulhos;4;4;8;245
3508504;Caçapava;3518404;Guaratinguetá;4;4;8;63
3510500;Caraguatatuba;3518404;Guaratinguetá;4;4;8;92
3304557;Rio de Janeiro;3518305;Guararema;4;4;8;290
3170107;Uberaba;3517703;Guará;4;4;8;77
3170206;Uberlândia;3517703;Guará;4;4;8;175
3511102;Catanduva;3515608;Fernando Prestes;4;4;8;34
1302603;Manaus;3515004;Embu;4;4;8;2609
3510609;Carapicuíba;3515004;Embu;4;4;8;14
2905701;Camaçari;3513801;Diadema;4;4;8;1466
3106705;Betim;3513801;Diadema;4;4;8;479
3306305;Volta Redonda;3513504;Cubatão;4;4;8;282
3503208;Araraquara;3513504;Cubatão;4;4;8;293
3170107;Uberaba;3513108;Cravinhos;4;4;8;178
3503307;Araras;3512407;Cordeirópolis;4;4;8;16
3509502;Campinas;3512209;Conchal;4;4;8;64
3304557;Rio de Janeiro;3511102;Catanduva;4;4;8;628
3502804;Araçatuba;3511102;Catanduva;4;4;8;153
3509502;Campinas;3511102;Catanduva;4;4;8;280
3106200;Belo Horizonte;3510500;Caraguatatuba;4;4;8;437
3508504;Caçapava;3510500;Caraguatatuba;4;4;8;62
1100205;Porto Velho;3509502;Campinas;4;4;8;2281
1505536;Parauapebas;3509502;Campinas;4;4;8;1889
2111300;São Luís;3509502;Campinas;4;4;8;2270
2211001;Teresina;3509502;Campinas;4;4;8;2014
3201308;Cariacica;3509502;Campinas;4;4;8;733
3505500;Barretos;3509502;Campinas;4;4;8;303
3506102;Bebedouro;3509502;Campinas;4;4;8;265
3508504;Caçapava;3509502;Campinas;4;4;8;140
3501004;Altinópolis;3509403;Cajuru;4;4;8;29
3502804;Araçatuba;3508108;Buritama;4;4;8;37
3505708;Barueri;3507506;Botucatu;4;4;8;176
3301702;Duque de Caxias;3507001;Boituva;4;4;8;449
3506409;Bilac;3506508;Birigui;4;4;8;19
2504009;Campina Grande;3505708;Barueri;4;4;8;2100
2609600;Olinda;3505708;Barueri;4;4;8;2079
2904506;Brotas de Macaúbas;3505708;Barueri;4;4;8;1341
3152501;Pouso Alegre;3505708;Barueri;4;4;8;172
3300704;Cabo Frio;3505708;Barueri;4;4;8;495
3303203;Nilópolis;3505708;Barueri;4;4;8;359
2304400;Fortaleza;3505500;Barretos;4;4;8;2114
3127107;Frutal;3505500;Barretos;4;4;8;64
3304557;Rio de Janeiro;3504909;Bananal;4;4;8;111
3106705;Betim;3504107;Atibaia;4;4;8;424
3152501;Pouso Alegre;3504107;Atibaia;4;4;8;117
3106200;Belo Horizonte;3504008;Assis;4;4;8;726
3151800;Poços de Caldas;3503307;Araras;4;4;8;107
2927408;Salvador;3503208;Araraquara;4;4;8;1380
3170206;Uberlândia;3502804;Araçatuba;4;4;8;342
3500105;Adamantina;3502804;Araçatuba;4;4;8;83
3500501;Águas de Lindóia;3501905;Amparo;4;4;8;28
3118601;Contagem;3306305;Volta Redonda;4;4;8;286
3136702;Juiz de Fora;3306305;Volta Redonda;4;4;8;114
3306008;Três Rios;3306107;Valença;4;4;8;55
3303302;Niterói;3306008;Três Rios;4;4;8;91
3305406;Sapucaia;3306008;Três Rios;4;4;8;34
3136702;Juiz de Fora;3305802;Teresópolis;4;4;8;81
3301850;Guapimirim;3305802;Teresópolis;4;4;8;13
3302403;Macaé;3305802;Teresópolis;4;4;8;115
3305158;São José do Vale do Rio Preto;3305802;Teresópolis;4;4;8;32
3301900;Itaboraí;3305752;Tanguá;4;4;8;13
3303203;Nilópolis;3305505;Saquarema;4;4;8;99
3303500;Nova Iguaçu;3305505;Saquarema;4;4;8;104
3300233;Armação dos Búzios;3305208;São Pedro da Aldeia;4;4;8;23
3106200;Belo Horizonte;3305109;São João de Meriti;4;4;8;326
3304144;Queimados;3305109;São João de Meriti;4;4;8;23
3304706;Santo Antônio de Pádua;3304805;São Fidélis;4;4;8;46
3151107;Pirapetinga;3304706;Santo Antônio de Pádua;4;4;8;22
3304557;Rio de Janeiro;3304706;Santo Antônio de Pádua;4;4;8;186
3304557;Rio de Janeiro;3304607;Santa Maria Madalena;4;4;8;166
1100122;Ji-Paraná;3304557;Rio de Janeiro;4;4;8;2275
1501303;Barcarena;3304557;Rio de Janeiro;4;4;8;2422
2101400;Balsas;3304557;Rio de Janeiro;4;4;8;1724
2208007;Picos;3304557;Rio de Janeiro;4;4;8;1757
2304202;Crato;3304557;Rio de Janeiro;4;4;8;1774
2510808;Patos;3304557;Rio de Janeiro;4;4;8;1851
2513703;Santa Rita;3304557;Rio de Janeiro;4;4;8;1923
2706901;Pilar;3304557;Rio de Janeiro;4;4;8;1638
2931350;Teixeira de Freitas;3304557;Rio de Janeiro;4;4;8;690
3118304;Conselheiro Lafaiete;3304557;Rio de Janeiro;4;4;8;252
3137601;Lagoa Santa;3304557;Rio de Janeiro;4;4;8;366
3163706;São Lourenço;3304557;Rio de Janeiro;4;4;8;199
3168606;Teófilo Otoni;3304557;Rio de Janeiro;4;4;8;583
3169307;Três Corações;3304557;Rio de Janeiro;4;4;8;241
3200607;Aracruz;3304557;Rio de Janeiro;4;4;8;455
3303807;Parati;3304557;Rio de Janeiro;4;4;8;154
3302205;Itaperuna;3304524;Rio das Ostras;4;4;8;147
3300704;Cabo Frio;3304300;Rio Bonito;4;4;8;60
3303401;Nova Friburgo;3304300;Rio Bonito;4;4;8;46
3301009;Campos dos Goytacazes;3304151;Quissamã;4;4;8;38
3303104;Natividade;3304102;Porciúncula;4;4;8;11
3301009;Campos dos Goytacazes;3303906;Petrópolis;4;4;8;211
3302809;Mendes;3303609;Paracambi;4;4;8;8
3303500;Nova Iguaçu;3303609;Paracambi;4;4;8;31
3300407;Barra Mansa;3303500;Nova Iguaçu;4;4;8;79
3302007;Itaguaí;3303500;Nova Iguaçu;4;4;8;35
3300209;Araruama;3303401;Nova Friburgo;4;4;8;70
2800308;Aracaju;3303302;Niterói;4;4;8;1455
3118601;Contagem;3303302;Niterói;4;4;8;343
3300209;Araruama;3302502;Magé;4;4;8;79
2907509;Catu;3302403;Macaé;4;4;8;1162
3106200;Belo Horizonte;3301900;Itaboraí;4;4;8;335
3300209;Araruama;3301876;Iguaba Grande;4;4;8;15
2408102;Natal;3301702;Duque de Caxias;4;4;8;2036
2611606;Recife;3301702;Duque de Caxias;4;4;8;1820
3205200;Vila Velha;3301702;Duque de Caxias;4;4;8;403
3300506;Bom Jardim;3301504;Cordeiro;4;4;8;14
3106200;Belo Horizonte;3300704;Cabo Frio;4;4;8;382
3300100;Angra dos Reis;3300308;Barra do Piraí;4;4;8;69
2914802;Itabuna;3205309;Vitória;4;4;8;613
3145901;Ouro Branco;3205309;Vitória;4;4;8;355
3201001;Boa Esperança;3205309;Vitória;4;4;8;189
3204708;São Gabriel da Palha;3205309;Vitória;4;4;8;143
1100205;Porto Velho;3205200;Vila Velha;4;4;8;2709
2931350;Teixeira de Freitas;3205200;Vila Velha;4;4;8;316
3202504;Ibiraçu;3205200;Vila Velha;4;4;8;56
3202603;Iconha;3205200;Vila Velha;4;4;8;68
3203908;Nova Venécia;3205150;Vila Pavão;4;4;8;26
3106200;Belo Horizonte;3205101;Viana;4;4;8;360
3201209;Cachoeiro de Itapemirim;3205101;Viana;4;4;8;71
3204559;Santa Maria de Jetibá;3205069;Venda Nova do Imigrante;4;4;8;52
2111300;São Luís;3205002;Serra;4;4;8;1986
2914802;Itabuna;3205002;Serra;4;4;8;600
2919207;Lauro de Freitas;3205002;Serra;4;4;8;827
3200300;Alfredo Chaves;3205002;Serra;4;4;8;73
3202504;Ibiraçu;3205002;Serra;4;4;8;34
3201506;Colatina;3204955;São Roque do Canaã;4;4;8;21
3204609;Santa Teresa;3204955;São Roque do Canaã;4;4;8;23
2922003;Mucuri;3204906;São Mateus;4;4;8;91
2927408;Salvador;3204906;São Mateus;4;4;8;654
3201506;Colatina;3204906;São Mateus;4;4;8;118
3204658;São Domingos do Norte;3204708;São Gabriel da Palha;4;4;8;19
3202702;Itaguaçu;3204559;Santa Maria de Jetibá;4;4;8;29
3201209;Cachoeiro de Itapemirim;3204302;Presidente Kennedy;4;4;8;30
3200300;Alfredo Chaves;3204203;Piúma;4;4;8;21
3201506;Colatina;3204005;Pancas;4;4;8;44
3201209;Cachoeiro de Itapemirim;3203908;Nova Venécia;4;4;8;245
3201506;Colatina;3203908;Nova Venécia;4;4;8;96
3201209;Cachoeiro de Itapemirim;3203106;Jerônimo Monteiro;4;4;8;32
3202652;Irupi;3203007;Iúna;4;4;8;12
3200607;Aracruz;3202504;Ibiraçu;4;4;8;10
3201209;Cachoeiro de Itapemirim;3202306;Guaçuí;4;4;8;62
3202009;Dores do Rio Preto;3202306;Guaçuí;4;4;8;17
3200607;Aracruz;3202207;Fundão;4;4;8;19
2931350;Teixeira de Freitas;3201506;Colatina;4;4;8;241
3106200;Belo Horizonte;3201506;Colatina;4;4;8;355
3200607;Aracruz;3201506;Colatina;4;4;8;46
3127701;Governador Valadares;3201308;Cariacica;4;4;8;227
3200102;Afonso Cláudio;3201209;Cachoeiro de Itapemirim;4;4;8;83
3127701;Governador Valadares;3200904;Barra de São Francisco;4;4;8;112
3101102;Aimorés;3200805;Baixo Guandu;4;4;8;10
3134103;Itueta;3200805;Baixo Guandu;4;4;8;24
3119302;Coromandel;3171006;Vazante;4;4;8;57
3110707;Cambuquira;3170701;Varginha;4;4;8;40
3158300;Santana da Vargem;3170701;Varginha;4;4;8;30
3170206;Uberlândia;3170701;Varginha;4;4;8;412
3134400;Iturama;3170438;União de Minas;4;4;8;27
1501402;Belém;3170206;Uberlândia;4;4;8;1938
1721000;Palmas;3170206;Uberlândia;4;4;8;945
2800308;Aracaju;3170206;Uberlândia;4;4;8;1455
2914802;Itabuna;3170206;Uberlândia;4;4;8;1041
2919553;Luís Eduardo magalhães;3170206;Uberlândia;4;4;8;794
3112604;Capinópolis;3170206;Uberlândia;4;4;8;139
3130705;Indianópolis;3170206;Uberlândia;4;4;8;40
3137502;Lagoa Formosa;3170206;Uberlândia;4;4;8;196
2919553;Luís Eduardo magalhães;3170107;Uberaba;4;4;8;873
3113404;Caratinga;3170057;Ubaporanga;4;4;8;22
3112307;Capelinha;3169703;Turmalina;4;4;8;49
3107109;Boa Esperança;3169406;Três Pontas;4;4;8;31
3111606;Campos Gerais;3169406;Três Pontas;4;4;8;29
3136306;João Pinheiro;3169356;Três Marias;4;4;8;113
3162104;São Gotardo;3168903;Tiros;4;4;8;34
3127701;Governador Valadares;3168705;Timóteo;4;4;8;110
3104007;Araxá;3168101;Tapira;4;4;8;39
3155603;Rio Pardo de Minas;3168002;Taiobeiras;4;4;8;39
3139409;Manhuaçu;3167608;Simonésia;4;4;8;14
3131000;Inhaúma;3167202;Sete Lagoas;4;4;8;17
3121605;Diamantina;3167103;Serro;4;4;8;50
3101607;Alfenas;3166907;Serrania;4;4;8;18
3144300;Nanuque;3166709;Serra dos Aimorés;4;4;8;16
3118601;Contagem;3164704;São Sebastião do Paraíso;4;4;8;321
3134806;Jacuí;3164704;São Sebastião do Paraíso;4;4;8;27
3143203;Monte Santo de Minas;3164704;São Sebastião do Paraíso;4;4;8;29
3120805;Cruzília;3163706;São Lourenço;4;4;8;39
3137809;Lambari;3163706;São Lourenço;4;4;8;42
3151800;Poços de Caldas;3163706;São Lourenço;4;4;8;161
3106200;Belo Horizonte;3162955;São José da Lapa;4;4;8;23
3106705;Betim;3162922;São Joaquim de Bicas;4;4;8;13
3106200;Belo Horizonte;3162906;São João Nepomuceno;4;4;8;207
3128006;Guanhães;3162807;São João Evangelista;4;4;8;29
3144508;Nazareno;3162500;São João del Rei;4;4;8;34
3101904;Alpinópolis;3162203;São João Batista do Glória;4;4;8;28
3111507;Campos Altos;3162104;São Gotardo;4;4;8;45
3110905;Campanha;3162005;São Gonçalo do Sapucaí;4;4;8;21
3148004;Patos de Minas;3161700;São Gonçalo do Abaeté;4;4;8;76
3143302;Montes Claros;3161106;São Francisco;4;4;8;132
3118007;Congonhas;3160900;São Brás do Suaçuí;4;4;8;17
3149903;Perdões;3159902;Santo Antônio do Amparo;4;4;8;24
3106200;Belo Horizonte;3159605;Santa Rita do Sapucaí;4;4;8;314
3109709;Cachoeira de Minas;3159605;Santa Rita do Sapucaí;4;4;8;14
3110301;Caldas;3159209;Santa Rita de Caldas;4;4;8;13
3131703;Itabira;3158003;Santa Maria de Itabira;4;4;8;24
3149804;Perdizes;3157708;Santa Juliana;4;4;8;25
3106200;Belo Horizonte;3157203;Santa Bárbara;4;4;8;59
3115359;Catas Altas;3157203;Santa Bárbara;4;4;8;13
3136207;João Monlevade;3157203;Santa Bárbara;4;4;8;30
3128006;Guanhães;3156809;Sabinópolis;4;4;8;18
3110004;Caeté;3156700;Sabará;4;4;8;16
3101706;Almenara;3156601;Rubim;4;4;8;33
3151305;Piraúba;3155801;Rio Pomba;4;4;8;16
3143302;Montes Claros;3155603;Rio Pardo de Minas;4;4;8;190
3149309;Pedro Leopoldo;3154606;Ribeirão das Neves;4;4;8;17
3127701;Governador Valadares;3154309;Resplendor;4;4;8;98
3111101;Campina Verde;3152808;Prata;4;4;8;57
3106705;Betim;3152501;Pouso Alegre;4;4;8;308
3107901;Bom Repouso;3152501;Pouso Alegre;4;4;8;35
3113602;Careaçu;3152501;Pouso Alegre;4;4;8;32
3115508;Caxambu;3152501;Pouso Alegre;4;4;8;104
3136207;João Monlevade;3152105;Ponte Nova;4;4;8;72
3100203;Abaeté;3152006;Pompéu;4;4;8;55
3106200;Belo Horizonte;3152006;Pompéu;4;4;8;125
3120904;Curvelo;3152006;Pompéu;4;4;8;70
3105301;Bandeira do Sul;3151800;Poços de Caldas;4;4;8;17
3132404;Itajubá;3151800;Poços de Caldas;4;4;8;132
3106200;Belo Horizonte;3151503;Piumhi;4;4;8;216
3122306;Divinópolis;3151503;Piumhi;4;4;8;117
3147907;Passos;3151503;Piumhi;4;4;8;75
3113404;Caratinga;3150158;Piedade de Caratinga;4;4;8;15
3111200;Campo Belo;3149903;Perdões;4;4;8;27
3145208;Nova Serrana;3149705;Perdigão;4;4;8;13
3147105;Pará de Minas;3149606;Pequi;4;4;8;25
3117876;Confins;3149309;Pedro Leopoldo;4;4;8;8
3122306;Divinópolis;3149309;Pedro Leopoldo;4;4;8;106
3143104;Monte Carmelo;3148103;Patrocínio;4;4;8;61
3137106;Lagamar;3148004;Patos de Minas;4;4;8;55
3143104;Monte Carmelo;3148004;Patos de Minas;4;4;8;107
3128709;Guaxupé;3147907;Passos;4;4;8;67
3133758;Itaú de Minas;3147907;Passos;4;4;8;16
3107406;Bom Despacho;3147105;Pará de Minas;4;4;8;69
3114204;Carmo do Cajuru;3147105;Pará de Minas;4;4;8;40
3146909;Papagaios;3147105;Pará de Minas;4;4;8;47
3136306;João Pinheiro;3147006;Paracatu;4;4;8;96
3118304;Conselheiro Lafaiete;3146107;Ouro Preto;4;4;8;43
3118601;Contagem;3146107;Ouro Preto;4;4;8;76
3145901;Ouro Branco;3146107;Ouro Preto;4;4;8;22
3111200;Campo Belo;3145604;Oliveira;4;4;8;48
3118601;Contagem;3145208;Nova Serrana;4;4;8;94
2931350;Teixeira de Freitas;3144300;Nanuque;4;4;8;77
3127701;Governador Valadares;3144300;Nanuque;4;4;8;201
2933307;Vitória da Conquista;3143302;Montes Claros;4;4;8;382
3104106;Arceburgo;3143203;Monte Santo de Minas;4;4;8;23
3104007;Araxá;3143104;Monte Carmelo;4;4;8;112
3119302;Coromandel;3143104;Monte Carmelo;4;4;8;43
3141009;Mato Verde;3142908;Monte Azul;4;4;8;27
3137205;Lagoa da Prata;3142403;Moema;4;4;8;23
3112307;Capelinha;3141801;Minas Novas;4;4;8;52
3112505;Capim Branco;3141108;Matozinhos;4;4;8;7
3135100;Janaúba;3141009;Mato Verde;4;4;8;68
3118601;Contagem;3140803;Matias Barbosa;4;4;8;230
3106903;Bicas;3140209;Maripá de Minas;4;4;8;13
3136207;João Monlevade;3140001;Mariana;4;4;8;67
3124203;Espera Feliz;3139409;Manhuaçu;4;4;8;49
3104007;Araxá;3138807;Luz;4;4;8;133
3101508;Além Paraíba;3138401;Leopoldina;4;4;8;31
3130408;Ijaci;3138203;Lavras;4;4;8;11
3136306;João Pinheiro;3137536;Lagoa Grande;4;4;8;34
3131307;Ipatinga;3136702;Juiz de Fora;4;4;8;266
3102308;Alvinópolis;3136207;João Monlevade;4;4;8;35
3106200;Belo Horizonte;3135407;Jeceaba;4;4;8;70
3106200;Belo Horizonte;3135209;Januária;4;4;8;493
3124302;Espinosa;3135100;Janaúba;4;4;8;112
3111101;Campina Verde;3134400;Iturama;4;4;8;78
3127107;Frutal;3134400;Iturama;4;4;8;135
3104007;Araxá;3133808;Itaúna;4;4;8;253
3127107;Frutal;3133402;Itapagipe;4;4;8;48
3103405;Araçuaí;3133303;Itaobim;4;4;8;62
3120904;Curvelo;3131109;Inimutaba;4;4;8;13
3108305;Borda da Mata;3130606;Inconfidentes;4;4;8;17
3106705;Betim;3129806;Ibirité;4;4;8;16
3123700;Engenheiro Caldas;3127701;Governador Valadares;4;4;8;46
3106200;Belo Horizonte;3127107;Frutal;4;4;8;523
3119955;Córrego Fundo;3126109;Formiga;4;4;8;14
3110103;Caiana;3124203;Espera Feliz;4;4;8;5
3107406;Bom Despacho;3123205;Dores do Indaiá;4;4;8;46
3101607;Alfenas;3122405;Divisa Nova;4;4;8;27
3119104;Corinto;3120904;Curvelo;4;4;8;43
3115508;Caxambu;3120805;Cruzília;4;4;8;22
3111200;Campo Belo;3120201;Cristais;4;4;8;26
3113404;Caratinga;3119401;Coronel Fabriciano;4;4;8;55
3118304;Conselheiro Lafaiete;3118601;Contagem;4;4;8;87
3113206;Carandaí;3118304;Conselheiro Lafaiete;4;4;8;34
3106200;Belo Horizonte;3115508;Caxambu;4;4;8;249
3101508;Além Paraíba;3115300;Cataguases;4;4;8;50
3101904;Alpinópolis;3114402;Carmo do Rio Claro;4;4;8;31
3102852;Angelândia;3112307;Capelinha;4;4;8;40
3104007;Araxá;3111507;Campos Altos;4;4;8;82
3106200;Belo Horizonte;3111200;Campo Belo;4;4;8;173
3107109;Boa Esperança;3111200;Campo Belo;4;4;8;38
3102803;Andrelândia;3107505;Bom Jardim de Minas;4;4;8;29
1400100;Boa Vista;3106200;Belo Horizonte;4;4;8;3030
1505437;Ourilândia do Norte;3106200;Belo Horizonte;4;4;8;1623
1600402;Mazagão;3106200;Belo Horizonte;4;4;8;2308
3103405;Araçuaí;3106200;Belo Horizonte;4;4;8;390
3103504;Araguari;3104007;Araxá;4;4;8;168
2928950;São Domingos;2933000;Valente;4;4;8;13
2905404;Cairu;2932903;Valença;4;4;8;19
2914802;Itabuna;2932200;Ubaitaba;4;4;8;59
2304400;Fortaleza;2931350;Teixeira de Freitas;4;4;8;1529
2904605;Brumado;2931004;Tanhaçu;4;4;8;51
2900702;Alagoinhas;2930709;Simões Filho;4;4;8;72
2913606;Ilhéus;2930709;Simões Filho;4;4;8;235
2902104;Araci;2930501;Serrinha;4;4;8;36
2800308;Aracaju;2929503;São Sebastião do Passé;4;4;8;235
2927408;Salvador;2929305;São Gonçalo dos Campos;4;4;8;82
2914604;Irecê;2929255;São Gabriel;4;4;8;14
2905701;Camaçari;2929206;São Francisco do Conde;4;4;8;39
2919926;Madre de Deus;2929206;São Francisco do Conde;4;4;8;14
2919553;Luís Eduardo magalhães;2928901;São Desidério;4;4;8;96
2927408;Salvador;2928802;Santo Estêvão;4;4;8;105
2903201;Barreiras;2928208;Santana;4;4;8;130
2926103;Retirolândia;2928000;Santaluz;4;4;8;27
2307650;Maracanaú;2927408;Salvador;4;4;8;1010
2403251;Parnamirim;2927408;Salvador;4;4;8;855
2901007;Amargosa;2927408;Salvador;4;4;8;123
2905206;Caetité;2927408;Salvador;4;4;8;455
2907509;Catu;2927408;Salvador;4;4;8;71
2908408;Conceição do Coité;2927408;Salvador;4;4;8;183
2910503;Entre Rios;2927408;Salvador;4;4;8;126
2913705;Inhambupe;2927408;Salvador;4;4;8;134
2913903;Ipiaú;2927408;Salvador;4;4;8;180
2919553;Luís Eduardo magalhães;2927408;Salvador;4;4;8;801
2907905;Cipó;2926608;Ribeira do Pombal;4;4;8;31
2908408;Conceição do Coité;2926301;Riachão do Jacuípe;4;4;8;35
2910800;Feira de Santana;2926301;Riachão do Jacuípe;4;4;8;68
2903201;Barreiras;2926202;Riachão das Neves;4;4;8;52
2921500;Monte Santo;2925808;Queimadas;4;4;8;66
2914604;Irecê;2925600;Presidente Dutra;4;4;8;15
2916401;Itapetinga;2925402;Potiraguá;4;4;8;53
2914653;Itabela;2925303;Porto Seguro;4;4;8;47
2900702;Alagoinhas;2925204;Pojuca;4;4;8;35
2704302;Maceió;2924009;Paulo Afonso;4;4;8;285
2900702;Alagoinhas;2924009;Paulo Afonso;4;4;8;301
2918803;Laje;2922409;Mutuípe;4;4;8;10
2909802;Cruz das Almas;2922300;Muritiba;4;4;8;12
2919405;Licínio de Almeida;2921807;Mortugaba;4;4;8;41
2914604;Irecê;2921708;Morro do Chapéu;4;4;8;82
2911709;Guanambi;2921054;Matina;4;4;8;42
2919207;Lauro de Freitas;2921005;Mata de São João;4;4;8;39
2904902;Cachoeira;2920601;Maragogipe;4;4;8;17
1707009;Dianópolis;2919553;Luís Eduardo magalhães;4;4;8;126
2201903;Bom Jesus;2919553;Luís Eduardo magalhães;4;4;8;371
2304400;Fortaleza;2919553;Luís Eduardo magalhães;4;4;8;1209
2911105;Formosa do Rio Preto;2919553;Luís Eduardo magalhães;4;4;8;137
2903904;Bom Jesus da Lapa;2919504;Livramento de Nossa Senhora;4;4;8;171
2911709;Guanambi;2919504;Livramento de Nossa Senhora;4;4;8;127
2914802;Itabuna;2919207;Lauro de Freitas;4;4;8;236
2304400;Fortaleza;2918001;Jequié;4;4;8;1123
2906501;Candeias;2918001;Jequié;4;4;8;207
2911709;Guanambi;2918001;Jequié;4;4;8;299
2915106;Itagi;2918001;Jequié;4;4;8;40
2910800;Feira de Santana;2917508;Jacobina;4;4;8;202
2909307;Correntina;2917359;Jaborandi;4;4;8;34
2916401;Itapetinga;2916807;Itarantim;4;4;8;46
2910800;Feira de Santana;2914703;Itaberaba;4;4;8;148
2906873;Capim Grosso;2914604;Irecê;4;4;8;202
2902609;Baixa Grande;2914000;Ipirá;4;4;8;53
2910727;Eunápolis;2913606;Ilhéus;4;4;8;182
2912301;Ibicuí;2913507;Iguaí;4;4;8;15
2911006;Floresta Azul;2912103;Ibicaraí;4;4;8;12
2901106;Amélia Rodrigues;2910800;Feira de Santana;4;4;8;26
2907806;Cícero Dantas;2910750;Fátima;4;4;8;25
2907004;Cardeal da Silva;2910602;Esplanada;4;4;8;18
2910503;Entre Rios;2910602;Esplanada;4;4;8;17
2304400;Fortaleza;2906501;Candeias;4;4;8;985
2602902;Cabo de Santo Agostinho;2906501;Candeias;4;4;8;616
2607208;Ipojuca;2906501;Candeias;4;4;8;604
2611606;Recife;2906501;Candeias;4;4;8;636
2704708;Marechal Deodoro;2905701;Camaçari;4;4;8;422
2611606;Recife;2903201;Barreiras;4;4;8;1177
2803500;Lagarto;2806206;Salgado;4;4;8;34
2800308;Aracaju;2806107;Rosário do Catete;4;4;8;22
2800308;Aracaju;2806008;Ribeirópolis;4;4;8;52
2800308;Aracaju;2805901;Riachuelo;4;4;8;21
2804508;Nossa Senhora da Glória;2805406;Poço Redondo;4;4;8;53
2800308;Aracaju;2805109;Pedrinhas;4;4;8;71
2700300;Arapiraca;2804805;Nossa Senhora do Socorro;4;4;8;130
2801306;Capela;2804607;Nossa Senhora das Dores;4;4;8;12
2800308;Aracaju;2804409;Neópolis;4;4;8;80
2611606;Recife;2803609;Laranjeiras;4;4;8;384
2800308;Aracaju;2803609;Laranjeiras;4;4;8;12
2802106;Estância;2802908;Itabaiana;4;4;8;69
2800308;Aracaju;2801207;Canindé de São Francisco;4;4;8;159
2800308;Aracaju;2801009;Campo do Brito;4;4;8;46
2800308;Aracaju;2800670;Boquim;4;4;8;64
1302603;Manaus;2800308;Aracaju;4;4;8;2628
2609600;Olinda;2800308;Aracaju;4;4;8;399
2708303;São José da Laje;2709301;União dos Palmares;4;4;8;20
2700300;Arapiraca;2709152;Teotônio Vilela;4;4;8;41
2704302;Maceió;2708907;Satuba;4;4;8;12
2705101;Matriz de Camaragibe;2708501;São Luís do Quitunde;4;4;8;16
2704500;Maragogi;2707305;Porto Calvo;4;4;8;20
2611606;Recife;2706307;Palmeira dos Índios;4;4;8;237
2704302;Maceió;2704807;Maribondo;4;4;8;61
2111300;São Luís;2704302;Maceió;4;4;8;1213
2304285;Eusébio;2704302;Maceió;4;4;8;701
2611101;Petrolina;2704302;Maceió;4;4;8;526
2700300;Arapiraca;2702900;Girau do Ponciano;4;4;8;20
2700102;Água Branca;2702405;Delmiro Gouveia;4;4;8;12
2700300;Arapiraca;2701407;Campo Alegre;4;4;8;38
2606002;Garanhuns;2700300;Arapiraca;4;4;8;103
2608909;Limoeiro;2616407;Vitória de Santo Antão;4;4;8;32
2611309;Pombos;2616407;Vitória de Santo Antão;4;4;8;12
2609501;Nazaré da Mata;2615300;Timbaúba;4;4;8;27
2604106;Caruaru;2614501;Surubim;4;4;8;58
2607208;Ipojuca;2614204;Sirinhaém;4;4;8;22
2611606;Recife;2614204;Sirinhaém;4;4;8;56
2612802;Santa Terezinha;2613602;São José do Egito;4;4;8;22
2602308;Bonito;2613305;São Joaquim do Monte;4;4;8;9
2611606;Recife;2612604;Santa Maria da Boa Vista;4;4;8;544
2602605;Brejo da Madre de Deus;2612505;Santa Cruz do Capibaribe;4;4;8;28
2608909;Limoeiro;2612505;Santa Cruz do Capibaribe;4;4;8;84
2601607;Belém de São Francisco;2612208;Salgueiro;4;4;8;68
2603009;Cabrobó;2612208;Salgueiro;4;4;8;38
2610400;Parnamirim;2612208;Salgueiro;4;4;8;46
2601409;Barreiros;2611903;Rio Formoso;4;4;8;16
2407104;Macaíba;2611606;Recife;4;4;8;255
2600104;Afogados da Ingazeira;2611606;Recife;4;4;8;299
2601102;Araripina;2611606;Recife;4;4;8;614
2605459;Fernando de Noronha;2611606;Recife;4;4;8;543
2611002;Petrolândia;2611606;Recife;4;4;8;387
2408003;Mossoró;2611101;Petrolina;4;4;8;574
2601102;Araripina;2611101;Petrolina;4;4;8;193
2601201;Arcoverde;2611101;Petrolina;4;4;8;392
2603009;Cabrobó;2611101;Petrolina;4;4;8;166
2601706;Belo Jardim;2610905;Pesqueira;4;4;8;35
2608909;Limoeiro;2610509;Passira;4;4;8;20
2604205;Catende;2610004;Palmares;4;4;8;14
2605202;Escada;2610004;Palmares;4;4;8;55
2603454;Camaragibe;2609600;Olinda;4;4;8;12
2606200;Goiana;2609600;Olinda;4;4;8;49
2605400;Feira Nova;2608909;Limoeiro;4;4;8;11
1501402;Belém;2607901;Jaboatão dos Guararapes;4;4;8;1646
2601706;Belo Jardim;2607901;Jaboatão dos Guararapes;4;4;8;155
2604007;Carpina;2607901;Jaboatão dos Guararapes;4;4;8;39
2606408;Gravatá;2607901;Jaboatão dos Guararapes;4;4;8;59
2600203;Afrânio;2605152;Dormentes;4;4;8;32
2601201;Arcoverde;2601706;Belo Jardim;4;4;8;72
2600104;Afogados da Ingazeira;2601201;Arcoverde;4;4;8;96
2503704;Cajazeiras;2516904;Uiraúna;4;4;8;46
2408003;Mossoró;2516201;Sousa;4;4;8;203
2506004;Esperança;2516003;Solânea;4;4;8;30
2513703;Santa Rita;2515302;Sapé;4;4;8;26
2504306;Catolé do Rocha;2513901;São Bento;4;4;8;36
2504306;Catolé do Rocha;2512101;Pombal;4;4;8;51
2507507;João Pessoa;2512101;Pombal;4;4;8;325
2506301;Guarabira;2508901;Mamanguape;4;4;8;38
2111300;São Luís;2507507;João Pessoa;4;4;8;1153
2504603;Conde;2507507;João Pessoa;4;4;8;9
2503704;Cajazeiras;2507002;Itaporanga;4;4;8;64
2307304;Juazeiro do Norte;2504009;Campina Grande;4;4;8;377
2402006;Caicó;2504009;Campina Grande;4;4;8;159
2500601;Alhandra;2503001;Caaporã;4;4;8;9
2500304;Alagoa Grande;2501104;Areia;4;4;8;12
2402204;Canguaretama;2412203;São José de Mipibu;4;4;8;35
2408102;Natal;2411502;Santo Antônio;4;4;8;60
2403251;Parnamirim;2411205;Santa Cruz;4;4;8;91
2405702;Jardim do Seridó;2408904;Parelhas;4;4;8;20
2403251;Parnamirim;2408300;Nova Cruz;4;4;8;65
2403251;Parnamirim;2408201;Nísia Floresta;4;4;8;20
2400802;Angicos;2408102;Natal;4;4;8;152
2403004;Cruzeta;2408102;Natal;4;4;8;183
2401453;Baraúna;2408003;Mossoró;4;4;8;32
2407104;Macaíba;2408003;Mossoró;4;4;8;233
2407203;Macau;2408003;Mossoró;4;4;8;80
2400703;Alto do Rodrigues;2407203;Macau;4;4;8;24
2402600;Ceará-Mirim;2407203;Macau;4;4;8;146
2402600;Ceará-Mirim;2403251;Parnamirim;4;4;8;34
2401008;Apodi;2402303;Caraúbas;4;4;8;32
2304400;Fortaleza;2402006;Caicó;4;4;8;335
2304400;Fortaleza;2400703;Alto do Rodrigues;4;4;8;259
2400208;Açu;2400703;Alto do Rodrigues;4;4;8;36
2306306;Itapagé;2313807;Uruburetama;4;4;8;11
2305308;Ibiapina;2313609;Ubajara;4;4;8;8
2301505;Arneiroz;2313302;Tauá;4;4;8;39
2311264;Quiterianópolis;2313302;Tauá;4;4;8;45
2309300;Nova Russas;2313203;Tamboril;4;4;8;29
2311801;Russas;2313104;Tabuleiro do Norte;4;4;8;39
2304269;Deputado Irapuan Pinheiro;2313005;Solonópole;4;4;8;35
2304350;Forquilha;2312908;Sobral;4;4;8;19
2307601;Limoeiro do Norte;2312908;Sobral;4;4;8;302
2307650;Maracanaú;2312908;Sobral;4;4;8;193
2312304;São Benedito;2312908;Sobral;4;4;8;69
2303659;Catunda;2312205;Santa Quitéria;4;4;8;36
2308708;Morada Nova;2311801;Russas;4;4;8;50
2304400;Fortaleza;2311504;Quixeré;4;4;8;157
2305506;Iguatu;2311405;Quixeramobim;4;4;8;128
2305506;Iguatu;2311306;Quixadá;4;4;8;157
2301257;Ararendá;2311009;Poranga;4;4;8;10
2304400;Fortaleza;2309805;Pacoti;4;4;8;66
2301406;Aratuba;2309102;Mulungu;4;4;8;14
2305506;Iguatu;2308500;Mombaça;4;4;8;78
2304400;Fortaleza;2308302;Milagres;4;4;8;395
2304400;Fortaleza;2308104;Mauriti;4;4;8;401
2304400;Fortaleza;2307809;Marco;4;4;8;193
2307304;Juazeiro do Norte;2307650;Maracanaú;4;4;8;380
2302404;Boa Viagem;2307635;Madalena;4;4;8;40
2211001;Teresina;2307304;Juazeiro do Norte;4;4;8;451
2302701;Campos Sales;2307304;Juazeiro do Norte;4;4;8;116
2304400;Fortaleza;2306900;Jaguaribe;4;4;8;237
2300754;Amontada;2306405;Itapipoca;4;4;8;32
2306306;Itapagé;2306405;Itapipoca;4;4;8;20
2304400;Fortaleza;2304459;Fortim;4;4;8;112
1302603;Manaus;2304285;Eusébio;4;4;8;2397
2301307;Araripe;2304202;Crato;4;4;8;82
2207009;Oeiras;2211308;Valença do Piauí;4;4;8;76
2208106;Pimenteiras;2211308;Valença do Piauí;4;4;8;47
2101400;Balsas;2211209;Uruçuí;4;4;8;170
2111102;São João dos Patos;2211001;Teresina;4;4;8;183
2202901;Corrente;2211001;Teresina;4;4;8;648
2203305;Demerval Lobão;2211001;Teresina;4;4;8;32
2204303;Fronteiras;2211001;Teresina;4;4;8;328
2206209;Miguel Alves;2211001;Teresina;4;4;8;100
2208809;Regeneração;2211001;Teresina;4;4;8;131
2200707;Anísio de Abreu;2210607;São Raimundo Nonato;4;4;8;43
2202117;Campo Alegre do Fidalgo;2210003;São João do Piauí;4;4;8;49
2202455;Capitão Gervásio Oliveira;2210003;São João do Piauí;4;4;8;53
2208007;Picos;2209401;Santo Antônio de Lisboa;4;4;8;29
2202406;Capitão de Campos;2208403;Piripiri;4;4;8;27
2201903;Bom Jesus;2208007;Picos;4;4;8;389
2202307;Canto do Buriti;2208007;Picos;4;4;8;196
2100907;Araioses;2207702;Parnaíba;4;4;8;17
2201200;Barras;2207702;Parnaíba;4;4;8;162
2202000;Buriti dos Lopes;2207702;Parnaíba;4;4;8;38
2203701;Esperantina;2207702;Parnaíba;4;4;8;122
2203909;Floriano;2207009;Oeiras;4;4;8;100
2201903;Bom Jesus;2204402;Gilbués;4;4;8;137
2111102;São João dos Patos;2203909;Floriano;4;4;8;83
2109908;Santa Inês;2114007;Zé Doca;4;4;8;78
2105302;Imperatriz;2112209;Timon;4;4;8;510
1718204;Porto Nacional;2111300;São Luís;4;4;8;1015
2101608;Barra do Corda;2111300;São Luís;4;4;8;348
2110203;Santa Rita;2111300;São Luís;4;4;8;58
2103505;Colinas;2111102;São João dos Patos;4;4;8;77
2109106;Presidente Dutra;2111102;São João dos Patos;4;4;8;157
2103208;Chapadinha;2110609;São Bernardo;4;4;8;113
2102325;Buriticupu;2110005;Santa Luzia;4;4;8;87
1501402;Belém;2109908;Santa Inês;4;4;8;429
2105401;Itapecuru Mirim;2109908;Santa Inês;4;4;8;135
2101608;Barra do Corda;2109106;Presidente Dutra;4;4;8;84
2103505;Colinas;2109106;Presidente Dutra;4;4;8;88
2108207;Pedreiras;2109106;Presidente Dutra;4;4;8;84
2102101;Brejo;2103208;Chapadinha;4;4;8;69
1702109;Araguaína;2101400;Balsas;4;4;8;239
1702208;Araguatins;1721208;Tocantinópolis;4;4;8;105
1504208;Marabá;1721000;Palmas;4;4;8;558
1701101;Aparecida do Rio Negro;1721000;Palmas;4;4;8;64
1707009;Dianópolis;1718204;Porto Nacional;4;4;8;193
1706100;Cristalândia;1716109;Paraíso do Tocantins;4;4;8;58
1700350;Aliança do Tocantins;1709500;Gurupi;4;4;8;47
1705508;Colinas do Tocantins;1709302;Guaraí;4;4;8;91
1702208;Araguatins;1702554;Augustinópolis;4;4;8;33
1506807;Santarém;1600303;Macapá;4;4;8;494
1502707;Conceição do Araguaia;1508407;Xinguara;4;4;8;145
1505536;Parauapebas;1508100;Tucuruí;4;4;8;249
1501402;Belém;1508084;Tucumã;4;4;8;666
1502400;Castanhal;1507607;São Miguel do Guamá;4;4;8;60
1505031;Novo Progresso;1506807;Santarém;4;4;8;522
1501402;Belém;1506187;Rondon do Pará;4;4;8;380
1502764;Cumaru do Norte;1506138;Redenção;4;4;8;87
1503044;Floresta do Araguaia;1506138;Redenção;4;4;8;59
1500800;Ananindeua;1505536;Parauapebas;4;4;8;538
1502772;Curionópolis;1505536;Parauapebas;4;4;8;21
1502400;Castanhal;1505502;Paragominas;4;4;8;201
1504059;Mãe do Rio;1505502;Paragominas;4;4;8;112
1302603;Manaus;1505304;Oriximiná;4;4;8;493
1503093;Goianésia do Pará;1505064;Novo Repartimento;4;4;8;109
1500602;Altamira;1504422;Marituba;4;4;8;477
1501501;Benevides;1504208;Marabá;4;4;8;453
1503804;Jacundá;1504208;Marabá;4;4;8;105
1501402;Belém;1501782;Breu Branco;4;4;8;313
1500909;Augusto Corrêa;1501709;Bragança;4;4;8;15
1400100;Boa Vista;1400456;Pacaraima;4;4;8;180
1400050;Alto Alegre;1400100;Boa Vista;4;4;8;71
1302603;Manaus;1303106;Nova Olinda do Norte;4;4;8;137
1100023;Ariquemes;1302603;Manaus;4;4;8;821
1100205;Porto Velho;1301704;Humaitá;4;4;8;163
1200203;Cruzeiro do Sul;1301654;Guajará;4;4;8;13
1200013;Acrelândia;1200401;Rio Branco;4;4;8;103
1100114;Jaru;1101302;Mirante da Serra;4;4;8;65
1100122;Ji-Paraná;1100346;Alvorada d'Oeste;4;4;8;65
1100205;Porto Velho;1100338;Nova Mamoré;4;4;8;241
1100122;Ji-Paraná;1100320;São Miguel do Guaporé;4;4;8;124
1100023;Ariquemes;1100304;Vilhena;4;4;8;444
1100288;Rolim de Moura;1100304;Vilhena;4;4;8;201
1100288;Rolim de Moura;1100296;Santa Luzia d'Oeste;4;4;8;15
1500503;Almeirim;5300108;Brasília;3;5;8;1656
2702306;Coruripe;5300108;Brasília;3;5;8;1394
2806701;São Cristóvão;5300108;Brasília;3;5;8;1256
2900702;Alagoinhas;5300108;Brasília;3;5;8;1088
2929206;São Francisco do Conde;5300108;Brasília;3;5;8;1044
3115300;Cataguases;5300108;Brasília;3;5;8;839
3134202;Ituiutaba;5300108;Brasília;3;5;8;387
3138203;Lavras;5300108;Brasília;3;5;8;679
3139409;Manhuaçu;5300108;Brasília;3;5;8;802
3145208;Nova Serrana;5300108;Brasília;3;5;8;551
3301306;Casimiro de Abreu;5300108;Brasília;3;5;8;967
3302908;Miguel Pereira;5300108;Brasília;3;5;8;882
3303203;Nilópolis;5300108;Brasília;3;5;8;917
3500105;Adamantina;5300108;Brasília;3;5;8;736
3502101;Andradina;5300108;Brasília;3;5;8;681
3505302;Barra Bonita;5300108;Brasília;3;5;8;743
3506102;Bebedouro;5300108;Brasília;3;5;8;572
3508405;Cabreúva;5300108;Brasília;3;5;8;835
3508504;Caçapava;5300108;Brasília;3;5;8;843
3509700;Campos do Jordão;5300108;Brasília;3;5;8;806
3510500;Caraguatatuba;5300108;Brasília;3;5;8;905
3513405;Cruzeiro;5300108;Brasília;3;5;8;816
3513504;Cubatão;5300108;Brasília;3;5;8;910
3515707;Ferraz de Vasconcelos;5300108;Brasília;3;5;8;873
3516309;Francisco Morato;5300108;Brasília;3;5;8;835
3516408;Franco da Rocha;5300108;Brasília;3;5;8;842
3519600;Ibitinga;5300108;Brasília;3;5;8;666
3522109;Itanhaém;5300108;Brasília;3;5;8;935
3522604;Itapira;5300108;Brasília;3;5;8;743
3523404;Itatiba;5300108;Brasília;3;5;8;805
3526803;Lençóis Paulista;5300108;Brasília;3;5;8;759
3527207;Lorena;5300108;Brasília;3;5;8;827
3528502;Mairiporã;5300108;Brasília;3;5;8;844
3529302;Matão;5300108;Brasília;3;5;8;643
3530508;Mococa;5300108;Brasília;3;5;8;634
3531100;Mongaguá;5300108;Brasília;3;5;8;927
3533908;Olímpia;5300108;Brasília;3;5;8;557
3537305;Penápolis;5300108;Brasília;3;5;8;664
3539509;Pitangueiras;5300108;Brasília;3;5;8;576
3542602;Registro;5300108;Brasília;3;5;8;964
3550605;São Roque;5300108;Brasília;3;5;8;859
3550704;São Sebastião;5300108;Brasília;3;5;8;921
3553708;Taquaritinga;5300108;Brasília;3;5;8;627
3555406;Ubatuba;5300108;Brasília;3;5;8;895
4104204;Campo Largo;5300108;Brasília;3;5;8;1083
4111803;Jacarezinho;5300108;Brasília;3;5;8;845
4128203;União da Vitória;5300108;Brasília;3;5;8;1213
4207502;Indaial;5300108;Brasília;3;5;8;1236
4209409;Laguna;5300108;Brasília;3;5;8;1406
4213609;Porto União;5300108;Brasília;3;5;8;1210
4303004;Cachoeira do Sul;5300108;Brasília;3;5;8;1668
4310207;Ijuí;5300108;Brasília;3;5;8;1545
4311403;Lajeado;5300108;Brasília;3;5;8;1577
4319901;Sapiranga;5300108;Brasília;3;5;8;1570
4322004;Triunfo;5300108;Brasília;3;5;8;1618
5107958;Tangará da Serra;5300108;Brasília;3;5;8;1030
5211909;Jataí;5220504;Serranópolis;3;5;8;52
5210208;Iporá;5218805;Rio Verde;3;5;8;150
5208707;Goiânia;5213400;Moiporá;3;5;8;156
3530607;Moji das Cruzes;5208707;Goiânia;3;5;8;831
3548807;São Caetano do Sul;5201405;Aparecida de Goiânia;3;5;8;808
3534401;Osasco;5108402;Várzea Grande;3;5;8;1349
5106224;Nova Mutum;5106307;Paranatinga;3;5;8;229
3550308;São Paulo;5104807;Jaciara;3;5;8;1250
4216602;São José;5103403;Cuiabá;3;5;8;1566
3534401;Osasco;5008305;Três Lagoas;3;5;8;603
5002704;Campo Grande;5006903;Porto Murtinho;3;5;8;361
3524303;Jaboticabal;5000609;Amambaí;3;5;8;737
4304804;Carlos Barbosa;4322806;Veranópolis;3;5;8;40
4301602;Bagé;4322608;Venâncio Aires;3;5;8;268
4307906;Farroupilha;4322400;Uruguaiana;3;5;8;556
2905701;Camaçari;4322004;Triunfo;3;5;8;2262
4302204;Boa Vista do Buricá;4321808;Três de Maio;3;5;8;16
4310207;Ijuí;4321402;Tenente Portela;3;5;8;114
4314100;Passo Fundo;4321204;Taquara;3;5;8;219
4316808;Santa Cruz do Sul;4321204;Taquara;3;5;8;160
4307559;Estação;4320503;Sertão;3;5;8;8
4311601;Liberato Salzano;4320107;Sarandi;3;5;8;41
4307609;Estância Velha;4320008;Sapucaia do Sul;3;5;8;21
4303103;Cachoeirinha;4319901;Sapiranga;3;5;8;36
4310207;Ijuí;4317400;Santiago;3;5;8;128
4205407;Florianópolis;4317103;Santana do Livramento;3;5;8;750
4310108;Igrejinha;4316808;Santa Cruz do Sul;3;5;8;159
4308508;Frederico Westphalen;4315909;Rodeio Bonito;3;5;8;25
4307906;Farroupilha;4315602;Rio Grande;3;5;8;326
3151800;Poços de Caldas;4314902;Porto Alegre;3;5;8;1015
3170701;Varginha;4314902;Porto Alegre;3;5;8;1090
3304201;Resende;4314902;Porto Alegre;3;5;8;1046
3305109;São João de Meriti;4314902;Porto Alegre;3;5;8;1087
3503307;Araras;4314902;Porto Alegre;3;5;8;924
3505500;Barretos;4314902;Porto Alegre;3;5;8;1080
3523107;Itaquaquecetuba;4314902;Porto Alegre;3;5;8;858
3536505;Paulínia;4314902;Porto Alegre;3;5;8;892
3539301;Pirassununga;4314902;Porto Alegre;3;5;8;958
4101408;Apucarana;4314902;Porto Alegre;3;5;8;720
4104303;Campo Mourão;4314902;Porto Alegre;3;5;8;675
4127700;Toledo;4314902;Porto Alegre;3;5;8;638
4128104;Umuarama;4314902;Porto Alegre;3;5;8;727
4307906;Farroupilha;4314407;Pelotas;3;5;8;294
4312450;Morro Redondo;4314407;Pelotas;3;5;8;29
4304630;Capão da Canoa;4313904;Panambi;3;5;8;379
3550308;São Paulo;4313201;Nova Petrópolis;3;5;8;762
4306700;Dona Francisca;4313102;Nova Palma;3;5;8;19
4311809;Marau;4312674;Nicolau Vergueiro;3;5;8;28
4308508;Frederico Westphalen;4310504;Iraí;3;5;8;23
3543402;Ribeirão Preto;4305108;Caxias do Sul;3;5;8;942
3550308;São Paulo;4304358;Candiota;3;5;8;1087
4302378;Bom Progresso;4304002;Campo Novo;3;5;8;16
4302600;Braga;4304002;Campo Novo;3;5;8;9
3534401;Osasco;4303103;Cachoeirinha;3;5;8;818
3518800;Guarulhos;4215802;São Bento do Sul;3;5;8;418
4208401;Itapiranga;4212106;Palmitos;3;5;8;57
3534401;Osasco;4211900;Palhoça;3;5;8;493
1302603;Manaus;4209102;Joinville;3;5;8;2772
3304557;Rio de Janeiro;4208906;Jaraguá do Sul;3;5;8;697
3548708;São Bernardo do Campo;4208906;Jaraguá do Sul;3;5;8;393
4200200;Agrolândia;4208500;Ituporanga;3;5;8;22
4204202;Chapecó;4208302;Itapema;3;5;8;395
3304557;Rio de Janeiro;4204301;Concórdia;3;5;8;978
4200101;Abelardo Luz;4204202;Chapecó;3;5;8;67
4125704;São Miguel do Iguaçu;4127700;Toledo;3;5;8;85
4100301;Agudos do Sul;4127601;Tijucas do Sul;3;5;8;15
4117107;Nova Londrina;4127304;Terra Rica;3;5;8;38
4101507;Arapongas;4127106;Telêmaco Borba;3;5;8;131
4109807;Ibiporã;4126504;Sertanópolis;3;5;8;23
4113205;Lapa;4125605;São Mateus do Sul;3;5;8;67
4117107;Nova Londrina;4123303;Santa Cruz de Monte Castelo;3;5;8;38
4122404;Rolândia;4122701;Sabáudia;3;5;8;19
3505708;Barueri;4119905;Ponta Grossa;3;5;8;374
3550308;São Paulo;4117602;Palmas;3;5;8;613
4108403;Francisco Beltrão;4116950;Nova Esperança do Sudoeste;3;5;8;29
3525904;Jundiaí;4113700;Londrina;3;5;8;435
4112108;Jandaia do Sul;4113700;Londrina;3;5;8;60
4106902;Curitiba;4112108;Jandaia do Sul;3;5;8;315
4105508;Cianorte;4111506;Ivaiporã;3;5;8;110
4106902;Curitiba;4109500;Guaraqueçaba;3;5;8;98
3543303;Ribeirão Pires;4106902;Curitiba;3;5;8;345
1100122;Ji-Paraná;4104808;Cascavel;3;5;8;1754
3555406;Ubatuba;3557105;Votuporanga;3;5;8;608
3506102;Bebedouro;3553708;Taquaritinga;3;5;8;56
2611606;Recife;3552403;Sumaré;3;5;8;2032
3549805;São José do Rio Preto;3552403;Sumaré;3;5;8;310
3543402;Ribeirão Preto;3550902;São Simão;3;5;8;44
3135605;Jequitaí;3550308;São Paulo;3;5;8;749
3517505;Guapiaçu;3550308;São Paulo;3;5;8;409
3521309;Ipuã;3550308;São Paulo;3;5;8;381
3532827;Nova Campina;3550308;São Paulo;3;5;8;236
3534906;Pacaembu;3550308;São Paulo;3;5;8;521
3535606;Paraibuna;3550308;São Paulo;3;5;8;105
3538907;Pirajuí;3550308;São Paulo;3;5;8;338
3540804;Potirendaba;3550308;São Paulo;3;5;8;399
3543501;Riversul;3550308;São Paulo;3;5;8;284
3507605;Bragança Paulista;3549904;São José dos Campos;3;5;8;74
3131307;Ipatinga;3548807;São Caetano do Sul;3;5;8;612
3170107;Uberaba;3548807;São Caetano do Sul;3;5;8;449
3201308;Cariacica;3548807;São Caetano do Sul;3;5;8;721
3303203;Nilópolis;3548807;São Caetano do Sul;3;5;8;331
3501608;Americana;3548807;São Caetano do Sul;3;5;8;124
3541406;Presidente Prudente;3548807;São Caetano do Sul;3;5;8;517
3519071;Hortolândia;3548708;São Bernardo do Campo;3;5;8;115
3524402;Jacareí;3548708;São Bernardo do Campo;3;5;8;79
3510609;Carapicuíba;3547304;Santana de Parnaíba;3;5;8;12
3536307;Patrocínio Paulista;3543402;Ribeirão Preto;3;5;8;76
3519071;Hortolândia;3538709;Piracicaba;3;5;8;45
3525300;Jaú;3538709;Piracicaba;3;5;8;109
3530607;Moji das Cruzes;3538709;Piracicaba;3;5;8;174
3531506;Monte Azul Paulista;3535705;Paraíso;3;5;8;18
3170701;Varginha;3534401;Osasco;3;5;8;265
3304201;Resende;3534401;Osasco;3;5;8;263
3504503;Avaré;3534401;Osasco;3;5;8;223
3523404;Itatiba;3534401;Osasco;3;5;8;59
3530300;Mirassol;3531407;Monte Aprazível;3;5;8;21
3516200;Franca;3530706;Mogi Guaçu;3;5;8;203
3506706;Boa Esperança do Sul;3529302;Matão;3;5;8;44
3514700;Echaporã;3529005;Marília;3;5;8;35
3506102;Bebedouro;3522703;Itápolis;3;5;8;78
3118601;Contagem;3519071;Hortolândia;3;5;8;455
3170206;Uberlândia;3517406;Guaíra;3;5;8;157
2927408;Salvador;3515004;Embu;3;5;8;1441
2800308;Aracaju;3509502;Campinas;3;5;8;1656
2910800;Feira de Santana;3509502;Campinas;3;5;8;1424
3500105;Adamantina;3502101;Andradina;3;5;8;90
3301009;Campos dos Goytacazes;3305109;São João de Meriti;3;5;8;238
1503606;Itaituba;3304557;Rio de Janeiro;3;5;8;2413
2700300;Arapiraca;3304557;Rio de Janeiro;3;5;8;1590
3120904;Curvelo;3304557;Rio de Janeiro;3;5;8;473
3301702;Duque de Caxias;3302007;Itaguaí;3;5;8;51
3202801;Itapemirim;3205309;Vitória;3;5;8;106
2910727;Eunápolis;3204906;São Mateus;3;5;8;266
2914802;Itabuna;3201308;Cariacica;3;5;8;617
3167202;Sete Lagoas;3201308;Cariacica;3;5;8;405
3154606;Ribeirão das Neves;3171204;Vespasiano;3;5;8;18
3144607;Nepomuceno;3169406;Três Pontas;3;5;8;33
3118304;Conselheiro Lafaiete;3167202;Sete Lagoas;3;5;8;142
3106705;Betim;3154606;Ribeirão das Neves;3;5;8;24
3135803;Jequitinhonha;3148707;Pedra Azul;3;5;8;56
3100203;Abaeté;3146404;Paineiras;3;5;8;27
2304400;Fortaleza;3136702;Juiz de Fora;3;5;8;2046
3111101;Campina Verde;3134202;Ituiutaba;3;5;8;61
3100104;Abadia dos Dourados;3119302;Coromandel;3;5;8;21
3100203;Abaeté;3107000;Biquinhas;3;5;8;40
2914802;Itabuna;2917102;Itororó;3;5;8;90
2910800;Feira de Santana;2913606;Ilhéus;3;5;8;277
2606002;Garanhuns;2612505;Santa Cruz do Capibaribe;3;5;8;105
2504009;Campina Grande;2508901;Mamanguape;3;5;8;92
2108207;Pedreiras;2211001;Teresina;3;5;8;205
2204709;Inhuma;2208007;Picos;3;5;8;55
1500800;Ananindeua;2105302;Imperatriz;3;5;8;470
1503606;Itaituba;1508050;Trairão;3;5;8;69
1400100;Boa Vista;1506807;Santarém;3;5;8;887
1501402;Belém;1504802;Monte Alegre;3;5;8;632
1300706;Boca do Acre;1302603;Manaus;3;5;8;1028
3534302;Orlândia;5221551;Turvelândia;2;6;8;409
3157807;Santa Luzia;5208707;Goiânia;2;6;8;677
3109303;Buritis;5208004;Formosa;2;6;8;98
5003256;Costa Rica;5205471;Chapadão do Céu;2;6;8;67
3556206;Valinhos;5002704;Campo Grande;2;6;8;854
4101507;Arapongas;5002704;Campo Grande;2;6;8;473
4304002;Campo Novo;4321907;Três Passos;2;6;8;28
4302105;Bento Gonçalves;4318705;São Leopoldo;2;6;8;75
4313409;Novo Hamburgo;4318408;São Jerônimo;2;6;8;65
3131307;Ipatinga;4314902;Porto Alegre;2;6;8;1419
3302403;Macaé;4314902;Porto Alegre;2;6;8;1216
3518701;Guarujá;4314902;Porto Alegre;2;6;8;819
4301602;Bagé;4314100;Passo Fundo;2;6;8;381
2304400;Fortaleza;4209300;Lages;2;6;8;2876
3516200;Franca;4209102;Joinville;2;6;8;651
2611606;Recife;4208906;Jaraguá do Sul;2;6;8;2433
4204202;Chapecó;4204806;Curitibanos;2;6;8;201
3534401;Osasco;4204202;Chapecó;2;6;8;694
3550308;São Paulo;4128005;Ubiratã;2;6;8;647
1200401;Rio Branco;4113700;Londrina;2;6;8;2207
3509502;Campinas;3555406;Ubatuba;2;6;8;205
1508407;Xinguara;3550308;São Paulo;2;6;8;1860
3170206;Uberlândia;3548807;São Caetano do Sul;2;6;8;549
3205200;Vila Velha;3548807;São Caetano do Sul;2;6;8;723
3139003;Machado;3548500;Santos;2;6;8;250
3545209;Salto;3545803;Santa Bárbara d'Oeste;2;6;8;51
3510203;Capão Bonito;3545209;Salto;2;6;8;141
3509502;Campinas;3542602;Registro;2;6;8;198
3302403;Macaé;3534401;Osasco;2;6;8;514
3303401;Nova Friburgo;3534401;Osasco;2;6;8;450
3306305;Volta Redonda;3534401;Osasco;2;6;8;297
3530706;Mogi Guaçu;3534401;Osasco;2;6;8;135
3511102;Catanduva;3528858;Marapoama;2;6;8;19
3170206;Uberlândia;3524105;Ituverava;2;6;8;166
3503208;Araraquara;3514304;Dourado;2;6;8;38
3502101;Andradina;3509502;Campinas;2;6;8;494
3302403;Macaé;3304755;São Francisco de Itabapoana;2;6;8;147
3119104;Corinto;3304557;Rio de Janeiro;2;6;8;514
3145604;Oliveira;3304557;Rio de Janeiro;2;6;8;291
3170529;Urucuia;3304557;Rio de Janeiro;2;6;8;787
3118601;Contagem;3162500;São João del Rei;2;6;8;136
3106200;Belo Horizonte;3144607;Nepomuceno;2;6;8;197
2602902;Cabo de Santo Agostinho;2604106;Caruaru;2;6;8;107
1302603;Manaus;1303809;São Gabriel da Cachoeira;2;6;8;852
3118601;Contagem;5218805;Rio Verde;1;7;8;768
4104303;Campo Mourão;5102637;Campo Novo do Parecis;1;7;8;1302
3543907;Rio Claro;5006309;Paranaíba;1;7;8;491
3550308;São Paulo;4312906;Nova Bassano;1;7;8;741
4312401;Montenegro;4312906;Nova Bassano;1;7;8;106
2306306;Itapagé;4304606;Canoas;1;7;8;3085
4104659;Carambeí;4208203;Itajaí;1;7;8;260
1100122;Ji-Paraná;4107256;Douradina;1;7;8;1619
1100205;Porto Velho;4101507;Arapongas;1;7;8;2028
3545605;Santa Adélia;3556008;Urupês;1;7;8;51
3121308;Descoberto;3550308;São Paulo;1;7;8;445
3132602;Itamarati de Minas;3550308;São Paulo;1;7;8;459
3535903;Paranapuã;3545605;Santa Adélia;1;7;8;228
3511508;Cerquilho;3541653;Quadra;1;7;8;35
3525706;José Bonifácio;3539608;Planalto;1;7;8;25
3301009;Campos dos Goytacazes;3534401;Osasco;1;7;8;587
3130804;Ingaí;3304557;Rio de Janeiro;1;7;8;235
3135803;Jequitinhonha;3151206;Pirapora;1;7;8;425
2306306;Itapagé;2408102;Natal;1;7;8;535
3109402;Buritizeiro;3136306;João Pinheiro;3;4;7;137
3135100;Janaúba;3135209;Januária;3;4;7;118
3134202;Ituiutaba;3134400;Iturama;3;4;7;115
3106200;Belo Horizonte;3132107;Itacarambi;3;4;7;530
3127701;Governador Valadares;3131802;Itabirinha de Mantena;3;4;7;84
2927408;Salvador;3131307;Ipatinga;3;4;7;831
3106200;Belo Horizonte;3131208;Ipanema;3;4;7;239
3111002;Campestre;3128709;Guaxupé;3;4;7;67
3107109;Boa Esperança;3128105;Guapé;3;4;7;52
2927408;Salvador;3127701;Governador Valadares;3;4;7;740
3115102;Cássia;3121209;Delfinópolis;3;4;7;26
3117603;Conceição do Pará;3118601;Contagem;3;4;7;87
3106200;Belo Horizonte;3113503;Carbonita;3;4;7;282
2904605;Brumado;3106200;Belo Horizonte;3;4;7;675
2906501;Candeias;2933307;Vitória da Conquista;3;4;7;346
2917607;Jaguaquara;2933307;Vitória da Conquista;3;4;7;177
2925303;Porto Seguro;2933307;Vitória da Conquista;3;4;7;253
2931350;Teixeira de Freitas;2933307;Vitória da Conquista;3;4;7;321
2930600;Serrolândia;2933109;Várzea do Poço;3;4;7;13
2906501;Candeias;2932903;Valença;3;4;7;97
2918407;Juazeiro;2932002;Uauá;3;4;7;124
2904407;Brejolândia;2930907;Tabocas do Brejo Velho;3;4;7;25
2804805;Nossa Senhora do Socorro;2930709;Simões Filho;3;4;7;254
2900702;Alagoinhas;2930501;Serrinha;3;4;7;83
2920502;Maracás;2924900;Planaltino;3;4;7;22
2917508;Jacobina;2921203;Miguel Calmon;3;4;7;24
2913606;Ilhéus;2919207;Lauro de Freitas;3;4;7;228
2904308;Brejões;2917607;Jaguaquara;3;4;7;49
2904605;Brumado;2916401;Itapetinga;3;4;7;192
2913606;Ilhéus;2915502;Itajuípe;3;4;7;30
2914802;Itabuna;2915502;Itajuípe;3;4;7;16
2900702;Alagoinhas;2909802;Cruz das Almas;3;4;7;94
2901205;Anagé;2902906;Barra do Choça;3;4;7;66
2700300;Arapiraca;2805703;Propriá;3;4;7;53
2802106;Estância;2804805;Nossa Senhora do Socorro;3;4;7;57
2611606;Recife;2802908;Itabaiana;3;4;7;389
2800308;Aracaju;2801405;Carira;3;4;7;88
2702306;Coruripe;2708600;São Miguel dos Campos;3;4;7;39
2609907;Ouricuri;2615607;Trindade;3;4;7;22
2506301;Guarabira;2611606;Recife;3;4;7;153
2608057;Jatobá;2611002;Petrolândia;3;4;7;13
2408102;Natal;2610707;Paulista;3;4;7;237
2605202;Escada;2609600;Olinda;3;4;7;53
2605202;Escada;2607901;Jaboatão dos Guararapes;3;4;7;34
2604106;Caruaru;2606200;Goiana;3;4;7;136
2600500;Águas Belas;2606002;Garanhuns;3;4;7;72
2600906;Amaraji;2605202;Escada;3;4;7;25
2601409;Barreiros;2602902;Cabo de Santo Agostinho;3;4;7;62
2504009;Campina Grande;2516102;Soledade;3;4;7;54
2501104;Areia;2516003;Solânea;3;4;7;20
2509701;Monteiro;2515500;Serra Branca;3;4;7;71
2504306;Catolé do Rocha;2512804;Riacho dos Cavalos;3;4;7;14
2500304;Alagoa Grande;2507507;João Pessoa;3;4;7;86
2502508;Boqueirão;2507507;João Pessoa;3;4;7;144
2402006;Caicó;2504306;Catolé do Rocha;3;4;7;70
2502508;Boqueirão;2504009;Campina Grande;3;4;7;40
2408102;Natal;2412906;São Tomé;3;4;7;94
2403103;Currais Novos;2409407;Pau dos Ferros;3;4;7;193
2408300;Nova Cruz;2409100;Passa e Fica;3;4;7;24
2404705;Ipanguaçu;2408102;Natal;3;4;7;181
2304285;Eusébio;2408003;Mossoró;3;4;7;188
2403251;Parnamirim;2407807;Monte Alegre;3;4;7;18
2403103;Currais Novos;2406106;Jucurutu;3;4;7;56
2400208;Açu;2404705;Ipanguaçu;3;4;7;11
2403103;Currais Novos;2403251;Parnamirim;3;4;7;143
2400109;Acari;2403103;Currais Novos;3;4;7;24
2402709;Cerro Corá;2403103;Currais Novos;3;4;7;30
2306405;Itapipoca;2313401;Tianguá;3;4;7;159
2304103;Crateús;2313302;Tauá;3;4;7;99
2304400;Fortaleza;2313104;Tabuleiro do Norte;3;4;7;170
2303709;Caucaia;2312403;São Gonçalo do Amarante;3;4;7;35
2305506;Iguatu;2311801;Russas;3;4;7;218
2303931;Choró;2311306;Quixadá;3;4;7;16
2304400;Fortaleza;2310902;Piquet Carneiro;3;4;7;245
2303501;Cascavel;2310852;Pindoretama;3;4;7;14
2208007;Picos;2307304;Juazeiro do Norte;3;4;7;239
1302504;Manacapuru;2304400;Fortaleza;3;4;7;2452
2304350;Forquilha;2304400;Fortaleza;3;4;7;191
2300200;Acaraú;2304251;Cruz;3;4;7;9
2208007;Picos;2304202;Crato;3;4;7;228
1400100;Boa Vista;2211001;Teresina;3;4;7;2164
2207009;Oeiras;2210805;Simplício Mendes;3;4;7;98
2201903;Bom Jesus;2203107;Cristino Castro;3;4;7;32
2103307;Codó;2112100;Timbiras;3;4;7;27
2103000;Caxias;2109908;Santa Inês;3;4;7;261
2103000;Caxias;2108454;Peritoró;3;4;7;124
1505502;Paragominas;2105302;Imperatriz;3;4;7;275
1506138;Redenção;2105302;Imperatriz;3;4;7;397
2101202;Bacabal;2105302;Imperatriz;3;4;7;332
1600402;Mazagão;1600600;Santana;3;4;7;18
1501402;Belém;1508159;Uruará;3;4;7;643
1505064;Novo Repartimento;1508100;Tucuruí;3;4;7;61
1501501;Benevides;1506500;Santa Isabel do Pará;3;4;7;12
1501402;Belém;1506302;Salvaterra;3;4;7;70
1504208;Marabá;1506187;Rondon do Pará;3;4;7;131
1501402;Belém;1505809;Portel;3;4;7;269
1505502;Paragominas;1505536;Parauapebas;3;4;7;431
1501576;Bom Jesus do Tocantins;1504208;Marabá;3;4;7;65
1502954;Eldorado dos Carajás;1504208;Marabá;3;4;7;86
1501402;Belém;1504059;Mãe do Rio;3;4;7;122
1400100;Boa Vista;1400175;Cantá;3;4;7;31
1302603;Manaus;1302702;Manicoré;3;4;7;328
1300144;Apuí;1301704;Humaitá;3;4;7;351
1303403;Parintins;5300108;Brasília;3;4;7;1721
1600279;Laranjal do Jari;5300108;Brasília;3;4;7;1681
2103000;Caxias;5300108;Brasília;3;4;7;1304
2106102;Loreto;5300108;Brasília;3;4;7;1009
2107506;Paço do Lumiar;5300108;Brasília;3;4;7;1522
2301109;Aracati;5300108;Brasília;3;4;7;1639
2304202;Crato;5300108;Brasília;3;4;7;1307
2306900;Jaguaribe;5300108;Brasília;3;4;7;1468
2307601;Limoeiro do Norte;5300108;Brasília;3;4;7;1569
2414209;Tibau do Sul;5300108;Brasília;3;4;7;1716
2503209;Cabedelo;5300108;Brasília;3;4;7;1684
2603454;Camaragibe;5300108;Brasília;3;4;7;1612
2612208;Salgueiro;5300108;Brasília;3;4;7;1256
2616407;Vitória de Santo Antão;5300108;Brasília;3;4;7;1581
2802106;Estância;5300108;Brasília;3;4;7;1218
2906006;Campo Formoso;5300108;Brasília;3;4;7;997
2917508;Jacobina;5300108;Brasília;3;4;7;937
2922003;Mucuri;5300108;Brasília;3;4;7;932
2923001;Nova Viçosa;5300108;Brasília;3;4;7;935
2928703;Santo Antônio de Jesus;5300108;Brasília;3;4;7;971
2931905;Tucano;5300108;Brasília;3;4;7;1104
3101607;Alfenas;5300108;Brasília;3;4;7;655
3110509;Camanducaia;5300108;Brasília;3;4;7;793
3113404;Caratinga;5300108;Brasília;3;4;7;762
3120904;Curvelo;5300108;Brasília;3;4;7;495
3131703;Itabira;5300108;Brasília;3;4;7;660
3132404;Itajubá;5300108;Brasília;3;4;7;778
3133808;Itaúna;5300108;Brasília;3;4;7;597
3143906;Muriaé;5300108;Brasília;3;4;7;841
3145901;Ouro Branco;5300108;Brasília;3;4;7;695
3152105;Ponte Nova;5300108;Brasília;3;4;7;745
3162500;São João del Rei;5300108;Brasília;3;4;7;709
3169901;Ubá;5300108;Brasília;3;4;7;794
3203320;Marataízes;5300108;Brasília;3;4;7;961
3300803;Cachoeiras de Macacu;5300108;Brasília;3;4;7;935
3301108;Cantagalo;5300108;Brasília;3;4;7;909
3302205;Itaperuna;5300108;Brasília;3;4;7;882
3302700;Maricá;5300108;Brasília;3;4;7;965
3303708;Paraíba do Sul;5300108;Brasília;3;4;7;866
3304003;Piraí;5300108;Brasília;3;4;7;874
3304144;Queimados;5300108;Brasília;3;4;7;899
3304300;Rio Bonito;5300108;Brasília;3;4;7;958
3304508;Rio das Flores;5300108;Brasília;3;4;7;848
3304805;São Fidélis;5300108;Brasília;3;4;7;934
3305208;São Pedro da Aldeia;5300108;Brasília;3;4;7;1003
3306206;Vassouras;5300108;Brasília;3;4;7;866
3500303;Aguaí;5300108;Brasília;3;4;7;699
3500501;Águas de Lindóia;5300108;Brasília;3;4;7;751
3502507;Aparecida;5300108;Brasília;3;4;7;833
3503802;Artur Nogueira;5300108;Brasília;3;4;7;753
3505203;Bariri;5300108;Brasília;3;4;7;699
3505807;Bastos;5300108;Brasília;3;4;7;743
3505906;Batatais;5300108;Brasília;3;4;7;563
3506300;Bernardino de Campos;5300108;Brasília;3;4;7;815
3507001;Boituva;5300108;Brasília;3;4;7;828
3507803;Brodowski;5300108;Brasília;3;4;7;574
3507902;Brotas;5300108;Brasília;3;4;7;717
3508603;Cachoeira Paulista;5300108;Brasília;3;4;7;823
3509205;Cajamar;5300108;Brasília;3;4;7;843
3509403;Cajuru;5300108;Brasília;3;4;7;609
3510005;Cândido Mota;5300108;Brasília;3;4;7;814
3510203;Capão Bonito;5300108;Brasília;3;4;7;909
3510401;Capivari;5300108;Brasília;3;4;7;797
3510807;Casa Branca;5300108;Brasília;3;4;7;666
3511508;Cerquilho;5300108;Brasília;3;4;7;814
3512803;Cosmópolis;5300108;Brasília;3;4;7;761
3513108;Cravinhos;5300108;Brasília;3;4;7;613
3513702;Descalvado;5300108;Brasília;3;4;7;675
3514403;Dracena;5300108;Brasília;3;4;7;746
3515186;Espírito Santo do Pinhal;5300108;Brasília;3;4;7;718
3515202;Estrela d'Oeste;5300108;Brasília;3;4;7;564
3517406;Guaíra;5300108;Brasília;3;4;7;501
3518206;Guararapes;5300108;Brasília;3;4;7;672
3518602;Guariba;5300108;Brasília;3;4;7;615
3519709;Ibiúna;5300108;Brasília;3;4;7;872
3520103;Igarapava;5300108;Brasília;3;4;7;469
3520301;Iguape;5300108;Brasília;3;4;7;986
3520400;Ilhabela;5300108;Brasília;3;4;7;926
3520442;Ilha Solteira;5300108;Brasília;3;4;7;632
3521408;Iracemápolis;5300108;Brasília;3;4;7;751
3522703;Itápolis;5300108;Brasília;3;4;7;648
3524105;Ituverava;5300108;Brasília;3;4;7;502
3524600;Jacupiranga;5300108;Brasília;3;4;7;983
3525102;Jardinópolis;5300108;Brasília;3;4;7;577
3525508;Joanópolis;5300108;Brasília;3;4;7;809
3525706;José Bonifácio;5300108;Brasília;3;4;7;611
3526407;Laranjal Paulista;5300108;Brasília;3;4;7;802
3527405;Lucélia;5300108;Brasília;3;4;7;736
3528403;Mairinque;5300108;Brasília;3;4;7;860
3530300;Mirassol;5300108;Brasília;3;4;7;581
3530805;Moji-Mirim;5300108;Brasília;3;4;7;740
3531407;Monte Aprazível;5300108;Brasília;3;4;7;583
3531506;Monte Azul Paulista;5300108;Brasília;3;4;7;570
3531803;Monte Mor;5300108;Brasília;3;4;7;793
3531902;Morro Agudo;5300108;Brasília;3;4;7;545
3533007;Nova Granada;5300108;Brasília;3;4;7;544
3533403;Nova Odessa;5300108;Brasília;3;4;7;773
3533502;Novo Horizonte;5300108;Brasília;3;4;7;642
3534302;Orlândia;5300108;Brasília;3;4;7;544
3534609;Osvaldo Cruz;5300108;Brasília;3;4;7;737
3535309;Palmital;5300108;Brasília;3;4;7;812
3535507;Paraguaçu Paulista;5300108;Brasília;3;4;7;787
3536703;Pederneiras;5300108;Brasília;3;4;7;730
3537107;Pedreira;5300108;Brasília;3;4;7;775
3537404;Pereira Barreto;5300108;Brasília;3;4;7;633
3537602;Peruíbe;5300108;Brasília;3;4;7;945
3537800;Piedade;5300108;Brasília;3;4;7;876
3537909;Pilar do Sul;5300108;Brasília;3;4;7;886
3538808;Piraju;5300108;Brasília;3;4;7;833
3538907;Pirajuí;5300108;Brasília;3;4;7;705
3540002;Pompéia;5300108;Brasília;3;4;7;739
3540200;Pontal;5300108;Brasília;3;4;7;577
3540606;Porto Feliz;5300108;Brasília;3;4;7;821
3540705;Porto Ferreira;5300108;Brasília;3;4;7;671
3541307;Presidente Epitácio;5300108;Brasília;3;4;7;802
3541505;Presidente Venceslau;5300108;Brasília;3;4;7;796
3541604;Promissão;5300108;Brasília;3;4;7;668
3542206;Rancharia;5300108;Brasília;3;4;7;781
3546306;Santa Cruz das Palmeiras;5300108;Brasília;3;4;7;670
3546405;Santa Cruz do Rio Pardo;5300108;Brasília;3;4;7;807
3546603;Santa Fé do Sul;5300108;Brasília;3;4;7;588
3546702;Santa Gertrudes;5300108;Brasília;3;4;7;737
3547502;Santa Rita do Passa Quatro;5300108;Brasília;3;4;7;655
3547601;Santa Rosa de Viterbo;5300108;Brasília;3;4;7;630
3547700;Santo Anastácio;5300108;Brasília;3;4;7;794
3549409;São Joaquim da Barra;5300108;Brasília;3;4;7;530
3549706;São José do Rio Pardo;5300108;Brasília;3;4;7;650
3550100;São Manuel;5300108;Brasília;3;4;7;769
3550407;São Pedro;5300108;Brasília;3;4;7;746
3551504;Serrana;5300108;Brasília;3;4;7;599
3551603;Serra Negra;5300108;Brasília;3;4;7;765
3552106;Socorro;5300108;Brasília;3;4;7;766
3553302;Tambaú;5300108;Brasília;3;4;7;656
3553807;Taquarituba;5300108;Brasília;3;4;7;867
3556008;Urupês;5300108;Brasília;3;4;7;615
3556404;Vargem Grande do Sul;5300108;Brasília;3;4;7;676
3556503;Várzea Paulista;5300108;Brasília;3;4;7;828
4100400;Almirante Tamandaré;5300108;Brasília;3;4;7;1064
4101507;Arapongas;5300108;Brasília;3;4;7;926
4104006;Campina Grande do Sul;5300108;Brasília;3;4;7;1059
4106407;Cornélio Procópio;5300108;Brasília;3;4;7;869
4109609;Guaratuba;5300108;Brasília;3;4;7;1125
4127106;Telêmaco Borba;5300108;Brasília;3;4;7;994
4128500;Wenceslau Braz;5300108;Brasília;3;4;7;916
4201406;Araranguá;5300108;Brasília;3;4;7;1465
4202305;Biguaçu;5300108;Brasília;3;4;7;1297
4202800;Braço do Norte;5300108;Brasília;3;4;7;1387
4203204;Camboriú;5300108;Brasília;3;4;7;1245
4203600;Campos Novos;5300108;Brasília;3;4;7;1337
4204004;Catanduvas;5300108;Brasília;3;4;7;1314
4204806;Curitibanos;5300108;Brasília;3;4;7;1303
4205506;Fraiburgo;5300108;Brasília;3;4;7;1286
4206900;Ibirama;5300108;Brasília;3;4;7;1258
4207007;Içara;5300108;Brasília;3;4;7;1438
4207304;Imbituba;5300108;Brasília;3;4;7;1373
4208302;Itapema;5300108;Brasília;3;4;7;1252
4208500;Ituporanga;5300108;Brasília;3;4;7;1298
4208807;Jaguaruna;5300108;Brasília;3;4;7;1423
4210100;Mafra;5300108;Brasília;3;4;7;1163
4210506;Maravilha;5300108;Brasília;3;4;7;1345
4211702;Orleans;5300108;Brasília;3;4;7;1395
4212908;Pinhalzinho;5300108;Brasília;3;4;7;1345
4213203;Pomerode;5300108;Brasília;3;4;7;1218
4215000;Rio Negrinho;5300108;Brasília;3;4;7;1170
4216305;São João Batista;5300108;Brasília;3;4;7;1274
4216503;São Joaquim;5300108;Brasília;3;4;7;1398
4217501;Seara;5300108;Brasília;3;4;7;1346
4217600;Siderópolis;5300108;Brasília;3;4;7;1426
4217709;Sombrio;5300108;Brasília;3;4;7;1484
4217808;Taió;5300108;Brasília;3;4;7;1274
4218202;Timbó;5300108;Brasília;3;4;7;1231
4218806;Turvo;5300108;Brasília;3;4;7;1465
4219002;Urussanga;5300108;Brasília;3;4;7;1416
4219507;Xanxerê;5300108;Brasília;3;4;7;1321
4304408;Canela;5300108;Brasília;3;4;7;1533
4304630;Capão da Canoa;5300108;Brasília;3;4;7;1562
4304705;Carazinho;5300108;Brasília;3;4;7;1485
4306106;Cruz Alta;5300108;Brasília;3;4;7;1555
4307708;Esteio;5300108;Brasília;3;4;7;1597
4307906;Farroupilha;5300108;Brasília;3;4;7;1534
4309100;Gramado;5300108;Brasília;3;4;7;1541
4312401;Montenegro;5300108;Brasília;3;4;7;1586
4313904;Panambi;5300108;Brasília;3;4;7;1514
4317202;Santa Rosa;5300108;Brasília;3;4;7;1520
4318002;São Borja;5300108;Brasília;3;4;7;1685
4321204;Taquara;5300108;Brasília;3;4;7;1566
4321600;Tramandaí;5300108;Brasília;3;4;7;1589
5005707;Naviraí;5300108;Brasília;3;4;7;1053
5006200;Nova Andradina;5300108;Brasília;3;4;7;929
5006309;Paranaíba;5300108;Brasília;3;4;7;552
5007901;Sidrolândia;5300108;Brasília;3;4;7;954
5102504;Cáceres;5300108;Brasília;3;4;7;1046
5105101;Juara;5300108;Brasília;3;4;7;1135
5107040;Primavera do Leste;5300108;Brasília;3;4;7;688
5211800;Jaraguá;5300108;Brasília;3;4;7;153
5213103;Mineiros;5300108;Brasília;3;4;7;536
5220405;São Simão;5300108;Brasília;3;4;7;452
5221601;Uruaçu;5300108;Brasília;3;4;7;196
5208707;Goiânia;5222054;Vicentinópolis;3;4;7;128
5216403;Paraúna;5218805;Rio Verde;3;4;7;105
3550308;São Paulo;5217104;Piracanjuba;3;4;7;748
5215702;Palmeiras de Goiás;5216403;Paraúna;3;4;7;60
5203906;Buriti Alegre;5213806;Morrinhos;3;4;7;47
5203500;Bom Jesus de Goiás;5213004;Maurilândia;3;4;7;65
3550308;São Paulo;5212204;Jussara;3;4;7;977
5203500;Bom Jesus de Goiás;5209101;Goiatuba;3;4;7;49
4106902;Curitiba;5206206;Cristalina;3;4;7;969
3552403;Sumaré;5205109;Catalão;3;4;7;521
3304557;Rio de Janeiro;5204508;Caldas Novas;3;4;7;811
3550308;São Paulo;5203203;Barro Alto;3;4;7;993
2111300;São Luís;5201405;Aparecida de Goiânia;3;4;7;1664
1709500;Gurupi;5201108;Anápolis;3;4;7;510
1716109;Paraíso do Tocantins;5201108;Anápolis;3;4;7;680
5107305;São José do Rio Claro;5108907;Nova Maringá;3;4;7;58
5103403;Cuiabá;5108006;Tapurah;3;4;7;312
5102504;Cáceres;5107909;Sinop;3;4;7;519
5104906;Jangada;5107701;Rosário Oeste;3;4;7;47
3550308;São Paulo;5106505;Poconé;3;4;7;1366
5103403;Cuiabá;5106240;Nova Ubiratã;3;4;7;298
5104104;Guarantã do Norte;5105606;Matupá;3;4;7;24
3205200;Vila Velha;5103403;Cuiabá;3;4;7;1791
3548708;São Bernardo do Campo;5103403;Cuiabá;3;4;7;1382
4128104;Umuarama;5103254;Colniza;3;4;7;1717
3503208;Araraquara;5008305;Três Lagoas;3;4;7;389
3516705;Garça;5008305;Três Lagoas;3;4;7;271
3543402;Ribeirão Preto;5008305;Três Lagoas;3;4;7;413
5005400;Maracaju;5007208;Rio Brilhante;3;4;7;69
3549805;São José do Rio Preto;5006309;Paranaíba;3;4;7;230
4128104;Umuarama;5005681;Mundo Novo;3;4;7;102
5002704;Campo Grande;5004700;Ivinhema;3;4;7;227
3550308;São Paulo;5004601;Itaquiraí;3;4;7;771
4128104;Umuarama;5003702;Dourados;3;4;7;227
4303905;Campo Bom;5002951;Chapadão do Sul;3;4;7;1218
4128104;Umuarama;5002704;Campo Grande;3;4;7;393
5001003;Aparecida do Taboado;5002704;Campo Grande;3;4;7;372
3550308;São Paulo;5000708;Anastácio;3;4;7;1028
4309100;Gramado;4323804;Xangri-lá;3;4;7;92
4308706;Gaurama;4322905;Viadutos;3;4;7;7
4322608;Venâncio Aires;4322707;Vera Cruz;3;4;7;33
4318705;São Leopoldo;4322400;Uruguaiana;3;4;7;573
4321303;Taquari;4322004;Triunfo;3;4;7;20
4320107;Sarandi;4321956;Trindade do Sul;3;4;7;47
4320107;Sarandi;4321857;Três Palmeiras;3;4;7;37
4309001;Giruá;4321808;Três de Maio;3;4;7;32
3304557;Rio de Janeiro;4321600;Tramandaí;3;4;7;1017
4319406;São Pedro do Sul;4321493;Toropi;3;4;7;17
4303103;Cachoeirinha;4321451;Teutônia;3;4;7;87
4306320;Derrubadas;4321402;Tenente Portela;3;4;7;16
4309100;Gramado;4321204;Taquara;3;4;7;31
4306106;Cruz Alta;4321006;Tapera;3;4;7;71
4316709;Santa Bárbara do Sul;4321006;Tapera;3;4;7;47
4300646;Ametista do Sul;4320800;Soledade;3;4;7;174
4312708;Nonoai;4320107;Sarandi;3;4;7;66
4318408;São Jerônimo;4320008;Sapucaia do Sul;3;4;7;57
3516200;Franca;4318705;São Leopoldo;3;4;7;1079
4307906;Farroupilha;4318705;São Leopoldo;3;4;7;62
4307708;Esteio;4318408;São Jerônimo;3;4;7;54
4312401;Montenegro;4318408;São Jerônimo;3;4;7;39
3550308;São Paulo;4318309;São Gabriel;3;4;7;1028
4312658;Não-Me-Toque;4317756;Santo Antônio do Planalto;3;4;7;15
4301602;Bagé;4317400;Santiago;3;4;7;249
4201406;Araranguá;4316808;Santa Cruz do Sul;3;4;7;296
4301008;Arroio do Meio;4316808;Santa Cruz do Sul;3;4;7;59
4309209;Gravataí;4316808;Santa Cruz do Sul;3;4;7;142
4311809;Marau;4316808;Santa Cruz do Sul;3;4;7;143
4301651;Barão;4316501;Salvador do Sul;3;4;7;7
4302352;Bom Princípio;4316501;Salvador do Sul;3;4;7;16
4308102;Feliz;4316501;Salvador do Sul;3;4;7;20
3127701;Governador Valadares;4314902;Porto Alegre;3;4;7;1508
3201209;Cachoeiro de Itapemirim;4314902;Porto Alegre;3;4;7;1387
3518404;Guaratinguetá;4314902;Porto Alegre;3;4;7;980
3545209;Salto;4314902;Porto Alegre;3;4;7;843
3550704;São Sebastião;4314902;Porto Alegre;3;4;7;883
4104204;Campo Largo;4314902;Porto Alegre;3;4;7;533
4213203;Pomerode;4314902;Porto Alegre;3;4;7;414
4302501;Bossoroca;4314902;Porto Alegre;3;4;7;384
4310405;Independência;4314902;Porto Alegre;3;4;7;376
4312476;Morro Reuter;4314902;Porto Alegre;3;4;7;58
4313953;Pantano Grande;4314902;Porto Alegre;3;4;7;114
4305108;Caxias do Sul;4314803;Portão;3;4;7;60
4109401;Guarapuava;4314100;Passo Fundo;3;4;7;330
4309001;Giruá;4314100;Passo Fundo;3;4;7;193
4304606;Canoas;4314050;Parobé;3;4;7;46
4306908;Encruzilhada do Sul;4313953;Pantano Grande;3;4;7;39
4113700;Londrina;4313409;Novo Hamburgo;3;4;7;708
4309209;Gravataí;4313409;Novo Hamburgo;3;4;7;31
4312476;Morro Reuter;4313409;Novo Hamburgo;3;4;7;17
4309902;Ibiraiaras;4312906;Nova Bassano;3;4;7;40
4307906;Farroupilha;4312401;Montenegro;3;4;7;51
4304606;Canoas;4311809;Marau;3;4;7;190
4303103;Cachoeirinha;4311403;Lajeado;3;4;7;106
4306106;Cruz Alta;4311205;Júlio de Castilhos;3;4;7;65
4300406;Alegrete;4310603;Itaqui;3;4;7;102
4305587;Colinas;4310363;Imigrante;3;4;7;10
4306304;David Canabarro;4309902;Ibiraiaras;3;4;7;21
3518800;Guarulhos;4308607;Garibaldi;3;4;7;799
4304606;Canoas;4308607;Garibaldi;3;4;7;80
4304804;Carlos Barbosa;4308201;Flores da Cunha;3;4;7;43
4105508;Cianorte;4307906;Farroupilha;3;4;7;628
4125506;São José dos Pinhais;4307906;Farroupilha;3;4;7;458
4301602;Bagé;4307906;Farroupilha;3;4;7;358
4305108;Caxias do Sul;4307708;Esteio;3;4;7;76
4300554;Alto Alegre;4307500;Espumoso;3;4;7;15
4304606;Canoas;4306767;Eldorado do Sul;3;4;7;46
4114302;Mandirituba;4305108;Caxias do Sul;3;4;7;414
2304400;Fortaleza;4304606;Canoas;3;4;7;3110
3118601;Contagem;4304606;Canoas;3;4;7;1288
4204202;Chapecó;4304606;Canoas;3;4;7;339
4304408;Canela;4304606;Canoas;3;4;7;73
3505708;Barueri;4303103;Cachoeirinha;3;4;7;817
3556701;Vinhedo;4303103;Cachoeirinha;3;4;7;859
4207205;Imaruí;4218707;Tubarão;3;4;7;26
4211207;Morro da Fumaça;4218707;Tubarão;3;4;7;25
4215505;Santa Cecília;4218251;Timbó Grande;3;4;7;45
4212908;Pinhalzinho;4217550;Serra Alta;3;4;7;14
4215901;São Bonifácio;4217105;São Martinho;3;4;7;30
4200705;Alfredo Wagner;4216602;São José;3;4;7;65
4200101;Abelardo Luz;4216107;São Domingos;3;4;7;20
4204202;Chapecó;4213153;Planalto Alegre;3;4;7;27
4205407;Florianópolis;4213104;Piratuba;3;4;7;323
4209102;Joinville;4212502;Penha;3;4;7;61
4205407;Florianópolis;4212304;Paulo Lopes;3;4;7;44
4211009;Mondaí;4212106;Palmitos;3;4;7;30
4125506;São José dos Pinhais;4211900;Palhoça;3;4;7;238
4205704;Garopaba;4211900;Palhoça;3;4;7;43
4207007;Içara;4211702;Orleans;3;4;7;43
4101804;Araucária;4210100;Mafra;3;4;7;75
4203600;Campos Novos;4209300;Lages;3;4;7;96
3556206;Valinhos;4209102;Joinville;3;4;7;410
4205506;Fraiburgo;4209003;Joaçaba;3;4;7;63
3205002;Serra;4208906;Jaraguá do Sul;3;4;7;1106
3522604;Itapira;4208203;Itajaí;3;4;7;533
3552205;Sorocaba;4208203;Itajaí;3;4;7;402
4204707;Cunha Porã;4207759;Iraceminha;3;4;7;18
4125506;São José dos Pinhais;4205407;Florianópolis;3;4;7;237
3509502;Campinas;4204608;Criciúma;3;4;7;676
1302603;Manaus;4204301;Concórdia;3;4;7;2770
4118204;Paranaguá;4204301;Concórdia;3;4;7;386
4202909;Brusque;4204202;Chapecó;3;4;7;368
3550308;São Paulo;4203956;Capivari de Baixo;3;4;7;575
4202909;Brusque;4203204;Camboriú;3;4;7;23
3534401;Osasco;4202909;Brusque;3;4;7;445
3548807;São Caetano do Sul;4202909;Brusque;3;4;7;449
3548807;São Caetano do Sul;4202404;Blumenau;3;4;7;444
4105508;Cianorte;4202404;Blumenau;3;4;7;501
4125506;São José dos Pinhais;4202008;Balneário Camboriú;3;4;7;168
4107207;Dois Vizinhos;4128609;Verê;3;4;7;22
4124806;São João;4128609;Verê;3;4;7;19
4109401;Guarapuava;4128203;União da Vitória;3;4;7;103
4101507;Arapongas;4128104;Umuarama;3;4;7;194
4115200;Maringá;4127908;Tuneiras do Oeste;3;4;7;108
4109708;Ibaiti;4127106;Telêmaco Borba;3;4;7;75
4124806;São João;4126652;Sulina;3;4;7;14
4103701;Cambé;4126504;Sertanópolis;3;4;7;36
4115200;Maringá;4126504;Sertanópolis;3;4;7;100
4126405;Sertaneja;4126504;Sertanópolis;3;4;7;20
4122404;Rolândia;4126009;São Sebastião da Amoreira;3;4;7;64
4107207;Dois Vizinhos;4125209;São Jorge d'Oeste;3;4;7;14
4108304;Foz do Iguaçu;4123501;Santa Helena;3;4;7;72
4115200;Maringá;4122701;Sabáudia;3;4;7;40
4102802;Bela Vista do Paraíso;4122404;Rolândia;3;4;7;39
4104600;Capitão Leônidas Marques;4121406;Realeza;3;4;7;33
4113205;Lapa;4121208;Quitandinha;3;4;7;25
3548708;São Bernardo do Campo;4120804;Quatro Barras;3;4;7;309
4104501;Capanema;4120358;Pranchita;3;4;7;37
4106902;Curitiba;4120101;Porto Amazonas;3;4;7;61
4100806;Alvorada do Sul;4120002;Porecatu;3;4;7;15
1302603;Manaus;4119905;Ponta Grossa;3;4;7;2610
4104303;Campo Mourão;4119905;Ponta Grossa;3;4;7;252
4108809;Guaíra;4119905;Ponta Grossa;3;4;7;424
4105805;Colombo;4119509;Piraquara;3;4;7;28
4115200;Maringá;4118006;Paraíso do Norte;3;4;7;71
4104303;Campo Mourão;4117909;Palotina;3;4;7;147
4108809;Guaíra;4117909;Palotina;3;4;7;49
4113502;Loanda;4117107;Nova Londrina;3;4;7;24
4101408;Apucarana;4115754;Mauá da Serra;3;4;7;44
1100122;Ji-Paraná;4115200;Maringá;3;4;7;1697
3548807;São Caetano do Sul;4115200;Maringá;3;4;7;549
4105805;Colombo;4115200;Maringá;3;4;7;342
4108601;Goioerê;4115200;Maringá;3;4;7;141
4111605;Ivatuba;4115200;Maringá;3;4;7;36
4112405;Japurá;4115200;Maringá;3;4;7;64
4101408;Apucarana;4114906;Marilândia do Sul;3;4;7;25
4101507;Arapongas;4114203;Mandaguari;3;4;7;31
1721000;Palmas;4113700;Londrina;3;4;7;1458
2611606;Recife;4113700;Londrina;3;4;7;2316
3205002;Serra;4113700;Londrina;3;4;7;1152
4113502;Loanda;4113700;Londrina;3;4;7;207
4111506;Ivaiporã;4112108;Jandaia do Sul;3;4;7;71
4109708;Ibaiti;4112009;Jaguariaíva;3;4;7;68
4105508;Cianorte;4110409;Indianópolis;3;4;7;23
4106506;Coronel Vivida;4108403;Francisco Beltrão;3;4;7;51
3552205;Sorocaba;4108304;Foz do Iguaçu;3;4;7;733
1500800;Ananindeua;4106902;Curitiba;3;4;7;2663
2604106;Caruaru;4106902;Curitiba;3;4;7;2287
3303500;Nova Iguaçu;4106902;Curitiba;3;4;7;651
3526902;Limeira;4106902;Curitiba;3;4;7;370
4102901;Bituruna;4106902;Curitiba;3;4;7;242
4104451;Cantagalo;4105409;Chopinzinho;3;4;7;67
3509502;Campinas;4104808;Cascavel;3;4;7;680
3534401;Osasco;4101804;Araucária;3;4;7;345
3504008;Assis;4101507;Arapongas;3;4;7;131
3541406;Presidente Prudente;4101507;Arapongas;3;4;7;142
3304557;Rio de Janeiro;3556206;Valinhos;3;4;7;383
3549805;São José do Rio Preto;3556107;Valentim Gentil;3;4;7;88
3549805;São José do Rio Preto;3556008;Urupês;3;4;7;43
3519006;Herculândia;3555000;Tupã;3;4;7;18
3510401;Capivari;3554508;Tietê;3;4;7;24
3552205;Sorocaba;3554508;Tietê;3;4;7;48
3501608;Americana;3554003;Tatuí;3;4;7;85
3512605;Coronel Macedo;3553807;Taquarituba;3;4;7;13
3513009;Cotia;3552205;Sorocaba;3;4;7;61
3507803;Brodowski;3551504;Serrana;3;4;7;25
3550308;São Paulo;3550506;São Pedro do Turvo;3;4;7;334
1502954;Eldorado dos Carajás;3550308;São Paulo;3;4;7;1959
2201903;Bom Jesus;3550308;São Paulo;3;4;7;1630
2207702;Parnaíba;3550308;São Paulo;3;4;7;2346
2306405;Itapipoca;3550308;São Paulo;3;4;7;2333
2516201;Sousa;3550308;São Paulo;3;4;7;2039
2601706;Belo Jardim;3550308;São Paulo;3;4;7;1966
2905206;Caetité;3550308;São Paulo;3;4;7;1136
2916401;Itapetinga;3550308;São Paulo;3;4;7;1124
3109105;Bueno Brandão;3550308;São Paulo;3;4;7;138
3162500;São João del Rei;3550308;São Paulo;3;4;7;367
3203908;Nova Venécia;3550308;São Paulo;3;4;7;832
3300803;Cachoeiras de Macacu;3550308;São Paulo;3;4;7;427
3306107;Valença;3550308;São Paulo;3;4;7;335
3531209;Monte Alegre do Sul;3550308;São Paulo;3;4;7;108
3532405;Nazaré Paulista;3550308;São Paulo;3;4;7;58
3541505;Presidente Venceslau;3550308;São Paulo;3;4;7;567
3541703;Quatá;3550308;São Paulo;3;4;7;439
3542800;Ribeira;3550308;São Paulo;3;4;7;266
3541059;Pratânia;3550100;São Manuel;3;4;7;13
2408102;Natal;3549904;São José dos Campos;3;4;7;2188
3529401;Mauá;3549904;São José dos Campos;3;4;7;79
1100205;Porto Velho;3549805;São José do Rio Preto;3;4;7;1979
1501402;Belém;3549805;São José do Rio Preto;3;4;7;2153
3535002;Palestina;3549805;São José do Rio Preto;3;4;7;50
3170206;Uberlândia;3549409;São Joaquim da Barra;3;4;7;192
3503307;Araras;3549102;São João da Boa Vista;3;4;7;73
3505708;Barueri;3549102;São João da Boa Vista;3;4;7;172
1721000;Palmas;3548807;São Caetano do Sul;3;4;7;1477
3105608;Barbacena;3548807;São Caetano do Sul;3;4;7;387
3167202;Sete Lagoas;3548807;São Caetano do Sul;3;4;7;518
3300308;Barra do Piraí;3548807;São Caetano do Sul;3;4;7;306
3302007;Itaguaí;3548807;São Caetano do Sul;3;4;7;294
3303401;Nova Friburgo;3548807;São Caetano do Sul;3;4;7;431
3304144;Queimados;3548807;São Caetano do Sul;3;4;7;319
3503208;Araraquara;3548807;São Caetano do Sul;3;4;7;259
3507506;Botucatu;3548807;São Caetano do Sul;3;4;7;207
3516408;Franco da Rocha;3548807;São Caetano do Sul;3;4;7;36
3518404;Guaratinguetá;3548807;São Caetano do Sul;3;4;7;167
3524402;Jacareí;3548807;São Caetano do Sul;3;4;7;71
3542602;Registro;3548807;São Caetano do Sul;3;4;7;168
3503901;Arujá;3548708;São Bernardo do Campo;3;4;7;45
3537602;Peruíbe;3548708;São Bernardo do Campo;3;4;7;77
3539806;Poá;3548708;São Bernardo do Campo;3;4;7;33
3509502;Campinas;3547502;Santa Rita do Passa Quatro;3;4;7;139
3503307;Araras;3545803;Santa Bárbara d'Oeste;3;4;7;44
2611606;Recife;3545209;Salto;3;4;7;2064
3118601;Contagem;3545209;Salto;3;4;7;487
3170107;Uberaba;3543907;Rio Claro;3;4;7;297
3523602;Itirapina;3543907;Rio Claro;3;4;7;32
3104106;Arceburgo;3543402;Ribeirão Preto;3;4;7;92
3534401;Osasco;3542602;Registro;3;4;7;155
3526803;Lençóis Paulista;3541703;Quatá;3;4;7;198
3534401;Osasco;3539806;Poá;3;4;7;45
3502101;Andradina;3537404;Pereira Barreto;3;4;7;49
3510005;Cândido Mota;3535309;Palmital;3;4;7;18
3505708;Barueri;3534708;Ourinhos;3;4;7;316
2307650;Maracanaú;3534401;Osasco;3;4;7;2317
3503307;Araras;3534401;Osasco;3;4;7;143
3508405;Cabreúva;3534401;Osasco;3;4;7;43
3509700;Campos do Jordão;3534401;Osasco;3;4;7;153
3522307;Itapetininga;3534401;Osasco;3;4;7;129
3525300;Jaú;3534401;Osasco;3;4;7;228
3517901;Guaraci;3533908;Olímpia;3;4;7;28
3529302;Matão;3533908;Olímpia;3;4;7;108
3506102;Bebedouro;3533502;Novo Horizonte;3;4;7;92
3525706;José Bonifácio;3532702;Nipoã;3;4;7;18
3304557;Rio de Janeiro;3532009;Morungaba;3;4;7;362
3511102;Catanduva;3531308;Monte Alto;3;4;7;54
3501905;Amparo;3530805;Moji-Mirim;3;4;7;37
3152501;Pouso Alegre;3530706;Mogi Guaçu;3;4;7;104
3527603;Luís Antônio;3530706;Mogi Guaçu;3;4;7;115
3151800;Poços de Caldas;3530508;Mococa;3;4;7;61
3502101;Andradina;3530102;Mirandópolis;3;4;7;39
3516853;Gavião Peixoto;3529302;Matão;3;4;7;28
3511102;Catanduva;3529005;Marília;3;4;7;155
3505708;Barueri;3527306;Louveira;3;4;7;49
3504503;Avaré;3525300;Jaú;3;4;7;98
3509502;Campinas;3525201;Jarinu;3;4;7;40
3302403;Macaé;3525003;Jandira;3;4;7;525
3506102;Bebedouro;3524808;Jales;3;4;7;223
3509502;Campinas;3524808;Jales;3;4;7;469
3505609;Barrinha;3524303;Jaboticabal;3;4;7;16
3513009;Cotia;3524006;Itupeva;3;4;7;52
2927408;Salvador;3523909;Itu;3;4;7;1437
3522505;Itapevi;3523909;Itu;3;4;7;46
3503703;Ariranha;3522604;Itapira;3;4;7;244
3304557;Rio de Janeiro;3522208;Itapecerica da Serra;3;4;7;376
3170206;Uberlândia;3521309;Ipuã;3;4;7;172
3121258;Delta;3520103;Igarapava;3;4;7;13
1702109;Araguaína;3518800;Guarulhos;3;4;7;1804
3513504;Cubatão;3518800;Guarulhos;3;4;7;53
3503208;Araraquara;3516200;Franca;3;4;7;159
3509502;Campinas;3513702;Descalvado;3;4;7;125
3300407;Barra Mansa;3513405;Cruzeiro;3;4;7;79
3304201;Resende;3513405;Cruzeiro;3;4;7;53
3301702;Duque de Caxias;3513009;Cotia;3;4;7;378
3304557;Rio de Janeiro;3511409;Cerqueira César;3;4;7;605
3506003;Bauru;3511102;Catanduva;3;4;7;133
3136702;Juiz de Fora;3509502;Campinas;3;4;7;401
3138203;Lavras;3509502;Campinas;3;4;7;279
3505906;Batatais;3509502;Campinas;3;4;7;230
3170206;Uberlândia;3506102;Bebedouro;3;4;7;227
3127701;Governador Valadares;3505708;Barueri;3;4;7;716
3300407;Barra Mansa;3505708;Barueri;3;4;7;293
3170701;Varginha;3504107;Atibaia;3;4;7;213
3304557;Rio de Janeiro;3502507;Aparecida;3;4;7;202
3306008;Três Rios;3306206;Vassouras;3;4;7;57
3303401;Nova Friburgo;3306008;Três Rios;3;4;7;72
3304524;Rio das Ostras;3305109;São João de Meriti;3;4;7;150
3303906;Petrópolis;3304904;São Gonçalo;3;4;7;32
2803609;Laranjeiras;3304557;Rio de Janeiro;3;4;7;1466
3146107;Ouro Preto;3304557;Rio de Janeiro;3;4;7;279
3148103;Patrocínio;3304557;Rio de Janeiro;3;4;7;575
3136702;Juiz de Fora;3304201;Resende;3;4;7;142
3303500;Nova Iguaçu;3304201;Resende;3;4;7;105
2304400;Fortaleza;3303906;Petrópolis;3;4;7;2126
3301108;Cantagalo;3303401;Nova Friburgo;3;4;7;44
3205200;Vila Velha;3303302;Niterói;3;4;7;395
2304400;Fortaleza;3302403;Macaé;3;4;7;2083
3201308;Cariacica;3302403;Macaé;3;4;7;276
2927408;Salvador;3301702;Duque de Caxias;3;4;7;1185
3202306;Guaçuí;3205309;Vitória;3;4;7;155
3202702;Itaguaçu;3205309;Vitória;3;4;7;77
3203056;Jaguaré;3205309;Vitória;3;4;7;151
3203320;Marataízes;3205309;Vitória;3;4;7;107
3203502;Montanha;3205309;Vitória;3;4;7;238
3203700;Muniz Freire;3205309;Vitória;3;4;7;118
3202603;Iconha;3205101;Viana;3;4;7;50
1302603;Manaus;3205002;Serra;3;4;7;2741
3201308;Cariacica;3204906;São Mateus;3;4;7;177
3201605;Conceição da Barra;3204906;São Mateus;3;4;7;22
3200136;Águia Branca;3204708;São Gabriel da Palha;3;4;7;18
3200102;Afonso Cláudio;3204559;Santa Maria de Jetibá;3;4;7;40
2931350;Teixeira de Freitas;3204104;Pinheiros;3;4;7;110
3203502;Montanha;3204104;Pinheiros;3;4;7;37
3204054;Pedro Canário;3204104;Pinheiros;3;4;7;43
3122306;Divinópolis;3170206;Uberlândia;3;4;7;384
3152808;Prata;3170107;Uberaba;3;4;7;121
3118601;Contagem;3169901;Ubá;3;4;7;173
3112653;Capitão Andrade;3169505;Tumiritinga;3;4;7;24
3135803;Jequitinhonha;3168606;Teófilo Otoni;3;4;7;162
3119104;Corinto;3167202;Sete Lagoas;3;4;7;120
3104304;Areado;3166907;Serrania;3;4;7;24
3138708;Luminárias;3165206;São Thomé das Letras;3;4;7;25
3128709;Guaxupé;3164704;São Sebastião do Paraíso;3;4;7;50
3132909;Itamogi;3164704;São Sebastião do Paraíso;3;4;7;18
3138203;Lavras;3159902;Santo Antônio do Amparo;3;4;7;33
3110509;Camanducaia;3159605;Santa Rita do Sapucaí;3;4;7;72
3139409;Manhuaçu;3157906;Santa Margarida;3;4;7;25
3152105;Ponte Nova;3154002;Raul Soares;3;4;7;60
3118601;Contagem;3151404;Pitangui;3;4;7;88
3127800;Grão Mogol;3151206;Pirapora;3;4;7;231
3136702;Juiz de Fora;3149507;Pequeri;3;4;7;24
3103504;Araguari;3148103;Patrocínio;3;4;7;134
3146909;Papagaios;3147402;Paraopeba;3;4;7;42
3100203;Abaeté;3147105;Pará de Minas;3;4;7;117
3140704;Mateus Leme;3147105;Pará de Minas;3;4;7;25
3143302;Montes Claros;3147006;Paracatu;3;4;7;329
3106200;Belo Horizonte;3144300;Nanuque;3;4;7;446
3116159;Chapada Gaúcha;3143302;Montes Claros;3;4;7;243
3122306;Divinópolis;3143302;Montes Claros;3;4;7;395
3106200;Belo Horizonte;3143104;Monte Carmelo;3;4;7;395
3101607;Alfenas;3143005;Monte Belo;3;4;7;43
3106200;Belo Horizonte;3142700;Montalvânia;3;4;7;603
3106200;Belo Horizonte;3141801;Minas Novas;3;4;7;332
3133303;Itaobim;3141405;Medina;3;4;7;38
3106200;Belo Horizonte;3141207;Matutina;3;4;7;223
3135050;Jaíba;3140852;Matias Cardoso;3;4;7;53
3116001;Chalé;3139409;Manhuaçu;3;4;7;45
3123601;Elói Mendes;3139003;Machado;3;4;7;37
3118601;Contagem;3138807;Luz;3;4;7;169
2606002;Garanhuns;2800308;Aracaju;2;5;7;233
2403400;Equador;2408904;Parelhas;2;5;7;29
2305506;Iguatu;2307650;Maracanaú;2;5;7;286
2101400;Balsas;2201150;Baixa Grande do Ribeiro;2;5;7;101
1302603;Manaus;1702109;Araguaína;2;5;7;1377
1200385;Plácido de Castro;1200401;Rio Branco;2;5;7;80
2305001;Guaraciaba do Norte;5300108;Brasília;2;5;7;1492
3534302;Orlândia;5217401;Pires do Rio;2;5;7;382
5208707;Goiânia;5217203;Piranhas;2;5;7;270
3534302;Orlândia;5210109;Ipameri;2;5;7;332
5105259;Lucas do Rio Verde;5107768;Santa Rita do Trivelato;2;5;7;107
1302603;Manaus;5107602;Rondonópolis;2;5;7;1575
3522406;Itapeva;5008305;Três Lagoas;2;5;7;465
3509205;Cajamar;5006200;Nova Andradina;2;5;7;687
3516200;Franca;5002704;Campo Grande;2;5;7;757
4318705;São Leopoldo;4321600;Tramandaí;2;5;7;99
4314779;Pontão;4320107;Sarandi;2;5;7;27
3505708;Barueri;4318705;São Leopoldo;2;5;7;800
4305108;Caxias do Sul;4318408;São Jerônimo;2;5;7;103
4317202;Santa Rosa;4318002;São Borja;2;5;7;174
4314100;Passo Fundo;4317400;Santiago;2;5;7;260
4113700;Londrina;4316907;Santa Maria;2;5;7;752
4209102;Joinville;4316808;Santa Cruz do Sul;2;5;7;511
4303905;Campo Bom;4316808;Santa Cruz do Sul;2;5;7;133
4312401;Montenegro;4316501;Salvador do Sul;2;5;7;25
2305233;Horizonte;4314902;Porto Alegre;2;5;7;3092
3301009;Campos dos Goytacazes;4314902;Porto Alegre;2;5;7;1297
4101507;Arapongas;4314902;Porto Alegre;2;5;7;736
3534401;Osasco;4314100;Passo Fundo;2;5;7;751
4306809;Encantado;4314100;Passo Fundo;2;5;7;118
4310603;Itaqui;4314100;Passo Fundo;2;5;7;419
4305603;Colorado;4312658;Não-Me-Toque;2;5;7;18
4305900;Coronel Bicaco;4310207;Ijuí;2;5;7;78
3550308;São Paulo;4308508;Frederico Westphalen;2;5;7;775
4307559;Estação;4308250;Floriano Peixoto;2;5;7;18
4301602;Bagé;4303103;Cachoeirinha;2;5;7;328
4200408;Água Doce;4219309;Videira;2;5;7;40
4200408;Água Doce;4209003;Joaçaba;2;5;7;17
4204608;Criciúma;4208906;Jaraguá do Sul;2;5;7;244
4204004;Catanduvas;4208203;Itajaí;2;5;7;292
4116950;Nova Esperança do Sudoeste;4204202;Chapecó;2;5;7;147
3534401;Osasco;4202008;Balneário Camboriú;2;5;7;425
4106902;Curitiba;4127007;Teixeira Soares;2;5;7;118
4104501;Capanema;4119004;Pérola d'Oeste;2;5;7;17
2507507;João Pessoa;4113700;Londrina;2;5;7;2395
4101101;Andirá;4113700;Londrina;2;5;7;98
3509502;Campinas;4109401;Guarapuava;2;5;7;518
4104303;Campo Mourão;4109401;Guarapuava;2;5;7;176
4103453;Cafelândia;4108205;Formosa do Oeste;2;5;7;36
3534401;Osasco;4101507;Arapongas;2;5;7;476
3545605;Santa Adélia;3556909;Vista Alegre do Alto;2;5;7;20
2704302;Maceió;3552809;Taboão da Serra;2;5;7;1886
3304557;Rio de Janeiro;3551009;São Vicente;2;5;7;344
3507159;Bom Sucesso de Itararé;3550308;São Paulo;2;5;7;265
3513009;Cotia;3548708;São Bernardo do Campo;2;5;7;36
3522109;Itanhaém;3548708;São Bernardo do Campo;2;5;7;56
3304557;Rio de Janeiro;3543303;Ribeirão Pires;2;5;7;334
3510153;Canitar;3534708;Ourinhos;2;5;7;12
2609600;Olinda;3534401;Osasco;2;5;7;2077
2919207;Lauro de Freitas;3534401;Osasco;2;5;7;1446
3300456;Belford Roxo;3534401;Osasco;2;5;7;356
3305109;São João de Meriti;3534401;Osasco;2;5;7;357
3511102;Catanduva;3534401;Osasco;2;5;7;345
3503208;Araraquara;3530706;Mogi Guaçu;2;5;7;139
3512100;Colômbia;3529302;Matão;2;5;7;157
3526902;Limeira;3529302;Matão;2;5;7;149
3525706;José Bonifácio;3528106;Macaubal;2;5;7;40
3506003;Bauru;3516200;Franca;2;5;7;266
3509502;Campinas;3514403;Dracena;2;5;7;492
3102605;Andradas;3509502;Campinas;2;5;7;105
3127107;Frutal;3503208;Araraquara;2;5;7;203
2611606;Recife;3303906;Petrópolis;2;5;7;1793
3302403;Macaé;3303203;Nilópolis;2;5;7;165
2910727;Eunápolis;3201308;Cariacica;2;5;7;439
3108552;Brasilândia de Minas;3170206;Uberlândia;2;5;7;316
3168606;Teófilo Otoni;3168705;Timóteo;2;5;7;225
3106655;Berizal;3135209;Januária;1;6;7;283
2111300;São Luís;2933307;Vitória da Conquista;1;6;7;1410
2211001;Teresina;2933307;Vitória da Conquista;1;6;7;1100
2112605;Urbano Santos;2927408;Salvador;1;6;7;1203
2910503;Entre Rios;2925204;Pojuca;1;6;7;63
2804805;Nossa Senhora do Socorro;2900702;Alagoinhas;1;6;7;199
2306306;Itapagé;2604106;Caruaru;1;6;7;643
4208203;Itajaí;5211909;Jataí;1;6;7;1051
4205902;Gaspar;5107925;Sorriso;1;6;7;1768
4208203;Itajaí;5106224;Nova Mutum;1;6;7;1667
5102504;Cáceres;5104906;Jangada;1;6;7;155
4306809;Encantado;4315602;Rio Grande;1;6;7;317
4207502;Indaial;4304606;Canoas;1;6;7;382
3532207;Narandiba;4123600;Santa Inês;1;6;7;47
3550308;São Paulo;4106308;Corbélia;1;6;7;681
2927408;Salvador;3550209;São Miguel Arcanjo;1;6;7;1527
3533007;Nova Granada;3545605;Santa Adélia;1;6;7;95
3540309;Pontes Gestal;3545605;Santa Adélia;1;6;7;153
2704302;Maceió;3516200;Franca;1;6;7;1689
3146008;Ouro Fino;3503703;Ariranha;1;6;7;280
3159902;Santo Antônio do Amparo;3304557;Rio de Janeiro;1;6;7;273
3169356;Três Marias;3304557;Rio de Janeiro;1;6;7;556
3133758;Itaú de Minas;3170404;Unaí;1;6;7;481
3143302;Montes Claros;3157609;Santa Fé de Minas;1;6;7;164
3100203;Abaeté;3151404;Pitangui;1;6;7;83
3143104;Monte Carmelo;3143302;Montes Claros;1;6;7;448
1100015;Alta Floresta d'Oeste;5300108;Brasília;3;3;6;1556
1100130;Machadinho d'Oeste;5300108;Brasília;3;3;6;1650
1100148;Nova Brasilândia d'Oeste;5300108;Brasília;3;3;6;1595
1100254;Presidente Médici;5300108;Brasília;3;3;6;1567
1100452;Buritis;5300108;Brasília;3;3;6;1795
1200054;Assis Brasil;5300108;Brasília;3;3;6;2360
1200500;Sena Madureira;5300108;Brasília;3;3;6;2317
1301209;Coari;5300108;Brasília;3;3;6;2054
1302504;Manacapuru;5300108;Brasília;3;3;6;1923
1302702;Manicoré;5300108;Brasília;3;3;6;1785
1302900;Maués;5300108;Brasília;3;3;6;1713
1400209;Caracaraí;5300108;Brasília;3;3;6;2393
1400456;Pacaraima;5300108;Brasília;3;3;6;2630
1500107;Abaetetuba;5300108;Brasília;3;3;6;1559
1501709;Bragança;5300108;Brasília;3;3;6;1635
1501808;Breves;5300108;Brasília;3;3;6;1591
1502202;Capanema;5300108;Brasília;3;3;6;1609
1504703;Moju;5300108;Brasília;3;3;6;1537
1506203;Salinópolis;5300108;Brasília;3;3;6;1675
1506609;Santa Maria do Pará;5300108;Brasília;3;3;6;1599
1507300;São Félix do Xingu;5300108;Brasília;3;3;6;1094
1508159;Uruará;5300108;Brasília;3;3;6;1472
1508357;Vitória do Xingu;5300108;Brasília;3;3;6;1493
1508407;Xinguara;5300108;Brasília;3;3;6;987
1600105;Amapá;5300108;Brasília;3;3;6;1998
1702208;Araguatins;5300108;Brasília;3;3;6;1124
1716109;Paraíso do Tocantins;5300108;Brasília;3;3;6;633
1716208;Paranã;5300108;Brasília;3;3;6;352
1721208;Tocantinópolis;5300108;Brasília;3;3;6;1050
2101608;Barra do Corda;5300108;Brasília;3;3;6;1173
2102804;Carolina;5300108;Brasília;3;3;6;936
2103208;Chapadinha;5300108;Brasília;3;3;6;1419
2103307;Codó;5300108;Brasília;3;3;6;1321
2103406;Coelho Neto;5300108;Brasília;3;3;6;1377
2106755;Miranda do Norte;5300108;Brasília;3;3;6;1398
2108207;Pedreiras;5300108;Brasília;3;3;6;1294
2108454;Peritoró;5300108;Brasília;3;3;6;1319
2108603;Pinheiro;5300108;Brasília;3;3;6;1500
2109908;Santa Inês;5300108;Brasília;3;3;6;1350
2110609;São Bernardo;5300108;Brasília;3;3;6;1493
2111102;São João dos Patos;5300108;Brasília;3;3;6;1124
2111201;São José de Ribamar;5300108;Brasília;3;3;6;1524
2112803;Viana;5300108;Brasília;3;3;6;1429
2114007;Zé Doca;5300108;Brasília;3;3;6;1407
2201200;Barras;5300108;Brasília;3;3;6;1409
2201903;Bom Jesus;5300108;Brasília;3;3;6;835
2202208;Campo Maior;5300108;Brasília;3;3;6;1354
2202901;Corrente;5300108;Brasília;3;3;6;662
2207009;Oeiras;5300108;Brasília;3;3;6;1150
2207801;Paulistana;5300108;Brasília;3;3;6;1106
2208403;Piripiri;5300108;Brasília;3;3;6;1429
2210607;São Raimundo Nonato;5300108;Brasília;3;3;6;934
2211209;Uruçuí;5300108;Brasília;3;3;6;1014
2300200;Acaraú;5300108;Brasília;3;3;6;1647
2302107;Baturité;5300108;Brasília;3;3;6;1585
2302503;Brejo Santo;5300108;Brasília;3;3;6;1316
2302602;Camocim;5300108;Brasília;3;3;6;1604
2302800;Canindé;5300108;Brasília;3;3;6;1557
2303501;Cascavel;5300108;Brasília;3;3;6;1644
2305803;Ipu;5300108;Brasília;3;3;6;1481
2306306;Itapagé;5300108;Brasília;3;3;6;1601
2306405;Itapipoca;5300108;Brasília;3;3;6;1618
2307700;Maranguape;5300108;Brasília;3;3;6;1636
2307809;Marco;5300108;Brasília;3;3;6;1623
2308708;Morada Nova;5300108;Brasília;3;3;6;1550
2309607;Pacajus;5300108;Brasília;3;3;6;1626
2311306;Quixadá;5300108;Brasília;3;3;6;1520
2311405;Quixeramobim;5300108;Brasília;3;3;6;1484
2313302;Tauá;5300108;Brasília;3;3;6;1347
2313401;Tianguá;5300108;Brasília;3;3;6;1521
2401008;Apodi;5300108;Brasília;3;3;6;1533
2401107;Areia Branca;5300108;Brasília;3;3;6;1651
2402600;Ceará-Mirim;5300108;Brasília;3;3;6;1730
2404200;Goianinha;5300108;Brasília;3;3;6;1702
2405801;João Câmara;5300108;Brasília;3;3;6;1706
2407104;Macaíba;5300108;Brasília;3;3;6;1720
2407203;Macau;5300108;Brasília;3;3;6;1676
2408300;Nova Cruz;5300108;Brasília;3;3;6;1672
2409407;Pau dos Ferros;5300108;Brasília;3;3;6;1480
2411205;Santa Cruz;5300108;Brasília;3;3;6;1640
2412005;São Gonçalo do Amarante;5300108;Brasília;3;3;6;1727
2501104;Areia;5300108;Brasília;3;3;6;1618
2501500;Bananeiras;5300108;Brasília;3;3;6;1637
2503704;Cajazeiras;5300108;Brasília;3;3;6;1393
2504306;Catolé do Rocha;5300108;Brasília;3;3;6;1498
2506004;Esperança;5300108;Brasília;3;3;6;1602
2506301;Guarabira;5300108;Brasília;3;3;6;1642
2506905;Itabaiana;5300108;Brasília;3;3;6;1625
2507002;Itaporanga;5300108;Brasília;3;3;6;1395
2508901;Mamanguape;5300108;Brasília;3;3;6;1671
2512101;Pombal;5300108;Brasília;3;3;6;1461
2513703;Santa Rita;5300108;Brasília;3;3;6;1666
2515302;Sapé;5300108;Brasília;3;3;6;1649
2516201;Sousa;5300108;Brasília;3;3;6;1425
2517001;Umbuzeiro;5300108;Brasília;3;3;6;1574
2601102;Araripina;5300108;Brasília;3;3;6;1204
2601409;Barreiros;5300108;Brasília;3;3;6;1550
2601706;Belo Jardim;5300108;Brasília;3;3;6;1467
2601904;Bezerros;5300108;Brasília;3;3;6;1530
2602100;Bom Conselho;5300108;Brasília;3;3;6;1394
2603009;Cabrobó;5300108;Brasília;3;3;6;1222
2604007;Carpina;5300108;Brasília;3;3;6;1602
2604205;Catende;5300108;Brasília;3;3;6;1512
2605103;Custódia;5300108;Brasília;3;3;6;1380
2605202;Escada;5300108;Brasília;3;3;6;1574
2606408;Gravatá;5300108;Brasília;3;3;6;1552
2606804;Igarassu;5300108;Brasília;3;3;6;1628
2608800;Lajedo;5300108;Brasília;3;3;6;1458
2608909;Limoeiro;5300108;Brasília;3;3;6;1582
2609501;Nazaré da Mata;5300108;Brasília;3;3;6;1609
2609907;Ouricuri;5300108;Brasília;3;3;6;1203
2610004;Palmares;5300108;Brasília;3;3;6;1522
2610905;Pesqueira;5300108;Brasília;3;3;6;1441
2612505;Santa Cruz do Capibaribe;5300108;Brasília;3;3;6;1511
2613602;São José do Egito;5300108;Brasília;3;3;6;1451
2613701;São Lourenço da Mata;5300108;Brasília;3;3;6;1610
2613909;Serra Talhada;5300108;Brasília;3;3;6;1336
2614105;Sertânia;5300108;Brasília;3;3;6;1412
2614501;Surubim;5300108;Brasília;3;3;6;1559
2615409;Toritama;5300108;Brasília;3;3;6;1522
2700409;Atalaia;5300108;Brasília;3;3;6;1439
2702355;Craíbas;5300108;Brasília;3;3;6;1364
2702405;Delmiro Gouveia;5300108;Brasília;3;3;6;1269
2704500;Maragogi;5300108;Brasília;3;3;6;1539
2705507;Murici;5300108;Brasília;3;3;6;1457
2706901;Pilar;5300108;Brasília;3;3;6;1440
2707305;Porto Calvo;5300108;Brasília;3;3;6;1521
2708006;Santana do Ipanema;5300108;Brasília;3;3;6;1336
2708600;São Miguel dos Campos;5300108;Brasília;3;3;6;1418
2709152;Teotônio Vilela;5300108;Brasília;3;3;6;1388
2709301;União dos Palmares;5300108;Brasília;3;3;6;1449
2709400;Viçosa;5300108;Brasília;3;3;6;1426
2802304;Frei Paulo;5300108;Brasília;3;3;6;1245
2803005;Itabaianinha;5300108;Brasília;3;3;6;1187
2803500;Lagarto;5300108;Brasília;3;3;6;1211
2804409;Neópolis;5300108;Brasília;3;3;6;1341
2807105;Simão Dias;5300108;Brasília;3;3;6;1213
2807402;Tobias Barreto;5300108;Brasília;3;3;6;1170
2807600;Umbaúba;5300108;Brasília;3;3;6;1194
2900801;Alcobaça;5300108;Brasília;3;3;6;954
2901007;Amargosa;5300108;Brasília;3;3;6;938
2904506;Brotas de Macaúbas;5300108;Brasília;3;3;6;703
2904605;Brumado;5300108;Brasília;3;3;6;692
2904902;Cachoeira;5300108;Brasília;3;3;6;1019
2905206;Caetité;5300108;Brasília;3;3;6;609
2905602;Camacan;5300108;Brasília;3;3;6;900
2905800;Camamu;5300108;Brasília;3;3;6;959
2906501;Candeias;5300108;Brasília;3;3;6;1056
2906907;Caravelas;5300108;Brasília;3;3;6;956
2907301;Castro Alves;5300108;Brasília;3;3;6;965
2907509;Catu;5300108;Brasília;3;3;6;1087
2908408;Conceição do Coité;5300108;Brasília;3;3;6;1039
2910057;Dias d'Ávila;5300108;Brasília;3;3;6;1083
2910107;Dom Basílio;5300108;Brasília;3;3;6;694
2910503;Entre Rios;5300108;Brasília;3;3;6;1128
2910602;Esplanada;5300108;Brasília;3;3;6;1143
2910701;Euclides da Cunha;5300108;Brasília;3;3;6;1110
2911204;Gandu;5300108;Brasília;3;3;6;928
2912103;Ibicaraí;5300108;Brasília;3;3;6;901
2913200;Ibotirama;5300108;Brasília;3;3;6;642
2914000;Ipirá;5300108;Brasília;3;3;6;955
2915601;Itamaraju;5300108;Brasília;3;3;6;913
2916401;Itapetinga;5300108;Brasília;3;3;6;823
2917607;Jaguaquara;5300108;Brasília;3;3;6;886
2919504;Livramento de Nossa Senhora;5300108;Brasília;3;3;6;692
2919801;Macaúbas;5300108;Brasília;3;3;6;633
2922508;Nazaré;5300108;Brasília;3;3;6;995
2925204;Pojuca;5300108;Brasília;3;3;6;1087
2926004;Remanso;5300108;Brasília;3;3;6;925
2928208;Santana;5300108;Brasília;3;3;6;517
2928604;Santo Amaro;5300108;Brasília;3;3;6;1044
2928802;Santo Estêvão;5300108;Brasília;3;3;6;995
2929057;São Félix do Coribe;5300108;Brasília;3;3;6;478
2929305;São Gonçalo dos Campos;5300108;Brasília;3;3;6;1023
2930105;Senhor do Bonfim;5300108;Brasília;3;3;6;1011
2930303;Serra Dourada;5300108;Brasília;3;3;6;536
2930501;Serrinha;5300108;Brasília;3;3;6;1052
2932200;Ubaitaba;5300108;Brasília;3;3;6;932
2932903;Valença;5300108;Brasília;3;3;6;977
2933208;Vera Cruz;5300108;Brasília;3;3;6;1036
2933604;Xique-Xique;5300108;Brasília;3;3;6;782
3100906;Águas Formosas;5300108;Brasília;3;3;6;760
3101102;Aimorés;5300108;Brasília;3;3;6;845
3101508;Além Paraíba;5300108;Brasília;3;3;6;874
3101706;Almenara;5300108;Brasília;3;3;6;774
3102605;Andradas;5300108;Brasília;3;3;6;708
3103405;Araçuaí;5300108;Brasília;3;3;6;644
3104205;Arcos;5300108;Brasília;3;3;6;559
3105400;Barão de Cocais;5300108;Brasília;3;3;6;661
3106903;Bicas;5300108;Brasília;3;3;6;839
3107109;Boa Esperança;5300108;Brasília;3;3;6;638
3107307;Bocaiúva;5300108;Brasília;3;3;6;464
3107406;Bom Despacho;5300108;Brasília;3;3;6;521
3108008;Bom Sucesso;5300108;Brasília;3;3;6;673
3108305;Borda da Mata;5300108;Brasília;3;3;6;741
3108552;Brasilândia de Minas;5300108;Brasília;3;3;6;245
3109006;Brumadinho;5300108;Brasília;3;3;6;627
3109303;Buritis;5300108;Brasília;3;3;6;162
3110004;Caeté;5300108;Brasília;3;3;6;644
3110301;Caldas;5300108;Brasília;3;3;6;697
3110608;Cambuí;5300108;Brasília;3;3;6;780
3110905;Campanha;5300108;Brasília;3;3;6;721
3111002;Campestre;5300108;Brasília;3;3;6;678
3111101;Campina Verde;5300108;Brasília;3;3;6;444
3111200;Campo Belo;5300108;Brasília;3;3;6;632
3111507;Campos Altos;5300108;Brasília;3;3;6;470
3111606;Campos Gerais;5300108;Brasília;3;3;6;645
3112307;Capelinha;5300108;Brasília;3;3;6;617
3112604;Capinópolis;5300108;Brasília;3;3;6;365
3113206;Carandaí;5300108;Brasília;3;3;6;720
3113305;Carangola;5300108;Brasília;3;3;6;841
3113701;Carlos Chagas;5300108;Brasília;3;3;6;798
3114303;Carmo do Paranaíba;5300108;Brasília;3;3;6;392
3115102;Cássia;5300108;Brasília;3;3;6;538
3115508;Caxambu;5300108;Brasília;3;3;6;751
3116605;Cláudio;5300108;Brasília;3;3;6;617
3117306;Conceição das Alagoas;5300108;Brasília;3;3;6;457
3117504;Conceição do Mato Dentro;5300108;Brasília;3;3;6;604
3118403;Conselheiro Pena;5300108;Brasília;3;3;6;789
3119104;Corinto;5300108;Brasília;3;3;6;470
3119609;Coronel Pacheco;5300108;Brasília;3;3;6;816
3120508;Cristina;5300108;Brasília;3;3;6;766
3121605;Diamantina;5300108;Brasília;3;3;6;535
3123205;Dores do Indaiá;5300108;Brasília;3;3;6;476
3123601;Elói Mendes;5300108;Brasília;3;3;6;692
3124104;Esmeraldas;5300108;Brasília;3;3;6;587
3124203;Espera Feliz;5300108;Brasília;3;3;6;845
3127107;Frutal;5300108;Brasília;3;3;6;490
3128006;Guanhães;5300108;Brasília;3;3;6;629
3128303;Guaranésia;5300108;Brasília;3;3;6;620
3128709;Guaxupé;5300108;Brasília;3;3;6;622
3129509;Ibiá;5300108;Brasília;3;3;6;429
3129806;Ibirité;5300108;Brasília;3;3;6;627
3130903;Inhapim;5300108;Brasília;3;3;6;753
3131604;Iraí de Minas;5300108;Brasília;3;3;6;355
3131901;Itabirito;5300108;Brasília;3;3;6;665
3133006;Itamonte;5300108;Brasília;3;3;6;790
3133501;Itapecerica;5300108;Brasília;3;3;6;599
3133758;Itaú de Minas;5300108;Brasília;3;3;6;560
3134905;Jacutinga;5300108;Brasília;3;3;6;731
3135209;Januária;5300108;Brasília;3;3;6;381
3136652;Juatuba;5300108;Brasília;3;3;6;601
3137205;Lagoa da Prata;5300108;Brasília;3;3;6;533
3137809;Lambari;5300108;Brasília;3;3;6;734
3138401;Leopoldina;5300108;Brasília;3;3;6;853
3138807;Luz;5300108;Brasília;3;3;6;503
3139003;Machado;5300108;Brasília;3;3;6;685
3139508;Manhumirim;5300108;Brasília;3;3;6;820
3139607;Mantena;5300108;Brasília;3;3;6;813
3139904;Maria da Fé;5300108;Brasília;3;3;6;771
3140704;Mateus Leme;5300108;Brasília;3;3;6;598
3141108;Matozinhos;5300108;Brasília;3;3;6;587
3141405;Medina;5300108;Brasília;3;3;6;689
3142601;Monsenhor Paulo;5300108;Brasília;3;3;6;708
3142809;Monte Alegre de Minas;5300108;Brasília;3;3;6;354
3143203;Monte Santo de Minas;5300108;Brasília;3;3;6;602
3143401;Monte Sião;5300108;Brasília;3;3;6;748
3143500;Morada Nova de Minas;5300108;Brasília;3;3;6;409
3144102;Muzambinho;5300108;Brasília;3;3;6;635
3144300;Nanuque;5300108;Brasília;3;3;6;845
3144607;Nepomuceno;5300108;Brasília;3;3;6;668
3144706;Nova Era;5300108;Brasília;3;3;6;686
3145604;Oliveira;5300108;Brasília;3;3;6;635
3146008;Ouro Fino;5300108;Brasília;3;3;6;736
3147303;Paraisópolis;5300108;Brasília;3;3;6;782
3147402;Paraopeba;5300108;Brasília;3;3;6;540
3149903;Perdões;5300108;Brasília;3;3;6;659
3151206;Pirapora;5300108;Brasília;3;3;6;365
3151404;Pitangui;5300108;Brasília;3;3;6;538
3151503;Piumhi;5300108;Brasília;3;3;6;558
3152006;Pompéu;5300108;Brasília;3;3;6;497
3152808;Prata;5300108;Brasília;3;3;6;405
3154002;Raul Soares;5300108;Brasília;3;3;6;760
3154903;Rio Casca;5300108;Brasília;3;3;6;751
3155801;Rio Pomba;5300108;Brasília;3;3;6;795
3156908;Sacramento;5300108;Brasília;3;3;6;451
3157005;Salinas;5300108;Brasília;3;3;6;606
3157203;Santa Bárbara;5300108;Brasília;3;3;6;671
3158003;Santa Maria de Itabira;5300108;Brasília;3;3;6;658
3159605;Santa Rita do Sapucaí;5300108;Brasília;3;3;6;753
3159803;Santa Vitória;5300108;Brasília;3;3;6;412
3160405;Santo Antônio do Monte;5300108;Brasília;3;3;6;553
3160702;Santos Dumont;5300108;Brasília;3;3;6;788
3161106;São Francisco;5300108;Brasília;3;3;6;332
3162005;São Gonçalo do Sapucaí;5300108;Brasília;3;3;6;720
3162104;São Gotardo;5300108;Brasília;3;3;6;436
3162906;São João Nepomuceno;5300108;Brasília;3;3;6;830
3162922;São Joaquim de Bicas;5300108;Brasília;3;3;6;614
3163706;São Lourenço;5300108;Brasília;3;3;6;767
3168002;Taiobeiras;5300108;Brasília;3;3;6;609
3169307;Três Corações;5300108;Brasília;3;3;6;712
3169356;Três Marias;5300108;Brasília;3;3;6;391
3169406;Três Pontas;5300108;Brasília;3;3;6;669
3169604;Tupaciguara;5300108;Brasília;3;3;6;319
3170800;Várzea da Palma;5300108;Brasília;3;3;6;393
3172004;Visconde do Rio Branco;5300108;Brasília;3;3;6;798
3200102;Afonso Cláudio;5300108;Brasília;3;3;6;875
3200201;Alegre;5300108;Brasília;3;3;6;883
3200409;Anchieta;5300108;Brasília;3;3;6;957
3200805;Baixo Guandu;5300108;Brasília;3;3;6;855
3200904;Barra de São Francisco;5300108;Brasília;3;3;6;824
3201407;Castelo;5300108;Brasília;3;3;6;897
3201605;Conceição da Barra;5300108;Brasília;3;3;6;928
3201902;Domingos Martins;5300108;Brasília;3;3;6;935
3202306;Guaçuí;5300108;Brasília;3;3;6;873
3202603;Iconha;5300108;Brasília;3;3;6;949
3202702;Itaguaçu;5300108;Brasília;3;3;6;883
3203007;Iúna;5300108;Brasília;3;3;6;858
3203130;João Neiva;5300108;Brasília;3;3;6;924
3203346;Marechal Floriano;5300108;Brasília;3;3;6;936
3203502;Montanha;5300108;Brasília;3;3;6;854
3203700;Muniz Freire;5300108;Brasília;3;3;6;874
3203809;Muqui;5300108;Brasília;3;3;6;914
3203908;Nova Venécia;5300108;Brasília;3;3;6;874
3204104;Pinheiros;5300108;Brasília;3;3;6;878
3204559;Santa Maria de Jetibá;5300108;Brasília;3;3;6;908
3204609;Santa Teresa;5300108;Brasília;3;3;6;916
3204708;São Gabriel da Palha;5300108;Brasília;3;3;6;869
3204807;São José do Calçado;5300108;Brasília;3;3;6;893
3205069;Venda Nova do Imigrante;5300108;Brasília;3;3;6;891
3300506;Bom Jardim;5300108;Brasília;3;3;6;924
3300605;Bom Jesus do Itabapoana;5300108;Brasília;3;3;6;899
3302106;Itaocara;5300108;Brasília;3;3;6;909
3302254;Itatiaia;5300108;Brasília;3;3;6;823
3302809;Mendes;5300108;Brasília;3;3;6;871
3303005;Miracema;5300108;Brasília;3;3;6;877
3303104;Natividade;5300108;Brasília;3;3;6;868
3303609;Paracambi;5300108;Brasília;3;3;6;880
3303807;Parati;5300108;Brasília;3;3;6;892
3304102;Porciúncula;5300108;Brasília;3;3;6;857
3304706;Santo Antônio de Pádua;5300108;Brasília;3;3;6;891
3304755;São Francisco de Itabapoana;5300108;Brasília;3;3;6;963
3305000;São João da Barra;5300108;Brasília;3;3;6;987
3500600;Águas de São Pedro;5300108;Brasília;3;3;6;751
3506359;Bertioga;5300108;Brasília;3;3;6;908
3506607;Biritiba-Mirim;5300108;Brasília;3;3;6;884
3509254;Cajati;5300108;Brasília;3;3;6;986
3511003;Castilho;5300108;Brasília;3;3;6;681
3512001;Colina;5300108;Brasília;3;3;6;547
3515400;Fartura;5300108;Brasília;3;3;6;857
3519055;Holambra;5300108;Brasília;3;3;6;761
3523206;Itararé;5300108;Brasília;3;3;6;931
3527306;Louveira;5300108;Brasília;3;3;6;811
3532009;Morungaba;5300108;Brasília;3;3;6;792
3538105;Pindorama;5300108;Brasília;3;3;6;605
3538501;Piquete;5300108;Brasília;3;3;6;811
3540903;Pradópolis;5300108;Brasília;3;3;6;614
3544905;Sales Oliveira;5300108;Brasília;3;3;6;549
3546207;Santa Cruz da Conceição;5300108;Brasília;3;3;6;701
3546801;Santa Isabel;5300108;Brasília;3;3;6;852
3554805;Tremembé;5300108;Brasília;3;3;6;833
4100509;Altônia;5300108;Brasília;3;3;6;1107
4101200;Antonina;5300108;Brasília;3;3;6;1063
4101606;Arapoti;5300108;Brasília;3;3;6;948
4101903;Assaí;5300108;Brasília;3;3;6;896
4102000;Assis Chateaubriand;5300108;Brasília;3;3;6;1136
4102109;Astorga;5300108;Brasília;3;3;6;918
4102406;Bandeirantes;5300108;Brasília;3;3;6;851
4103453;Cafelândia;5300108;Brasília;3;3;6;1141
4103602;Cambará;5300108;Brasília;3;3;6;835
4104501;Capanema;5300108;Brasília;3;3;6;1272
4104907;Castro;5300108;Brasília;3;3;6;1021
4105409;Chopinzinho;5300108;Brasília;3;3;6;1223
4105607;Cidade Gaúcha;5300108;Brasília;3;3;6;1002
4105904;Colorado;5300108;Brasília;3;3;6;895
4106308;Corbélia;5300108;Brasília;3;3;6;1156
4106605;Cruzeiro do Oeste;5300108;Brasília;3;3;6;1048
4107207;Dois Vizinhos;5300108;Brasília;3;3;6;1237
4108601;Goioerê;5300108;Brasília;3;3;6;1084
4108809;Guaíra;5300108;Brasília;3;3;6;1150
4109708;Ibaiti;5300108;Brasília;3;3;6;925
4109807;Ibiporã;5300108;Brasília;3;3;6;894
4110102;Imbituva;5300108;Brasília;3;3;6;1084
4110607;Iporã;5300108;Brasília;3;3;6;1107
4110706;Irati;5300108;Brasília;3;3;6;1111
4111209;Itapejara d'Oeste;5300108;Brasília;3;3;6;1247
4111506;Ivaiporã;5300108;Brasília;3;3;6;1023
4112009;Jaguariaíva;5300108;Brasília;3;3;6;957
4112108;Jandaia do Sul;5300108;Brasília;3;3;6;954
4113205;Lapa;5300108;Brasília;3;3;6;1120
4113304;Laranjeiras do Sul;5300108;Brasília;3;3;6;1179
4113502;Loanda;5300108;Brasília;3;3;6;973
4114005;Mamborê;5300108;Brasília;3;3;6;1069
4114203;Mandaguari;5300108;Brasília;3;3;6;953
4114609;Marechal Cândido Rondon;5300108;Brasília;3;3;6;1180
4114807;Marialva;5300108;Brasília;3;3;6;949
4115705;Matinhos;5300108;Brasília;3;3;6;1110
4115804;Medianeira;5300108;Brasília;3;3;6;1251
4116208;Morretes;5300108;Brasília;3;3;6;1075
4116901;Nova Esperança;5300108;Brasília;3;3;6;941
4117107;Nova Londrina;5300108;Brasília;3;3;6;948
4117503;Paiçandu;5300108;Brasília;3;3;6;960
4117602;Palmas;5300108;Brasília;3;3;6;1266
4117701;Palmeira;5300108;Brasília;3;3;6;1089
4117909;Palotina;5300108;Brasília;3;3;6;1141
4118006;Paraíso do Norte;5300108;Brasília;3;3;6;973
4119400;Piraí do Sul;5300108;Brasília;3;3;6;993
4119608;Pitanga;5300108;Brasília;3;3;6;1078
4120002;Porecatu;5300108;Brasília;3;3;6;857
4120606;Prudentópolis;5300108;Brasília;3;3;6;1097
4120804;Quatro Barras;5300108;Brasília;3;3;6;1066
4121406;Realeza;5300108;Brasília;3;3;6;1265
4121802;Ribeirão Claro;5300108;Brasília;3;3;6;842
4122206;Rio Branco do Sul;5300108;Brasília;3;3;6;1050
4122305;Rio Negro;5300108;Brasília;3;3;6;1159
4123501;Santa Helena;5300108;Brasília;3;3;6;1226
4125605;São Mateus do Sul;5300108;Brasília;3;3;6;1143
4125704;São Miguel do Iguaçu;5300108;Brasília;3;3;6;1265
4126603;Siqueira Campos;5300108;Brasília;3;3;6;897
4128005;Ubiratã;5300108;Brasília;3;3;6;1116
4200101;Abelardo Luz;5300108;Brasília;3;3;6;1287
4201208;Antônio Carlos;5300108;Brasília;3;3;6;1300
4202107;Barra Velha;5300108;Brasília;3;3;6;1201
4203907;Capinzal;5300108;Brasília;3;3;6;1341
4203956;Capivari de Baixo;5300108;Brasília;3;3;6;1404
4204509;Corupá;5300108;Brasília;3;3;6;1184
4206504;Guaramirim;5300108;Brasília;3;3;6;1187
4206702;Herval d'Oeste;5300108;Brasília;3;3;6;1321
4208450;Itapoá;5300108;Brasília;3;3;6;1144
4211207;Morro da Fumaça;5300108;Brasília;3;3;6;1429
4211751;Otacílio Costa;5300108;Brasília;3;3;6;1315
4212106;Palmitos;5300108;Brasília;3;3;6;1375
4212502;Penha;5300108;Brasília;3;3;6;1220
4215703;Santo Amaro da Imperatriz;5300108;Brasília;3;3;6;1319
4216701;São José do Cedro;5300108;Brasília;3;3;6;1332
4219705;Xaxim;5300108;Brasília;3;3;6;1337
4300109;Agudo;5300108;Brasília;3;3;6;1644
4300802;Antônio Prado;5300108;Brasília;3;3;6;1493
4301008;Arroio do Meio;5300108;Brasília;3;3;6;1571
4301404;Arvorezinha;5300108;Brasília;3;3;6;1522
4302709;Butiá;5300108;Brasília;3;3;6;1647
4302808;Caçapava do Sul;5300108;Brasília;3;3;6;1741
4303806;Campinas do Sul;5300108;Brasília;3;3;6;1418
4304200;Candelária;5300108;Brasília;3;3;6;1632
4304507;Canguçu;5300108;Brasília;3;3;6;1809
4304663;Capão do Leão;5300108;Brasília;3;3;6;1840
4304804;Carlos Barbosa;5300108;Brasília;3;3;6;1546
4304903;Casca;5300108;Brasília;3;3;6;1482
4305207;Cerro Largo;5300108;Brasília;3;3;6;1563
4305801;Constantina;5300108;Brasília;3;3;6;1436
4306007;Crissiumal;5300108;Brasília;3;3;6;1465
4306205;Cruzeiro do Sul;5300108;Brasília;3;3;6;1585
4306601;Dom Pedrito;5300108;Brasília;3;3;6;1842
4306767;Eldorado do Sul;5300108;Brasília;3;3;6;1634
4306809;Encantado;5300108;Brasília;3;3;6;1551
4306908;Encruzilhada do Sul;5300108;Brasília;3;3;6;1709
4307500;Espumoso;5300108;Brasília;3;3;6;1532
4307807;Estrela;5300108;Brasília;3;3;6;1582
4308003;Faxinal do Soturno;5300108;Brasília;3;3;6;1645
4308102;Feliz;5300108;Brasília;3;3;6;1557
4308201;Flores da Cunha;5300108;Brasília;3;3;6;1508
4308508;Frederico Westphalen;5300108;Brasília;3;3;6;1416
4308904;Getúlio Vargas;5300108;Brasília;3;3;6;1421
4309001;Giruá;5300108;Brasília;3;3;6;1530
4309407;Guaporé;5300108;Brasília;3;3;6;1510
4309605;Horizontina;5300108;Brasília;3;3;6;1488
4310009;Ibirubá;5300108;Brasília;3;3;6;1532
4310108;Igrejinha;5300108;Brasília;3;3;6;1558
4310603;Itaqui;5300108;Brasília;3;3;6;1764
4310801;Ivoti;5300108;Brasília;3;3;6;1568
4311007;Jaguarão;5300108;Brasília;3;3;6;1951
4311106;Jaguari;5300108;Brasília;3;3;6;1695
4311205;Júlio de Castilhos;5300108;Brasília;3;3;6;1619
4311304;Lagoa Vermelha;5300108;Brasília;3;3;6;1430
4311809;Marau;5300108;Brasília;3;3;6;1478
4312658;Não-Me-Toque;5300108;Brasília;3;3;6;1503
4312906;Nova Bassano;5300108;Brasília;3;3;6;1491
4313201;Nova Petrópolis;5300108;Brasília;3;3;6;1544
4313300;Nova Prata;5300108;Brasília;3;3;6;1494
4313375;Nova Santa Rita;5300108;Brasília;3;3;6;1600
4313508;Osório;5300108;Brasília;3;3;6;1580
4314050;Parobé;5300108;Brasília;3;3;6;1565
4314803;Portão;5300108;Brasília;3;3;6;1583
4315305;Quaraí;5300108;Brasília;3;3;6;1875
4315503;Restinga Seca;5300108;Brasília;3;3;6;1667
4315701;Rio Pardo;5300108;Brasília;3;3;6;1639
4316006;Rolante;5300108;Brasília;3;3;6;1561
4316402;Rosário do Sul;5300108;Brasília;3;3;6;1784
4316600;Sananduva;5300108;Brasília;3;3;6;1412
4317301;Santa Vitória do Palmar;5300108;Brasília;3;3;6;2058
4317400;Santiago;5300108;Brasília;3;3;6;1673
4317608;Santo Antônio da Patrulha;5300108;Brasília;3;3;6;1578
4317806;Santo Augusto;5300108;Brasília;3;3;6;1484
4317905;Santo Cristo;5300108;Brasília;3;3;6;1527
4318200;São Francisco de Paula;5300108;Brasília;3;3;6;1539
4318309;São Gabriel;5300108;Brasília;3;3;6;1760
4318408;São Jerônimo;5300108;Brasília;3;3;6;1624
4318903;São Luiz Gonzaga;5300108;Brasília;3;3;6;1600
4319406;São Pedro do Sul;5300108;Brasília;3;3;6;1682
4319505;São Sebastião do Caí;5300108;Brasília;3;3;6;1574
4319604;São Sepé;5300108;Brasília;3;3;6;1713
4320107;Sarandi;5300108;Brasília;3;3;6;1454
4320404;Serafina Corrêa;5300108;Brasília;3;3;6;1497
4320552;Sertão Santana;5300108;Brasília;3;3;6;1674
4320701;Sobradinho;5300108;Brasília;3;3;6;1612
4320800;Soledade;5300108;Brasília;3;3;6;1532
4320909;Tapejara;5300108;Brasília;3;3;6;1432
4321105;Tapes;5300108;Brasília;3;3;6;1692
4321303;Taquari;5300108;Brasília;3;3;6;1611
4321451;Teutônia;5300108;Brasília;3;3;6;1571
4321501;Torres;5300108;Brasília;3;3;6;1510
4321709;Três Coroas;5300108;Brasília;3;3;6;1551
4321808;Três de Maio;5300108;Brasília;3;3;6;1498
4321907;Três Passos;5300108;Brasília;3;3;6;1453
4322202;Tupanciretã;5300108;Brasília;3;3;6;1613
4322608;Venâncio Aires;5300108;Brasília;3;3;6;1600
4322707;Vera Cruz;5300108;Brasília;3;3;6;1623
4322806;Veranópolis;5300108;Brasília;3;3;6;1509
5000609;Amambaí;5300108;Brasília;3;3;6;1140
5001102;Aquidauana;5300108;Brasília;3;3;6;994
5002902;Cassilândia;5300108;Brasília;3;3;6;554
5002951;Chapadão do Sul;5300108;Brasília;3;3;6;606
5003306;Coxim;5300108;Brasília;3;3;6;793
5003801;Fátima do Sul;5300108;Brasília;3;3;6;1024
5004700;Ivinhema;5300108;Brasília;3;3;6;965
5005004;Jardim;5300108;Brasília;3;3;6;1100
5007208;Rio Brilhante;5300108;Brasília;3;3;6;980
5007695;São Gabriel do Oeste;5300108;Brasília;3;3;6;822
5100201;Água Boa;5300108;Brasília;3;3;6;495
5100300;Alto Araguaia;5300108;Brasília;3;3;6;595
5101704;Barra do Bugres;5300108;Brasília;3;3;6;994
5102637;Campo Novo do Parecis;5300108;Brasília;3;3;6;1090
5102678;Campo Verde;5300108;Brasília;3;3;6;776
5103056;Cláudia;5300108;Brasília;3;3;6;879
5103205;Colíder;5300108;Brasília;3;3;6;972
5103353;Confresa;5300108;Brasília;3;3;6;690
5104104;Guarantã do Norte;5300108;Brasília;3;3;6;983
5104807;Jaciara;5300108;Brasília;3;3;6;759
5105150;Juína;5300108;Brasília;3;3;6;1248
5105507;Vila Bela da Santíssima Trindade;5300108;Brasília;3;3;6;1285
5105903;Nobres;5300108;Brasília;3;3;6;912
5106224;Nova Mutum;5300108;Brasília;3;3;6;897
5106752;Pontes e Lacerda;5300108;Brasília;3;3;6;1223
5200100;Abadiânia;5300108;Brasília;3;3;6;95
5200605;Alto Paraíso de Goiás;5300108;Brasília;3;3;6;191
5201306;Anicuns;5300108;Brasília;3;3;6;231
5203500;Bom Jesus de Goiás;5300108;Brasília;3;3;6;332
5204003;Cabeceiras;5300108;Brasília;3;3;6;107
5205802;Corumbá de Goiás;5300108;Brasília;3;3;6;96
5208806;Goianira;5300108;Brasília;3;3;6;181
5208905;Goiás;5300108;Brasília;3;3;6;244
5209101;Goiatuba;5300108;Brasília;3;3;6;289
5210000;Inhumas;5300108;Brasília;3;3;6;184
5210208;Iporá;5300108;Brasília;3;3;6;351
5210901;Itapaci;5300108;Brasília;3;3;6;200
5211305;Itarumã;5300108;Brasília;3;3;6;494
5211701;Jandaia;5300108;Brasília;3;3;6;275
5212204;Jussara;5300108;Brasília;3;3;6;316
5213004;Maurilândia;5300108;Brasília;3;3;6;354
5214002;Mozarlândia;5300108;Brasília;3;3;6;308
5215306;Orizona;5300108;Brasília;3;3;6;141
5217104;Piracanjuba;5300108;Brasília;3;3;6;203
5217708;Pontalina;5300108;Brasília;3;3;6;250
5218508;Quirinópolis;5300108;Brasília;3;3;6;400
5220207;São Miguel do Araguaia;5300108;Brasília;3;3;6;368
5220603;Silvânia;5300108;Brasília;3;3;6;119
5221197;Terezópolis de Goiás;5300108;Brasília;3;3;6;140
5221700;Uruana;5300108;Brasília;3;3;6;192
5212105;Joviânia;5222054;Vicentinópolis;3;3;6;22
5217401;Pires do Rio;5222005;Vianópolis;3;3;6;65
3304557;Rio de Janeiro;5221858;Valparaíso de Goiás;3;3;6;913
5201108;Anápolis;5221858;Valparaíso de Goiás;3;3;6;108
1709500;Gurupi;5221601;Uruaçu;3;3;6;311
5214606;Niquelândia;5221601;Uruaçu;3;3;6;75
5218052;Porteirão;5221551;Turvelândia;3;3;6;15
5201108;Anápolis;5221197;Terezópolis de Goiás;3;3;6;16
3170206;Uberlândia;5220454;Senador Canedo;3;3;6;258
3304557;Rio de Janeiro;5220454;Senador Canedo;3;3;6;932
5208707;Goiânia;5220405;São Simão;3;3;6;287
3550308;São Paulo;5220108;São Luís de Montes Belos;3;3;6;885
5210208;Iporá;5220108;São Luís de Montes Belos;3;3;6;81
3550308;São Paulo;5219753;Santo Antônio do Descoberto;3;3;6;873
5208707;Goiânia;5219753;Santo Antônio do Descoberto;3;3;6;134
5200134;Acreúna;5219308;Santa Helena de Goiás;3;3;6;51
5208707;Goiânia;5219308;Santa Helena de Goiás;3;3;6;186
5218508;Quirinópolis;5219308;Santa Helena de Goiás;3;3;6;73
5205406;Ceres;5218904;Rubiataba;3;3;6;25
2919553;Luís Eduardo magalhães;5218805;Rio Verde;3;3;6;827
3148004;Patos de Minas;5218805;Rio Verde;3;3;6;479
3509502;Campinas;5218805;Rio Verde;3;3;6;703
4115200;Maringá;5218805;Rio Verde;3;3;6;633
4118204;Paranaguá;5218805;Rio Verde;3;3;6;900
4119905;Ponta Grossa;5218805;Rio Verde;3;3;6;814
4219309;Videira;5218805;Rio Verde;3;3;6;1020
5213806;Morrinhos;5218805;Rio Verde;3;3;6;193
5204508;Caldas Novas;5218789;Rio Quente;3;3;6;17
5208707;Goiânia;5218789;Rio Quente;3;3;6;131
5208707;Goiânia;5218706;Rianápolis;3;3;6;140
3540903;Pradópolis;5218508;Quirinópolis;3;3;6;410
3550308;São Paulo;5218508;Quirinópolis;3;3;6;706
5204300;Caçu;5218508;Quirinópolis;3;3;6;74
2919553;Luís Eduardo magalhães;5218300;Posse;3;3;6;228
3550308;São Paulo;5218300;Posse;3;3;6;1059
5208004;Formosa;5218300;Posse;3;3;6;191
3550308;São Paulo;5217708;Pontalina;3;3;6;743
5209101;Goiatuba;5217708;Pontalina;3;3;6;55
3550308;São Paulo;5217302;Pirenópolis;3;3;6;898
5210208;Iporá;5217203;Piranhas;3;3;6;71
5203302;Bela Vista de Goiás;5217104;Piracanjuba;3;3;6;37
5204508;Caldas Novas;5217104;Piracanjuba;3;3;6;65
5208707;Goiânia;5216809;Petrolina de Goiás;3;3;6;66
5211503;Itumbiara;5216007;Panamá;3;3;6;26
4319505;São Sebastião do Caí;5215306;Orizona;3;3;6;1432
3550308;São Paulo;5215231;Novo Gama;3;3;6;854
5208707;Goiânia;5214838;Nova Crixás;3;3;6;309
5214051;Mundo Novo;5214838;Nova Crixás;3;3;6;37
5201108;Anápolis;5214606;Niquelândia;3;3;6;211
5205406;Ceres;5214606;Niquelândia;3;3;6;153
3550308;São Paulo;5214507;Nerópolis;3;3;6;850
5201108;Anápolis;5213087;Minaçu;3;3;6;319
3170404;Unaí;5212501;Luziânia;3;3;6;110
5200258;Águas Lindas de Goiás;5212501;Luziânia;3;3;6;66
5203559;Bonfinópolis;5212303;Leopoldo de Bulhões;3;3;6;23
5210208;Iporá;5212204;Jussara;3;3;6;69
5208707;Goiânia;5212105;Joviânia;3;3;6;128
3304557;Rio de Janeiro;5211909;Jataí;3;3;6;1062
4106902;Curitiba;5211909;Jataí;3;3;6;874
5200134;Acreúna;5211909;Jataí;3;3;6;151
5204102;Cachoeira Alta;5211909;Jataí;3;3;6;125
5207253;Doverlândia;5211909;Jataí;3;3;6;146
3550308;São Paulo;5211800;Jaraguá;3;3;6;922
5205406;Ceres;5211800;Jaraguá;3;3;6;62
5210604;Itaguaru;5211800;Jaraguá;3;3;6;30
5208707;Goiânia;5211701;Jandaia;3;3;6;100
3103504;Araguari;5211503;Itumbiara;3;3;6;114
3103751;Araporã;5211503;Itumbiara;3;3;6;9
3106200;Belo Horizonte;5211503;Itumbiara;3;3;6;585
3134202;Ituiutaba;5211503;Itumbiara;3;3;6;67
3509502;Campinas;5211503;Itumbiara;3;3;6;552
4314902;Porto Alegre;5211503;Itumbiara;3;3;6;1309
5204300;Caçu;5211305;Itarumã;3;3;6;30
5208905;Goiás;5210406;Itaberaí;3;3;6;39
3550308;São Paulo;5210109;Ipameri;3;3;6;676
5204805;Campo Alegre de Goiás;5210109;Ipameri;3;3;6;41
3550308;São Paulo;5209200;Guapó;3;3;6;818
3517406;Guaíra;5209101;Goiatuba;3;3;6;279
1508407;Xinguara;5208707;Goiânia;3;3;6;1064
2303709;Caucaia;5208707;Goiânia;3;3;6;1811
2305233;Horizonte;5208707;Goiânia;3;3;6;1790
2704302;Maceió;5208707;Goiânia;3;3;6;1622
2903201;Barreiras;5208707;Goiânia;3;3;6;672
2910800;Feira de Santana;5208707;Goiânia;3;3;6;1194
2919553;Luís Eduardo magalhães;5208707;Goiânia;3;3;6;626
3134202;Ituiutaba;5208707;Goiânia;3;3;6;253
3136702;Juiz de Fora;5208707;Goiânia;3;3;6;854
3301702;Duque de Caxias;5208707;Goiânia;3;3;6;934
3501608;Americana;5208707;Goiânia;3;3;6;702
3506003;Bauru;5208707;Goiânia;3;3;6;626
3519071;Hortolândia;5208707;Goiânia;3;3;6;718
3522505;Itapevi;5208707;Goiânia;3;3;6;800
3529401;Mauá;5208707;Goiânia;3;3;6;831
3547809;Santo André;5208707;Goiânia;3;3;6;826
3552809;Taboão da Serra;5208707;Goiânia;3;3;6;811
3557105;Votuporanga;5208707;Goiânia;3;3;6;422
4105508;Cianorte;5208707;Goiânia;3;3;6;852
4118204;Paranaguá;5208707;Goiânia;3;3;6;987
4205407;Florianópolis;5208707;Goiânia;3;3;6;1210
4216602;São José;5208707;Goiânia;3;3;6;1207
4304606;Canoas;5208707;Goiânia;3;3;6;1479
5100201;Água Boa;5208707;Goiânia;3;3;6;424
5102702;Canarana;5208707;Goiânia;3;3;6;471
5107065;Querência;5208707;Goiânia;3;3;6;570
5200829;Amaralina;5208707;Goiânia;3;3;6;306
5201603;Araçu;5208707;Goiânia;3;3;6;56
5201702;Aragarças;5208707;Goiânia;3;3;6;329
5203203;Barro Alto;5208707;Goiânia;3;3;6;195
5203559;Bonfinópolis;5208707;Goiânia;3;3;6;35
5204409;Caiapônia;5208707;Goiânia;3;3;6;274
5206404;Crixás;5208707;Goiânia;3;3;6;249
5201108;Anápolis;5208608;Goianésia;3;3;6;112
2919553;Luís Eduardo magalhães;5208004;Formosa;3;3;6;413
3170404;Unaí;5208004;Formosa;3;3;6;105
5204904;Campos Belos;5208004;Formosa;3;3;6;286
3550308;São Paulo;5207402;Edéia;3;3;6;783
3550308;São Paulo;5206404;Crixás;3;3;6;1073
3550308;São Paulo;5205497;Cidade Ocidental;3;3;6;850
3550308;São Paulo;5205455;Cezarina;3;3;6;814
3106200;Belo Horizonte;5205109;Catalão;3;3;6;463
4309605;Horizontina;5205109;Catalão;3;3;6;1258
3170206;Uberlândia;5204508;Caldas Novas;3;3;6;134
3550308;São Paulo;5204409;Caiapônia;3;3;6;932
3549805;São José do Rio Preto;5204300;Caçu;3;3;6;311
5204102;Cachoeira Alta;5204300;Caçu;3;3;6;30
3550308;São Paulo;5203500;Bom Jesus de Goiás;3;3;6;691
3550308;São Paulo;5201702;Aragarças;3;3;6;1056
1501402;Belém;5201405;Aparecida de Goiânia;3;3;6;1709
1716109;Paraíso do Tocantins;5201405;Aparecida de Goiânia;3;3;6;736
2919207;Lauro de Freitas;5201405;Aparecida de Goiânia;3;3;6;1235
3106705;Betim;5201405;Aparecida de Goiânia;3;3;6;647
3167202;Sete Lagoas;5201405;Aparecida de Goiânia;3;3;6;613
3525904;Jundiaí;5201405;Aparecida de Goiânia;3;3;6;750
3547304;Santana de Parnaíba;5201405;Aparecida de Goiânia;3;3;6;777
3549904;São José dos Campos;5201405;Aparecida de Goiânia;3;3;6;796
4125506;São José dos Pinhais;5201405;Aparecida de Goiânia;3;3;6;966
4204608;Criciúma;5201405;Aparecida de Goiânia;3;3;6;1312
5200258;Águas Lindas de Goiás;5201405;Aparecida de Goiânia;3;3;6;156
1302603;Manaus;5201108;Anápolis;3;3;6;1863
2611606;Recife;5201108;Anápolis;3;3;6;1730
2906501;Candeias;5201108;Anápolis;3;3;6;1174
2909307;Correntina;5201108;Anápolis;3;3;6;564
4113700;Londrina;5201108;Anápolis;3;3;6;810
4204608;Criciúma;5201108;Anápolis;3;3;6;1368
5002704;Campo Grande;5201108;Anápolis;3;3;6;766
5103403;Cuiabá;5201108;Anápolis;3;3;6;767
5107602;Rondonópolis;5201108;Anápolis;3;3;6;612
3304557;Rio de Janeiro;5200308;Alexânia;3;3;6;945
5200100;Abadiânia;5200308;Alexânia;3;3;6;25
1506708;Santana do Araguaia;5108600;Vila Rica;3;3;6;116
5103700;Feliz Natal;5108501;Vera;3;3;6;42
3536505;Paulínia;5108402;Várzea Grande;3;3;6;1262
3548708;São Bernardo do Campo;5108402;Várzea Grande;3;3;6;1380
3552205;Sorocaba;5108402;Várzea Grande;3;3;6;1287
4202404;Blumenau;5108402;Várzea Grande;3;3;6;1478
4208203;Itajaí;5108402;Várzea Grande;3;3;6;1496
4313904;Panambi;5108402;Várzea Grande;3;3;6;1429
5100250;Alta Floresta;5108402;Várzea Grande;3;3;6;638
5102678;Campo Verde;5108402;Várzea Grande;3;3;6;109
5103007;Chapada dos Guimarães;5108402;Várzea Grande;3;3;6;50
5103205;Colíder;5108402;Várzea Grande;3;3;6;540
5105622;Mirassol d'Oeste;5108402;Várzea Grande;3;3;6;207
5105903;Nobres;5108402;Várzea Grande;3;3;6;106
5106752;Pontes e Lacerda;5108402;Várzea Grande;3;3;6;342
5103205;Colíder;5108055;Terra Nova do Norte;3;3;6;42
3550308;São Paulo;5108006;Tapurah;3;3;6;1635
5107909;Sinop;5108006;Tapurah;3;3;6;153
2611606;Recife;5107958;Tangará da Serra;3;3;6;2508
4113700;Londrina;5107958;Tangará da Serra;3;3;6;1188
5101308;Arenápolis;5107958;Tangará da Serra;3;3;6;72
5105622;Mirassol d'Oeste;5107958;Tangará da Serra;3;3;6;135
5107909;Sinop;5107941;Tabaporã;3;3;6;160
5102637;Campo Novo do Parecis;5107925;Sorriso;3;3;6;266
5106240;Nova Ubiratã;5107925;Sorriso;3;3;6;73
1503606;Itaituba;5107909;Sinop;3;3;6;846
4106902;Curitiba;5107909;Sinop;3;3;6;1657
4115200;Maringá;5107909;Sinop;3;3;6;1342
5002704;Campo Grande;5107909;Sinop;3;3;6;953
5102637;Campo Novo do Parecis;5107909;Sinop;3;3;6;331
5104559;Itaúba;5107909;Sinop;3;3;6;91
5105150;Juína;5107909;Sinop;3;3;6;357
3550308;São Paulo;5107875;Sapezal;3;3;6;1794
5100359;Alto Boa Vista;5107859;São Félix do Araguaia;3;3;6;73
2611606;Recife;5107602;Rondonópolis;3;3;6;2268
3103504;Araguari;5107602;Rondonópolis;3;3;6;737
3106200;Belo Horizonte;5107602;Rondonópolis;3;3;6;1216
3505708;Barueri;5107602;Rondonópolis;3;3;6;1157
4109807;Ibiporã;5107602;Rondonópolis;3;3;6;855
4314902;Porto Alegre;5107602;Rondonópolis;3;3;6;1558
5007935;Sonora;5107602;Rondonópolis;3;3;6;127
5100201;Água Boa;5107602;Rondonópolis;3;3;6;373
5100300;Alto Araguaia;5107602;Rondonópolis;3;3;6;182
5100409;Alto Garças;5107602;Rondonópolis;3;3;6;132
5101803;Barra do Garças;5107602;Rondonópolis;3;3;6;265
5103601;Dom Aquino;5107602;Rondonópolis;3;3;6;73
5105150;Juína;5107602;Rondonópolis;3;3;6;703
5106224;Nova Mutum;5107602;Rondonópolis;3;3;6;323
5106752;Pontes e Lacerda;5107602;Rondonópolis;3;3;6;513
3550308;São Paulo;5107305;São José do Rio Claro;3;3;6;1593
5103403;Cuiabá;5107305;São José do Rio Claro;3;3;6;245
5105622;Mirassol d'Oeste;5107206;Rio Branco;3;3;6;48
5106752;Pontes e Lacerda;5107206;Rio Branco;3;3;6;130
5101258;Araputanga;5107107;São José dos Quatro Marcos;3;3;6;29
5103403;Cuiabá;5107107;São José dos Quatro Marcos;3;3;6;222
5105002;Jauru;5107107;São José dos Quatro Marcos;3;3;6;79
4106902;Curitiba;5107040;Primavera do Leste;3;3;6;1231
5101902;Brasnorte;5107040;Primavera do Leste;3;3;6;538
5102637;Campo Novo do Parecis;5107040;Primavera do Leste;3;3;6;432
5102702;Canarana;5107040;Primavera do Leste;3;3;6;312
5103502;Diamantino;5107040;Primavera do Leste;3;3;6;256
5103601;Dom Aquino;5107040;Primavera do Leste;3;3;6;69
5104807;Jaciara;5107040;Primavera do Leste;3;3;6;85
5106281;Novo São Joaquim;5107040;Primavera do Leste;3;3;6;158
5107008;Poxoréo;5107040;Primavera do Leste;3;3;6;35
5105622;Mirassol d'Oeste;5106828;Porto Esperidião;3;3;6;42
5102637;Campo Novo do Parecis;5106752;Pontes e Lacerda;3;3;6;233
3550308;São Paulo;5106422;Peixoto de Azevedo;3;3;6;1757
5105606;Matupá;5106422;Peixoto de Azevedo;3;3;6;10
5100805;Apiacás;5106299;Paranaíta;3;3;6;109
5104104;Guarantã do Norte;5106265;Novo Mundo;3;3;6;31
5102637;Campo Novo do Parecis;5106232;Nova Olímpia;3;3;6;141
4106902;Curitiba;5106216;Nova Canaã do Norte;3;3;6;1793
5104559;Itaúba;5106190;Nova Santa Helena;3;3;6;25
3550308;São Paulo;5106158;Nova Bandeirantes;3;3;6;1988
5100805;Apiacás;5106158;Nova Bandeirantes;3;3;6;55
5105176;Juruena;5106158;Nova Bandeirantes;3;3;6;77
5105259;Lucas do Rio Verde;5105903;Nobres;3;3;6;191
5105234;Lambari d'Oeste;5105622;Mirassol d'Oeste;3;3;6;41
5103403;Cuiabá;5105580;Marcelândia;3;3;6;531
4314902;Porto Alegre;5105259;Lucas do Rio Verde;3;3;6;1956
5102504;Cáceres;5105259;Lucas do Rio Verde;3;3;6;381
5102678;Campo Verde;5105259;Lucas do Rio Verde;3;3;6;283
5103205;Colíder;5105259;Lucas do Rio Verde;3;3;6;253
5105150;Juína;5105259;Lucas do Rio Verde;3;3;6;359
5101902;Brasnorte;5105176;Juruena;3;3;6;207
5103403;Cuiabá;5105176;Juruena;3;3;6;631
5100250;Alta Floresta;5105150;Juína;3;3;6;335
5101704;Barra do Bugres;5105150;Juína;3;3;6;438
5103379;Cotriguaçu;5105150;Juína;3;3;6;173
5101407;Aripuanã;5105101;Juara;3;3;6;237
1500602;Altamira;5103403;Cuiabá;3;3;6;1429
1506138;Redenção;5103403;Cuiabá;3;3;6;1055
1600303;Macapá;5103403;Cuiabá;3;3;6;1807
2111300;São Luís;5103403;Cuiabá;3;3;6;1905
2919553;Luís Eduardo magalhães;5103403;Cuiabá;3;3;6;1160
3106705;Betim;5103403;Cuiabá;3;3;6;1382
3118601;Contagem;5103403;Cuiabá;3;3;6;1391
3127701;Governador Valadares;5103403;Cuiabá;3;3;6;1570
3543907;Rio Claro;5103403;Cuiabá;3;3;6;1203
4209102;Joinville;5103403;Cuiabá;3;3;6;1433
4304606;Canoas;5103403;Cuiabá;3;3;6;1683
5100201;Água Boa;5103403;Cuiabá;3;3;6;451
3550308;São Paulo;5103254;Colniza;3;3;6;2121
5100250;Alta Floresta;5102793;Carlinda;3;3;6;28
1100304;Vilhena;5102686;Campos de Júlio;3;3;6;163
5101803;Barra do Garças;5102603;Campinápolis;3;3;6;159
4113700;Londrina;5102504;Cáceres;3;3;6;1075
5101704;Barra do Bugres;5102504;Cáceres;3;3;6;122
3550308;São Paulo;5101902;Brasnorte;3;3;6;1797
3549805;São José do Rio Preto;5101308;Arenápolis;3;3;6;1080
3304557;Rio de Janeiro;5100607;Alto Taquari;3;3;6;1218
3170206;Uberlândia;5100300;Alto Araguaia;3;3;6;559
5003801;Fátima do Sul;5008404;Vicentina;3;3;6;9
1302603;Manaus;5008305;Três Lagoas;3;3;6;2123
3170206;Uberlândia;5008305;Três Lagoas;3;3;6;414
3505708;Barueri;5008305;Três Lagoas;3;3;6;594
3506003;Bauru;5008305;Três Lagoas;3;3;6;328
3514403;Dracena;5008305;Três Lagoas;3;3;6;86
3518206;Guararapes;5008305;Três Lagoas;3;3;6;126
3530102;Mirandópolis;5008305;Três Lagoas;3;3;6;78
3530706;Mogi Guaçu;5008305;Três Lagoas;3;3;6;530
4106902;Curitiba;5008305;Três Lagoas;3;3;6;578
4204301;Concórdia;5008305;Três Lagoas;3;3;6;715
4314902;Porto Alegre;5008305;Três Lagoas;3;3;6;1030
5002951;Chapadão do Sul;5008305;Três Lagoas;3;3;6;237
5006200;Nova Andradina;5007976;Taquarussu;3;3;6;28
3550308;São Paulo;5007935;Sonora;3;3;6;1108
5004502;Itaporã;5007208;Rio Brilhante;3;3;6;40
3552205;Sorocaba;5007109;Ribas do Rio Pardo;3;3;6;743
5002100;Bela Vista;5006903;Porto Murtinho;3;3;6;142
5003157;Coronel Sapucaia;5006606;Ponta Porã;3;3;6;85
5006200;Nova Andradina;5006606;Ponta Porã;3;3;6;238
3541406;Presidente Prudente;5006200;Nova Andradina;3;3;6;207
5003702;Dourados;5006002;Nova Alvorada do Sul;3;3;6;95
3541406;Presidente Prudente;5005707;Naviraí;3;3;6;303
4106902;Curitiba;5005707;Naviraí;3;3;6;574
5000609;Amambaí;5005707;Naviraí;3;3;6;109
5004601;Itaquiraí;5005707;Naviraí;3;3;6;50
4114609;Marechal Cândido Rondon;5005681;Mundo Novo;3;3;6;73
5001102;Aquidauana;5005400;Maracaju;3;3;6;143
5005004;Jardim;5005400;Maracaju;3;3;6;106
5003702;Dourados;5005004;Jardim;3;3;6;167
5003801;Fátima do Sul;5004700;Ivinhema;3;3;6;74
5002704;Campo Grande;5004502;Itaporã;3;3;6;184
5002704;Campo Grande;5004106;Guia Lopes da Laguna;3;3;6;188
3509502;Campinas;5003702;Dourados;3;3;6;804
4118204;Paranaguá;5003702;Dourados;3;3;6;750
5000609;Amambaí;5003702;Dourados;3;3;6;110
5003207;Corumbá;5003702;Dourados;3;3;6;457
5002704;Campo Grande;5003488;Dois Irmãos do Buriti;3;3;6;73
4106902;Curitiba;5003306;Coxim;3;3;6;976
5002605;Camapuã;5003306;Coxim;3;3;6;144
5002605;Camapuã;5003256;Costa Rica;3;3;6;148
5001102;Aquidauana;5003207;Corumbá;3;3;6;250
5002704;Campo Grande;5003108;Corguinho;3;3;6;70
4106902;Curitiba;5002951;Chapadão do Sul;3;3;6;818
4314902;Porto Alegre;5002951;Chapadão do Sul;3;3;6;1256
3550308;São Paulo;5002803;Caracol;3;3;6;1093
1200401;Rio Branco;5002704;Campo Grande;3;3;6;1768
1400100;Boa Vista;5002704;Campo Grande;3;3;6;2647
3106705;Betim;5002704;Campo Grande;3;3;6;1092
3503208;Araraquara;5002704;Campo Grande;3;3;6;696
3513504;Cubatão;5002704;Campo Grande;3;3;6;950
3536505;Paulínia;5002704;Campo Grande;3;3;6;830
3547809;Santo André;5002704;Campo Grande;3;3;6;928
3552403;Sumaré;5002704;Campo Grande;3;3;6;821
4101804;Araucária;5002704;Campo Grande;3;3;6;799
4118204;Paranaguá;5002704;Campo Grande;3;3;6;864
4122404;Rolândia;5002704;Campo Grande;3;3;6;471
4205407;Florianópolis;5002704;Campo Grande;3;3;6;1031
4216602;São José;5002704;Campo Grande;3;3;6;1018
4304606;Canoas;5002704;Campo Grande;3;3;6;1115
4307906;Farroupilha;5002704;Campo Grande;3;3;6;1038
5000708;Anastácio;5002704;Campo Grande;3;3;6;121
5001904;Bataguassu;5002704;Campo Grande;3;3;6;272
5001102;Aquidauana;5002209;Bonito;3;3;6;109
3550308;São Paulo;5002159;Bodoquena;3;3;6;1115
3506508;Birigui;5001003;Aparecida do Taboado;3;3;6;157
3524808;Jales;5001003;Aparecida do Taboado;3;3;6;61
4209102;Joinville;5001003;Aparecida do Taboado;3;3;6;727
4104808;Cascavel;5000609;Amambaí;3;3;6;274
3502804;Araçatuba;5000203;Água Clara;3;3;6;266
4305108;Caxias do Sul;4323804;Xangri-lá;3;3;6;127
4303558;Camargo;4323408;Vila Maria;3;3;6;7
4316808;Santa Cruz do Sul;4323002;Viamão;3;3;6;142
4320008;Sapucaia do Sul;4323002;Viamão;3;3;6;29
4307864;Fagundes Varela;4322806;Veranópolis;3;3;6;16
4314902;Porto Alegre;4322707;Vera Cruz;3;3;6;132
4322533;Vale do Sol;4322707;Vera Cruz;3;3;6;21
3518800;Guarulhos;4322608;Venâncio Aires;3;3;6;865
4209102;Joinville;4322608;Venâncio Aires;3;3;6;486
4306809;Encantado;4322608;Venâncio Aires;3;3;6;50
4307906;Farroupilha;4322608;Venâncio Aires;3;3;6;93
4315602;Rio Grande;4322608;Venâncio Aires;3;3;6;275
4305108;Caxias do Sul;4322541;Vale Real;3;3;6;26
4308102;Feliz;4322541;Vale Real;3;3;6;8
4313201;Nova Petrópolis;4322541;Vale Real;3;3;6;15
4316808;Santa Cruz do Sul;4322533;Vale do Sol;3;3;6;28
4106902;Curitiba;4322509;Vacaria;3;3;6;376
4303673;Campestre da Serra;4322509;Vacaria;3;3;6;35
4311403;Lajeado;4322509;Vacaria;3;3;6;148
4316808;Santa Cruz do Sul;4322509;Vacaria;3;3;6;199
4320909;Tapejara;4322509;Vacaria;3;3;6;116
3548807;São Caetano do Sul;4322400;Uruguaiana;3;3;6;1203
4311403;Lajeado;4322400;Uruguaiana;3;3;6;488
4313409;Novo Hamburgo;4322400;Uruguaiana;3;3;6;575
4315602;Rio Grande;4322400;Uruguaiana;3;3;6;541
4317400;Santiago;4322400;Uruguaiana;3;3;6;223
4318309;São Gabriel;4322400;Uruguaiana;3;3;6;276
4317400;Santiago;4322376;Unistalda;3;3;6;32
4309407;Guaporé;4322350;União da Serra;3;3;6;14
4319505;São Sebastião do Caí;4322251;Tupandi;3;3;6;13
3505708;Barueri;4322004;Triunfo;3;3;6;842
4106902;Curitiba;4322004;Triunfo;3;3;6;546
4311403;Lajeado;4322004;Triunfo;3;3;6;62
4318705;São Leopoldo;4322004;Triunfo;3;3;6;56
4304705;Carazinho;4321907;Três Passos;3;3;6;148
4309001;Giruá;4321907;Três Passos;3;3;6;75
4317202;Santa Rosa;4321907;Três Passos;3;3;6;68
4316105;Ronda Alta;4321857;Três Palmeiras;3;3;6;17
4305108;Caxias do Sul;4321709;Três Coroas;3;3;6;55
4313409;Novo Hamburgo;4321709;Três Coroas;3;3;6;39
4314050;Parobé;4321709;Três Coroas;3;3;6;14
4316006;Rolante;4321709;Três Coroas;3;3;6;25
4300604;Alvorada;4321600;Tramandaí;3;3;6;90
4303905;Campo Bom;4321600;Tramandaí;3;3;6;93
4307708;Esteio;4321600;Tramandaí;3;3;6;100
4308201;Flores da Cunha;4321600;Tramandaí;3;3;6;144
4313201;Nova Petrópolis;4321600;Tramandaí;3;3;6;114
4319901;Sapiranga;4321600;Tramandaí;3;3;6;91
4321204;Taquara;4321600;Tramandaí;3;3;6;71
4204608;Criciúma;4321501;Torres;3;3;6;83
4303103;Cachoeirinha;4321501;Torres;3;3;6;145
4307906;Farroupilha;4321501;Torres;3;3;6;149
4310363;Imigrante;4321451;Teutônia;3;3;6;11
4314100;Passo Fundo;4321451;Teutônia;3;3;6;144
4316501;Salvador do Sul;4321451;Teutônia;3;3;6;29
4321303;Taquari;4321451;Teutônia;3;3;6;39
4308508;Frederico Westphalen;4321402;Tenente Portela;3;3;6;36
4312302;Miraguaí;4321402;Tenente Portela;3;3;6;15
4320859;Tabaí;4321303;Taquari;3;3;6;23
3304557;Rio de Janeiro;4321204;Taquara;3;3;6;1031
4303509;Camaquã;4321204;Taquara;3;3;6;165
4304606;Canoas;4321204;Taquara;3;3;6;49
4316006;Rolante;4321204;Taquara;3;3;6;20
4320354;Sentinela do Sul;4321105;Tapes;3;3;6;16
4311270;Lagoa dos Três Cantos;4321006;Tapera;3;3;6;6
4320503;Sertão;4320909;Tapejara;3;3;6;26
4307500;Espumoso;4320800;Soledade;3;3;6;31
4314902;Porto Alegre;4320701;Sobradinho;3;3;6;191
4204301;Concórdia;4320602;Severiano de Almeida;3;3;6;26
4307005;Erechim;4320602;Severiano de Almeida;3;3;6;27
4301750;Barão do Triunfo;4320552;Sertão Santana;3;3;6;15
3550308;São Paulo;4320404;Serafina Corrêa;3;3;6;755
4314902;Porto Alegre;4320404;Serafina Corrêa;3;3;6;165
4308508;Frederico Westphalen;4320206;Seberi;3;3;6;13
4315909;Rodeio Bonito;4320206;Seberi;3;3;6;23
4312658;Não-Me-Toque;4320107;Sarandi;3;3;6;58
4312401;Montenegro;4320008;Sapucaia do Sul;3;3;6;39
3516200;Franca;4319901;Sapiranga;3;3;6;1062
4106902;Curitiba;4319901;Sapiranga;3;3;6;493
4300877;Araricá;4319901;Sapiranga;3;3;6;7
4318705;São Leopoldo;4319901;Sapiranga;3;3;6;19
4304804;Carlos Barbosa;4319505;São Sebastião do Caí;3;3;6;34
4306403;Dois Irmãos;4319505;São Sebastião do Caí;3;3;6;28
4307708;Esteio;4319505;São Sebastião do Caí;3;3;6;35
4307906;Farroupilha;4319505;São Sebastião do Caí;3;3;6;40
4313409;Novo Hamburgo;4319505;São Sebastião do Caí;3;3;6;27
4314035;Pareci Novo;4319505;São Sebastião do Caí;3;3;6;7
4305207;Cerro Largo;4319372;São Pedro do Butiá;3;3;6;16
4305207;Cerro Largo;4319158;São Miguel das Missões;3;3;6;48
4304804;Carlos Barbosa;4319000;São Marcos;3;3;6;56
4316808;Santa Cruz do Sul;4318804;São Lourenço do Sul;3;3;6;181
4317301;Santa Vitória do Palmar;4318804;São Lourenço do Sul;3;3;6;278
3118601;Contagem;4318705;São Leopoldo;3;3;6;1272
4204202;Chapecó;4318705;São Leopoldo;3;3;6;326
4309100;Gramado;4318705;São Leopoldo;3;3;6;46
4309308;Guaíba;4318705;São Leopoldo;3;3;6;43
4310207;Ijuí;4318705;São Leopoldo;3;3;6;307
4209300;Lages;4318622;São José dos Ausentes;3;3;6;108
4302303;Bom Jesus;4318622;São José dos Ausentes;3;3;6;36
4203600;Campos Novos;4318606;São José do Ouro;3;3;6;53
4303202;Cacique Doble;4318606;São José do Ouro;3;3;6;7
4311304;Lagoa Vermelha;4318606;São José do Ouro;3;3;6;49
4312500;Mostardas;4318507;São José do Norte;3;3;6;145
4313706;Palmeira das Missões;4318457;São José das Missões;3;3;6;24
4312203;Maximiliano de Almeida;4318424;São João da Urtiga;3;3;6;21
4303004;Cachoeira do Sul;4318408;São Jerônimo;3;3;6;115
4314100;Passo Fundo;4318408;São Jerônimo;3;3;6;200
4306601;Dom Pedrito;4318309;São Gabriel;3;3;6;79
4316808;Santa Cruz do Sul;4318309;São Gabriel;3;3;6;191
4309100;Gramado;4318200;São Francisco de Paula;3;3;6;32
4311759;Manoel Viana;4318101;São Francisco de Assis;3;3;6;33
4316907;Santa Maria;4318101;São Francisco de Assis;3;3;6;129
4314001;Paraí;4318051;São Domingos do Sul;3;3;6;12
4300307;Alecrim;4317905;Santo Cristo;3;3;6;21
4310207;Ijuí;4317905;Santo Cristo;3;3;6;97
4309001;Giruá;4317509;Santo Ângelo;3;3;6;31
4317400;Santiago;4317509;Santo Ângelo;3;3;6;115
4312104;Mata;4317400;Santiago;3;3;6;57
4305108;Caxias do Sul;4317202;Santa Rosa;3;3;6;356
4306106;Cruz Alta;4317202;Santa Rosa;3;3;6;121
4307005;Erechim;4317202;Santa Rosa;3;3;6;216
3550308;São Paulo;4317103;Santana do Livramento;3;3;6;1144
4312476;Morro Reuter;4316956;Santa Maria do Herval;3;3;6;10
4314902;Porto Alegre;4316956;Santa Maria do Herval;3;3;6;65
3106200;Belo Horizonte;4316907;Santa Maria;3;3;6;1420
3518800;Guarulhos;4316907;Santa Maria;3;3;6;974
4115200;Maringá;4316907;Santa Maria;3;3;6;717
4208906;Jaraguá do Sul;4316907;Santa Maria;3;3;6;576
4302907;Cacequi;4316907;Santa Maria;3;3;6;101
4306601;Dom Pedrito;4316907;Santa Maria;3;3;6;163
4306932;Entre-Ijuís;4316907;Santa Maria;3;3;6;155
4311106;Jaguari;4316907;Santa Maria;3;3;6;95
4313706;Palmeira das Missões;4316907;Santa Maria;3;3;6;205
4315503;Restinga Seca;4316907;Santa Maria;3;3;6;45
4315602;Rio Grande;4316907;Santa Maria;3;3;6;309
3106200;Belo Horizonte;4316808;Santa Cruz do Sul;3;3;6;1342
4122305;Rio Negro;4316808;Santa Cruz do Sul;3;3;6;473
4209300;Lages;4316808;Santa Cruz do Sul;3;3;6;293
4214805;Rio do Sul;4316808;Santa Cruz do Sul;3;3;6;386
4302808;Caçapava do Sul;4316808;Santa Cruz do Sul;3;3;6;131
4304507;Canguçu;4316808;Santa Cruz do Sul;3;3;6;188
4315503;Restinga Seca;4316808;Santa Cruz do Sul;3;3;6;92
4316436;Saldanha Marinho;4316709;Santa Bárbara do Sul;3;3;6;15
4313607;Paim Filho;4316600;Sananduva;3;3;6;27
4303707;Campina das Missões;4316303;Roque Gonzales;3;3;6;24
4314902;Porto Alegre;4316105;Ronda Alta;3;3;6;299
4314902;Porto Alegre;4316006;Rolante;3;3;6;75
4314902;Porto Alegre;4315909;Rodeio Bonito;3;3;6;347
4314902;Porto Alegre;4315800;Roca Sales;3;3;6;107
4302709;Butiá;4315701;Rio Pardo;3;3;6;45
4303004;Cachoeira do Sul;4315701;Rio Pardo;3;3;6;53
4207304;Imbituba;4315602;Rio Grande;3;3;6;537
4300109;Agudo;4315503;Restinga Seca;3;3;6;23
4300406;Alegrete;4315305;Quaraí;3;3;6;92
4312054;Marques de Souza;4315156;Progresso;3;3;6;23
4314902;Porto Alegre;4315156;Progresso;3;3;6;141
4313201;Nova Petrópolis;4315149;Presidente Lucena;3;3;6;17
4109401;Guarapuava;4315107;Porto Xavier;3;3;6;454
4305207;Cerro Largo;4315107;Porto Xavier;3;3;6;49
4314902;Porto Alegre;4315107;Porto Xavier;3;3;6;458
4314902;Porto Alegre;4315008;Porto Lucena;3;3;6;451
1504208;Marabá;4314902;Porto Alegre;3;3;6;2738
2105302;Imperatriz;4314902;Porto Alegre;3;3;6;2737
2408003;Mossoró;4314902;Porto Alegre;3;3;6;3022
2602308;Bonito;4314902;Porto Alegre;3;3;6;2768
2906501;Candeias;4314902;Porto Alegre;3;3;6;2242
3507001;Boituva;4314902;Porto Alegre;3;3;6;820
3509205;Cajamar;4314902;Porto Alegre;3;3;6;845
3553609;Tapiratiba;4314902;Porto Alegre;3;3;6;1037
3554003;Tatuí;4314902;Porto Alegre;3;3;6;807
4108403;Francisco Beltrão;4314902;Porto Alegre;3;3;6;473
4205902;Gaspar;4314902;Porto Alegre;3;3;6;406
4215000;Rio Negrinho;4314902;Porto Alegre;3;3;6;450
4216206;São Francisco do Sul;4314902;Porto Alegre;3;3;6;483
4219309;Videira;4314902;Porto Alegre;3;3;6;337
4219507;Xanxerê;4314902;Porto Alegre;3;3;6;372
4302303;Bom Jesus;4314902;Porto Alegre;3;3;6;170
4302352;Bom Princípio;4314902;Porto Alegre;3;3;6;64
4302907;Cacequi;4314902;Porto Alegre;3;3;6;351
4303608;Cambará do Sul;4314902;Porto Alegre;3;3;6;151
4304309;Cândido Godói;4314902;Porto Alegre;3;3;6;411
4305207;Cerro Largo;4314902;Porto Alegre;3;3;6;398
4305306;Chapada;4314902;Porto Alegre;3;3;6;284
4305405;Chiapetta;4314902;Porto Alegre;3;3;6;352
4305603;Colorado;4314902;Porto Alegre;3;3;6;241
4306502;Dom Feliciano;4314902;Porto Alegre;3;3;6;114
4307104;Herval;4314902;Porto Alegre;3;3;6;306
4307302;Erval Seco;4314902;Porto Alegre;3;3;6;354
4307401;Esmeralda;4314902;Porto Alegre;3;3;6;222
4308904;Getúlio Vargas;4314902;Porto Alegre;3;3;6;261
4310504;Iraí;4314902;Porto Alegre;3;3;6;372
4310900;Jacutinga;4314902;Porto Alegre;3;3;6;287
4311908;Marcelino Ramos;4314902;Porto Alegre;3;3;6;294
4312203;Maximiliano de Almeida;4314902;Porto Alegre;3;3;6;274
4312609;Muçum;4314902;Porto Alegre;3;3;6;121
4312807;Nova Araçá;4314902;Porto Alegre;3;3;6;163
4313003;Nova Bréscia;4314902;Porto Alegre;3;3;6;122
4313086;Nova Pádua;4314902;Porto Alegre;3;3;6;114
4313102;Nova Palma;4314902;Porto Alegre;3;3;6;227
4313359;Nova Roma do Sul;4314902;Porto Alegre;3;3;6;119
4314001;Paraí;4314902;Porto Alegre;3;3;6;171
4314159;Paverama;4314902;Porto Alegre;3;3;6;75
4314605;Piratini;4314902;Porto Alegre;3;3;6;241
3550308;São Paulo;4314803;Portão;3;3;6;798
4304689;Capela de Santana;4314803;Portão;3;3;6;8
4307906;Farroupilha;4314803;Portão;3;3;6;54
4312401;Montenegro;4314803;Portão;3;3;6;25
4305850;Coqueiros do Sul;4314779;Pontão;3;3;6;12
4304358;Candiota;4314506;Pinheiro Machado;3;3;6;29
3505708;Barueri;4314464;Pinhal da Serra;3;3;6;637
2304400;Fortaleza;4314407;Pelotas;3;3;6;3326
2927408;Salvador;4314407;Pelotas;3;3;6;2413
3518800;Guarulhos;4314407;Pelotas;3;3;6;1061
4306056;Cristal;4314407;Pelotas;3;3;6;86
4306601;Dom Pedrito;4314407;Pelotas;3;3;6;232
4314209;Pedro Osório;4314407;Pelotas;3;3;6;46
4306106;Cruz Alta;4314308;Pejuçara;3;3;6;25
4307005;Erechim;4314134;Paulo Bento;3;3;6;16
3509502;Campinas;4314100;Passo Fundo;3;3;6;784
4118501;Pato Branco;4314100;Passo Fundo;3;3;6;226
4125506;São José dos Pinhais;4314100;Passo Fundo;3;3;6;433
4203600;Campos Novos;4314100;Passo Fundo;3;3;6;148
4300802;Antônio Prado;4314100;Passo Fundo;3;3;6;128
4302709;Butiá;4314100;Passo Fundo;3;3;6;210
4305801;Constantina;4314100;Passo Fundo;3;3;6;82
4305975;Coxilha;4314100;Passo Fundo;3;3;6;17
4307807;Estrela;4314100;Passo Fundo;3;3;6;145
4313300;Nova Prata;4314100;Passo Fundo;3;3;6;97
4305108;Caxias do Sul;4314050;Parobé;3;3;6;61
4302709;Butiá;4313953;Pantano Grande;3;3;6;40
3518800;Guarulhos;4313904;Panambi;3;3;6;856
3550308;São Paulo;4313904;Panambi;3;3;6;835
4304606;Canoas;4313904;Panambi;3;3;6;292
4310009;Ibirubá;4313904;Panambi;3;3;6;56
4310207;Ijuí;4313706;Palmeira das Missões;3;3;6;80
4313508;Osório;4313656;Palmares do Sul;3;3;6;48
3304557;Rio de Janeiro;4313508;Osório;3;3;6;1016
4305306;Chapada;4313490;Novo Barreiro;3;3;6;17
2930709;Simões Filho;4313409;Novo Hamburgo;3;3;6;2203
3145208;Nova Serrana;4313409;Novo Hamburgo;3;3;6;1228
3518800;Guarulhos;4313409;Novo Hamburgo;3;3;6;815
3525904;Jundiaí;4313409;Novo Hamburgo;3;3;6;823
3552809;Taboão da Serra;4313409;Novo Hamburgo;3;3;6;790
3556701;Vinhedo;4313409;Novo Hamburgo;3;3;6;835
4208203;Itajaí;4313409;Novo Hamburgo;3;3;6;380
4302105;Bento Gonçalves;4313409;Novo Hamburgo;3;3;6;69
4313060;Nova Hartz;4313409;Novo Hamburgo;3;3;6;25
2602902;Cabo de Santo Agostinho;4313300;Nova Prata;3;3;6;2734
4310801;Ivoti;4313201;Nova Petrópolis;3;3;6;24
4300877;Araricá;4313060;Nova Hartz;3;3;6;5
4306403;Dois Irmãos;4313060;Nova Hartz;3;3;6;18
4306809;Encantado;4313003;Nova Bréscia;3;3;6;12
4204350;Cordilheira Alta;4312708;Nonoai;3;3;6;44
4300471;Almirante Tamandaré do Sul;4312658;Não-Me-Toque;3;3;6;39
4311809;Marau;4312658;Não-Me-Toque;3;3;6;61
4304507;Canguçu;4312450;Morro Redondo;3;3;6;21
4304689;Capela de Santana;4312401;Montenegro;3;3;6;17
4302105;Bento Gonçalves;4312385;Monte Belo do Sul;3;3;6;14
4307005;Erechim;4312005;Mariano Moro;3;3;6;33
4303558;Camargo;4311809;Marau;3;3;6;15
4307005;Erechim;4311809;Marau;3;3;6;91
4308854;Gentil;4311809;Marau;3;3;6;16
4311304;Lagoa Vermelha;4311809;Marau;3;3;6;71
4302659;Brochier;4311791;Maratá;3;3;6;4
4306403;Dois Irmãos;4311627;Lindolfo Collor;3;3;6;14
3518800;Guarulhos;4311403;Lajeado;3;3;6;842
4301602;Bagé;4311403;Lajeado;3;3;6;293
4303509;Camaquã;4311403;Lajeado;3;3;6;157
4304630;Capão da Canoa;4311403;Lajeado;3;3;6;196
4306106;Cruz Alta;4311403;Lajeado;3;3;6;175
4306403;Dois Irmãos;4311403;Lajeado;3;3;6;93
4307005;Erechim;4311304;Lagoa Vermelha;3;3;6;97
4302303;Bom Jesus;4311122;Jaquirana;3;3;6;25
4307005;Erechim;4310462;Ipiranga do Sul;3;3;6;37
4300802;Antônio Prado;4310439;Ipê;3;3;6;6
4304630;Capão da Canoa;4310330;Imbé;3;3;6;26
4301404;Arvorezinha;4310306;Ilópolis;3;3;6;8
3304557;Rio de Janeiro;4310207;Ijuí;3;3;6;1190
4208203;Itajaí;4310207;Ijuí;3;3;6;529
4306809;Encantado;4310207;Ijuí;3;3;6;219
4309605;Horizontina;4310207;Ijuí;3;3;6;93
3304557;Rio de Janeiro;4310108;Igrejinha;3;3;6;1026
4305108;Caxias do Sul;4310108;Igrejinha;3;3;6;59
4309258;Guabiju;4309902;Ibiraiaras;3;3;6;20
4305108;Caxias do Sul;4309605;Horizontina;3;3;6;355
4301057;Arroio do Sal;4309407;Guaporé;3;3;6;211
4305108;Caxias do Sul;4309407;Guaporé;3;3;6;80
4306809;Encantado;4309407;Guaporé;3;3;6;43
3548708;São Bernardo do Campo;4309308;Guaíba;3;3;6;837
4301909;Barra do Ribeiro;4309308;Guaíba;3;3;6;21
3106705;Betim;4309209;Gravataí;3;3;6;1273
4305454;Cidreira;4309209;Gravataí;3;3;6;77
4309050;Glorinha;4309209;Gravataí;3;3;6;22
4303103;Cachoeirinha;4309100;Gramado;3;3;6;64
4104808;Cascavel;4308508;Frederico Westphalen;3;3;6;268
4212106;Palmitos;4308508;Frederico Westphalen;3;3;6;40
4307906;Farroupilha;4308508;Frederico Westphalen;3;3;6;291
4301404;Arvorezinha;4308300;Fontoura Xavier;3;3;6;21
1302603;Manaus;4307906;Farroupilha;3;3;6;2996
3525904;Jundiaí;4307906;Farroupilha;3;3;6;791
4118501;Pato Branco;4307906;Farroupilha;3;3;6;355
4208203;Itajaí;4307906;Farroupilha;3;3;6;355
4218707;Tubarão;4307906;Farroupilha;3;3;6;237
4303509;Camaquã;4307906;Farroupilha;3;3;6;185
4304408;Canela;4307906;Farroupilha;3;3;6;53
4307807;Estrela;4307906;Farroupilha;3;3;6;68
4305207;Cerro Largo;4307831;Eugênio de Castro;3;3;6;70
4306809;Encantado;4307807;Estrela;3;3;6;31
2607901;Jaboatão dos Guararapes;4307708;Esteio;3;3;6;2815
3534401;Osasco;4307708;Esteio;3;3;6;812
4217709;Sombrio;4307708;Esteio;3;3;6;168
3550308;São Paulo;4307609;Estância Velha;3;3;6;789
4304606;Canoas;4307609;Estância Velha;3;3;6;29
4304705;Carazinho;4307500;Espumoso;3;3;6;48
3518800;Guarulhos;4307005;Erechim;3;3;6;723
4106902;Curitiba;4307005;Erechim;3;3;6;380
4305116;Centenário;4307005;Erechim;3;3;6;31
4306957;Entre Rios do Sul;4307005;Erechim;3;3;6;46
4306973;Erebango;4307005;Erechim;3;3;6;25
4302709;Butiá;4306908;Encruzilhada do Sul;3;3;6;71
4304697;Capitão;4306809;Encantado;3;3;6;9
4106902;Curitiba;4306767;Eldorado do Sul;3;3;6;560
4303103;Cachoeirinha;4306403;Dois Irmãos;3;3;6;41
4304606;Canoas;4306403;Dois Irmãos;3;3;6;38
3304557;Rio de Janeiro;4306106;Cruz Alta;3;3;6;1175
4303509;Camaquã;4306056;Cristal;3;3;6;29
3304557;Rio de Janeiro;4305355;Charqueadas;3;3;6;1108
4303301;Caibaté;4305207;Cerro Largo;3;3;6;19
4304200;Candelária;4305132;Cerro Branco;3;3;6;15
3106705;Betim;4305108;Caxias do Sul;3;3;6;1211
3205002;Serra;4305108;Caxias do Sul;3;3;6;1428
3509700;Campos do Jordão;4305108;Caxias do Sul;3;3;6;889
3538709;Piracicaba;4305108;Caxias do Sul;3;3;6;784
3556206;Valinhos;4305108;Caxias do Sul;3;3;6;792
4104808;Cascavel;4305108;Caxias do Sul;3;3;6;515
4301602;Bagé;4305108;Caxias do Sul;3;3;6;375
4302352;Bom Princípio;4305108;Caxias do Sul;3;3;6;40
4301008;Arroio do Meio;4304697;Capitão;3;3;6;15
3550308;São Paulo;4304630;Capão da Canoa;3;3;6;748
1302603;Manaus;4304606;Canoas;3;3;6;3071
3205002;Serra;4304606;Canoas;3;3;6;1481
3301702;Duque de Caxias;4304606;Canoas;3;3;6;1082
3515004;Embu;4304606;Canoas;3;3;6;804
3526902;Limeira;4304606;Canoas;3;3;6;888
3536505;Paulínia;4304606;Canoas;3;3;6;877
4105805;Colombo;4304606;Canoas;3;3;6;548
4211900;Palhoça;4304606;Canoas;3;3;6;343
2611606;Recife;4303905;Campo Bom;3;3;6;2799
3516200;Franca;4303905;Campo Bom;3;3;6;1068
4301602;Bagé;4303509;Camaquã;3;3;6;226
4303103;Cachoeirinha;4303509;Camaquã;3;3;6;119
4113700;Londrina;4303103;Cachoeirinha;3;3;6;737
4209102;Joinville;4303103;Cachoeirinha;3;3;6;459
4209300;Lages;4303103;Cachoeirinha;3;3;6;249
4219309;Videira;4303103;Cachoeirinha;3;3;6;326
3518800;Guarulhos;4302105;Bento Gonçalves;3;3;6;789
4209102;Joinville;4302105;Bento Gonçalves;3;3;6;408
4209300;Lages;4302105;Bento Gonçalves;3;3;6;189
3550308;São Paulo;4300406;Alegrete;3;3;6;1094
4104808;Cascavel;4219507;Xanxerê;3;3;6;236
4108403;Francisco Beltrão;4219507;Xanxerê;3;3;6;107
4213005;Pinheiro Preto;4219309;Videira;3;3;6;9
4118501;Pato Branco;4219176;Vargem Bonita;3;3;6;124
4217600;Siderópolis;4219002;Urussanga;3;3;6;12
4218707;Tubarão;4219002;Urussanga;3;3;6;33
4209300;Lages;4218954;Urupema;3;3;6;46
4216503;São Joaquim;4218905;Urubici;3;3;6;47
4207650;Iporã do Oeste;4218756;Tunápolis;3;3;6;11
2910800;Feira de Santana;4218707;Tubarão;3;3;6;2022
3518800;Guarulhos;4218707;Tubarão;3;3;6;608
4101804;Araucária;4218707;Tubarão;3;3;6;323
4214904;Rio Fortuna;4218707;Tubarão;3;3;6;40
4202859;Braço do Trombudo;4218608;Trombudo Central;3;3;6;11
4106902;Curitiba;4218301;Três Barras;3;3;6;127
4202404;Blumenau;4218251;Timbó Grande;3;3;6;163
4202909;Brusque;4218202;Timbó;3;3;6;45
4214805;Rio do Sul;4218202;Timbó;3;3;6;55
4215109;Rodeio;4218202;Timbó;3;3;6;13
3106200;Belo Horizonte;4218004;Tijucas;3;3;6;928
4210506;Maravilha;4217956;Tigrinhos;3;3;6;9
4204806;Curitibanos;4217808;Taió;3;3;6;59
4206900;Ibirama;4217808;Taió;3;3;6;52
4211751;Otacílio Costa;4217808;Taió;3;3;6;42
4115200;Maringá;4217709;Sombrio;3;3;6;664
4207007;Içara;4217709;Sombrio;3;3;6;55
4207502;Indaial;4217709;Sombrio;3;3;6;247
4211603;Nova Veneza;4217600;Siderópolis;3;3;6;7
4210902;Modelo;4217550;Serra Alta;3;3;6;6
4204707;Cunha Porã;4217303;Saudades;3;3;6;17
4216008;São Carlos;4217303;Saudades;3;3;6;16
3550308;São Paulo;4217204;São Miguel do Oeste;3;3;6;757
4118501;Pato Branco;4217204;São Miguel do Oeste;3;3;6;102
4201505;Armazém;4217105;São Martinho;3;3;6;11
4211702;Orleans;4217006;São Ludgero;3;3;6;14
4104808;Cascavel;4216909;São Lourenço do Oeste;3;3;6;168
4106902;Curitiba;4216909;São Lourenço do Oeste;3;3;6;372
4107207;Dois Vizinhos;4216909;São Lourenço do Oeste;3;3;6;73
4203501;Campo Erê;4216909;São Lourenço do Oeste;3;3;6;20
4214201;Quilombo;4216909;São Lourenço do Oeste;3;3;6;42
4206405;Guaraciaba;4216701;São José do Cedro;3;3;6;16
4214151;Princesa;4216701;São José do Cedro;3;3;6;7
3170206;Uberlândia;4216602;São José;3;3;6;962
4203204;Camboriú;4216602;São José;3;3;6;61
4206009;Governador Celso Ramos;4216602;São José;3;3;6;31
4205407;Florianópolis;4216305;São João Batista;3;3;6;48
4207650;Iporã do Oeste;4216255;São João do Oeste;3;3;6;14
3201308;Cariacica;4216206;São Francisco do Sul;3;3;6;1041
4201307;Araquari;4216206;São Francisco do Sul;3;3;6;19
4208450;Itapoá;4216206;São Francisco do Sul;3;3;6;20
4208906;Jaraguá do Sul;4216206;São Francisco do Sul;3;3;6;51
4215505;Santa Cecília;4216057;São Cristovão do Sul;3;3;6;32
4200507;Águas de Chapecó;4216008;São Carlos;3;3;6;3
4204509;Corupá;4215802;São Bento do Sul;3;3;6;23
4208203;Itajaí;4215802;São Bento do Sul;3;3;6;98
4117602;Palmas;4215505;Santa Cecília;3;3;6;158
4213708;Pouso Redondo;4215505;Santa Cecília;3;3;6;62
4200408;Água Doce;4215406;Salto Veloso;3;3;6;18
4214805;Rio do Sul;4215307;Salete;3;3;6;48
1302603;Manaus;4215000;Rio Negrinho;3;3;6;2746
4101804;Araucária;4215000;Rio Negrinho;3;3;6;75
4112009;Jaguariaíva;4215000;Rio Negrinho;3;3;6;220
4122305;Rio Negro;4215000;Rio Negrinho;3;3;6;32
4201307;Araquari;4215000;Rio Negrinho;3;3;6;74
4205407;Florianópolis;4215000;Rio Negrinho;3;3;6;179
4209300;Lages;4215000;Rio Negrinho;3;3;6;190
4206108;Grão Pará;4214904;Rio Fortuna;3;3;6;16
4201703;Ascurra;4214805;Rio do Sul;3;3;6;37
4201901;Aurora;4214805;Rio do Sul;3;3;6;9
4203006;Caçador;4214805;Rio do Sul;3;3;6;154
4204806;Curitibanos;4214805;Rio do Sul;3;3;6;98
4205902;Gaspar;4214805;Rio do Sul;3;3;6;73
4206504;Guaramirim;4214805;Rio do Sul;3;3;6;104
4209151;José Boiteux;4214805;Rio do Sul;3;3;6;31
4202404;Blumenau;4214706;Rio dos Cedros;3;3;6;31
4209508;Laurentino;4214607;Rio do Oeste;3;3;6;7
4205407;Florianópolis;4214300;Rancho Queimado;3;3;6;51
4205431;Formosa do Sul;4214201;Quilombo;3;3;6;11
4207858;Irati;4214201;Quilombo;3;3;6;19
4203006;Caçador;4213708;Pouso Redondo;3;3;6;125
3550308;São Paulo;4213609;Porto União;3;3;6;523
4108403;Francisco Beltrão;4213609;Porto União;3;3;6;202
4207908;Irineópolis;4213609;Porto União;3;3;6;25
4202008;Balneário Camboriú;4213500;Porto Belo;3;3;6;21
4204558;Correia Pinto;4213302;Ponte Alta;3;3;6;11
4202909;Brusque;4213203;Pomerode;3;3;6;47
4204301;Concórdia;4213104;Piratuba;3;3;6;33
4207601;Ipira;4213104;Piratuba;3;3;6;4
4202404;Blumenau;4212809;Piçarras;3;3;6;41
4205407;Florianópolis;4212809;Piçarras;3;3;6;95
4208500;Ituporanga;4212700;Petrolândia;3;3;6;17
4211900;Palhoça;4212304;Paulo Lopes;3;3;6;35
4202073;Balneário Gaivota;4212254;Passo de Torres;3;3;6;16
3518800;Guarulhos;4211900;Palhoça;3;3;6;512
4113700;Londrina;4211900;Palhoça;3;3;6;535
4202008;Balneário Camboriú;4211900;Palhoça;3;3;6;73
4204202;Chapecó;4211900;Palhoça;3;3;6;387
4204608;Criciúma;4211900;Palhoça;3;3;6;129
4207007;Içara;4211900;Palhoça;3;3;6;131
4209300;Lages;4211900;Palhoça;3;3;6;158
4209003;Joaçaba;4211801;Ouro;3;3;6;21
4204806;Curitibanos;4211751;Otacílio Costa;3;3;6;53
4201406;Araranguá;4211702;Orleans;3;3;6;70
4203204;Camboriú;4211306;Navegantes;3;3;6;17
4205902;Gaspar;4211306;Navegantes;3;3;6;29
4203808;Canoinhas;4211108;Monte Castelo;3;3;6;34
4203105;Caibi;4211009;Mondaí;3;3;6;17
4210506;Maravilha;4211009;Mondaí;3;3;6;46
4127601;Tijucas do Sul;4210803;Meleiro;3;3;6;324
4205407;Florianópolis;4210605;Massaranduba;3;3;6;119
4209102;Joinville;4210605;Massaranduba;3;3;6;39
4202909;Brusque;4210407;Maracajá;3;3;6;201
4125605;São Mateus do Sul;4210100;Mafra;3;3;6;64
4128203;União da Vitória;4210100;Mafra;3;3;6;132
4206504;Guaramirim;4210100;Mafra;3;3;6;91
4206900;Ibirama;4209904;Lontras;3;3;6;12
4207700;Ipumirim;4209854;Lindóia do Sul;3;3;6;7
4203600;Campos Novos;4209706;Lebon Régis;3;3;6;76
3106200;Belo Horizonte;4209300;Lages;3;3;6;1065
4101804;Araucária;4209300;Lages;3;3;6;262
4104808;Cascavel;4209300;Lages;3;3;6;439
4115200;Maringá;4209300;Lages;3;3;6;508
4118501;Pato Branco;4209300;Lages;3;3;6;287
4208302;Itapema;4209300;Lages;3;3;6;184
2905701;Camaçari;4209102;Joinville;3;3;6;1810
3300407;Barra Mansa;4209102;Joinville;3;3;6;619
3513009;Cotia;4209102;Joinville;3;3;6;353
3513801;Diadema;4209102;Joinville;3;3;6;363
3543402;Ribeirão Preto;4209102;Joinville;3;3;6;577
4101408;Apucarana;4209102;Joinville;3;3;6;395
4109609;Guaratuba;4209102;Joinville;3;3;6;42
4128104;Umuarama;4209102;Joinville;3;3;6;522
4203808;Canoinhas;4209102;Joinville;3;3;6;155
4106902;Curitiba;4209003;Joaçaba;3;3;6;292
4127700;Toledo;4209003;Joaçaba;3;3;6;346
4204806;Curitibanos;4209003;Joaçaba;3;3;6;94
4205308;Faxinal dos Guedes;4209003;Joaçaba;3;3;6;78
4119103;Piên;4208906;Jaraguá do Sul;3;3;6;55
4125506;São José dos Pinhais;4208906;Jaraguá do Sul;3;3;6;105
4205902;Gaspar;4208906;Jaraguá do Sul;3;3;6;51
4201406;Araranguá;4208807;Jaguaruna;3;3;6;58
4204608;Criciúma;4208708;Jacinto Machado;3;3;6;52
4204806;Curitibanos;4208500;Ituporanga;3;3;6;100
4115705;Matinhos;4208450;Itapoá;3;3;6;34
4119954;Pontal do Paraná;4208450;Itapoá;3;3;6;51
4106902;Curitiba;4208302;Itapema;3;3;6;194
4203709;Canelinha;4208302;Itapema;3;3;6;24
3106705;Betim;4208203;Itajaí;3;3;6;890
3205101;Viana;4208203;Itajaí;3;3;6;1073
3205200;Vila Velha;4208203;Itajaí;3;3;6;1092
3306305;Volta Redonda;4208203;Itajaí;3;3;6;669
3512803;Cosmópolis;4208203;Itajaí;3;3;6;499
3522208;Itapecerica da Serra;4208203;Itajaí;3;3;6;403
3529401;Mauá;4208203;Itajaí;3;3;6;426
3543402;Ribeirão Preto;4208203;Itajaí;3;3;6;648
4104808;Cascavel;4208203;Itajaí;3;3;6;513
4202453;Bombinhas;4208203;Itajaí;3;3;6;31
4203006;Caçador;4208203;Itajaí;3;3;6;233
4205407;Florianópolis;4208005;Itá;3;3;6;382
4201273;Arabutã;4207700;Ipumirim;3;3;6;9
3518800;Guarulhos;4207502;Indaial;3;3;6;464
4204608;Criciúma;4207502;Indaial;3;3;6;196
4205407;Florianópolis;4207502;Indaial;3;3;6;105
4206900;Ibirama;4207502;Indaial;3;3;6;33
4204608;Criciúma;4207304;Imbituba;3;3;6;82
4202404;Blumenau;4207106;Ilhota;3;3;6;26
4205407;Florianópolis;4207106;Ilhota;3;3;6;83
4201257;Apiúna;4206900;Ibirama;3;3;6;13
4201703;Ascurra;4206900;Ibirama;3;3;6;16
4203600;Campos Novos;4206702;Herval d'Oeste;3;3;6;38
4204301;Concórdia;4206702;Herval d'Oeste;3;3;6;52
4202800;Braço do Norte;4206207;Gravatal;3;3;6;14
4205407;Florianópolis;4206207;Gravatal;3;3;6;96
4202800;Braço do Norte;4206108;Grão Pará;3;3;6;13
4202008;Balneário Camboriú;4205902;Gaspar;3;3;6;28
4106902;Curitiba;4205803;Garuva;3;3;6;79
4119905;Ponta Grossa;4205803;Garuva;3;3;6;166
3550308;São Paulo;4205704;Garopaba;3;3;6;522
4204806;Curitibanos;4205506;Fraiburgo;3;3;6;42
1100205;Porto Velho;4205407;Florianópolis;3;3;6;2528
2104057;Estreito;4205407;Florianópolis;3;3;6;2329
2408102;Natal;4205407;Florianópolis;3;3;6;2708
3170206;Uberlândia;4205407;Florianópolis;3;3;6;963
3513009;Cotia;4205407;Florianópolis;3;3;6;468
3543402;Ribeirão Preto;4205407;Florianópolis;3;3;6;717
3548708;São Bernardo do Campo;4205407;Florianópolis;3;3;6;469
4200705;Alfredo Wagner;4205407;Florianópolis;3;3;6;82
4202107;Barra Velha;4205407;Florianópolis;3;3;6;109
4202602;Bom Retiro;4205407;Florianópolis;3;3;6;99
4203600;Campos Novos;4205407;Florianópolis;3;3;6;267
4204301;Concórdia;4205308;Faxinal dos Guedes;3;3;6;47
4106902;Curitiba;4204806;Curitibanos;3;3;6;241
4200200;Agrolândia;4204806;Curitibanos;3;3;6;78
4203907;Capinzal;4204806;Curitibanos;3;3;6;100
4204558;Correia Pinto;4204806;Curitibanos;3;3;6;42
4204707;Cunha Porã;4204756;Cunhataí;3;3;6;11
3157807;Santa Luzia;4204608;Criciúma;3;3;6;1115
3523404;Itatiba;4204608;Criciúma;3;3;6;672
3546702;Santa Gertrudes;4204608;Criciúma;3;3;6;710
4201950;Balneário Arroio do Silva;4204608;Criciúma;3;3;6;33
2611606;Recife;4204301;Concórdia;3;3;6;2652
3509502;Campinas;4204301;Concórdia;3;3;6;680
4108403;Francisco Beltrão;4204301;Concórdia;3;3;6;162
4118501;Pato Branco;4204301;Concórdia;3;3;6;127
4119905;Ponta Grossa;4204301;Concórdia;3;3;6;296
3550308;São Paulo;4204251;Cocal do Sul;3;3;6;605
2304400;Fortaleza;4204202;Chapecó;3;3;6;2899
3509502;Campinas;4204202;Chapecó;3;3;6;715
4113700;Londrina;4204202;Chapecó;3;3;6;446
4202305;Biguaçu;4204202;Chapecó;3;3;6;392
4203600;Campos Novos;4204202;Chapecó;3;3;6;144
4203006;Caçador;4203907;Capinzal;3;3;6;79
4202404;Blumenau;4203808;Canoinhas;3;3;6;158
4203402;Campo Belo do Sul;4203600;Campos Novos;3;3;6;69
4108403;Francisco Beltrão;4203501;Campo Erê;3;3;6;34
3550308;São Paulo;4203204;Camboriú;3;3;6;424
3509502;Campinas;4203006;Caçador;3;3;6;585
4108403;Francisco Beltrão;4203006;Caçador;3;3;6;210
4108502;General Carneiro;4203006;Caçador;3;3;6;47
4117602;Palmas;4203006;Caçador;3;3;6;94
4118501;Pato Branco;4203006;Caçador;3;3;6;168
4202909;Brusque;4203006;Caçador;3;3;6;219
3501608;Americana;4202909;Brusque;3;3;6;506
4125506;São José dos Pinhais;4202909;Brusque;3;3;6;174
4201406;Araranguá;4202800;Braço do Norte;3;3;6;81
1302603;Manaus;4202404;Blumenau;3;3;6;2830
1501402;Belém;4202404;Blumenau;3;3;6;2829
3503802;Artur Nogueira;4202404;Blumenau;3;3;6;519
3509205;Cajamar;4202404;Blumenau;3;3;6;453
3522604;Itapira;4202404;Blumenau;3;3;6;546
3543402;Ribeirão Preto;4202404;Blumenau;3;3;6;654
3552809;Taboão da Serra;4202404;Blumenau;3;3;6;435
3556206;Valinhos;4202404;Blumenau;3;3;6;485
4101804;Araucária;4202404;Blumenau;3;3;6;154
4108304;Foz do Iguaçu;4202404;Blumenau;3;3;6;558
4200408;Água Doce;4202404;Blumenau;3;3;6;246
4201208;Antônio Carlos;4202305;Biguaçu;3;3;6;10
4106902;Curitiba;4201406;Araranguá;3;3;6;390
3550308;São Paulo;4201208;Antônio Carlos;3;3;6;476
4125704;São Miguel do Iguaçu;4128559;Vera Cruz do Oeste;3;3;6;49
3550308;São Paulo;4128500;Wenceslau Braz;3;3;6;324
4112009;Jaguariaíva;4128500;Wenceslau Braz;3;3;6;46
4125407;São José da Boa Vista;4128500;Wenceslau Braz;3;3;6;18
4126603;Siqueira Campos;4128500;Wenceslau Braz;3;3;6;20
4101903;Assaí;4128401;Uraí;3;3;6;20
4118501;Pato Branco;4128203;União da Vitória;3;3;6;151
4120309;Porto Vitória;4128203;União da Vitória;3;3;6;16
1100122;Ji-Paraná;4128104;Umuarama;3;3;6;1650
2933307;Vitória da Conquista;4128104;Umuarama;3;3;6;1580
4103479;Cafezal do Sul;4128104;Umuarama;3;3;6;30
4107256;Douradina;4128104;Umuarama;3;3;6;40
4108304;Foz do Iguaçu;4128104;Umuarama;3;3;6;231
4108403;Francisco Beltrão;4128104;Umuarama;3;3;6;261
4114708;Maria Helena;4128104;Umuarama;3;3;6;18
4119905;Ponta Grossa;4128104;Umuarama;3;3;6;357
4122404;Rolândia;4128104;Umuarama;3;3;6;204
4116703;Nova Aurora;4128005;Ubiratã;3;3;6;28
4103040;Boa Ventura de São Roque;4127965;Turvo;3;3;6;22
4123857;Santa Maria do Oeste;4127965;Turvo;3;3;6;36
4103057;Boa Vista da Aparecida;4127858;Três Barras do Paraná;3;3;6;23
3550308;São Paulo;4127809;Tomazina;3;3;6;336
4106308;Corbélia;4127700;Toledo;3;3;6;48
4109401;Guarapuava;4127700;Toledo;3;3;6;245
4113304;Laranjeiras do Sul;4127700;Toledo;3;3;6;152
4115804;Medianeira;4127700;Toledo;3;3;6;72
4117453;Ouro Verde do Oeste;4127700;Toledo;3;3;6;17
4118501;Pato Branco;4127700;Toledo;3;3;6;201
4127403;Terra Roxa;4127700;Toledo;3;3;6;71
3550308;São Paulo;4127502;Tibagi;3;3;6;392
4100509;Altônia;4127403;Terra Roxa;3;3;6;37
4110607;Iporã;4127403;Terra Roxa;3;3;6;43
4107504;Engenheiro Beltrão;4127205;Terra Boa;3;3;6;19
4101606;Arapoti;4127106;Telêmaco Borba;3;3;6;89
4101804;Araucária;4127106;Telêmaco Borba;3;3;6;187
4110706;Irati;4127007;Teixeira Soares;3;3;6;22
4117206;Nova Olímpia;4126900;Tapira;3;3;6;17
4115200;Maringá;4126801;Tapejara;3;3;6;102
4115200;Maringá;4126702;Tamboara;3;3;6;61
4117305;Ortigueira;4126678;Tamarana;3;3;6;56
3550308;São Paulo;4126603;Siqueira Campos;3;3;6;325
4124103;Santo Antônio da Platina;4126603;Siqueira Campos;3;3;6;52
4106407;Cornélio Procópio;4126504;Sertanópolis;3;3;6;41
4106902;Curitiba;4126504;Sertanópolis;3;3;6;319
4120507;Primeiro de Maio;4126504;Sertanópolis;3;3;6;23
3550308;São Paulo;4126256;Sarandi;3;3;6;535
4113700;Londrina;4126256;Sarandi;3;3;6;75
4113700;Londrina;4126207;Sapopema;3;3;6;89
4115200;Maringá;4126108;São Tomé;3;3;6;69
4101903;Assaí;4126009;São Sebastião da Amoreira;3;3;6;13
4106407;Cornélio Procópio;4126009;São Sebastião da Amoreira;3;3;6;33
4102505;Barbosa Ferraz;4125803;São Pedro do Ivaí;3;3;6;24
4107702;Fênix;4125803;São Pedro do Ivaí;3;3;6;14
3550308;São Paulo;4125704;São Miguel do Iguaçu;3;3;6;782
4105300;Céu Azul;4125704;São Miguel do Iguaçu;3;3;6;46
4123501;Santa Helena;4125704;São Miguel do Iguaçu;3;3;6;53
4104204;Campo Largo;4125605;São Mateus do Sul;3;3;6;95
4113908;Mallet;4125605;São Mateus do Sul;3;3;6;44
4119905;Ponta Grossa;4125605;São Mateus do Sul;3;3;6;84
2607901;Jaboatão dos Guararapes;4125506;São José dos Pinhais;3;3;6;2356
3520509;Indaiatuba;4125506;São José dos Pinhais;3;3;6;333
3545209;Salto;4125506;São José dos Pinhais;3;3;6;320
3548906;São Carlos;4125506;São José dos Pinhais;3;3;6;410
3549805;São José do Rio Preto;4125506;São José dos Pinhais;3;3;6;522
4101507;Arapongas;4125506;São José dos Pinhais;3;3;6;326
4104006;Campina Grande do Sul;4125506;São José dos Pinhais;3;3;6;29
4113205;Lapa;4125506;São José dos Pinhais;3;3;6;59
4119905;Ponta Grossa;4125100;São João do Triunfo;3;3;6;65
3541406;Presidente Prudente;4124509;Santo Inácio;3;3;6;75
4105904;Colorado;4124509;Santo Inácio;3;3;6;24
4101002;Ampére;4124400;Santo Antônio do Sudoeste;3;3;6;30
4120358;Pranchita;4124400;Santo Antônio do Sudoeste;3;3;6;6
4101507;Arapongas;4124103;Santo Antônio da Platina;3;3;6;137
4103602;Cambará;4124103;Santo Antônio da Platina;3;3;6;28
4104709;Carlópolis;4124103;Santo Antônio da Platina;3;3;6;42
4109005;Guapirama;4124103;Santo Antônio da Platina;3;3;6;25
4112801;Joaquim Távora;4124103;Santo Antônio da Platina;3;3;6;30
4121802;Ribeirão Claro;4124103;Santo Antônio da Platina;3;3;6;38
4104808;Cascavel;4124053;Santa Terezinha de Itaipu;3;3;6;113
3550308;São Paulo;4124020;Santa Tereza do Oeste;3;3;6;718
4119608;Pitanga;4123857;Santa Maria do Oeste;3;3;6;22
4107207;Dois Vizinhos;4123808;Santa Izabel do Oeste;3;3;6;44
4106902;Curitiba;4123501;Santa Helena;3;3;6;512
4109203;Guaraci;4123402;Santa Fé;3;3;6;17
4111902;Jaguapitã;4123402;Santa Fé;3;3;6;29
4113502;Loanda;4123303;Santa Cruz de Monte Castelo;3;3;6;16
4116950;Nova Esperança do Sudoeste;4123006;Salto do Lontra;3;3;6;14
4101903;Assaí;4122404;Rolândia;3;3;6;54
4105904;Colorado;4122404;Rolândia;3;3;6;80
4106407;Cornélio Procópio;4122404;Rolândia;3;3;6;74
4119608;Pitanga;4122404;Rolândia;3;3;6;166
4104105;Campo do Tenente;4122305;Rio Negro;3;3;6;18
4106902;Curitiba;4122305;Rio Negro;3;3;6;90
3550308;São Paulo;4122206;Rio Branco do Sul;3;3;6;316
4113700;Londrina;4121901;Ribeirão do Pinhal;3;3;6;82
4114401;Mangueirinha;4121752;Reserva do Iguaçu;3;3;6;19
4106902;Curitiba;4121703;Reserva;3;3;6;180
4108403;Francisco Beltrão;4121604;Renascença;3;3;6;12
4115408;Marmeleiro;4121604;Renascença;3;3;6;6
4118501;Pato Branco;4121604;Renascença;3;3;6;32
3550308;São Paulo;4121406;Realeza;3;3;6;724
4101002;Ampére;4121406;Realeza;3;3;6;17
4113304;Laranjeiras do Sul;4120903;Quedas do Iguaçu;3;3;6;43
3304557;Rio de Janeiro;4120804;Quatro Barras;3;3;6;642
4105805;Colombo;4120804;Quatro Barras;3;3;6;21
4119152;Pinhais;4120804;Quatro Barras;3;3;6;15
4104907;Castro;4120606;Prudentópolis;3;3;6;110
4100806;Alvorada do Sul;4120507;Primeiro de Maio;3;3;6;20
4119004;Pérola d'Oeste;4120358;Pranchita;3;3;6;22
4113304;Laranjeiras do Sul;4120150;Porto Barreiro;3;3;6;14
4102802;Bela Vista do Paraíso;4120002;Porecatu;3;3;6;33
4101804;Araucária;4119954;Pontal do Paraná;3;3;6;90
4109609;Guaratuba;4119954;Pontal do Paraná;3;3;6;33
2304400;Fortaleza;4119905;Ponta Grossa;3;3;6;2610
3522406;Itapeva;4119905;Ponta Grossa;3;3;6;179
3523206;Itararé;4119905;Ponta Grossa;3;3;6;139
4101408;Apucarana;4119905;Ponta Grossa;3;3;6;214
4109609;Guaratuba;4119905;Ponta Grossa;3;3;6;178
4111407;Ivaí;4119905;Ponta Grossa;3;3;6;71
4119004;Pérola d'Oeste;4119806;Planalto;3;3;6;12
4106902;Curitiba;4119608;Pitanga;3;3;6;260
3304557;Rio de Janeiro;4119509;Piraquara;3;3;6;644
3550308;São Paulo;4119202;Pinhalão;3;3;6;347
2304400;Fortaleza;4119152;Pinhais;3;3;6;2605
3518800;Guarulhos;4118501;Pato Branco;3;3;6;677
4104501;Capanema;4118501;Pato Branco;3;3;6;129
4113700;Londrina;4118501;Pato Branco;3;3;6;357
4114401;Mangueirinha;4118501;Pato Branco;3;3;6;58
4115200;Maringá;4118501;Pato Branco;3;3;6;318
3304557;Rio de Janeiro;4118402;Paranavaí;3;3;6;941
4100608;Alto Paraná;4118402;Paranavaí;3;3;6;13
3548708;São Bernardo do Campo;4118204;Paranaguá;3;3;6;285
4105805;Colombo;4118204;Paranaguá;3;3;6;78
4109807;Ibiporã;4118204;Paranaguá;3;3;6;357
4115200;Maringá;4118105;Paranacity;3;3;6;60
3550308;São Paulo;4117909;Palotina;3;3;6;728
4110607;Iporã;4117909;Palotina;3;3;6;34
4117222;Nova Santa Rosa;4117909;Palotina;3;3;6;24
4114401;Mangueirinha;4117602;Palmas;3;3;6;66
4105508;Cianorte;4117503;Paiçandu;3;3;6;61
4108403;Francisco Beltrão;4117255;Nova Prata do Iguaçu;3;3;6;58
4105607;Cidade Gaúcha;4117107;Nova Londrina;3;3;6;68
3550308;São Paulo;4117008;Nova Fátima;3;3;6;401
4106001;Congonhinhas;4117008;Nova Fátima;3;3;6;13
4106407;Cornélio Procópio;4117008;Nova Fátima;3;3;6;30
3550308;São Paulo;4116703;Nova Aurora;3;3;6;674
4110953;Itaipulândia;4116059;Missal;3;3;6;7
4114609;Marechal Cândido Rondon;4115804;Medianeira;3;3;6;81
4101507;Arapongas;4115754;Mauá da Serra;3;3;6;58
4107603;Faxinal;4115754;Mauá da Serra;3;3;6;15
4104808;Cascavel;4115606;Matelândia;3;3;6;63
4112108;Jandaia do Sul;4115507;Marumbi;3;3;6;11
1302603;Manaus;4115200;Maringá;3;3;6;2383
2408102;Natal;4115200;Maringá;3;3;6;2542
3134905;Jacutinga;4115200;Maringá;3;3;6;556
3170107;Uberaba;4115200;Maringá;3;3;6;575
3513504;Cubatão;4115200;Maringá;3;3;6;566
3525904;Jundiaí;4115200;Maringá;3;3;6;514
3547304;Santana de Parnaíba;4115200;Maringá;3;3;6;512
3548708;São Bernardo do Campo;4115200;Maringá;3;3;6;548
3552205;Sorocaba;4115200;Maringá;3;3;6;453
4102406;Bandeirantes;4115200;Maringá;3;3;6;163
4103602;Cambará;4115200;Maringá;3;3;6;194
4106308;Corbélia;4115200;Maringá;3;3;6;206
4106704;Cruzeiro do Sul;4115200;Maringá;3;3;6;57
4108809;Guaíra;4115200;Maringá;3;3;6;248
4110003;Iguaraçu;4115200;Maringá;3;3;6;28
4113502;Loanda;4115200;Maringá;3;3;6;135
3550308;São Paulo;4114807;Marialva;3;3;6;526
4112108;Jandaia do Sul;4114807;Marialva;3;3;6;20
4102000;Assis Chateaubriand;4114609;Marechal Cândido Rondon;3;3;6;56
4106902;Curitiba;4114609;Marechal Cândido Rondon;3;3;6;494
4108304;Foz do Iguaçu;4114609;Marechal Cândido Rondon;3;3;6;115
4106902;Curitiba;4114203;Mandaguari;3;3;6;324
4110706;Irati;4113908;Mallet;3;3;6;48
1100049;Cacoal;4113700;Londrina;3;3;6;1663
3170701;Varginha;4113700;Londrina;3;3;6;617
3500105;Adamantina;4113700;Londrina;3;3;6;179
3513009;Cotia;4113700;Londrina;3;3;6;435
3551009;São Vicente;4113700;Londrina;3;3;6;488
3555000;Tupã;4113700;Londrina;3;3;6;163
4105102;Centenário do Sul;4113700;Londrina;3;3;6;70
4105805;Colombo;4113700;Londrina;3;3;6;293
4106001;Congonhinhas;4113700;Londrina;3;3;6;67
4110706;Irati;4113700;Londrina;3;3;6;247
3550308;São Paulo;4113403;Leópolis;3;3;6;426
4104451;Cantagalo;4113304;Laranjeiras do Sul;3;3;6;37
4109401;Guarapuava;4113304;Laranjeiras do Sul;3;3;6;103
4101309;Antônio Olinto;4113205;Lapa;3;3;6;54
4102307;Balsa Nova;4113205;Lapa;3;3;6;22
4104204;Campo Largo;4113205;Lapa;3;3;6;39
4103305;Borrazópolis;4113106;Kaloré;3;3;6;16
4109708;Ibaiti;4112801;Joaquim Távora;3;3;6;49
4102000;Assis Chateaubriand;4112751;Jesuítas;3;3;6;14
4112108;Jandaia do Sul;4112504;Jardim Alegre;3;3;6;64
4102505;Barbosa Ferraz;4112108;Jandaia do Sul;3;3;6;61
4103305;Borrazópolis;4112108;Jandaia do Sul;3;3;6;38
4107702;Fênix;4112108;Jandaia do Sul;3;3;6;49
3522406;Itapeva;4112009;Jaguariaíva;3;3;6;88
4102109;Astorga;4111902;Jaguapitã;3;3;6;19
4101507;Arapongas;4111506;Ivaiporã;3;3;6;96
4110102;Imbituva;4111407;Ivaí;3;3;6;35
4100400;Almirante Tamandaré;4111258;Itaperuçu;3;3;6;13
4105904;Colorado;4110904;Itaguajé;3;3;6;24
4104303;Campo Mourão;4110805;Iretama;3;3;6;51
3550308;São Paulo;4110706;Irati;3;3;6;446
4100509;Altônia;4110607;Iporã;3;3;6;23
3505708;Barueri;4109807;Ibiporã;3;3;6;428
4101507;Arapongas;4109807;Ibiporã;3;3;6;43
4104808;Cascavel;4109807;Ibiporã;3;3;6;310
4104808;Cascavel;4109757;Ibema;3;3;6;48
4107751;Figueira;4109708;Ibaiti;3;3;6;22
3106200;Belo Horizonte;4109401;Guarapuava;3;3;6;956
4101408;Apucarana;4109401;Guarapuava;3;3;6;203
4106902;Curitiba;4109302;Guaraniaçu;3;3;6;363
4102000;Assis Chateaubriand;4108601;Goioerê;3;3;6;57
4105409;Chopinzinho;4108403;Francisco Beltrão;3;3;6;59
4107405;Enéas Marques;4108403;Francisco Beltrão;3;3;6;19
3506003;Bauru;4108304;Foz do Iguaçu;3;3;6;642
3548807;São Caetano do Sul;4108304;Foz do Iguaçu;3;3;6;819
4107207;Dois Vizinhos;4108304;Foz do Iguaçu;3;3;6;147
4104303;Campo Mourão;4107702;Fênix;3;3;6;44
4104600;Capitão Leônidas Marques;4107207;Dois Vizinhos;3;3;6;63
1100023;Ariquemes;4106902;Curitiba;3;3;6;2166
1100304;Vilhena;4106902;Curitiba;3;3;6;1749
1505502;Paragominas;4106902;Curitiba;3;3;6;2486
2602902;Cabo de Santo Agostinho;4106902;Curitiba;3;3;6;2340
2609600;Olinda;4106902;Curitiba;3;3;6;2372
2913606;Ilhéus;4106902;Curitiba;3;3;6;1538
2919207;Lauro de Freitas;4106902;Curitiba;3;3;6;1748
2919553;Luís Eduardo magalhães;4106902;Curitiba;3;3;6;1514
3144805;Nova Lima;4106902;Curitiba;3;3;6;804
3151800;Poços de Caldas;4106902;Curitiba;3;3;6;489
3200607;Aracruz;4106902;Curitiba;3;3;6;1085
3300407;Barra Mansa;4106902;Curitiba;3;3;6;600
3301900;Itaboraí;4106902;Curitiba;3;3;6;707
3304904;São Gonçalo;4106902;Curitiba;3;3;6;686
3305208;São Pedro da Aldeia;4106902;Curitiba;3;3;6;771
3502804;Araçatuba;4106902;Curitiba;3;3;6;480
3503307;Araras;4106902;Curitiba;3;3;6;390
3504008;Assis;4106902;Curitiba;3;3;6;327
3504503;Avaré;4106902;Curitiba;3;3;6;261
3506508;Birigui;4106902;Curitiba;3;3;6;469
3510203;Capão Bonito;4106902;Curitiba;3;3;6;184
3510609;Carapicuíba;4106902;Curitiba;3;3;6;324
3518701;Guarujá;4106902;Curitiba;3;3;6;344
3522208;Itapecerica da Serra;4106902;Curitiba;3;3;6;310
3522406;Itapeva;4106902;Curitiba;3;3;6;167
3525003;Jandira;4106902;Curitiba;3;3;6;319
3526209;Juquitiba;4106902;Curitiba;3;3;6;278
3526803;Lençóis Paulista;4106902;Curitiba;3;3;6;317
3527108;Lins;4106902;Curitiba;3;3;6;418
3527207;Lorena;4106902;Curitiba;3;3;6;515
3530805;Moji-Mirim;4106902;Curitiba;3;3;6;405
3531308;Monte Alto;4106902;Curitiba;3;3;6;466
3541307;Presidente Epitácio;4106902;Curitiba;3;3;6;492
3541406;Presidente Prudente;4106902;Curitiba;3;3;6;421
3545803;Santa Bárbara d'Oeste;4106902;Curitiba;3;3;6;351
3551702;Sertãozinho;4106902;Curitiba;3;3;6;493
4102000;Assis Chateaubriand;4106902;Curitiba;3;3;6;437
4102109;Astorga;4106902;Curitiba;3;3;6;340
4104659;Carambeí;4106902;Curitiba;3;3;6;99
4106001;Congonhinhas;4106902;Curitiba;3;3;6;244
4106605;Cruzeiro do Oeste;4106902;Curitiba;3;3;6;420
4106803;Cruz Machado;4106902;Curitiba;3;3;6;217
4105409;Chopinzinho;4106506;Coronel Vivida;3;3;6;16
3518305;Guararema;4106407;Cornélio Procópio;3;3;6;474
4103602;Cambará;4106407;Cornélio Procópio;3;3;6;62
4103453;Cafelândia;4106308;Corbélia;3;3;6;19
3301702;Duque de Caxias;4105805;Colombo;3;3;6;653
3548708;São Bernardo do Campo;4105805;Colombo;3;3;6;316
4101804;Araucária;4105805;Colombo;3;3;6;40
4104204;Campo Largo;4105805;Colombo;3;3;6;36
2304400;Fortaleza;4105508;Cianorte;3;3;6;2592
3518800;Guarulhos;4105508;Cianorte;3;3;6;616
3523206;Itararé;4104907;Castro;3;3;6;104
2910800;Feira de Santana;4104808;Cascavel;3;3;6;1986
3529005;Marília;4104808;Cascavel;3;3;6;463
4103354;Braganey;4104808;Cascavel;3;3;6;37
4103453;Cafelândia;4104808;Cascavel;3;3;6;39
3550308;São Paulo;4104709;Carlópolis;3;3;6;315
4101507;Arapongas;4104303;Campo Mourão;3;3;6;119
4104204;Campo Largo;4104253;Campo Magro;3;3;6;13
3505708;Barueri;4103701;Cambé;3;3;6;451
3509502;Campinas;4103701;Cambé;3;3;6;433
3541406;Presidente Prudente;4103701;Cambé;3;3;6;129
4101804;Araucária;4103701;Cambé;3;3;6;319
4102406;Bandeirantes;4103602;Cambará;3;3;6;31
4102703;Barra do Jacaré;4103602;Cambará;3;3;6;13
4101101;Andirá;4102703;Barra do Jacaré;3;3;6;9
3534302;Orlândia;4102406;Bandeirantes;3;3;6;365
4100103;Abatiá;4102406;Bandeirantes;3;3;6;22
2307650;Maracanaú;4101804;Araucária;3;3;6;2613
2611606;Recife;4101804;Araucária;3;3;6;2377
3136702;Juiz de Fora;4101804;Araucária;3;3;6;735
3525904;Jundiaí;4101804;Araucária;3;3;6;365
3547809;Santo André;4101804;Araucária;3;3;6;358
4101507;Arapongas;4101804;Araucária;3;3;6;315
3550308;São Paulo;4101606;Arapoti;3;3;6;327
3304557;Rio de Janeiro;4100400;Almirante Tamandaré;3;3;6;661
3550308;São Paulo;4100202;Adrianópolis;3;3;6;262
3501806;Américo de Campos;3557105;Votuporanga;3;3;6;31
3506508;Birigui;3557105;Votuporanga;3;3;6;103
3512902;Cosmorama;3557105;Votuporanga;3;3;6;22
3532603;Nhandeara;3557105;Votuporanga;3;3;6;29
3548807;São Caetano do Sul;3557105;Votuporanga;3;3;6;503
3106200;Belo Horizonte;3557006;Votorantim;3;3;6;529
3522307;Itapetininga;3557006;Votorantim;3;3;6;67
3537800;Piedade;3557006;Votorantim;3;3;6;21
3548807;São Caetano do Sul;3557006;Votorantim;3;3;6;85
3531308;Monte Alto;3556909;Vista Alegre do Alto;3;3;6;20
3531902;Morro Agudo;3556800;Viradouro;3;3;6;29
3503307;Araras;3556701;Vinhedo;3;3;6;85
3548500;Santos;3556701;Vinhedo;3;3;6;115
3548708;São Bernardo do Campo;3556701;Vinhedo;3;3;6;86
3523404;Itatiba;3556503;Várzea Paulista;3;3;6;23
3524006;Itupeva;3556503;Várzea Paulista;3;3;6;24
3516200;Franca;3556404;Vargem Grande do Sul;3;3;6;152
3530706;Mogi Guaçu;3556404;Vargem Grande do Sul;3;3;6;55
3546306;Santa Cruz das Palmeiras;3556404;Vargem Grande do Sul;3;3;6;37
3550308;São Paulo;3556305;Valparaíso;3;3;6;517
3501608;Americana;3556206;Valinhos;3;3;6;43
3506003;Bauru;3556206;Valinhos;3;3;6;224
3523404;Itatiba;3556206;Valinhos;3;3;6;17
3526902;Limeira;3556206;Valinhos;3;3;6;61
3545803;Santa Bárbara d'Oeste;3556206;Valinhos;3;3;6;49
3548500;Santos;3556206;Valinhos;3;3;6;122
3521507;Irapuã;3556008;Urupês;3;3;6;15
3533502;Novo Horizonte;3556008;Urupês;3;3;6;30
3550308;São Paulo;3556008;Urupês;3;3;6;387
3524808;Jales;3555802;Urânia;3;3;6;12
3550308;São Paulo;3555802;Urânia;3;3;6;568
3549805;São José do Rio Preto;3555604;Uchoa;3;3;6;27
3538006;Pindamonhangaba;3555406;Ubatuba;3;3;6;63
3548807;São Caetano do Sul;3555406;Ubatuba;3;3;6;149
3526001;Junqueirópolis;3555109;Tupi Paulista;3;3;6;21
3536406;Paulicéia;3555109;Tupi Paulista;3;3;6;28
3516705;Garça;3555000;Tupã;3;3;6;98
3550308;São Paulo;3554904;Três Fronteiras;3;3;6;587
3508504;Caçapava;3554805;Tremembé;3;3;6;23
3538709;Piracicaba;3554706;Torrinha;3;3;6;65
3512308;Conchas;3554508;Tietê;3;3;6;32
3522307;Itapetininga;3554508;Tietê;3;3;6;63
3513405;Cruzeiro;3554102;Taubaté;3;3;6;79
3523107;Itaquaquecetuba;3554102;Taubaté;3;3;6;95
3527207;Lorena;3554102;Taubaté;3;3;6;59
3548906;São Carlos;3554102;Taubaté;3;3;6;260
3301702;Duque de Caxias;3554003;Tatuí;3;3;6;467
3526407;Laranjal Paulista;3554003;Tatuí;3;3;6;33
3537503;Pereiras;3554003;Tatuí;3;3;6;33
3545209;Salto;3554003;Tatuí;3;3;6;59
3504503;Avaré;3553807;Taquarituba;3;3;6;58
3530508;Mococa;3553609;Tapiratiba;3;3;6;30
3543402;Ribeirão Preto;3553609;Tapiratiba;3;3;6;114
3530300;Mirassol;3553401;Tanabi;3;3;6;25
3531407;Monte Aprazível;3553401;Tanabi;3;3;6;18
3550308;São Paulo;3553302;Tambaú;3;3;6;225
3524303;Jaboticabal;3553104;Taiaçu;3;3;6;25
3538808;Piraju;3553005;Taguaí;3;3;6;29
3550308;São Paulo;3552908;Taciba;3;3;6;499
1302603;Manaus;3552809;Taboão da Serra;3;3;6;2608
2304400;Fortaleza;3552809;Taboão da Serra;3;3;6;2335
2607901;Jaboatão dos Guararapes;3552809;Taboão da Serra;3;3;6;2063
2927408;Salvador;3552809;Taboão da Serra;3;3;6;1432
3151800;Poços de Caldas;3552809;Taboão da Serra;3;3;6;203
3506003;Bauru;3552809;Taboão da Serra;3;3;6;272
3513801;Diadema;3552809;Taboão da Serra;3;3;6;19
3525003;Jandira;3552809;Taboão da Serra;3;3;6;15
3525904;Jundiaí;3552809;Taboão da Serra;3;3;6;48
3547809;Santo André;3552809;Taboão da Serra;3;3;6;26
3549904;São José dos Campos;3552809;Taboão da Serra;3;3;6;101
3519600;Ibitinga;3552700;Tabatinga;3;3;6;16
3522703;Itápolis;3552700;Tabatinga;3;3;6;19
3547809;Santo André;3552502;Suzano;3;3;6;25
1501402;Belém;3552403;Sumaré;3;3;6;2374
3106200;Belo Horizonte;3552403;Sumaré;3;3;6;465
3170107;Uberaba;3552403;Sumaré;3;3;6;347
3506003;Bauru;3552403;Sumaré;3;3;6;193
3524709;Jaguariúna;3552403;Sumaré;3;3;6;32
3550308;São Paulo;3552304;Sud Mennucci;3;3;6;557
2111300;São Luís;3552205;Sorocaba;3;3;6;2339
2611101;Petrolina;3552205;Sorocaba;3;3;6;1712
3118601;Contagem;3552205;Sorocaba;3;3;6;524
3503208;Araraquara;3552205;Sorocaba;3;3;6;200
3503307;Araras;3552205;Sorocaba;3;3;6;125
3513504;Cubatão;3552205;Sorocaba;3;3;6;119
3515004;Embu;3552205;Sorocaba;3;3;6;69
3522505;Itapevi;3552205;Sorocaba;3;3;6;57
3536505;Paulínia;3552205;Sorocaba;3;3;6;87
3537503;Pereiras;3552205;Sorocaba;3;3;6;66
3537909;Pilar do Sul;3552205;Sorocaba;3;3;6;43
3540606;Porto Feliz;3552205;Sorocaba;3;3;6;30
3551009;São Vicente;3552205;Sorocaba;3;3;6;119
3110509;Camanducaia;3552106;Socorro;3;3;6;43
3501905;Amparo;3552106;Socorro;3;3;6;27
3542602;Registro;3551801;Sete Barras;3;3;6;16
3170107;Uberaba;3551702;Sertãozinho;3;3;6;155
3513108;Cravinhos;3551702;Sertãozinho;3;3;6;35
3518800;Guarulhos;3551702;Sertãozinho;3;3;6;295
3547601;Santa Rosa de Viterbo;3551702;Sertãozinho;3;3;6;75
3501004;Altinópolis;3551504;Serrana;3;3;6;31
3516200;Franca;3551504;Serrana;3;3;6;77
3525102;Jardinópolis;3551504;Serrana;3;3;6;28
3547601;Santa Rosa de Viterbo;3551504;Serrana;3;3;6;38
3550308;São Paulo;3551504;Serrana;3;3;6;288
3550902;São Simão;3551504;Serrana;3;3;6;30
3528106;Macaubal;3551306;Sebastianópolis do Sul;3;3;6;17
3532603;Nhandeara;3551306;Sebastianópolis do Sul;3;3;6;13
3550308;São Paulo;3551207;Sarutaiá;3;3;6;293
3518800;Guarulhos;3551009;São Vicente;3;3;6;59
3550308;São Paulo;3550902;São Simão;3;3;6;258
3513900;Divinolândia;3550803;São Sebastião da Grama;3;3;6;10
3506359;Bertioga;3550704;São Sebastião;3;3;6;74
3548807;São Caetano do Sul;3550704;São Sebastião;3;3;6;116
3509502;Campinas;3550605;São Roque;3;3;6;70
3520509;Indaiatuba;3550605;São Roque;3;3;6;50
3501608;Americana;3550407;São Pedro;3;3;6;63
1100106;Guajará-Mirim;3550308;São Paulo;3;3;6;2324
1100189;Pimenta Bueno;3550308;São Paulo;3;3;6;1954
1100288;Rolim de Moura;3550308;São Paulo;3;3;6;1981
1503606;Itaituba;3550308;São Paulo;3;3;6;2334
1507953;Tailândia;3550308;São Paulo;3;3;6;2301
1508084;Tucumã;3550308;São Paulo;3;3;6;1921
1707009;Dianópolis;3550308;São Paulo;3;3;6;1330
1713205;Miracema do Tocantins;3550308;São Paulo;3;3;6;1570
2109007;Porto Franco;3550308;São Paulo;3;3;6;1915
2109601;Rosário;3550308;São Paulo;3;3;6;2306
2109908;Santa Inês;3550308;São Paulo;3;3;6;2195
2111201;São José de Ribamar;3550308;São Paulo;3;3;6;2350
2201150;Baixa Grande do Ribeiro;3550308;São Paulo;3;3;6;1754
2203909;Floriano;3550308;São Paulo;3;3;6;1897
2307700;Maranguape;3550308;São Paulo;3;3;6;2320
2309706;Pacatuba;3550308;São Paulo;3;3;6;2312
2412005;São Gonçalo do Amarante;3550308;São Paulo;3;3;6;2264
2414407;Touros;3550308;São Paulo;3;3;6;2311
2510808;Patos;3550308;São Paulo;3;3;6;2056
2607752;Itapissuma;3550308;São Paulo;3;3;6;2098
2613909;Serra Talhada;3550308;São Paulo;3;3;6;1920
2802106;Estância;3550308;São Paulo;3;3;6;1644
2802908;Itabaiana;3550308;São Paulo;3;3;6;1702
2803609;Laranjeiras;3550308;São Paulo;3;3;6;1700
2806107;Rosário do Catete;3550308;São Paulo;3;3;6;1718
2908101;Cocos;3550308;São Paulo;3;3;6;1069
2911709;Guanambi;3550308;São Paulo;3;3;6;1105
2917359;Jaborandi;3550308;São Paulo;3;3;6;1133
2923001;Nova Viçosa;3550308;São Paulo;3;3;6;961
2928604;Santo Amaro;3550308;São Paulo;3;3;6;1458
2928703;Santo Antônio de Jesus;3550308;São Paulo;3;3;6;1388
3101706;Almenara;3550308;São Paulo;3;3;6;1019
3108255;Bonito de Minas;3550308;São Paulo;3;3;6;941
3108404;Botelhos;3550308;São Paulo;3;3;6;225
3108909;Brasópolis;3550308;São Paulo;3;3;6;168
3109303;Buritis;3550308;São Paulo;3;3;6;888
3111408;Campo Florido;3550308;São Paulo;3;3;6;472
3113206;Carandaí;3550308;São Paulo;3;3;6;409
3120805;Cruzília;3550308;São Paulo;3;3;6;274
3121605;Diamantina;3550308;São Paulo;3;3;6;674
3130408;Ijaci;3550308;São Paulo;3;3;6;326
3130606;Inconfidentes;3550308;São Paulo;3;3;6;152
3135209;Januária;3550308;São Paulo;3;3;6;934
3138807;Luz;3550308;São Paulo;3;3;6;437
3144508;Nazareno;3550308;São Paulo;3;3;6;340
3145208;Nova Serrana;3550308;São Paulo;3;3;6;451
3147600;Passa Quatro;3550308;São Paulo;3;3;6;221
3152808;Prata;3550308;São Paulo;3;3;6;534
3161908;São Gonçalo do Rio Abaixo;3550308;São Paulo;3;3;6;538
3162906;São João Nepomuceno;3550308;São Paulo;3;3;6;437
3171105;Veríssimo;3550308;São Paulo;3;3;6;472
3303955;Pinheiral;3550308;São Paulo;3;3;6;297
3305554;Seropédica;3550308;São Paulo;3;3;6;316
3501103;Alto Alegre;3550308;São Paulo;3;3;6;423
3501301;Álvares Machado;3550308;São Paulo;3;3;6;519
3504305;Avaí;3550308;São Paulo;3;3;6;319
3504404;Avanhandava;3550308;São Paulo;3;3;6;413
3507308;Boracéia;3550308;São Paulo;3;3;6;270
3508108;Buritama;3550308;São Paulo;3;3;6;455
3508207;Buritizal;3550308;São Paulo;3;3;6;398
3509403;Cajuru;3550308;São Paulo;3;3;6;271
3509809;Campos Novos Paulista;3550308;São Paulo;3;3;6;360
3509957;Canas;3550308;São Paulo;3;3;6;193
3511003;Castilho;3550308;São Paulo;3;3;6;578
3512001;Colina;3550308;São Paulo;3;3;6;377
3512100;Colômbia;3550308;São Paulo;3;3;6;433
3514106;Dois Córregos;3550308;São Paulo;3;3;6;226
3514205;Dolcinópolis;3550308;São Paulo;3;3;6;555
3516002;Flórida Paulista;3550308;São Paulo;3;3;6;511
3516101;Florínia;3550308;São Paulo;3;3;6;424
3517604;Guapiara;3550308;São Paulo;3;3;6;201
3517802;Guaraçaí;3550308;São Paulo;3;3;6;544
3519105;Iacanga;3550308;São Paulo;3;3;6;310
3519253;Iaras;3550308;São Paulo;3;3;6;270
3519501;Ibirarema;3550308;São Paulo;3;3;6;360
3519808;Icém;3550308;São Paulo;3;3;6;447
3520806;Inúbia Paulista;3550308;São Paulo;3;3;6;484
3521101;Ipeúna;3550308;São Paulo;3;3;6;173
3521903;Itajobi;3550308;São Paulo;3;3;6;355
3522158;Itaóca;3550308;São Paulo;3;3;6;250
3523008;Itapura;3550308;São Paulo;3;3;6;593
3523305;Itariri;3550308;São Paulo;3;3;6;88
3524600;Jacupiranga;3550308;São Paulo;3;3;6;180
3526001;Junqueirópolis;3550308;São Paulo;3;3;6;539
3526506;Lavínia;3550308;São Paulo;3;3;6;522
3528601;Manduri;3550308;São Paulo;3;3;6;281
3529807;Mineiros do Tietê;3550308;São Paulo;3;3;6;229
3530904;Mombuca;3550308;São Paulo;3;3;6;123
3532207;Narandiba;3550308;São Paulo;3;3;6;514
3534104;Oriente;3550308;São Paulo;3;3;6;387
3535903;Paranapuã;3550308;São Paulo;3;3;6;562
3544608;Sabino;3550308;São Paulo;3;3;6;383
3546306;Santa Cruz das Palmeiras;3550308;São Paulo;3;3;6;211
3543402;Ribeirão Preto;3550100;São Manuel;3;3;6;192
2905701;Camaçari;3549904;São José dos Campos;3;3;6;1383
3132404;Itajubá;3549904;São José dos Campos;3;3;6;97
3147303;Paraisópolis;3549904;São José dos Campos;3;3;6;72
3502507;Aparecida;3549904;São José dos Campos;3;3;6;77
3506003;Bauru;3549904;São José dos Campos;3;3;6;340
3515004;Embu;3549904;São José dos Campos;3;3;6;111
3518701;Guarujá;3549904;São José dos Campos;3;3;6;93
3522505;Itapevi;3549904;São José dos Campos;3;3;6;115
3524907;Jambeiro;3549904;São José dos Campos;3;3;6;21
3531704;Monteiro Lobato;3549904;São José dos Campos;3;3;6;27
1302603;Manaus;3549805;São José do Rio Preto;3;3;6;2231
2408102;Natal;3549805;São José do Rio Preto;3;3;6;2187
3118601;Contagem;3549805;São José do Rio Preto;3;3;6;560
3170107;Uberaba;3549805;São José do Rio Preto;3;3;6;195
3504008;Assis;3549805;São José do Rio Preto;3;3;6;231
3519808;Icém;3549805;São José do Rio Preto;3;3;6;57
3525904;Jundiaí;3549805;São José do Rio Preto;3;3;6;369
3526704;Leme;3549805;São José do Rio Preto;3;3;6;258
3534005;Onda Verde;3549805;São José do Rio Preto;3;3;6;27
3534708;Ourinhos;3549805;São José do Rio Preto;3;3;6;245
3537305;Penápolis;3549805;São José do Rio Preto;3;3;6;97
3539608;Planalto;3549805;São José do Rio Preto;3;3;6;60
3543907;Rio Claro;3549805;São José do Rio Preto;3;3;6;260
3545209;Salto;3549805;São José do Rio Preto;3;3;6;344
3545803;Santa Bárbara d'Oeste;3549805;São José do Rio Preto;3;3;6;298
3546603;Santa Fé do Sul;3549805;São José do Rio Preto;3;3;6;178
3547304;Santana de Parnaíba;3549805;São José do Rio Preto;3;3;6;390
3516200;Franca;3549706;São José do Rio Pardo;3;3;6;128
3505906;Batatais;3549409;São Joaquim da Barra;3;3;6;42
3506102;Bebedouro;3549409;São Joaquim da Barra;3;3;6;79
3529708;Miguelópolis;3549409;São Joaquim da Barra;3;3;6;49
3531902;Morro Agudo;3549409;São Joaquim da Barra;3;3;6;24
3101607;Alfenas;3549102;São João da Boa Vista;3;3;6;108
3128709;Guaxupé;3549102;São João da Boa Vista;3;3;6;73
3304557;Rio de Janeiro;3549102;São João da Boa Vista;3;3;6;381
3503208;Araraquara;3549102;São João da Boa Vista;3;3;6;142
3518800;Guarulhos;3549102;São João da Boa Vista;3;3;6;165
3522604;Itapira;3549102;São João da Boa Vista;3;3;6;52
3530508;Mococa;3549102;São João da Boa Vista;3;3;6;59
3540705;Porto Ferreira;3549102;São João da Boa Vista;3;3;6;70
3507902;Brotas;3548906;São Carlos;3;3;6;37
3527108;Lins;3548906;São Carlos;3;3;6;198
3548708;São Bernardo do Campo;3548906;São Carlos;3;3;6;232
3548807;São Caetano do Sul;3548906;São Carlos;3;3;6;223
1302603;Manaus;3548807;São Caetano do Sul;3;3;6;2620
2928703;Santo Antônio de Jesus;3548807;São Caetano do Sul;3;3;6;1380
3118304;Conselheiro Lafaiete;3548807;São Caetano do Sul;3;3;6;429
3119401;Coronel Fabriciano;3548807;São Caetano do Sul;3;3;6;602
3122306;Divinópolis;3548807;São Caetano do Sul;3;3;6;418
3132404;Itajubá;3548807;São Caetano do Sul;3;3;6;173
3139409;Manhuaçu;3548807;São Caetano do Sul;3;3;6;588
3147907;Passos;3548807;São Caetano do Sul;3;3;6;322
3151800;Poços de Caldas;3548807;São Caetano do Sul;3;3;6;204
3152501;Pouso Alegre;3548807;São Caetano do Sul;3;3;6;167
3157807;Santa Luzia;3548807;São Caetano do Sul;3;3;6;506
3168606;Teófilo Otoni;3548807;São Caetano do Sul;3;3;6;814
3169901;Ubá;3548807;São Caetano do Sul;3;3;6;457
3170701;Varginha;3548807;São Caetano do Sul;3;3;6;261
3300209;Araruama;3548807;São Caetano do Sul;3;3;6;437
3300407;Barra Mansa;3548807;São Caetano do Sul;3;3;6;269
3300456;Belford Roxo;3548807;São Caetano do Sul;3;3;6;336
3300704;Cabo Frio;3548807;São Caetano do Sul;3;3;6;465
3304524;Rio das Ostras;3548807;São Caetano do Sul;3;3;6;486
3501905;Amparo;3548807;São Caetano do Sul;3;3;6;103
3503307;Araras;3548807;São Caetano do Sul;3;3;6;161
3504008;Assis;3548807;São Caetano do Sul;3;3;6;408
3506508;Birigui;3548807;São Caetano do Sul;3;3;6;460
3507605;Bragança Paulista;3548807;São Caetano do Sul;3;3;6;74
3510500;Caraguatatuba;3548807;São Caetano do Sul;3;3;6;113
3510609;Carapicuíba;3548807;São Caetano do Sul;3;3;6;29
3513405;Cruzeiro;3548807;São Caetano do Sul;3;3;6;199
3515509;Fernandópolis;3548807;São Caetano do Sul;3;3;6;524
3516309;Francisco Morato;3548807;São Caetano do Sul;3;3;6;42
3522208;Itapecerica da Serra;3548807;São Caetano do Sul;3;3;6;31
3523107;Itaquaquecetuba;3548807;São Caetano do Sul;3;3;6;27
3525003;Jandira;3548807;São Caetano do Sul;3;3;6;36
3527108;Lins;3548807;São Caetano do Sul;3;3;6;389
3527207;Lorena;3548807;São Caetano do Sul;3;3;6;179
3533908;Olímpia;3548807;São Caetano do Sul;3;3;6;396
3534708;Ourinhos;3548807;São Caetano do Sul;3;3;6;346
3543907;Rio Claro;3548807;São Caetano do Sul;3;3;6;168
2111300;São Luís;3548708;São Bernardo do Campo;3;3;6;2355
2507507;João Pessoa;3548708;São Bernardo do Campo;3;3;6;2158
2919207;Lauro de Freitas;3548708;São Bernardo do Campo;3;3;6;1450
3125101;Extrema;3548708;São Bernardo do Campo;3;3;6;99
3300407;Barra Mansa;3548708;São Bernardo do Campo;3;3;6;275
3303500;Nova Iguaçu;3548708;São Bernardo do Campo;3;3;6;334
3523107;Itaquaquecetuba;3548708;São Bernardo do Campo;3;3;6;36
3523909;Itu;3548708;São Bernardo do Campo;3;3;6;87
3538006;Pindamonhangaba;3548708;São Bernardo do Campo;3;3;6;144
3538709;Piracicaba;3548708;São Bernardo do Campo;3;3;6;152
3545209;Salto;3548708;São Bernardo do Campo;3;3;6;92
3147303;Paraisópolis;3548609;São Bento do Sapucaí;3;3;6;16
1100205;Porto Velho;3548500;Santos;3;3;6;2394
1501402;Belém;3548500;Santos;3;3;6;2499
2304400;Fortaleza;3548500;Santos;3;3;6;2352
2704302;Maceió;3548500;Santos;3;3;6;1888
2933307;Vitória da Conquista;3548500;Santos;3;3;6;1138
3106705;Betim;3548500;Santos;3;3;6;487
3128709;Guaxupé;3548500;Santos;3;3;6;289
3139409;Manhuaçu;3548500;Santos;3;3;6;591
3148103;Patrocínio;3548500;Santos;3;3;6;551
3506003;Bauru;3548500;Santos;3;3;6;326
3510500;Caraguatatuba;3548500;Santos;3;3;6;96
3516200;Franca;3548500;Santos;3;3;6;386
3524402;Jacareí;3548500;Santos;3;3;6;76
3526902;Limeira;3548500;Santos;3;3;6;181
3530706;Mogi Guaçu;3548500;Santos;3;3;6;184
3502804;Araçatuba;3548054;Santo Antônio do Aracanguá;3;3;6;32
3503802;Artur Nogueira;3548005;Santo Antônio de Posse;3;3;6;26
2905701;Camaçari;3547809;Santo André;3;3;6;1458
2930709;Simões Filho;3547809;Santo André;3;3;6;1446
3106705;Betim;3547809;Santo André;3;3;6;472
3205002;Serra;3547809;Santo André;3;3;6;738
3507605;Bragança Paulista;3547809;Santo André;3;3;6;78
3513504;Cubatão;3547809;Santo André;3;3;6;29
3518701;Guarujá;3547809;Santo André;3;3;6;43
3530805;Moji-Mirim;3547809;Santo André;3;3;6;142
3538006;Pindamonhangaba;3547809;Santo André;3;3;6;135
3538709;Piracicaba;3547809;Santo André;3;3;6;151
3544103;Rio Grande da Serra;3547809;Santo André;3;3;6;16
3541505;Presidente Venceslau;3547700;Santo Anastácio;3;3;6;28
3501608;Americana;3547502;Santa Rita do Passa Quatro;3;3;6;115
3543402;Ribeirão Preto;3547502;Santa Rita do Passa Quatro;3;3;6;70
1100205;Porto Velho;3547304;Santana de Parnaíba;3;3;6;2326
2401453;Baraúna;3547304;Santana de Parnaíba;3;3;6;2226
2408102;Natal;3547304;Santana de Parnaíba;3;3;6;2260
2800308;Aracaju;3547304;Santana de Parnaíba;3;3;6;1694
3136702;Juiz de Fora;3547304;Santana de Parnaíba;3;3;6;409
3302403;Macaé;3547304;Santana de Parnaíba;3;3;6;525
3306305;Volta Redonda;3547304;Santana de Parnaíba;3;3;6;305
3501608;Americana;3547304;Santana de Parnaíba;3;3;6;89
3526902;Limeira;3547304;Santana de Parnaíba;3;3;6;109
3529401;Mauá;3547304;Santana de Parnaíba;3;3;6;53
3538709;Piracicaba;3547304;Santana de Parnaíba;3;3;6;107
3541406;Presidente Prudente;3547304;Santana de Parnaíba;3;3;6;478
3501707;Américo Brasiliense;3546900;Santa Lúcia;3;3;6;5
3520202;Igaratá;3546801;Santa Isabel;3;3;6;14
3510005;Cândido Mota;3546405;Santa Cruz do Rio Pardo;3;3;6;79
3513702;Descalvado;3546306;Santa Cruz das Palmeiras;3;3;6;39
3534401;Osasco;3546306;Santa Cruz das Palmeiras;3;3;6;195
3526704;Leme;3546207;Santa Cruz da Conceição;3;3;6;10
3525904;Jundiaí;3545803;Santa Bárbara d'Oeste;3;3;6;70
3536505;Paulínia;3545803;Santa Bárbara d'Oeste;3;3;6;27
3106200;Belo Horizonte;3545209;Salto;3;3;6;496
3170701;Varginha;3545209;Salto;3;3;6;268
3201308;Cariacica;3545209;Salto;3;3;6;766
3304300;Rio Bonito;3545209;Salto;3;3;6;479
3501608;Americana;3545209;Salto;3;3;6;51
3502309;Anhembi;3545209;Salto;3;3;6;98
3527207;Lorena;3545209;Salto;3;3;6;231
3543907;Rio Claro;3545209;Salto;3;3;6;92
3538709;Piracicaba;3545159;Saltinho;3;3;6;12
3506607;Biritiba-Mirim;3545001;Salesópolis;3;3;6;20
3534302;Orlândia;3544905;Sales Oliveira;3;3;6;8
3540200;Pontal;3544905;Sales Oliveira;3;3;6;35
3527108;Lins;3544608;Sabino;3;3;6;32
3515350;Euclides da Cunha Paulista;3544251;Rosana;3;3;6;48
3509502;Campinas;3544004;Rio das Pedras;3;3;6;57
3501004;Altinópolis;3543907;Rio Claro;3;3;6;154
3503208;Araraquara;3543907;Rio Claro;3;3;6;93
3536000;Parapuã;3543808;Rinópolis;3;3;6;10
3501707;Américo Brasiliense;3543709;Rincão;3;3;6;16
1302603;Manaus;3543402;Ribeirão Preto;3;3;6;2341
1501402;Belém;3543402;Ribeirão Preto;3;3;6;2188
3101607;Alfenas;3543402;Ribeirão Preto;3;3;6;193
3106705;Betim;3543402;Ribeirão Preto;3;3;6;396
3136702;Juiz de Fora;3543402;Ribeirão Preto;3;3;6;469
3504008;Assis;3543402;Ribeirão Preto;3;3;6;323
3515509;Fernandópolis;3543402;Ribeirão Preto;3;3;6;272
3520103;Igarapava;3543402;Ribeirão Preto;3;3;6;123
3531902;Morro Agudo;3543402;Ribeirão Preto;3;3;6;54
3536505;Paulínia;3543402;Ribeirão Preto;3;3;6;190
3538907;Pirajuí;3542503;Reginópolis;3;3;6;27
3504008;Assis;3542206;Rancharia;3;3;6;67
3541703;Quatá;3542206;Rancharia;3;3;6;20
3540002;Pompéia;3542008;Quintana;3;3;6;15
3504404;Avanhandava;3541604;Promissão;3;3;6;13
3537305;Penápolis;3541604;Promissão;3;3;6;25
3170206;Uberlândia;3541406;Presidente Prudente;3;3;6;479
3518800;Guarulhos;3541406;Presidente Prudente;3;3;6;521
3525904;Jundiaí;3541406;Presidente Prudente;3;3;6;479
3509502;Campinas;3541000;Praia Grande;3;3;6;139
3510500;Caraguatatuba;3541000;Praia Grande;3;3;6;105
3529401;Mauá;3541000;Praia Grande;3;3;6;38
3518859;Guatapará;3540903;Pradópolis;3;3;6;16
3518404;Guaratinguetá;3540754;Potim;3;3;6;12
3507001;Boituva;3540606;Porto Feliz;3;3;6;17
3525102;Jardinópolis;3540200;Pontal;3;3;6;28
1302603;Manaus;3539806;Poá;3;3;6;2622
2927408;Salvador;3539806;Poá;3;3;6;1402
3106200;Belo Horizonte;3539806;Poá;3;3;6;466
3503901;Arujá;3539806;Poá;3;3;6;14
3518800;Guarulhos;3539806;Poá;3;3;6;23
3506102;Bebedouro;3539509;Pitangueiras;3;3;6;34
3502002;Analândia;3539301;Pirassununga;3;3;6;27
3506102;Bebedouro;3539004;Pirangi;3;3;6;21
3511102;Catanduva;3539004;Pirangi;3;3;6;35
3506003;Bauru;3538907;Pirajuí;3;3;6;54
3527108;Lins;3538907;Pirajuí;3;3;6;48
3504503;Avaré;3538808;Piraju;3;3;6;48
3506300;Bernardino de Campos;3538808;Piraju;3;3;6;22
3515400;Fartura;3538808;Piraju;3;3;6;25
2704302;Maceió;3538709;Piracicaba;3;3;6;1870
3302403;Macaé;3538709;Piracicaba;3;3;6;591
3500600;Águas de São Pedro;3538709;Piracicaba;3;3;6;30
3502309;Anhembi;3538709;Piracicaba;3;3;6;52
3502804;Araçatuba;3538709;Piracicaba;3;3;6;333
3504503;Avaré;3538709;Piracicaba;3;3;6;138
3518701;Guarujá;3538709;Piracicaba;3;3;6;194
3520905;Ipaussu;3538709;Piracicaba;3;3;6;206
3529005;Marília;3538709;Piracicaba;3;3;6;243
3300407;Barra Mansa;3538006;Pindamonhangaba;3;3;6;136
3505708;Barueri;3538006;Pindamonhangaba;3;3;6;159
3508504;Caçapava;3538006;Pindamonhangaba;3;3;6;32
3529401;Mauá;3538006;Pindamonhangaba;3;3;6;132
3500105;Adamantina;3537305;Penápolis;3;3;6;110
3512506;Coroados;3537305;Penápolis;3;3;6;24
3526803;Lençóis Paulista;3537305;Penápolis;3;3;6;184
2408102;Natal;3536505;Paulínia;3;3;6;2212
3151800;Poços de Caldas;3536505;Paulínia;3;3;6;126
3300407;Barra Mansa;3536505;Paulínia;3;3;6;304
3506003;Bauru;3536505;Paulínia;3;3;6;203
3523909;Itu;3536505;Paulínia;3;3;6;60
3524402;Jacareí;3536505;Paulínia;3;3;6;139
3526902;Limeira;3536505;Paulínia;3;3;6;33
3533403;Nova Odessa;3536505;Paulínia;3;3;6;15
3520301;Iguape;3536208;Pariquera-Açu;3;3;6;33
3524600;Jacupiranga;3536208;Pariquera-Açu;3;3;6;12
3534609;Osvaldo Cruz;3536000;Parapuã;3;3;6;9
3529005;Marília;3535507;Paraguaçu Paulista;3;3;6;71
3170206;Uberlândia;3534708;Ourinhos;3;3;6;481
3500105;Adamantina;3534708;Ourinhos;3;3;6;188
3505807;Bastos;3534609;Osvaldo Cruz;3;3;6;20
2304285;Eusébio;3534401;Osasco;3;3;6;2320
3302254;Itatiaia;3534401;Osasco;3;3;6;253
3510401;Capivari;3534401;Osasco;3;3;6;94
3516309;Francisco Morato;3534401;Osasco;3;3;6;32
3519709;Ibiúna;3534401;Osasco;3;3;6;46
3523503;Itatinga;3534401;Osasco;3;3;6;192
3524303;Jaboticabal;3534401;Osasco;3;3;6;295
3528403;Mairinque;3534401;Osasco;3;3;6;40
3170206;Uberlândia;3534302;Orlândia;3;3;6;205
3533601;Nuporanga;3534302;Orlândia;3;3;6;16
3517406;Guaíra;3533908;Olímpia;3;3;6;78
3507407;Borborema;3533502;Novo Horizonte;3;3;6;23
3519071;Hortolândia;3533403;Nova Odessa;3;3;6;13
3517802;Guaraçaí;3532108;Murutinga do Sul;3;3;6;8
3501905;Amparo;3532009;Morungaba;3;3;6;20
3505500;Barretos;3531407;Monte Aprazível;3;3;6;120
3506102;Bebedouro;3531407;Monte Aprazível;3;3;6;124
3106200;Belo Horizonte;3530805;Moji-Mirim;3;3;6;414
3151800;Poços de Caldas;3530805;Moji-Mirim;3;3;6;85
3170107;Uberaba;3530805;Moji-Mirim;3;3;6;313
3304557;Rio de Janeiro;3530805;Moji-Mirim;3;3;6;386
3500303;Aguaí;3530805;Moji-Mirim;3;3;6;41
3515186;Espírito Santo do Pinhal;3530805;Moji-Mirim;3;3;6;35
3102605;Andradas;3530706;Mogi Guaçu;3;3;6;49
3523404;Itatiba;3530706;Mogi Guaçu;3;3;6;76
1302603;Manaus;3530607;Moji das Cruzes;3;3;6;2633
3518404;Guaratinguetá;3530607;Moji das Cruzes;3;3;6;132
3527207;Lorena;3530607;Moji das Cruzes;3;3;6;145
3529401;Mauá;3530607;Moji das Cruzes;3;3;6;30
3143203;Monte Santo de Minas;3530508;Mococa;3;3;6;32
3164704;São Sebastião do Paraíso;3530508;Mococa;3;3;6;60
3508702;Caconde;3530508;Mococa;3;3;6;41
3509502;Campinas;3530508;Mococa;3;3;6;158
3510807;Casa Branca;3530508;Mococa;3;3;6;34
3526902;Limeira;3530508;Mococa;3;3;6;127
3504800;Bálsamo;3530300;Mirassol;3;3;6;11
3505500;Barretos;3530300;Mirassol;3;3;6;102
3511102;Catanduva;3530300;Mirassol;3;3;6;67
3518800;Guarulhos;3530300;Mirassol;3;3;6;425
3518206;Guararapes;3530102;Mirandópolis;3;3;6;50
3526506;Lavínia;3530102;Mirandópolis;3;3;6;7
3526100;Juquiá;3529906;Miracatu;3;3;6;23
2905701;Camaçari;3529401;Mauá;3;3;6;1456
3106705;Betim;3529401;Mauá;3;3;6;470
3301702;Duque de Caxias;3529401;Mauá;3;3;6;335
3509502;Campinas;3529401;Mauá;3;3;6;105
3501707;Américo Brasiliense;3529302;Matão;3;3;6;34
3513504;Cubatão;3529302;Matão;3;3;6;327
3524303;Jaboticabal;3529302;Matão;3;3;6;39
3518800;Guarulhos;3529005;Marília;3;3;6;376
3509007;Caieiras;3528502;Mairiporã;3;3;6;17
3516408;Franco da Rocha;3528502;Mairiporã;3;3;6;14
3502754;Araçariguama;3528403;Mairinque;3;3;6;17
3519709;Ibiúna;3528403;Mairinque;3;3;6;13
3509502;Campinas;3527306;Louveira;3;3;6;22
3502507;Aparecida;3527207;Lorena;3;3;6;20
3508603;Cachoeira Paulista;3527207;Lorena;3;3;6;11
3524402;Jacareí;3527207;Lorena;3;3;6;110
3106200;Belo Horizonte;3526902;Limeira;3;3;6;456
3106705;Betim;3526902;Limeira;3;3;6;436
3503208;Araraquara;3526902;Limeira;3;3;6;117
3516200;Franca;3526902;Limeira;3;3;6;224
3518800;Guarulhos;3526902;Limeira;3;3;6;129
3507456;Borebi;3526803;Lençóis Paulista;3;3;6;16
3512209;Conchal;3526704;Leme;3;3;6;28
3512308;Conchas;3526407;Laranjal Paulista;3;3;6;18
2305233;Horizonte;3525904;Jundiaí;3;3;6;2265
3201308;Cariacica;3525904;Jundiaí;3;3;6;730
3301702;Duque de Caxias;3525904;Jundiaí;3;3;6;370
3503208;Araraquara;3525904;Jundiaí;3;3;6;201
3509007;Caieiras;3525904;Jundiaí;3;3;6;26
3513504;Cubatão;3525904;Jundiaí;3;3;6;93
3513801;Diadema;3525904;Jundiaí;3;3;6;63
3524402;Jacareí;3525904;Jundiaí;3;3;6;99
3508108;Buritama;3525706;José Bonifácio;3;3;6;48
3106200;Belo Horizonte;3525300;Jaú;3;3;6;538
3504008;Assis;3525300;Jaú;3;3;6;198
3506805;Bocaina;3525300;Jaú;3;3;6;16
3523404;Itatiba;3525201;Jarinu;3;3;6;15
3507803;Brodowski;3525102;Jardinópolis;3;3;6;11
3513504;Cubatão;3525102;Jardinópolis;3;3;6;348
3506508;Birigui;3524808;Jales;3;3;6;116
1302603;Manaus;3524709;Jaguariúna;3;3;6;2519
3505708;Barueri;3524709;Jaguariúna;3;3;6;90
3518800;Guarulhos;3524709;Jaguariúna;3;3;6;92
1302603;Manaus;3524402;Jacareí;3;3;6;2625
3518305;Guararema;3524402;Jacareí;3;3;6;15
3522505;Itapevi;3524402;Jacareí;3;3;6;105
3523107;Itaquaquecetuba;3524402;Jacareí;3;3;6;45
3503000;Aramina;3524105;Ituverava;3;3;6;28
3509502;Campinas;3524105;Ituverava;3;3;6;294
3508405;Cabreúva;3524006;Itupeva;3;3;6;19
3509502;Campinas;3524006;Itupeva;3;3;6;28
3520509;Indaiatuba;3524006;Itupeva;3;3;6;20
3523909;Itu;3524006;Itupeva;3;3;6;28
3106200;Belo Horizonte;3523909;Itu;3;3;6;503
3508405;Cabreúva;3523909;Itu;3;3;6;17
3518800;Guarulhos;3523909;Itu;3;3;6;77
3521705;Itaberá;3523206;Itararé;3;3;6;34
3522307;Itapetininga;3523206;Itararé;3;3;6;143
3509502;Campinas;3523107;Itaquaquecetuba;3;3;6;97
3506003;Bauru;3522703;Itápolis;3;3;6;87
2304400;Fortaleza;3522604;Itapira;3;3;6;2221
3518701;Guarujá;3522109;Itanhaém;3;3;6;58
3505203;Bariri;3522000;Itaju;3;3;6;12
3304557;Rio de Janeiro;3521002;Iperó;3;3;6;455
2611606;Recife;3520509;Indaiatuba;3;3;6;2053
2927408;Salvador;3520509;Indaiatuba;3;3;6;1418
3118601;Contagem;3520509;Indaiatuba;3;3;6;475
3512803;Cosmópolis;3520509;Indaiatuba;3;3;6;50
3519071;Hortolândia;3520509;Indaiatuba;3;3;6;26
3502101;Andradina;3520442;Ilha Solteira;3;3;6;56
3509254;Cajati;3520301;Iguape;3;3;6;58
3503000;Aramina;3520103;Igarapava;3;3;6;11
3516200;Franca;3519600;Ibitinga;3;3;6;200
1504208;Marabá;3518800;Guarulhos;3;3;6;2014
1504422;Marituba;3518800;Guarulhos;3;3;6;2448
1506807;Santarém;3518800;Guarulhos;3;3;6;2452
2306256;Itaitinga;3518800;Guarulhos;3;3;6;2292
2408003;Mossoró;3518800;Guarulhos;3;3;6;2211
2700300;Arapiraca;3518800;Guarulhos;3;3;6;1798
2707701;Rio Largo;3518800;Guarulhos;3;3;6;1869
2916500;Itapicuru;3518800;Guarulhos;3;3;6;1576
3139003;Machado;3518800;Guarulhos;3;3;6;206
3170107;Uberaba;3518800;Guarulhos;3;3;6;431
3302403;Macaé;3518800;Guarulhos;3;3;6;490
3303906;Petrópolis;3518800;Guarulhos;3;3;6;355
3306008;Três Rios;3518800;Guarulhos;3;3;6;370
3508504;Caçapava;3518800;Guarulhos;3;3;6;95
3510500;Caraguatatuba;3518800;Guarulhos;3;3;6;114
3511102;Catanduva;3518800;Guarulhos;3;3;6;353
3106200;Belo Horizonte;3518404;Guaratinguetá;3;3;6;345
3170206;Uberlândia;3518404;Guaratinguetá;3;3;6;535
3304201;Resende;3518404;Guaratinguetá;3;3;6;81
3505708;Barueri;3518404;Guaratinguetá;3;3;6;192
3513603;Cunha;3518404;Guaratinguetá;3;3;6;36
3502804;Araçatuba;3517109;Glicério;3;3;6;31
3504206;Auriflama;3516903;General Salgado;3;3;6;21
3508801;Cafelândia;3516705;Garça;3;3;6;47
3116407;Claraval;3516200;Franca;3;3;6;21
3139003;Machado;3516200;Franca;3;3;6;200
3170701;Varginha;3516200;Franca;3;3;6;235
3501004;Altinópolis;3516200;Franca;3;3;6;54
3503307;Araras;3516200;Franca;3;3;6;201
3507803;Brodowski;3516200;Franca;3;3;6;56
3513207;Cristais Paulista;3516200;Franca;3;3;6;16
3502804;Araçatuba;3515509;Fernandópolis;3;3;6;107
3146008;Ouro Fino;3515186;Espírito Santo do Pinhal;3;3;6;40
2304400;Fortaleza;3515004;Embu;3;3;6;2344
2607901;Jaboatão dos Guararapes;3515004;Embu;3;3;6;2072
3106200;Belo Horizonte;3515004;Embu;3;3;6;506
3509502;Campinas;3515004;Embu;3;3;6;86
3510401;Capivari;3514908;Elias Fausto;3;3;6;15
3505302;Barra Bonita;3514106;Dois Córregos;3;3;6;23
3151800;Poços de Caldas;3513900;Divinolândia;3;3;6;23
3508702;Caconde;3513900;Divinolândia;3;3;6;18
2607901;Jaboatão dos Guararapes;3513801;Diadema;3;3;6;2062
3205200;Vila Velha;3513801;Diadema;3;3;6;731
3507605;Bragança Paulista;3513801;Diadema;3;3;6;82
3503307;Araras;3513702;Descalvado;3;3;6;56
3205309;Vitória;3513504;Cubatão;3;3;6;736
3511102;Catanduva;3513504;Cubatão;3;3;6;399
3163706;São Lourenço;3513405;Cruzeiro;3;3;6;51
3508603;Cachoeira Paulista;3513405;Cruzeiro;3;3;6;11
2304400;Fortaleza;3513009;Cotia;3;3;6;2341
2607901;Jaboatão dos Guararapes;3513009;Cotia;3;3;6;2072
2927408;Salvador;3513009;Cotia;3;3;6;1441
3118601;Contagem;3513009;Cotia;3;3;6;498
3503208;Araraquara;3513009;Cotia;3;3;6;238
3506003;Bauru;3513009;Cotia;3;3;6;260
3506409;Bilac;3511904;Clementina;3;3;6;18
3503208;Araraquara;3511102;Catanduva;3;3;6;110
3502507;Aparecida;3510500;Caraguatatuba;3;3;6;88
3501608;Americana;3510401;Capivari;3;3;6;33
3507001;Boituva;3510401;Capivari;3;3;6;36
3304557;Rio de Janeiro;3509700;Campos do Jordão;3;3;6;239
3508504;Caçapava;3509700;Campos do Jordão;3;3;6;45
3509502;Campinas;3509601;Campo Limpo Paulista;3;3;6;44
1501402;Belém;3509502;Campinas;3;3;6;2384
2307304;Juazeiro do Norte;3509502;Campinas;3;3;6;1895
2602902;Cabo de Santo Agostinho;3509502;Campinas;3;3;6;2007
2704302;Maceió;3509502;Campinas;3;3;6;1845
2919207;Lauro de Freitas;3509502;Campinas;3;3;6;1409
3158953;Santana do Paraíso;3509502;Campinas;3;3;6;600
3159605;Santa Rita do Sapucaí;3509502;Campinas;3;3;6;156
3302403;Macaé;3509502;Campinas;3;3;6;532
3504008;Assis;3509502;Campinas;3;3;6;348
3509007;Caieiras;3509502;Campinas;3;3;6;61
3170107;Uberaba;3509254;Cajati;3;3;6;551
3304557;Rio de Janeiro;3509007;Caieiras;3;3;6;359
3304557;Rio de Janeiro;3508603;Cachoeira Paulista;3;3;6;181
2905701;Camaçari;3508504;Caçapava;3;3;6;1365
3106705;Betim;3508504;Caçapava;3;3;6;380
3106200;Belo Horizonte;3507605;Bragança Paulista;3;3;6;427
3110509;Camanducaia;3507605;Bragança Paulista;3;3;6;47
3143807;Munhoz;3507605;Bragança Paulista;3;3;6;42
3152501;Pouso Alegre;3507605;Bragança Paulista;3;3;6;102
3106705;Betim;3507506;Botucatu;3;3;6;539
3501608;Americana;3507506;Botucatu;3;3;6;114
3506102;Bebedouro;3506508;Birigui;3;3;6;191
3502804;Araçatuba;3506409;Bilac;3;3;6;20
3170107;Uberaba;3506102;Bebedouro;3;3;6;147
3500303;Aguaí;3506102;Bebedouro;3;3;6;205
2304400;Fortaleza;3506003;Bauru;3;3;6;2303
3118601;Contagem;3506003;Bauru;3;3;6;577
3170107;Uberaba;3506003;Bauru;3;3;6;311
3170206;Uberlândia;3505906;Batatais;3;3;6;230
1500800;Ananindeua;3505708;Barueri;3;3;6;2453
2307304;Juazeiro do Norte;3505708;Barueri;3;3;6;1948
2913606;Ilhéus;3505708;Barueri;3;3;6;1235
2919553;Luís Eduardo magalhães;3505708;Barueri;3;3;6;1267
2925303;Porto Seguro;3505708;Barueri;3;3;6;1101
2930709;Simões Filho;3505708;Barueri;3;3;6;1453
2933307;Vitória da Conquista;3505708;Barueri;3;3;6;1129
3122306;Divinópolis;3505708;Barueri;3;3;6;422
3143302;Montes Claros;3505708;Barueri;3;3;6;808
3203205;Linhares;3505708;Barueri;3;3;6;828
3300100;Angra dos Reis;3505708;Barueri;3;3;6;272
3502754;Araçariguama;3505708;Barueri;3;3;6;21
3118601;Contagem;3505500;Barretos;3;3;6;473
3504503;Avaré;3505302;Barra Bonita;3;3;6;77
3118601;Contagem;3504107;Atibaia;3;3;6;433
3125101;Extrema;3504107;Atibaia;3;3;6;37
3304557;Rio de Janeiro;3504008;Assis;3;3;6;739
3106200;Belo Horizonte;3503307;Araras;3;3;6;441
3170206;Uberlândia;3503307;Araras;3;3;6;393
3500303;Aguaí;3503307;Araras;3;3;6;53
3106200;Belo Horizonte;3502804;Araçatuba;3;3;6;686
1302603;Manaus;3501608;Americana;3;3;6;2504
3170206;Uberlândia;3501608;Americana;3;3;6;435
3205309;Vitória;3306305;Volta Redonda;3;3;6;461
3302007;Itaguaí;3306305;Volta Redonda;3;3;6;45
3303401;Nova Friburgo;3306305;Volta Redonda;3;3;6;158
3303906;Petrópolis;3306305;Volta Redonda;3;3;6;91
3306206;Vassouras;3306305;Volta Redonda;3;3;6;46
3306107;Valença;3306206;Vassouras;3;3;6;22
3106705;Betim;3306008;Três Rios;3;3;6;253
3140803;Matias Barbosa;3306008;Três Rios;3;3;6;24
3300225;Areal;3306008;Três Rios;3;3;6;21
3301702;Duque de Caxias;3306008;Três Rios;3;3;6;77
3106200;Belo Horizonte;3305802;Teresópolis;3;3;6;297
3205309;Vitória;3305802;Teresópolis;3;3;6;367
3304524;Rio das Ostras;3305802;Teresópolis;3;3;6;109
3303401;Nova Friburgo;3305703;Sumidouro;3;3;6;28
3304300;Rio Bonito;3305604;Silva Jardim;3;3;6;25
3300407;Barra Mansa;3305554;Seropédica;3;3;6;56
2304400;Fortaleza;3305505;Saquarema;3;3;6;2146
2611606;Recife;3305505;Saquarema;3;3;6;1791
2927408;Salvador;3305505;Saquarema;3;3;6;1162
3106200;Belo Horizonte;3305505;Saquarema;3;3;6;361
3205309;Vitória;3305505;Saquarema;3;3;6;362
3303401;Nova Friburgo;3305505;Saquarema;3;3;6;63
3305208;São Pedro da Aldeia;3305505;Saquarema;3;3;6;37
3304706;Santo Antônio de Pádua;3305406;Sapucaia;3;3;6;91
3302205;Itaperuna;3305133;São José de Ubá;3;3;6;25
3205002;Serra;3305109;São João de Meriti;3;3;6;430
3301850;Guapimirim;3305109;São João de Meriti;3;3;6;49
3302502;Magé;3305109;São João de Meriti;3;3;6;37
3205309;Vitória;3305000;São João da Barra;3;3;6;175
2304400;Fortaleza;3304904;São Gonçalo;3;3;6;2150
2927408;Salvador;3304904;São Gonçalo;3;3;6;1177
3304557;Rio de Janeiro;3304755;São Francisco de Itabapoana;3;3;6;290
3301504;Cordeiro;3304706;Santo Antônio de Pádua;3;3;6;58
3303401;Nova Friburgo;3304706;Santo Antônio de Pádua;3;3;6;93
1702109;Araguaína;3304557;Rio de Janeiro;3;3;6;1803
1716604;Peixe;3304557;Rio de Janeiro;3;3;6;1310
2101202;Bacabal;3304557;Rio de Janeiro;3;3;6;2071
2104057;Estreito;3304557;Rio de Janeiro;3;3;6;1850
2110302;Santo Antônio dos Lopes;3304557;Rio de Janeiro;3;3;6;1995
2111201;São José de Ribamar;3304557;Rio de Janeiro;3;3;6;2252
2301109;Aracati;3304557;Rio de Janeiro;3;3;6;2097
2613701;São Lourenço da Mata;3304557;Rio de Janeiro;3;3;6;1835
2803302;Japaratuba;3304557;Rio de Janeiro;3;3;6;1497
2905206;Caetité;3304557;Rio de Janeiro;3;3;6;977
2910503;Entre Rios;3304557;Rio de Janeiro;3;3;6;1318
2919553;Luís Eduardo magalhães;3304557;Rio de Janeiro;3;3;6;1220
2919926;Madre de Deus;3304557;Rio de Janeiro;3;3;6;1214
2922003;Mucuri;3304557;Rio de Janeiro;3;3;6;658
2928703;Santo Antônio de Jesus;3304557;Rio de Janeiro;3;3;6;1166
3113305;Carangola;3304557;Rio de Janeiro;3;3;6;269
3118007;Congonhas;3304557;Rio de Janeiro;3;3;6;272
3126109;Formiga;3304557;Rio de Janeiro;3;3;6;346
3133808;Itaúna;3304557;Rio de Janeiro;3;3;6;336
3139409;Manhuaçu;3304557;Rio de Janeiro;3;3;6;317
3145901;Ouro Branco;3304557;Rio de Janeiro;3;3;6;265
3147006;Paracatu;3304557;Rio de Janeiro;3;3;6;726
3156700;Sabará;3304557;Rio de Janeiro;3;3;6;337
3168705;Timóteo;3304557;Rio de Janeiro;3;3;6;370
3202504;Ibiraçu;3304557;Rio de Janeiro;3;3;6;447
3202603;Iconha;3304557;Rio de Janeiro;3;3;6;340
3301306;Casimiro de Abreu;3304557;Rio de Janeiro;3;3;6;117
3301504;Cordeiro;3304557;Rio de Janeiro;3;3;6;131
3301801;Engenheiro Paulo de Frontin;3304557;Rio de Janeiro;3;3;6;56
3303005;Miracema;3304557;Rio de Janeiro;3;3;6;194
3304110;Porto Real;3304557;Rio de Janeiro;3;3;6;121
3301702;Duque de Caxias;3304524;Rio das Ostras;3;3;6;144
3302700;Maricá;3304524;Rio das Ostras;3;3;6;102
3304300;Rio Bonito;3304524;Rio das Ostras;3;3;6;74
3205200;Vila Velha;3304300;Rio Bonito;3;3;6;349
3301009;Campos dos Goytacazes;3304300;Rio Bonito;3;3;6;168
3303500;Nova Iguaçu;3304300;Rio Bonito;3;3;6;87
3300308;Barra do Piraí;3304201;Resende;3;3;6;65
3303906;Petrópolis;3304201;Resende;3;3;6;127
3304110;Porto Real;3304201;Resende;3;3;6;18
3304128;Quatis;3304201;Resende;3;3;6;23
3302403;Macaé;3304151;Quissamã;3;3;6;52
3300456;Belford Roxo;3304144;Queimados;3;3;6;20
3304110;Porto Real;3304128;Quatis;3;3;6;7
3169208;Tombos;3304102;Porciúncula;3;3;6;7
3202306;Guaçuí;3304102;Porciúncula;3;3;6;43
3302205;Itaperuna;3304102;Porciúncula;3;3;6;25
3300407;Barra Mansa;3304003;Piraí;3;3;6;33
3302007;Itaguaí;3303906;Petrópolis;3;3;6;68
3302403;Macaé;3303906;Petrópolis;3;3;6;137
3303708;Paraíba do Sul;3303906;Petrópolis;3;3;6;41
3302270;Japeri;3303609;Paracambi;3;3;6;9
2304400;Fortaleza;3303500;Nova Iguaçu;3;3;6;2156
3136702;Juiz de Fora;3303500;Nova Iguaçu;3;3;6;112
3170206;Uberlândia;3303500;Nova Iguaçu;3;3;6;647
3302403;Macaé;3303500;Nova Iguaçu;3;3;6;167
3301603;Duas Barras;3303401;Nova Friburgo;3;3;6;27
3302502;Magé;3303401;Nova Friburgo;3;3;6;63
2704302;Maceió;3303302;Niterói;3;3;6;1636
2910800;Feira de Santana;3303302;Niterói;3;3;6;1242
3170107;Uberaba;3303302;Niterói;3;3;6;600
3201209;Cachoeiro de Itapemirim;3303302;Niterói;3;3;6;306
3300803;Cachoeiras de Macacu;3303302;Niterói;3;3;6;65
3303005;Miracema;3303302;Niterói;3;3;6;185
3300456;Belford Roxo;3303203;Nilópolis;3;3;6;6
3301801;Engenheiro Paulo de Frontin;3302809;Mendes;3;3;6;9
3301702;Duque de Caxias;3302601;Mangaratiba;3;3;6;75
3300803;Cachoeiras de Macacu;3302502;Magé;3;3;6;46
2408003;Mossoró;3302403;Macaé;3;3;6;1952
2801504;Carmópolis;3302403;Macaé;3;3;6;1385
3300936;Carapebus;3302403;Macaé;3;3;6;31
3106200;Belo Horizonte;3302205;Itaperuna;3;3;6;256
3113305;Carangola;3302205;Itaperuna;3;3;6;47
3124906;Eugenópolis;3302205;Itaperuna;3;3;6;31
3300902;Cambuci;3302106;Itaocara;3;3;6;22
3300308;Barra do Piraí;3302007;Itaguaí;3;3;6;37
3300407;Barra Mansa;3302007;Itaguaí;3;3;6;50
3205002;Serra;3301900;Itaboraí;3;3;6;389
3300209;Araruama;3301900;Itaboraí;3;3;6;55
3300803;Cachoeiras de Macacu;3301900;Itaboraí;3;3;6;38
3301850;Guapimirim;3301900;Itaboraí;3;3;6;26
2607901;Jaboatão dos Guararapes;3301702;Duque de Caxias;3;3;6;1816
3202603;Iconha;3301702;Duque de Caxias;3;3;6;336
3205101;Viana;3301702;Duque de Caxias;3;3;6;383
3300407;Barra Mansa;3301702;Duque de Caxias;3;3;6;94
3301009;Campos dos Goytacazes;3301157;Cardoso Moreira;3;3;6;45
3201506;Colatina;3301009;Campos dos Goytacazes;3;3;6;258
3203403;Mimoso do Sul;3301009;Campos dos Goytacazes;3;3;6;81
3205101;Viana;3301009;Campos dos Goytacazes;3;3;6;172
3300233;Armação dos Búzios;3301009;Campos dos Goytacazes;3;3;6;120
3106200;Belo Horizonte;3300803;Cachoeiras de Macacu;3;3;6;314
3136702;Juiz de Fora;3300704;Cabo Frio;3;3;6;179
3136702;Juiz de Fora;3300407;Barra Mansa;3;3;6;123
3205002;Serra;3300407;Barra Mansa;3;3;6;478
3205101;Viana;3300407;Barra Mansa;3;3;6;439
1600303;Macapá;3205309;Vitória;3;3;6;2497
1721000;Palmas;3205309;Vitória;3;3;6;1368
2507507;João Pessoa;3205309;Vitória;3;3;6;1547
2800308;Aracaju;3205309;Vitória;3;3;6;1087
3201704;Conceição do Castelo;3205309;Vitória;3;3;6;99
3202009;Dores do Rio Preto;3205309;Vitória;3;3;6;166
3203304;Mantenópolis;3205309;Vitória;3;3;6;175
3203601;Mucurici;3205309;Vitória;3;3;6;240
3203809;Muqui;3205309;Vitória;3;3;6;134
3204203;Piúma;3205309;Vitória;3;3;6;79
3204252;Ponto Belo;3205309;Vitória;3;3;6;237
3204351;Rio Bananal;3205309;Vitória;3;3;6;109
3205036;Vargem Alta;3205309;Vitória;3;3;6;87
2933307;Vitória da Conquista;3205200;Vila Velha;3;3;6;608
3106705;Betim;3205200;Vila Velha;3;3;6;401
3170701;Varginha;3205200;Vila Velha;3;3;6;543
3200409;Anchieta;3205200;Vila Velha;3;3;6;63
3201407;Castelo;3205200;Vila Velha;3;3;6;97
3204351;Rio Bananal;3205176;Vila Valério;3;3;6;30
2933307;Vitória da Conquista;3205101;Viana;3;3;6;614
3203205;Linhares;3205101;Viana;3;3;6;129
3202405;Guarapari;3205069;Venda Nova do Imigrante;3;3;6;68
3202454;Ibatiba;3205069;Venda Nova do Imigrante;3;3;6;41
3203346;Marechal Floriano;3205069;Venda Nova do Imigrante;3;3;6;48
3202603;Iconha;3205036;Vargem Alta;3;3;6;24
2503209;Cabedelo;3205002;Serra;3;3;6;1549
2704302;Maceió;3205002;Serra;3;3;6;1250
2905701;Camaçari;3205002;Serra;3;3;6;847
2929206;São Francisco do Conde;3205002;Serra;3;3;6;847
3200409;Anchieta;3205002;Serra;3;3;6;86
3200904;Barra de São Francisco;3205002;Serra;3;3;6;164
3201902;Domingos Martins;3205002;Serra;3;3;6;45
3203908;Nova Venécia;3205002;Serra;3;3;6;157
3168606;Teófilo Otoni;3204906;São Mateus;3;3;6;198
3201209;Cachoeiro de Itapemirim;3204906;São Mateus;3;3;6;263
2931350;Teixeira de Freitas;3204708;São Gabriel da Palha;3;3;6;182
3200607;Aracruz;3204708;São Gabriel da Palha;3;3;6;97
3201001;Boa Esperança;3204708;São Gabriel da Palha;3;3;6;57
3201308;Cariacica;3204559;Santa Maria de Jetibá;3;3;6;40
3201209;Cachoeiro de Itapemirim;3204401;Rio Novo do Sul;3;3;6;16
3203320;Marataízes;3204401;Rio Novo do Sul;3;3;6;22
3203502;Montanha;3204252;Ponto Belo;3;3;6;19
3204104;Pinheiros;3204252;Ponto Belo;3;3;6;46
3203320;Marataízes;3204203;Piúma;3;3;6;29
2931350;Teixeira de Freitas;3204054;Pedro Canário;3;3;6;70
3201308;Cariacica;3203908;Nova Venécia;3;3;6;171
3127701;Governador Valadares;3203205;Linhares;3;3;6;213
3202504;Ibiraçu;3203205;Linhares;3;3;6;63
3201506;Colatina;3203130;João Neiva;3;3;6;32
3200409;Anchieta;3202801;Itapemirim;3;3;6;32
3201209;Cachoeiro de Itapemirim;3202801;Itapemirim;3;3;6;28
3202405;Guarapari;3202603;Iconha;3;3;6;31
3137700;Lajinha;3202454;Ibatiba;3;3;6;15
3201902;Domingos Martins;3202405;Guarapari;3;3;6;32
3201159;Brejetuba;3201704;Conceição do Castelo;3;3;6;25
3201209;Cachoeiro de Itapemirim;3201704;Conceição do Castelo;3;3;6;53
3200300;Alfredo Chaves;3201308;Cariacica;3;3;6;53
3118601;Contagem;3201209;Cachoeiro de Itapemirim;3;3;6;327
3136702;Juiz de Fora;3201209;Cachoeiro de Itapemirim;3;3;6;256
3139409;Manhuaçu;3201209;Cachoeiro de Itapemirim;3;3;6;121
3200409;Anchieta;3201209;Cachoeiro de Itapemirim;3;3;6;38
3200706;Atilio Vivacqua;3201209;Cachoeiro de Itapemirim;3;3;6;15
3200805;Baixo Guandu;3201209;Cachoeiro de Itapemirim;3;3;6;141
2922003;Mucuri;3200607;Aracruz;3;3;6;215
3124609;Estrela Dalva;3172103;Volta Grande;3;3;6;9
3106200;Belo Horizonte;3172004;Visconde do Rio Branco;3;3;6;170
3124005;Ervália;3172004;Visconde do Rio Branco;3;3;6;27
3128006;Guanhães;3171808;Virginópolis;3;3;6;26
3143906;Muriaé;3171402;Vieiras;3;3;6;25
3143906;Muriaé;3171303;Viçosa;3;3;6;67
3146107;Ouro Preto;3171303;Viçosa;3;3;6;79
1505536;Parauapebas;3171204;Vespasiano;3;3;6;1630
3106200;Belo Horizonte;3171030;Verdelândia;3;3;6;479
3138104;Lassance;3170800;Várzea da Palma;3;3;6;36
3105608;Barbacena;3170701;Varginha;3;3;6;170
3106705;Betim;3170701;Varginha;3;3;6;212
3115508;Caxambu;3170701;Varginha;3;3;6;66
3122306;Divinópolis;3170701;Varginha;3;3;6;158
3126109;Formiga;3170701;Varginha;3;3;6;115
3139003;Machado;3170701;Varginha;3;3;6;57
3151503;Piumhi;3170602;Vargem Bonita;3;3;6;43
3150570;Pintópolis;3170529;Urucuia;3;3;6;63
3154002;Raul Soares;3170503;Urucânia;3;3;6;42
2919553;Luís Eduardo magalhães;3170404;Unaí;3;3;6;490
3109451;Cabeceira Grande;3170404;Unaí;3;3;6;45
3122306;Divinópolis;3170404;Unaí;3;3;6;471
1100122;Ji-Paraná;3170206;Uberlândia;3;3;6;1662
1100304;Vilhena;3170206;Uberlândia;3;3;6;1407
1200401;Rio Branco;3170206;Uberlândia;3;3;6;2246
1504422;Marituba;3170206;Uberlândia;3;3;6;1940
2105302;Imperatriz;3170206;Uberlândia;3;3;6;1484
2304202;Crato;3170206;Uberlândia;3;3;6;1581
2909307;Correntina;3170206;Uberlândia;3;3;6;721
2917359;Jaborandi;3170206;Uberlândia;3;3;6;707
3130309;Iguatama;3170206;Uberlândia;3;3;6;305
3144805;Nova Lima;3170206;Uberlândia;3;3;6;482
3149606;Pequi;3170206;Uberlândia;3;3;6;390
3151404;Pitangui;3170206;Uberlândia;3;3;6;368
3100708;Água Comprida;3170107;Uberaba;3;3;6;40
3119302;Coromandel;3170107;Uberaba;3;3;6;160
3129509;Ibiá;3170107;Uberaba;3;3;6;149
3134202;Ituiutaba;3170107;Uberaba;3;3;6;182
3113305;Carangola;3169901;Ubá;3;3;6;107
3121902;Divinésia;3169901;Ubá;3;3;6;12
3128808;Guidoval;3169901;Ubá;3;3;6;20
3138401;Leopoldina;3169901;Ubá;3;3;6;58
3165701;Senador Firmino;3169901;Ubá;3;3;6;23
3142809;Monte Alegre de Minas;3169604;Tupaciguara;3;3;6;36
3106200;Belo Horizonte;3169406;Três Pontas;3;3;6;227
3111200;Campo Belo;3169406;Três Pontas;3;3;6;59
3123601;Elói Mendes;3169406;Três Pontas;3;3;6;27
3106200;Belo Horizonte;3169356;Três Marias;3;3;6;232
3167202;Sete Lagoas;3169356;Três Marias;3;3;6;174
3107109;Boa Esperança;3169307;Três Corações;3;3;6;73
3132404;Itajubá;3169307;Três Corações;3;3;6;86
3152501;Pouso Alegre;3169307;Três Corações;3;3;6;97
3148004;Patos de Minas;3168903;Tiros;3;3;6;74
3127701;Governador Valadares;3168408;Tarumirim;3;3;6;52
2927408;Salvador;3167202;Sete Lagoas;3;3;6;929
3133808;Itaúna;3167202;Sete Lagoas;3;3;6;82
3135100;Janaúba;3167202;Sete Lagoas;3;3;6;413
3151206;Pirapora;3167202;Sete Lagoas;3;3;6;244
3106200;Belo Horizonte;3165909;Senador Modestino Gonçalves;3;3;6;231
3110608;Cambuí;3165578;Senador Amaral;3;3;6;11
3118601;Contagem;3165537;Sarzedo;3;3;6;14
3102803;Andrelândia;3165305;São Vicente de Minas;3;3;6;13
3145604;Oliveira;3165008;São Tiago;3;3;6;43
3154200;Resende Costa;3165008;São Tiago;3;3;6;28
3162500;São João del Rei;3165008;São Tiago;3;3;6;33
3106200;Belo Horizonte;3164704;São Sebastião do Paraíso;3;3;6;332
3133758;Itaú de Minas;3164704;São Sebastião do Paraíso;3;3;6;29
3106200;Belo Horizonte;3164605;São Sebastião do Oeste;3;3;6;115
3122306;Divinópolis;3164605;São Sebastião do Oeste;3;3;6;18
3152501;Pouso Alegre;3164407;São Sebastião da Bela Vista;3;3;6;21
3147600;Passa Quatro;3163706;São Lourenço;3;3;6;30
3118601;Contagem;3162922;São Joaquim de Bicas;3;3;6;24
3148608;Peçanha;3162807;São João Evangelista;3;3;6;24
3147402;Paraopeba;3162708;São João do Paraíso;3;3;6;508
3152501;Pouso Alegre;3162005;São Gonçalo do Sapucaí;3;3;6;51
3136207;João Monlevade;3161908;São Gonçalo do Rio Abaixo;3;3;6;20
3106200;Belo Horizonte;3161809;São Gonçalo do Pará;3;3;6;92
3134400;Iturama;3161304;São Francisco de Sales;3;3;6;46
3106200;Belo Horizonte;3161007;São Domingos do Prata;3;3;6;106
3121803;Dionísio;3161007;São Domingos do Prata;3;3;6;20
3144706;Nova Era;3161007;São Domingos do Prata;3;3;6;14
3130903;Inhapim;3160959;São Domingos das Dores;3;3;6;11
3106200;Belo Horizonte;3160900;São Brás do Suaçuí;3;3;6;80
3106200;Belo Horizonte;3160405;Santo Antônio do Monte;3;3;6;139
3122306;Divinópolis;3160405;Santo Antônio do Monte;3;3;6;44
3106200;Belo Horizonte;3159902;Santo Antônio do Amparo;3;3;6;151
3108008;Bom Sucesso;3159902;Santo Antônio do Amparo;3;3;6;20
3145604;Oliveira;3159902;Santo Antônio do Amparo;3;3;6;28
3129103;Gurinhatã;3159803;Santa Vitória;3;3;6;53
3149101;Pedralva;3159605;Santa Rita do Sapucaí;3;3;6;24
3138609;Lima Duarte;3159407;Santa Rita de Ibitipoca;3;3;6;33
3106200;Belo Horizonte;3159001;Santana do Riacho;3;3;6;86
3134608;Jaboticatubas;3159001;Santana do Riacho;3;3;6;38
3106200;Belo Horizonte;3158953;Santana do Paraíso;3;3;6;160
3139409;Manhuaçu;3158904;Santana do Manhuaçu;3;3;6;20
3102803;Andrelândia;3158706;Santana do Garambéu;3;3;6;28
3118700;Coqueiral;3158300;Santana da Vargem;3;3;6;10
3140902;Matipó;3157906;Santa Margarida;3;3;6;15
3134608;Jaboticatubas;3157807;Santa Luzia;3;3;6;30
3143302;Montes Claros;3157807;Santa Luzia;3;3;6;336
3149309;Pedro Leopoldo;3157807;Santa Luzia;3;3;6;28
3156502;Rubelita;3157005;Salinas;3;3;6;25
3104601;Astolfo Dutra;3156304;Rodeiro;3;3;6;13
3141009;Mato Verde;3155603;Rio Pardo de Minas;3;3;6;42
3154002;Raul Soares;3154903;Rio Casca;3;3;6;28
3124104;Esmeraldas;3154606;Ribeirão das Neves;3;3;6;24
3139409;Manhuaçu;3154150;Reduto;3;3;6;9
3106200;Belo Horizonte;3153905;Raposos;3;3;6;20
3106200;Belo Horizonte;3153608;Prudente de Morais;3;3;6;50
3139508;Manhumirim;3153509;Alto Jequitibá;3;3;6;7
3104007;Araxá;3153004;Pratinha;3;3;6;62
3109709;Cachoeira de Minas;3152501;Pouso Alegre;3;3;6;24
3117801;Conceição dos Ouros;3152501;Pouso Alegre;3;3;6;27
3124500;Estiva;3152501;Pouso Alegre;3;3;6;28
3147907;Passos;3152501;Pouso Alegre;3;3;6;181
3139201;Malacacheta;3152402;Poté;3;3;6;31
3141009;Mato Verde;3152204;Porteirinha;3;3;6;41
3143302;Montes Claros;3152204;Porteirinha;3;3;6;144
3118304;Conselheiro Lafaiete;3152105;Ponte Nova;3;3;6;100
3131901;Itabirito;3152105;Ponte Nova;3;3;6;99
3135506;Jequeri;3152105;Ponte Nova;3;3;6;26
3105103;Bambuí;3152006;Pompéu;3;3;6;141
3107109;Boa Esperança;3151800;Poços de Caldas;3;3;6;126
3125101;Extrema;3151800;Poços de Caldas;3;3;6;122
3127107;Frutal;3151602;Planura;3;3;6;29
3104205;Arcos;3151503;Piumhi;3;3;6;48
3118601;Contagem;3151503;Piumhi;3;3;6;204
3150505;Pimenta;3151503;Piumhi;3;3;6;17
3122306;Divinópolis;3151404;Pitangui;3;3;6;56
3146909;Papagaios;3151404;Pitangui;3;3;6;26
3132404;Itajubá;3151008;Piranguinho;3;3;6;10
3143302;Montes Claros;3149309;Pedro Leopoldo;3;3;6;320
3144805;Nova Lima;3149309;Pedro Leopoldo;3;3;6;50
3106200;Belo Horizonte;3148707;Pedra Azul;3;3;6;516
3106200;Belo Horizonte;3148608;Peçanha;3;3;6;212
3128907;Guimarânia;3148103;Patrocínio;3;3;6;23
3103504;Araguari;3148004;Patos de Minas;3;3;6;180
3118601;Contagem;3147907;Passos;3;3;6;278
3138203;Lavras;3147907;Passos;3;3;6;179
3106200;Belo Horizonte;3147709;Passa Tempo;3;3;6;99
3121407;Desterro de Entre Rios;3147709;Passa Tempo;3;3;6;17
3133006;Itamonte;3147600;Passa Quatro;3;3;6;15
3118908;Cordisburgo;3147402;Paraopeba;3;3;6;18
3139003;Machado;3147204;Paraguaçu;3;3;6;24
3126000;Florestal;3147105;Pará de Minas;3;3;6;20
3140506;Martinho Campos;3147105;Pará de Minas;3;3;6;87
3104007;Araxá;3147006;Paracatu;3;3;6;261
3118601;Contagem;3147006;Paracatu;3;3;6;426
3125705;Felixlândia;3146909;Papagaios;3;3;6;78
3141405;Medina;3146305;Padre Paraíso;3;3;6;95
3136702;Juiz de Fora;3146107;Ouro Preto;3;3;6;154
3126109;Formiga;3145604;Oliveira;3;3;6;64
3132305;Itaipé;3145307;Novo Cruzeiro;3;3;6;23
3137007;Ladainha;3145307;Novo Cruzeiro;3;3;6;23
3104007;Araxá;3145208;Nova Serrana;3;3;6;208
3133808;Itaúna;3145208;Nova Serrana;3;3;6;48
3138807;Luz;3145208;Nova Serrana;3;3;6;75
3143104;Monte Carmelo;3145000;Nova Ponte;3;3;6;49
3109006;Brumadinho;3144805;Nova Lima;3;3;6;39
3106200;Belo Horizonte;3144706;Nova Era;3;3;6;99
3106309;Belo Oriente;3144359;Naque;3;3;6;16
3137700;Lajinha;3144003;Mutum;3;3;6;44
3139409;Manhuaçu;3144003;Mutum;3;3;6;82
3125952;Fervedouro;3143906;Muriaé;3;3;6;39
2927408;Salvador;3143302;Montes Claros;3;3;6;705
3113404;Caratinga;3143302;Montes Claros;3;3;6;385
3121605;Diamantina;3143302;Montes Claros;3;3;6;167
3136702;Juiz de Fora;3143302;Montes Claros;3;3;6;559
3128709;Guaxupé;3143005;Monte Belo;3;3;6;36
3124302;Espinosa;3142908;Monte Azul;3;3;6;26
3106200;Belo Horizonte;3142304;Moeda;3;3;6;49
3127701;Governador Valadares;3141504;Mendes Pimentel;3;3;6;63
3137601;Lagoa Santa;3141108;Matozinhos;3;3;6;21
3100302;Abre Campo;3140902;Matipó;3;3;6;14
3106200;Belo Horizonte;3140852;Matias Cardoso;3;3;6;558
3106200;Belo Horizonte;3140803;Matias Barbosa;3;3;6;228
3139508;Manhumirim;3140530;Martins Soares;3;3;6;14
3118601;Contagem;3140506;Martinho Campos;3;3;6;137
3118304;Conselheiro Lafaiete;3140001;Mariana;3;3;6;53
3106903;Bicas;3139805;Mar de Espanha;3;3;6;20
3136702;Juiz de Fora;3139805;Mar de Espanha;3;3;6;36
3106200;Belo Horizonte;3139706;Maravilhas;3;3;6;85
3118601;Contagem;3139706;Maravilhas;3;3;6;76
3113404;Caratinga;3139508;Manhumirim;3;3;6;66
3131208;Ipanema;3139409;Manhuaçu;3;3;6;62
3124302;Espinosa;3139250;Mamonas;3;3;6;22
3111002;Campestre;3139003;Machado;3;3;6;34
3100906;Águas Formosas;3138906;Machacalis;3;3;6;28
3105103;Bambuí;3138807;Luz;3;3;6;39
3106200;Belo Horizonte;3138807;Luz;3;3;6;180
3137205;Lagoa da Prata;3138807;Luz;3;3;6;30
3114550;Carneirinho;3138625;Limeira do Oeste;3;3;6;20
3107505;Bom Jardim de Minas;3138609;Lima Duarte;3;3;6;43
3102803;Andrelândia;3138500;Liberdade;3;3;6;34
3114808;Carvalhos;3138500;Liberdade;3;3;6;15
3106200;Belo Horizonte;3138401;Leopoldina;3;3;6;225
3101607;Alfenas;3138203;Lavras;3;3;6;101
3130804;Ingaí;3138203;Lavras;3;3;6;21
3110905;Campanha;3137809;Lambari;3;3;6;12
3135902;Jesuânia;3137809;Lambari;3;3;6;11
3123528;Durandé;3137700;Lajinha;3;3;6;19
3106705;Betim;3137601;Lagoa Santa;3;3;6;48
3117876;Confins;3137601;Lagoa Santa;3;3;6;11
3134608;Jaboticatubas;3137601;Lagoa Santa;3;3;6;20
3123908;Entre Rios de Minas;3137403;Lagoa Dourada;3;3;6;27
3135308;Japaraíba;3137205;Lagoa da Prata;3;3;6;14
3128709;Guaxupé;3136900;Juruaia;3;3;6;16
3106705;Betim;3136652;Juatuba;3;3;6;16
3109006;Brumadinho;3136652;Juatuba;3;3;6;26
3126000;Florestal;3136652;Juatuba;3;3;6;12
3111200;Campo Belo;3136306;João Pinheiro;3;3;6;362
3103405;Araçuaí;3135456;Jenipapo de Minas;3;3;6;32
3118304;Conselheiro Lafaiete;3135407;Jeceaba;3;3;6;22
3132107;Itacarambi;3135209;Januária;3;3;6;49
3114550;Carneirinho;3134400;Iturama;3;3;6;52
3129103;Gurinhatã;3134202;Ituiutaba;3;3;6;44
3115102;Cássia;3133758;Itaú de Minas;3;3;6;24
3110509;Camanducaia;3133600;Itapeva;3;3;6;10
3114006;Carmo da Mata;3133501;Itapecerica;3;3;6;28
3112653;Capitão Andrade;3133204;Itanhomi;3;3;6;12
3128006;Guanhães;3132503;Itamarandiba;3;3;6;98
3117900;Congonhal;3131505;Ipuiúna;3;3;6;17
3106705;Betim;3131307;Ipatinga;3;3;6;181
3113404;Caratinga;3130556;Imbé de Minas;3;3;6;34
3128105;Guapé;3130507;Ilicínea;3;3;6;21
3104205;Arcos;3130309;Iguatama;3;3;6;22
3111507;Campos Altos;3129509;Ibiá;3;3;6;47
3101607;Alfenas;3128709;Guaxupé;3;3;6;80
3108404;Botelhos;3128709;Guaxupé;3;3;6;49
3109501;Cabo Verde;3128709;Guaxupé;3;3;6;38
3112307;Capelinha;3128006;Guanhães;3;3;6;124
3117504;Conceição do Mato Dentro;3128006;Guanhães;3;3;6;61
3106309;Belo Oriente;3127701;Governador Valadares;3;3;6;70
3126901;Frei Inocêncio;3127701;Governador Valadares;3;3;6;30
3121001;Datas;3127602;Gouveia;3;3;6;11
3121605;Diamantina;3127602;Gouveia;3;3;6;28
3106200;Belo Horizonte;3127206;Funilândia;3;3;6;59
3106200;Belo Horizonte;3126604;Francisco Dumont;3;3;6;287
3105103;Bambuí;3126109;Formiga;3;3;6;77
3107406;Bom Despacho;3126109;Formiga;3;3;6;83
3111200;Campo Belo;3126109;Formiga;3;3;6;50
3106200;Belo Horizonte;3125705;Felixlândia;3;3;6;160
3106200;Belo Horizonte;3125101;Extrema;3;3;6;404
3106200;Belo Horizonte;3123908;Entre Rios de Minas;3;3;6;86
3102308;Alvinópolis;3122702;Dom Silvério;3;3;6;10
1721000;Palmas;3122306;Divinópolis;3;3;6;1141
3104205;Arcos;3122306;Divinópolis;3;3;6;70
3111200;Campo Belo;3122306;Divinópolis;3;3;6;90
3120102;Couto de Magalhães de Minas;3121605;Diamantina;3;3;6;22
3118601;Contagem;3120904;Curvelo;3;3;6;135
3106200;Belo Horizonte;3120607;Crucilândia;3;3;6;65
3103405;Araçuaí;3119500;Coronel Murta;3;3;6;34
3106200;Belo Horizonte;3119302;Coromandel;3;3;6;377
3107109;Boa Esperança;3118700;Coqueiral;3;3;6;17
1504422;Marituba;3118601;Contagem;3;3;6;2097
1505536;Parauapebas;3118601;Contagem;3;3;6;1646
1721000;Palmas;3118601;Contagem;3;3;6;1145
2111300;São Luís;3118601;Contagem;3;3;6;1923
2933307;Vitória da Conquista;3118601;Contagem;3;3;6;652
3104205;Arcos;3118601;Contagem;3;3;6;158
3105103;Bambuí;3118601;Contagem;3;3;6;199
3105400;Barão de Cocais;3118601;Contagem;3;3;6;60
3118007;Congonhas;3118601;Contagem;3;3;6;67
3106705;Betim;3118304;Conselheiro Lafaiete;3;3;6;87
3106200;Belo Horizonte;3117603;Conceição do Pará;3;3;6;98
3102001;Alterosa;3117108;Conceição da Aparecida;3;3;6;18
3104304;Areado;3117108;Conceição da Aparecida;3;3;6;30
3106200;Belo Horizonte;3116803;Coluna;3;3;6;221
3106200;Belo Horizonte;3116605;Cláudio;3;3;6;102
3114006;Carmo da Mata;3116605;Cláudio;3;3;6;17
3106200;Belo Horizonte;3114501;Carmópolis de Minas;3;3;6;98
3106200;Belo Horizonte;3114006;Carmo da Mata;3;3;6;118
3107802;Bom Jesus do Galho;3113404;Caratinga;3;3;6;12
3106200;Belo Horizonte;3113305;Carangola;3;3;6;223
3106200;Belo Horizonte;3112505;Capim Branco;3;3;6;42
3107109;Boa Esperança;3111606;Campos Gerais;3;3;6;26
3107109;Boa Esperança;3111309;Campo do Meio;3;3;6;27
3101607;Alfenas;3111200;Campo Belo;3;3;6;91
3102605;Andradas;3110301;Caldas;3;3;6;25
3106200;Belo Horizonte;3110301;Caldas;3;3;6;333
3105400;Barão de Cocais;3110004;Caeté;3;3;6;18
3106200;Belo Horizonte;3109600;Cachoeira da Prata;3;3;6;65
3106200;Belo Horizonte;3109303;Buritis;3;3;6;541
3107307;Bocaiúva;3109204;Buenópolis;3;3;6;90
3106200;Belo Horizonte;3108206;Bonfinópolis de Minas;3;3;6;428
3100203;Abaeté;3107406;Bom Despacho;3;3;6;68
3101607;Alfenas;3107109;Boa Esperança;3;3;6;53
1302603;Manaus;3106705;Betim;3;3;6;2458
2906501;Candeias;3106705;Betim;3;3;6;993
2927408;Salvador;3106705;Betim;3;3;6;969
3104205;Arcos;3106705;Betim;3;3;6;146
1500602;Altamira;3106200;Belo Horizonte;3;3;6;2031
1502152;Canaã dos Carajás;3106200;Belo Horizonte;3;3;6;1599
1503903;Juruti;3106200;Belo Horizonte;3;3;6;2309
2100055;Açailândia;3106200;Belo Horizonte;3;3;6;1690
2101251;Bacabeira;3106200;Belo Horizonte;3;3;6;1873
2403251;Parnamirim;3106200;Belo Horizonte;3;3;6;1782
2606002;Garanhuns;3106200;Belo Horizonte;3;3;6;1439
2910727;Eunápolis;3106200;Belo Horizonte;3;3;6;599
2925303;Porto Seguro;3106200;Belo Horizonte;3;3;6;632
2925501;Prado;3106200;Belo Horizonte;3;3;6;567
2929206;São Francisco do Conde;3106200;Belo Horizonte;3;3;6;971
2930709;Simões Filho;3106200;Belo Horizonte;3;3;6;974
3102308;Alvinópolis;3106200;Belo Horizonte;3;3;6;100
3103504;Araguari;3106200;Belo Horizonte;3;3;6;463
3105004;Baldim;3106200;Belo Horizonte;3;3;6;68
3105103;Bambuí;3106200;Belo Horizonte;3;3;6;211
3102902;Antônio Carlos;3105608;Barbacena;3;3;6;14
3104007;Araxá;3105103;Bambuí;3;3;6;111
3104205;Arcos;3105103;Bambuí;3;3;6;56
3102001;Alterosa;3104304;Areado;3;3;6;12
2932804;Utinga;2933406;Wagner;3;3;6;24
2902807;Barra da Estiva;2933307;Vitória da Conquista;3;3;6;148
2913903;Ipiaú;2933307;Vitória da Conquista;3;3;6;150
2914604;Irecê;2933307;Vitória da Conquista;3;3;6;404
2915809;Itambé;2933307;Vitória da Conquista;3;3;6;49
2931806;Tremedal;2933307;Vitória da Conquista;3;3;6;62
2916104;Itaparica;2933208;Vera Cruz;3;3;6;6
2927200;Ruy Barbosa;2932804;Utinga;3;3;6;66
2913606;Ilhéus;2932705;Uruçuca;3;3;6;28
2911709;Guanambi;2932606;Urandi;3;3;6;55
2913606;Ilhéus;2932309;Ubatã;3;3;6;81
2917706;Jaguarari;2932002;Uauá;3;3;6;91
2927408;Salvador;2931202;Taperoá;3;3;6;93
2902807;Barra da Estiva;2931004;Tanhaçu;3;3;6;46
2917201;Ituaçu;2931004;Tanhaçu;3;3;6;24
2611101;Petrolina;2930774;Sobradinho;3;3;6;38
2903904;Bom Jesus da Lapa;2930758;Sítio do Mato;3;3;6;23
2307650;Maracanaú;2930709;Simões Filho;3;3;6;987
2910701;Euclides da Cunha;2930501;Serrinha;3;3;6;126
2611606;Recife;2930204;Sento Sé;3;3;6;791
2906873;Capim Grosso;2930105;Senhor do Bonfim;3;3;6;106
2904605;Brumado;2929909;Seabra;3;3;6;194
2927408;Salvador;2929909;Seabra;3;3;6;361
2906873;Capim Grosso;2929370;São José do Jacuípe;3;3;6;16
2908200;Conceição da Feira;2929305;São Gonçalo dos Campos;3;3;6;9
2918506;Jussara;2929255;São Gabriel;3;3;6;21
2304400;Fortaleza;2929206;São Francisco do Conde;3;3;6;980
2906501;Candeias;2929206;São Francisco do Conde;3;3;6;15
2928000;Santaluz;2928950;São Domingos;3;3;6;33
2901007;Amargosa;2928703;Santo Antônio de Jesus;3;3;6;34
2917607;Jaguaquara;2928703;Santo Antônio de Jesus;3;3;6;94
2904902;Cachoeira;2928604;Santo Amaro;3;3;6;26
2927408;Salvador;2928109;Santa Maria da Vitória;3;3;6;623
2910800;Feira de Santana;2928000;Santaluz;3;3;6;123
2921500;Monte Santo;2928000;Santaluz;3;3;6;91
2927408;Salvador;2928000;Santaluz;3;3;6;216
1100205;Porto Velho;2927408;Salvador;3;3;6;2777
1400100;Boa Vista;2927408;Salvador;3;3;6;2947
2105302;Imperatriz;2927408;Salvador;3;3;6;1268
2304285;Eusébio;2927408;Salvador;3;3;6;1006
2307304;Juazeiro do Norte;2927408;Salvador;3;3;6;644
2600054;Abreu e Lima;2927408;Salvador;3;3;6;681
2604106;Caruaru;2927408;Salvador;3;3;6;585
2803500;Lagarto;2927408;Salvador;3;3;6;249
2803609;Laranjeiras;2927408;Salvador;3;3;6;280
2806701;São Cristóvão;2927408;Salvador;3;3;6;263
2901106;Amélia Rodrigues;2927408;Salvador;3;3;6;71
2904050;Bonito;2927408;Salvador;3;3;6;323
2904308;Brejões;2927408;Salvador;3;3;6;144
2904902;Cachoeira;2927408;Salvador;3;3;6;64
2910701;Euclides da Cunha;2927408;Salvador;3;3;6;282
2911204;Gandu;2927408;Salvador;3;3;6;139
2913200;Ibotirama;2927408;Salvador;3;3;6;521
2916302;Itapebi;2927408;Salvador;3;3;6;347
2917300;Ituberá;2927408;Salvador;3;3;6;110
2920601;Maragogipe;2927408;Salvador;3;3;6;57
2920700;Maraú;2927408;Salvador;3;3;6;136
2922409;Mutuípe;2927408;Salvador;3;3;6;115
2922904;Nova Soure;2927408;Salvador;3;3;6;195
2925402;Potiraguá;2927408;Salvador;3;3;6;326
2927200;Ruy Barbosa;2927408;Salvador;3;3;6;232
2902609;Baixa Grande;2927200;Ruy Barbosa;3;3;6;52
2908408;Conceição do Coité;2926608;Ribeira do Pombal;3;3;6;105
2910800;Feira de Santana;2926608;Ribeira do Pombal;3;3;6;169
2918100;Jeremoabo;2926608;Ribeira do Pombal;3;3;6;86
2923100;Olindina;2926608;Ribeira do Pombal;3;3;6;65
2910800;Feira de Santana;2925956;Rafael Jambeiro;3;3;6;60
2910701;Euclides da Cunha;2925907;Quijingue;3;3;6;34
2906808;Cansanção;2925808;Queimadas;3;3;6;35
2906873;Capim Grosso;2925808;Queimadas;3;3;6;63
2915601;Itamaraju;2925501;Prado;3;3;6;41
2916807;Itarantim;2925402;Potiraguá;3;3;6;22
2304400;Fortaleza;2925303;Porto Seguro;3;3;6;1401
2911808;Guaratinga;2925303;Porto Seguro;3;3;6;70
2916401;Itapetinga;2925303;Porto Seguro;3;3;6;174
2906873;Capim Grosso;2925253;Ponto Novo;3;3;6;59
2907509;Catu;2925204;Pojuca;3;3;6;8
2910057;Dias d'Ávila;2925204;Pojuca;3;3;6;20
2913507;Iguaí;2925105;Poções;3;3;6;40
2921708;Morro do Chapéu;2924801;Piritiba;3;3;6;67
2922102;Mundo Novo;2924801;Piritiba;3;3;6;14
2611002;Petrolândia;2924009;Paulo Afonso;3;3;6;37
2918100;Jeremoabo;2924009;Paulo Afonso;3;3;6;73
2918407;Juazeiro;2924009;Paulo Afonso;3;3;6;241
2905602;Camacan;2923902;Pau Brasil;3;3;6;14
2803500;Lagarto;2923803;Paripiranga;3;3;6;26
2907103;Carinhanha;2923407;Palmas de Monte Alto;3;3;6;71
2901601;Antas;2923050;Novo Triunfo;3;3;6;12
2913002;Ibitiara;2923035;Novo Horizonte;3;3;6;18
2915601;Itamaraju;2923001;Nova Viçosa;3;3;6;92
2913507;Iguaí;2922706;Nova Canaã;3;3;6;7
2906808;Cansanção;2922656;Nordestina;3;3;6;18
2901007;Amargosa;2922409;Mutuípe;3;3;6;25
2921203;Miguel Calmon;2922102;Mundo Novo;3;3;6;44
2915601;Itamaraju;2922003;Mucuri;3;3;6;106
2905008;Caculé;2921807;Mortugaba;3;3;6;58
2914703;Itaberaba;2920502;Maracás;3;3;6;98
2916906;Itiruçu;2920502;Maracás;3;3;6;30
2918001;Jequié;2920403;Manoel Vitorino;3;3;6;35
2904605;Brumado;2920304;Malhada de Pedras;3;3;6;32
2916401;Itapetinga;2920007;Maiquinique;3;3;6;38
2907707;Chorrochó;2919900;Macururé;3;3;6;22
2903201;Barreiras;2919801;Macaúbas;3;3;6;260
2904605;Brumado;2919801;Macaúbas;3;3;6;174
2911709;Guanambi;2919553;Luís Eduardo magalhães;3;3;6;410
2607901;Jaboatão dos Guararapes;2919207;Lauro de Freitas;3;3;6;635
2900702;Alagoinhas;2919207;Lauro de Freitas;3;3;6;84
2914604;Irecê;2918506;Jussara;3;3;6;35
2607901;Jaboatão dos Guararapes;2918407;Juazeiro;3;3;6;620
2917706;Jaguarari;2918407;Juazeiro;3;3;6;94
2915106;Itagi;2918308;Jitaúna;3;3;6;24
2914604;Irecê;2918001;Jequié;3;3;6;334
2304400;Fortaleza;2917508;Jacobina;3;3;6;853
2905008;Caculé;2917409;Jacaraci;3;3;6;42
2913606;Ilhéus;2917300;Ituberá;3;3;6;117
2304400;Fortaleza;2916401;Itapetinga;3;3;6;1286
2904803;Caatiba;2916401;Itapetinga;3;3;6;38
2913507;Iguaí;2916401;Itapetinga;3;3;6;61
2914802;Itabuna;2916401;Itapetinga;3;3;6;118
2914653;Itabela;2915601;Itamaraju;3;3;6;50
2902708;Barra;2914604;Irecê;3;3;6;153
2903003;Barra do Mendes;2914604;Irecê;3;3;6;52
2903904;Bom Jesus da Lapa;2914604;Irecê;3;3;6;270
2905305;Cafarnaum;2914604;Irecê;3;3;6;58
2906204;Canarana;2914604;Irecê;3;3;6;39
2304400;Fortaleza;2913903;Ipiaú;3;3;6;1148
2900702;Alagoinhas;2913705;Inhambupe;3;3;6;39
2304400;Fortaleza;2913606;Ilhéus;3;3;6;1221
2905602;Camacan;2913606;Ilhéus;3;3;6;82
2908002;Coaraci;2913606;Ilhéus;3;3;6;48
2902807;Barra da Estiva;2912202;Ibicoara;3;3;6;23
2901007;Amargosa;2911907;Iaçu;3;3;6;66
2910727;Eunápolis;2911808;Guaratinga;3;3;6;33
2902807;Barra da Estiva;2911709;Guanambi;3;3;6;173
2903201;Barreiras;2911709;Guanambi;3;3;6;329
2906600;Candiba;2911709;Guanambi;3;3;6;16
2910800;Feira de Santana;2911709;Guanambi;3;3;6;467
2700300;Arapiraca;2910800;Feira de Santana;3;3;6;372
2906873;Capim Grosso;2910800;Feira de Santana;3;3;6;152
2907509;Catu;2910800;Feira de Santana;3;3;6;67
2304400;Fortaleza;2910727;Eunápolis;3;3;6;1398
2900702;Alagoinhas;2910602;Esplanada;3;3;6;59
2304400;Fortaleza;2910057;Dias d'Ávila;3;3;6;979
2906501;Candeias;2910057;Dias d'Ávila;3;3;6;28
2908309;Conceição do Almeida;2909802;Cruz das Almas;3;3;6;15
2903201;Barreiras;2909307;Correntina;3;3;6;130
2901106;Amélia Rodrigues;2908903;Coração de Maria;3;3;6;19
2905008;Caculé;2908705;Condeúba;3;3;6;53
2901106;Amélia Rodrigues;2908507;Conceição do Jacuípe;3;3;6;8
2901601;Antas;2907806;Cícero Dantas;3;3;6;25
2611606;Recife;2907202;Casa Nova;3;3;6;665
2906857;Capela do Alto Alegre;2906873;Capim Grosso;3;3;6;37
2900702;Alagoinhas;2906501;Candeias;3;3;6;61
2111300;São Luís;2905701;Camaçari;3;3;6;1290
2602902;Cabo de Santo Agostinho;2905701;Camaçari;3;3;6;604
2800308;Aracaju;2905701;Camaçari;3;3;6;240
2903201;Barreiras;2905206;Caetité;3;3;6;337
2902005;Aracatu;2904605;Brumado;3;3;6;33
2902807;Barra da Estiva;2904605;Brumado;3;3;6;73
2304400;Fortaleza;2903201;Barreiras;3;3;6;1163
2902708;Barra;2903201;Barreiras;3;3;6;235
2900306;Acajutiba;2901908;Aporá;3;3;6;7
2304400;Fortaleza;2900702;Alagoinhas;3;3;6;925
2800308;Aracaju;2900702;Alagoinhas;3;3;6;199
2802106;Estância;2807600;Umbaúba;3;3;6;25
2803005;Itabaianinha;2807600;Umbaúba;3;3;6;19
2802106;Estância;2807402;Tobias Barreto;3;3;6;64
2805505;Poço Verde;2807105;Simão Dias;3;3;6;39
2802908;Itabaiana;2806008;Ribeirópolis;3;3;6;10
2800209;Aquidabã;2805703;Propriá;3;3;6;18
2800308;Aracaju;2805505;Poço Verde;3;3;6;117
2800308;Aracaju;2805307;Pirambu;3;3;6;33
2801207;Canindé de São Francisco;2804508;Nossa Senhora da Glória;3;3;6;77
2706703;Penedo;2804409;Neópolis;3;3;6;11
2800308;Aracaju;2804300;Muribeca;3;3;6;54
2304400;Fortaleza;2803500;Lagarto;3;3;6;789
2800670;Boquim;2803500;Lagarto;3;3;6;34
2803005;Itabaianinha;2803500;Lagarto;3;3;6;46
2800308;Aracaju;2802502;General Maynard;3;3;6;26
2800308;Aracaju;2802304;Frei Paulo;3;3;6;60
2800308;Aracaju;2801306;Capela;3;3;6;41
2800308;Aracaju;2800407;Arauá;3;3;6;71
1501402;Belém;2800308;Aracaju;3;3;6;1615
1721000;Palmas;2800308;Aracaju;3;3;6;1233
2304285;Eusébio;2800308;Aracaju;3;3;6;787
2610707;Paulista;2800308;Aracaju;3;3;6;405
2706703;Penedo;2800308;Aracaju;3;3;6;91
2707701;Rio Largo;2800308;Aracaju;3;3;6;207
2702306;Coruripe;2709301;União dos Palmares;3;3;6;104
2700300;Arapiraca;2708808;São Sebastião;3;3;6;24
2611606;Recife;2708600;São Miguel dos Campos;3;3;6;224
2706703;Penedo;2708600;São Miguel dos Campos;3;3;6;73
2704609;Maravilha;2708006;Santana do Ipanema;3;3;6;19
2706307;Palmeira dos Índios;2708006;Santana do Ipanema;3;3;6;65
2607901;Jaboatão dos Guararapes;2707701;Rio Largo;3;3;6;175
2705101;Matriz de Camaragibe;2707305;Porto Calvo;3;3;6;20
2611606;Recife;2706703;Penedo;3;3;6;296
2706307;Palmeira dos Índios;2706703;Penedo;3;3;6;93
2703106;Igaci;2706307;Palmeira dos Índios;3;3;6;12
2704401;Major Isidoro;2706307;Palmeira dos Índios;3;3;6;38
2704807;Maribondo;2706307;Palmeira dos Índios;3;3;6;41
2704302;Maceió;2705101;Matriz de Camaragibe;3;3;6;57
2704302;Maceió;2704500;Maragogi;3;3;6;90
2408003;Mossoró;2704302;Maceió;3;3;6;522
2607208;Ipojuca;2704302;Maceió;3;3;6;156
2702405;Delmiro Gouveia;2704302;Maceió;3;3;6;249
2700300;Arapiraca;2704104;Lagoa da Canoa;3;3;6;9
2602902;Cabo de Santo Agostinho;2616407;Vitória de Santo Antão;3;3;6;35
2604007;Carpina;2616407;Vitória de Santo Antão;3;3;6;31
2606002;Garanhuns;2616407;Vitória de Santo Antão;3;3;6;159
2614501;Surubim;2616183;Vertente do Lério;3;3;6;12
2601201;Arcoverde;2615805;Tupanatinga;3;3;6;44
2613909;Serra Talhada;2615706;Triunfo;3;3;6;26
2611606;Recife;2615409;Toritama;3;3;6;124
2613107;São Caitano;2615409;Toritama;3;3;6;38
2615003;Taquaritinga do Norte;2615409;Toritama;3;3;6;10
2600708;Aliança;2615300;Timbaúba;3;3;6;13
2605509;Ferreiros;2615300;Timbaúba;3;3;6;10
2609006;Macaparana;2615300;Timbaúba;3;3;6;17
2601409;Barreiros;2614857;Tamandaré;3;3;6;10
2611606;Recife;2614709;Tacaimbó;3;3;6;151
2600104;Afogados da Ingazeira;2614105;Sertânia;3;3;6;46
2611606;Recife;2614105;Sertânia;3;3;6;261
2304400;Fortaleza;2613909;Serra Talhada;3;3;6;463
2601102;Araripina;2613909;Serra Talhada;3;3;6;243
2605103;Custódia;2613909;Serra Talhada;3;3;6;77
2600104;Afogados da Ingazeira;2613602;São José do Egito;3;3;6;49
2611606;Recife;2613602;São José do Egito;3;3;6;270
2612208;Salgueiro;2613503;São José do Belmonte;3;3;6;48
2601409;Barreiros;2613404;São José da Coroa Grande;3;3;6;7
2603504;Camocim de São Félix;2613305;São Joaquim do Monte;3;3;6;9
2304400;Fortaleza;2612505;Santa Cruz do Capibaribe;3;3;6;529
2604007;Carpina;2612505;Santa Cruz do Capibaribe;3;3;6;106
2606408;Gravatá;2612505;Santa Cruz do Capibaribe;3;3;6;76
2602605;Brejo da Madre de Deus;2612406;Sanharó;3;3;6;32
2602001;Bodocó;2612208;Salgueiro;3;3;6;94
2601409;Barreiros;2611804;Ribeirão;3;3;6;39
2602902;Cabo de Santo Agostinho;2611804;Ribeirão;3;3;6;47
2605905;Gameleira;2611804;Ribeirão;3;3;6;10
2611606;Recife;2611804;Ribeirão;3;3;6;66
1400100;Boa Vista;2611606;Recife;3;3;6;3068
1721000;Palmas;2611606;Recife;3;3;6;1506
2103406;Coelho Neto;2611606;Recife;3;3;6;989
2400208;Açu;2611606;Recife;3;3;6;358
2414209;Tibau do Sul;2611606;Recife;3;3;6;212
2500601;Alhandra;2611606;Recife;3;3;6;76
2504603;Conde;2611606;Recife;3;3;6;96
2513703;Santa Rita;2611606;Recife;3;3;6;110
2605707;Floresta;2611606;Recife;3;3;6;408
2603702;Canhotinho;2611507;Quipapá;3;3;6;19
2605202;Escada;2611408;Primavera;3;3;6;17
2606408;Gravatá;2611309;Pombos;3;3;6;20
2608800;Lajedo;2611101;Petrolina;3;3;6;468
2609907;Ouricuri;2611101;Petrolina;3;3;6;164
2606002;Garanhuns;2610905;Pesqueira;3;3;6;61
2601706;Belo Jardim;2610707;Paulista;3;3;6;176
2604106;Caruaru;2610707;Paulista;3;3;6;128
2607307;Ipubi;2609907;Ouricuri;3;3;6;26
1501402;Belém;2609600;Olinda;3;3;6;1654
2111300;São Luís;2609600;Olinda;3;3;6;1189
2211001;Teresina;2609600;Olinda;3;3;6;925
2304285;Eusébio;2609600;Olinda;3;3;6;598
2606002;Garanhuns;2609600;Olinda;3;3;6;203
2606804;Igarassu;2609600;Olinda;3;3;6;17
2606804;Igarassu;2609402;Moreno;3;3;6;35
2607901;Jaboatão dos Guararapes;2609402;Moreno;3;3;6;7
2605004;Cupira;2608701;Lagoa dos Gatos;3;3;6;7
2604700;Correntes;2608602;Lagoa do Ouro;3;3;6;14
2604106;Caruaru;2608107;João Alfredo;3;3;6;65
1302603;Manaus;2607901;Jaboatão dos Guararapes;3;3;6;2797
1500800;Ananindeua;2607901;Jaboatão dos Guararapes;3;3;6;1641
2305233;Horizonte;2607901;Jaboatão dos Guararapes;3;3;6;585
2606804;Igarassu;2607752;Itapissuma;3;3;6;8
2511202;Pedras de Fogo;2607653;Itambé;3;3;6;3
2606200;Goiana;2607653;Itambé;3;3;6;21
2606804;Igarassu;2607604;Ilha de Itamaracá;3;3;6;14
1302603;Manaus;2607208;Ipojuca;3;3;6;2797
2111300;São Luís;2607208;Ipojuca;3;3;6;1196
2408102;Natal;2607208;Ipojuca;3;3;6;286
2601409;Barreiros;2607208;Ipojuca;3;3;6;48
2601201;Arcoverde;2606606;Ibimirim;3;3;6;68
2602902;Cabo de Santo Agostinho;2606408;Gravatá;3;3;6;60
2604007;Carpina;2606200;Goiana;3;3;6;41
2604601;Condado;2606200;Goiana;3;3;6;12
2605400;Feira Nova;2606101;Glória do Goitá;3;3;6;12
2604700;Correntes;2606002;Garanhuns;3;3;6;38
2601409;Barreiros;2605202;Escada;3;3;6;49
2201739;Betânia do Piauí;2605152;Dormentes;3;3;6;33
2600104;Afogados da Ingazeira;2605103;Custódia;3;3;6;37
2307304;Juazeiro do Norte;2604106;Caruaru;3;3;6;383
2507507;João Pessoa;2604007;Carpina;3;3;6;83
2602308;Bonito;2603504;Camocim de São Félix;3;3;6;13
2601706;Belo Jardim;2603108;Cachoeirinha;3;3;6;24
2601102;Araripina;2603009;Cabrobó;3;3;6;164
2111300;São Luís;2602902;Cabo de Santo Agostinho;3;3;6;1193
2304400;Fortaleza;2602902;Cabo de Santo Agostinho;3;3;6;631
2601904;Bezerros;2602308;Bonito;3;3;6;27
2601300;Barra de Guabiraba;2601904;Bezerros;3;3;6;26
2304202;Crato;2601102;Araripina;3;3;6;124
2507507;João Pessoa;2600054;Abreu e Lima;3;3;6;78
2500775;Aparecida;2516201;Sousa;3;3;6;21
2504306;Catolé do Rocha;2516201;Sousa;3;3;6;75
2507002;Itaporanga;2516201;Sousa;3;3;6;59
2512101;Pombal;2516201;Sousa;3;3;6;56
2509107;Mari;2515302;Sapé;3;3;6;10
2408102;Natal;2513703;Santa Rita;3;3;6;148
2507507;João Pessoa;2512903;Rio Tinto;3;3;6;51
2502508;Boqueirão;2512507;Queimadas;3;3;6;31
2507507;João Pessoa;2512507;Queimadas;3;3;6;116
2504009;Campina Grande;2512408;Puxinanã;3;3;6;9
2501807;Bayeux;2510808;Patos;3;3;6;259
2507507;João Pessoa;2509701;Monteiro;3;3;6;265
2504009;Campina Grande;2508307;Lagoa Seca;3;3;6;7
2504009;Campina Grande;2507705;Juazeirinho;3;3;6;76
1302603;Manaus;2507507;João Pessoa;3;3;6;2807
2304285;Eusébio;2507507;João Pessoa;3;3;6;538
2312908;Sobral;2507507;João Pessoa;3;3;6;721
2409407;Pau dos Ferros;2507507;João Pessoa;3;3;6;393
2414209;Tibau do Sul;2507507;João Pessoa;3;3;6;112
2500601;Alhandra;2507507;João Pessoa;3;3;6;28
2507309;Jacaraú;2507507;João Pessoa;3;3;6;80
2504009;Campina Grande;2506806;Ingá;3;3;6;32
2408102;Natal;2506301;Guarabira;3;3;6;118
2504009;Campina Grande;2504306;Catolé do Rocha;3;3;6;226
2211001;Teresina;2504009;Campina Grande;3;3;6;795
2409407;Pau dos Ferros;2503704;Cajazeiras;3;3;6;96
2501807;Bayeux;2503209;Cabedelo;3;3;6;12
2408102;Natal;2501807;Bayeux;3;3;6;149
2407401;Martins;2414506;Umarizal;3;3;6;15
2410207;Portalegre;2414506;Umarizal;3;3;6;20
2407203;Macau;2414407;Touros;3;3;6;127
2408102;Natal;2414407;Touros;3;3;6;70
2404200;Goianinha;2414209;Tibau do Sul;3;3;6;15
2408102;Natal;2414001;Tangará;3;3;6;74
2408102;Natal;2412609;São Paulo do Potengi;3;3;6;58
2411205;Santa Cruz;2412609;São Paulo do Potengi;3;3;6;48
2404200;Goianinha;2412203;São José de Mipibu;3;3;6;29
2408201;Nísia Floresta;2412203;São José de Mipibu;3;3;6;5
2402006;Caicó;2412104;São João do Sabugi;3;3;6;30
2304400;Fortaleza;2412005;São Gonçalo do Amarante;3;3;6;420
2403251;Parnamirim;2411502;Santo Antônio;3;3;6;50
2408102;Natal;2411403;Santana do Matos;3;3;6;157
2408102;Natal;2409332;Santa Maria;3;3;6;50
2402303;Caraúbas;2409308;Patu;3;3;6;36
2404200;Goianinha;2408300;Nova Cruz;3;3;6;32
2407708;Montanhas;2408300;Nova Cruz;3;3;6;15
2400703;Alto do Rodrigues;2408102;Natal;3;3;6;178
2401008;Apodi;2408102;Natal;3;3;6;289
2401107;Areia Branca;2408102;Natal;3;3;6;229
2404200;Goianinha;2408102;Natal;3;3;6;58
2311801;Russas;2408003;Mossoró;3;3;6;75
2400802;Angicos;2408003;Mossoró;3;3;6;101
2402303;Caraúbas;2408003;Mossoró;3;3;6;70
2403103;Currais Novos;2406502;Lagoa Nova;3;3;6;19
2400703;Alto do Rodrigues;2404705;Ipanguaçu;3;3;6;25
2304400;Fortaleza;2404507;Guamaré;3;3;6;287
2307650;Maracanaú;2403251;Parnamirim;3;3;6;437
2401800;Brejinho;2403251;Parnamirim;3;3;6;32
2402204;Canguaretama;2403251;Parnamirim;3;3;6;53
2403004;Cruzeta;2403103;Currais Novos;3;3;6;35
2313401;Tianguá;2313609;Ubajara;3;3;6;16
2111300;São Luís;2312908;Sobral;3;3;6;448
2207702;Parnaíba;2312908;Sobral;3;3;6;181
2304202;Crato;2312908;Sobral;3;3;6;406
2312205;Santa Quitéria;2312908;Sobral;3;3;6;76
2305803;Ipu;2312304;São Benedito;3;3;6;33
2305209;Hidrolândia;2312205;Santa Quitéria;3;3;6;32
2309300;Nova Russas;2312205;Santa Quitéria;3;3;6;61
2310001;Palhano;2311801;Russas;3;3;6;20
2300150;Acarapé;2311603;Redenção;3;3;6;4
2300309;Acopiara;2311355;Quixelô;3;3;6;34
2307601;Limoeiro do Norte;2311306;Quixadá;3;3;6;109
2302503;Brejo Santo;2311108;Porteiras;3;3;6;13
2309102;Mulungu;2309805;Pacoti;3;3;6;12
2303709;Caucaia;2309607;Pacajus;3;3;6;55
2302107;Baturité;2309458;Ocara;3;3;6;36
2304103;Crateús;2309409;Novo Oriente;3;3;6;41
2304202;Crato;2309201;Nova Olinda;3;3;6;33
2302107;Baturité;2309102;Mulungu;3;3;6;13
2307809;Marco;2308906;Morrinhos;3;3;6;12
2301901;Barbalha;2308401;Missão Velha;3;3;6;20
2301901;Barbalha;2308104;Mauriti;3;3;6;60
2302503;Brejo Santo;2308104;Mauriti;3;3;6;28
2302305;Bela Cruz;2307809;Marco;3;3;6;9
2111300;São Luís;2307650;Maracanaú;3;3;6;638
2305233;Horizonte;2307650;Maracanaú;3;3;6;31
2307601;Limoeiro do Norte;2307650;Maracanaú;3;3;6;155
2301703;Aurora;2307502;Lavras da Mangabeira;3;3;6;19
2300309;Acopiara;2307403;Jucás;3;3;6;47
2305407;Icó;2307304;Juazeiro do Norte;3;3;6;103
2302305;Bela Cruz;2307254;Jijoca de Jericoacoara;3;3;6;44
2304251;Cruz;2307254;Jijoca de Jericoacoara;3;3;6;39
2305506;Iguatu;2306900;Jaguaribe;3;3;6;93
2306801;Jaguaribara;2306900;Jaguaribe;3;3;6;28
2304400;Fortaleza;2306702;Jaguaretama;3;3;6;210
2305803;Ipu;2305902;Ipueiras;3;3;6;22
2304400;Fortaleza;2305803;Ipu;3;3;6;247
2305209;Hidrolândia;2305803;Ipu;3;3;6;31
2301604;Assaré;2305506;Iguatu;3;3;6;82
2303808;Cedro;2305506;Iguatu;3;3;6;41
2304400;Fortaleza;2305357;Icapuí;3;3;6;168
2304236;Croatá;2305001;Guaraciaba do Norte;3;3;6;31
2304400;Fortaleza;2305001;Guaraciaba do Norte;3;3;6;249
2304400;Fortaleza;2304707;Granja;3;3;6;266
2211001;Teresina;2304509;Frecheirinha;3;3;6;265
1502400;Castanhal;2304400;Fortaleza;3;3;6;1075
1504422;Marituba;2304400;Fortaleza;3;3;6;1120
1506807;Santarém;2304400;Fortaleza;3;3;6;1803
1600600;Santana;2304400;Fortaleza;3;3;6;1462
2101400;Balsas;2304400;Fortaleza;3;3;6;935
2103307;Codó;2304400;Fortaleza;3;3;6;605
2108603;Pinheiro;2304400;Fortaleza;3;3;6;744
2111201;São José de Ribamar;2304400;Fortaleza;3;3;6;627
2202208;Campo Maior;2304400;Fortaleza;3;3;6;424
2203909;Floriano;2304400;Fortaleza;3;3;6;602
2300150;Acarapé;2304400;Fortaleza;3;3;6;54
2300903;Apuiarés;2304400;Fortaleza;3;3;6;101
2302305;Bela Cruz;2304400;Fortaleza;3;3;6;199
2303956;Chorozinho;2304400;Fortaleza;3;3;6;59
2301901;Barbalha;2304202;Crato;3;3;6;16
2303501;Cascavel;2303709;Caucaia;3;3;6;66
2301208;Aracoiaba;2302909;Capistrano;3;3;6;14
2301703;Aurora;2302008;Barro;3;3;6;34
1600303;Macapá;2211001;Teresina;3;3;6;1081
2201507;Batalha;2211001;Teresina;3;3;6;142
2201606;Beneditinos;2211001;Teresina;3;3;6;63
2202604;Castelo do Piauí;2211001;Teresina;3;3;6;136
2202703;Cocal;2211001;Teresina;3;3;6;225
2205102;Itaueira;2211001;Teresina;3;3;6;280
2205706;Luís Correia;2211001;Teresina;3;3;6;273
2205805;Luzilândia;2211001;Teresina;3;3;6;182
2207801;Paulistana;2211001;Teresina;3;3;6;392
2208007;Picos;2210805;Simplício Mendes;3;3;6;99
2201903;Bom Jesus;2210607;São Raimundo Nonato;3;3;6;182
2201051;Assunção do Piauí;2210409;São Miguel do Tapuio;3;3;6;52
2202604;Castelo do Piauí;2210409;São Miguel do Tapuio;3;3;6;33
2208007;Picos;2210201;São José do Piauí;3;3;6;23
2207009;Oeiras;2209955;São João da Varjota;3;3;6;28
2202604;Castelo do Piauí;2208403;Piripiri;3;3;6;119
2207702;Parnaíba;2208304;Piracuruca;3;3;6;119
2202208;Campo Maior;2208007;Picos;3;3;6;260
2203107;Cristino Castro;2208007;Picos;3;3;6;359
2204303;Fronteiras;2208007;Picos;3;3;6;96
2204352;Geminiano;2208007;Picos;3;3;6;15
2205003;Itainópolis;2208007;Picos;3;3;6;40
2111300;São Luís;2207702;Parnaíba;3;3;6;275
2204659;Ilha Grande;2207702;Parnaíba;3;3;6;4
2205805;Luzilândia;2207702;Parnaíba;3;3;6;94
2203909;Floriano;2205102;Itaueira;3;3;6;89
2203909;Floriano;2204501;Guadalupe;3;3;6;58
2201903;Bom Jesus;2203206;Curimatá;3;3;6;109
2201200;Barras;2202208;Campo Maior;3;3;6;67
2201200;Barras;2201507;Batalha;3;3;6;35
2106326;Maracaçumé;2114007;Zé Doca;3;3;6;134
2101202;Bacabal;2113009;Vitorino Freire;3;3;6;72
2111300;São Luís;2112902;Vitória do Mearim;3;3;6;125
2108603;Pinheiro;2112803;Viana;3;3;6;73
2111300;São Luís;2112803;Viana;3;3;6;118
2100501;Alto Parnaíba;2112001;Tasso Fragoso;3;3;6;70
2101202;Bacabal;2111508;São Mateus do Maranhão;3;3;6;35
2103307;Codó;2111508;São Mateus do Maranhão;3;3;6;77
1400100;Boa Vista;2111300;São Luís;3;3;6;1922
1502202;Capanema;2111300;São Luís;3;3;6;355
1504422;Marituba;2111300;São Luís;3;3;6;475
2101004;Arari;2111300;São Luís;3;3;6;119
2102325;Buriticupu;2111300;São Luís;3;3;6;314
2104057;Estreito;2111300;São Luís;3;3;6;570
2105708;Lago da Pedra;2111300;São Luís;3;3;6;247
2106755;Miranda do Norte;2111300;São Luís;3;3;6;121
2105401;Itapecuru Mirim;2111201;São José de Ribamar;3;3;6;101
2109106;Presidente Dutra;2110708;São Domingos do Maranhão;3;3;6;34
2103208;Chapadinha;2110104;Santa Quitéria do Maranhão;3;3;6;91
2102002;Bom Jardim;2109908;Santa Inês;3;3;6;37
2108504;Pindaré-Mirim;2109908;Santa Inês;3;3;6;26
2108603;Pinheiro;2109908;Santa Inês;3;3;6;151
2105401;Itapecuru Mirim;2109601;Rosário;3;3;6;54
2107506;Paço do Lumiar;2109452;Raposa;3;3;6;12
2101202;Bacabal;2109106;Presidente Dutra;3;3;6;124
2101400;Balsas;2109106;Presidente Dutra;3;3;6;299
2102309;Buriti Bravo;2109106;Presidente Dutra;3;3;6;92
2103307;Codó;2109106;Presidente Dutra;3;3;6;110
2104701;Graça Aranha;2109106;Presidente Dutra;3;3;6;21
2101202;Bacabal;2108702;Pio XII;3;3;6;64
2103703;Cururupu;2108603;Pinheiro;3;3;6;81
2108207;Pedreiras;2108603;Pinheiro;3;3;6;235
2101202;Bacabal;2108207;Pedreiras;3;3;6;43
2103307;Codó;2108207;Pedreiras;3;3;6;71
2105302;Imperatriz;2108207;Pedreiras;3;3;6;336
2105401;Itapecuru Mirim;2108207;Pedreiras;3;3;6;131
2105401;Itapecuru Mirim;2106755;Miranda do Norte;3;3;6;36
2104677;Governador Nunes Freire;2106326;Maracaçumé;3;3;6;12
2100055;Açailândia;2105427;Itinga do Maranhão;3;3;6;56
2103307;Codó;2105401;Itapecuru Mirim;3;3;6;127
1702554;Augustinópolis;2105302;Imperatriz;3;3;6;51
2100600;Amarante do Maranhão;2105302;Imperatriz;3;3;6;71
2102556;Campestre do Maranhão;2105302;Imperatriz;3;3;6;74
1721208;Tocantinópolis;2104057;Estreito;3;3;6;27
2101202;Bacabal;2103604;Coroatá;3;3;6;67
2102309;Buriti Bravo;2103505;Colinas;3;3;6;40
2101202;Bacabal;2103307;Codó;3;3;6;94
2101608;Barra do Corda;2103000;Caxias;3;3;6;224
2100501;Alto Parnaíba;2101400;Balsas;3;3;6;176
1501402;Belém;2101202;Bacabal;3;3;6;515
1504208;Marabá;2100055;Açailândia;3;3;6;187
1701002;Ananás;1721208;Tocantinópolis;3;3;6;68
1721000;Palmas;1721109;Tocantínia;3;3;6;88
1505536;Parauapebas;1721000;Palmas;3;3;6;508
1702208;Araguatins;1721000;Palmas;3;3;6;521
1713304;Miranorte;1721000;Palmas;3;3;6;97
1716505;Pedro Afonso;1721000;Palmas;3;3;6;151
1707009;Dianópolis;1720903;Taguatinga;3;3;6;97
1716109;Paraíso do Tocantins;1718204;Porto Nacional;3;3;6;84
1717909;Ponte Alta do Tocantins;1718204;Porto Nacional;3;3;6;88
1716109;Paraíso do Tocantins;1717503;Pium;3;3;6;43
1709500;Gurupi;1716604;Peixe;3;3;6;68
1703107;Barrolândia;1716109;Paraíso do Tocantins;3;3;6;41
1709302;Guaraí;1716109;Paraíso do Tocantins;3;3;6;148
1709500;Gurupi;1711902;Lagoa da Confusão;3;3;6;118
1700400;Almas;1707009;Dianópolis;3;3;6;34
1702109;Araguaína;1702554;Augustinópolis;3;3;6;196
1506138;Redenção;1702109;Araguaína;3;3;6;218
1507458;São Geraldo do Araguaia;1702109;Araguaína;3;3;6;102
1600204;Calçoene;1600303;Macapá;3;3;6;270
1600238;Ferreira Gomes;1600303;Macapá;3;3;6;85
1501303;Barcarena;1600154;Pedra Branca do Amaparí;3;3;6;448
1505536;Parauapebas;1508407;Xinguara;3;3;6;121
1501402;Belém;1508357;Vitória do Xingu;3;3;6;431
1502939;Dom Eliseu;1508126;Ulianópolis;3;3;6;64
1504208;Marabá;1508126;Ulianópolis;3;3;6;254
1505502;Paragominas;1508126;Ulianópolis;3;3;6;81
1500800;Ananindeua;1508100;Tucuruí;3;3;6;304
1501709;Bragança;1508035;Tracuateua;3;3;6;14
1500206;Acará;1508001;Tomé-Açu;3;3;6;52
1502756;Concórdia do Pará;1508001;Tomé-Açu;3;3;6;51
1500107;Abaetetuba;1507953;Tailândia;3;3;6;133
1501402;Belém;1507805;Senador José Porfírio;3;3;6;409
1502202;Capanema;1507607;São Miguel do Guamá;3;3;6;49
1505502;Paragominas;1507607;São Miguel do Guamá;3;3;6;157
1501402;Belém;1507300;São Félix do Xingu;3;3;6;700
1502400;Castanhal;1506807;Santarém;3;3;6;769
1502707;Conceição do Araguaia;1506708;Santana do Araguaia;3;3;6;168
1506583;Santa Maria das Barreiras;1506708;Santana do Araguaia;3;3;6;88
1502202;Capanema;1506609;Santa Maria do Pará;3;3;6;42
1502400;Castanhal;1506609;Santa Maria do Pará;3;3;6;41
1502202;Capanema;1506559;Santa Luzia do Pará;3;3;6;37
1502202;Capanema;1506203;Salinópolis;3;3;6;69
1502400;Castanhal;1506203;Salinópolis;3;3;6;95
1502939;Dom Eliseu;1506187;Rondon do Pará;3;3;6;75
1501402;Belém;1506005;Prainha;3;3;6;564
1501402;Belém;1505908;Porto de Moz;3;3;6;421
1302603;Manaus;1505536;Parauapebas;3;3;6;1169
1500404;Alenquer;1505304;Oriximiná;3;3;6;123
1500800;Ananindeua;1505304;Oriximiná;3;3;6;829
1503903;Juruti;1505304;Oriximiná;3;3;6;57
1505106;Óbidos;1505304;Oriximiná;3;3;6;37
1503903;Juruti;1505106;Óbidos;3;3;6;72
1501782;Breu Branco;1505064;Novo Repartimento;3;3;6;63
1500107;Abaetetuba;1504703;Moju;3;3;6;23
1501402;Belém;1504604;Mocajuba;3;3;6;176
1502103;Cametá;1504604;Mocajuba;3;3;6;40
1302603;Manaus;1504422;Marituba;3;3;6;1315
1501808;Breves;1504422;Marituba;3;3;6;240
1501782;Breu Branco;1504208;Marabá;3;3;6;155
1502400;Castanhal;1504208;Marabá;3;3;6;469
1503093;Goianésia do Pará;1504208;Marabá;3;3;6;169
1501402;Belém;1503903;Juruti;3;3;6;852
1501402;Belém;1503705;Itupiranga;3;3;6;429
1302603;Manaus;1503606;Itaituba;3;3;6;464
1500602;Altamira;1503606;Itaituba;3;3;6;434
1501303;Barcarena;1503457;Ipixuna do Pará;3;3;6;171
1500107;Abaetetuba;1503309;Igarapé-Miri;3;3;6;30
1502202;Capanema;1503200;Igarapé-Açu;3;3;6;50
1502400;Castanhal;1502905;Curuçá;3;3;6;62
1501402;Belém;1502772;Curionópolis;3;3;6;538
1500602;Altamira;1502400;Castanhal;3;3;6;524
1501303;Barcarena;1502400;Castanhal;3;3;6;83
1501402;Belém;1502152;Canaã dos Carajás;3;3;6;588
1500602;Altamira;1501725;Brasil Novo;3;3;6;37
1500800;Ananindeua;1501501;Benevides;3;3;6;14
1500602;Altamira;1500859;Anapu;3;3;6;120
1400100;Boa Vista;1400605;São Luiz;3;3;6;219
1302603;Manaus;1400472;Rorainópolis;3;3;6;451
1400100;Boa Vista;1400233;Caroebe;3;3;6;246
1301902;Itacoatiara;1303569;Rio Preto da Eva;3;3;6;142
1100114;Jaru;1302603;Manaus;3;3;6;861
1200203;Cruzeiro do Sul;1302603;Manaus;3;3;6;1495
1300300;Autazes;1302603;Manaus;3;3;6;117
1302553;Manaquiri;1302603;Manaus;3;3;6;62
1301704;Humaitá;1302405;Lábrea;3;3;6;190
1200104;Brasiléia;1200708;Xapuri;3;3;6;46
1200252;Epitaciolândia;1200708;Xapuri;3;3;6;50
1200401;Rio Branco;1200450;Senador Guiomard;3;3;6;20
1100304;Vilhena;1200401;Rio Branco;3;3;6;899
1200179;Capixaba;1200401;Rio Branco;3;3;6;67
1200203;Cruzeiro do Sul;1200336;Mâncio Lima;3;3;6;30
1100155;Ouro Preto do Oeste;1101807;Vale do Paraíso;3;3;6;40
1100114;Jaru;1101708;Urupá;3;3;6;76
1100122;Ji-Paraná;1101708;Urupá;3;3;6;54
1100346;Alvorada d'Oeste;1101708;Urupá;3;3;6;27
1100080;Costa Marques;1101492;São Francisco do Guaporé;3;3;6;84
1100189;Pimenta Bueno;1101476;Primavera de Rondônia;3;3;6;16
1100023;Ariquemes;1100809;Candeias do Jamari;3;3;6;142
1100023;Ariquemes;1100700;Campo Novo de Rondônia;3;3;6;99
1100148;Nova Brasilândia d'Oeste;1100320;São Miguel do Guaporé;3;3;6;46
1100288;Rolim de Moura;1100320;São Miguel do Guaporé;3;3;6;113
1100023;Ariquemes;1100288;Rolim de Moura;3;3;6;253
1100106;Guajará-Mirim;1100288;Rolim de Moura;3;3;6;408
1100023;Ariquemes;1100189;Pimenta Bueno;3;3;6;276
1100023;Ariquemes;1100155;Ouro Preto do Oeste;3;3;6;120
1100122;Ji-Paraná;1100130;Machadinho d'Oeste;3;3;6;166
1100015;Alta Floresta d'Oeste;1100049;Cacoal;3;3;6;82
1303536;Presidente Figueiredo;5300108;Brasília;2;4;6;1983
1505304;Oriximiná;5300108;Brasília;2;4;6;1762
2305902;Ipueiras;5300108;Brasília;2;4;6;1461
2917706;Jaguarari;5300108;Brasília;2;4;6;1023
3106309;Belo Oriente;5300108;Brasília;2;4;6;699
3202801;Itapemirim;5300108;Brasília;2;4;6;956
5211503;Itumbiara;5221551;Turvelândia;2;4;6;126
3534302;Orlândia;5220603;Silvânia;2;4;6;456
3509502;Campinas;5220207;São Miguel do Araguaia;2;4;6;1120
3534302;Orlândia;5218805;Rio Verde;2;4;6;460
3304557;Rio de Janeiro;5213087;Minaçu;2;4;6;1172
5204805;Campo Alegre de Goiás;5213004;Maurilândia;2;4;6;274
3534401;Osasco;5212501;Luziânia;2;4;6;815
4118204;Paranaguá;5211909;Jataí;2;4;6;916
3552205;Sorocaba;5208707;Goiânia;2;4;6;776
5207600;Fazenda Nova;5208707;Goiânia;2;4;6;169
4101507;Arapongas;5108402;Várzea Grande;2;4;6;1003
3534401;Osasco;5107602;Rondonópolis;2;4;6;1166
4118204;Paranaguá;5107040;Primavera do Leste;2;4;6;1284
5103809;Figueirópolis d'Oeste;5106828;Porto Esperidião;2;4;6;53
3556453;Vargem Grande Paulista;5103403;Cuiabá;2;4;6;1336
4101507;Arapongas;5103403;Cuiabá;2;4;6;1009
5005707;Naviraí;5006606;Ponta Porã;2;4;6;163
4104303;Campo Mourão;5005251;Laguna Carapã;2;4;6;330
5002704;Campo Grande;5004601;Itaquiraí;2;4;6;341
3550308;São Paulo;5004403;Inocência;2;4;6;711
3106200;Belo Horizonte;5003207;Corumbá;2;4;6;1447
4307906;Farroupilha;4323002;Viamão;2;4;6;99
4314100;Passo Fundo;4323002;Viamão;2;4;6;241
4314100;Passo Fundo;4322608;Venâncio Aires;2;4;6;150
4316600;Sananduva;4322509;Vacaria;2;4;6;105
4300455;Alegria;4321808;Três de Maio;2;4;6;21
4309704;Humaitá;4321808;Três de Maio;2;4;6;34
4321477;Tiradentes do Sul;4321808;Três de Maio;2;4;6;42
4314407;Pelotas;4321451;Teutônia;2;4;6;259
4304002;Campo Novo;4320230;Sede Nova;2;4;6;15
4314100;Passo Fundo;4319901;Sapiranga;2;4;6;203
4304002;Campo Novo;4319109;São Martinho;2;4;6;17
4314100;Passo Fundo;4318903;São Luiz Gonzaga;2;4;6;252
4308607;Garibaldi;4318705;São Leopoldo;2;4;6;67
4300604;Alvorada;4318408;São Jerônimo;2;4;6;62
4303103;Cachoeirinha;4318408;São Jerônimo;2;4;6;59
4309308;Guaíba;4318408;São Jerônimo;2;4;6;41
4316808;Santa Cruz do Sul;4317509;Santo Ângelo;2;4;6;240
4316808;Santa Cruz do Sul;4317400;Santiago;2;4;6;244
4303707;Campina das Missões;4317202;Santa Rosa;2;4;6;40
4313425;Novo Machado;4317202;Santa Rosa;2;4;6;33
4304606;Canoas;4317103;Santana do Livramento;2;4;6;423
3534401;Osasco;4316907;Santa Maria;2;4;6;951
4305207;Cerro Largo;4316907;Santa Maria;2;4;6;192
3534401;Osasco;4316808;Santa Cruz do Sul;2;4;6;867
4304705;Carazinho;4316808;Santa Cruz do Sul;2;4;6;162
4306106;Cruz Alta;4316808;Santa Cruz do Sul;2;4;6;164
4310603;Itaqui;4316808;Santa Cruz do Sul;2;4;6;400
4313706;Palmeira das Missões;4316808;Santa Cruz do Sul;2;4;6;219
4313904;Panambi;4316808;Santa Cruz do Sul;2;4;6;190
4316402;Rosário do Sul;4316808;Santa Cruz do Sul;2;4;6;252
4310009;Ibirubá;4316436;Saldanha Marinho;2;4;6;26
4304002;Campo Novo;4315404;Redentora;2;4;6;16
3122306;Divinópolis;4314902;Porto Alegre;2;4;6;1242
3305802;Teresópolis;4314902;Porto Alegre;2;4;6;1139
3522307;Itapetininga;4314902;Porto Alegre;2;4;6;775
3541000;Praia Grande;4314902;Porto Alegre;2;4;6;807
3543303;Ribeirão Pires;4314902;Porto Alegre;2;4;6;834
4302808;Caçapava do Sul;4314407;Pelotas;2;4;6;170
4313904;Panambi;4314308;Pejuçara;2;4;6;22
3534708;Ourinhos;4314100;Passo Fundo;2;4;6;631
4302808;Caçapava do Sul;4314100;Passo Fundo;2;4;6;269
4309308;Guaíba;4314100;Passo Fundo;2;4;6;231
4310009;Ibirubá;4314100;Passo Fundo;2;4;6;80
4311007;Jaguarão;4314100;Passo Fundo;2;4;6;484
4311205;Júlio de Castilhos;4314100;Passo Fundo;2;4;6;166
4304804;Carlos Barbosa;4314001;Paraí;2;4;6;83
4305850;Coqueiros do Sul;4312658;Não-Me-Toque;2;4;6;38
4208203;Itajaí;4311403;Lajeado;2;4;6;418
4307831;Eugênio de Castro;4311155;Jóia;2;4;6;14
4307559;Estação;4310900;Jacutinga;2;4;6;34
4308201;Flores da Cunha;4310439;Ipê;2;4;6;28
3136306;João Pinheiro;4309308;Guaíba;2;4;6;1447
3304557;Rio de Janeiro;4309308;Guaíba;2;4;6;1100
4306106;Cruz Alta;4308458;Fortaleza dos Valos;2;4;6;40
4113700;Londrina;4307906;Farroupilha;2;4;6;657
3550308;São Paulo;4306908;Encruzilhada do Sul;2;4;6;938
4304630;Capão da Canoa;4306403;Dois Irmãos;2;4;6;103
4216404;São João do Sul;4218806;Turvo;2;4;6;35
3509502;Campinas;4216602;São José;2;4;6;542
3548807;São Caetano do Sul;4216602;São José;2;4;6;485
4113700;Londrina;4216602;São José;2;4;6;531
4205407;Florianópolis;4216503;São Joaquim;2;4;6;161
4209102;Joinville;4216008;São Carlos;2;4;6;420
3529302;Matão;4215505;Santa Cecília;2;4;6;629
4204202;Chapecó;4213609;Porto União;2;4;6;183
4204905;Descanso;4212106;Palmitos;2;4;6;44
4205407;Florianópolis;4211603;Nova Veneza;2;4;6;150
4207007;Içara;4211603;Nova Veneza;2;4;6;22
2927408;Salvador;4208906;Jaraguá do Sul;2;4;6;1804
4206009;Governador Celso Ramos;4208302;Itapema;2;4;6;26
4118501;Pato Branco;4208203;Itajaí;2;4;6;395
4200408;Água Doce;4204301;Concórdia;2;4;6;52
4200507;Águas de Chapecó;4204202;Chapecó;2;4;6;36
3550308;São Paulo;4203105;Caibi;2;4;6;751
4113700;Londrina;4202909;Brusque;2;4;6;474
4201109;Anitápolis;4202909;Brusque;2;4;6;92
3549805;São José do Rio Preto;4202404;Blumenau;2;4;6;679
4113700;Londrina;4128005;Ubiratã;2;4;6;231
4104659;Carambeí;4127502;Tibagi;2;4;6;56
3507159;Bom Sucesso de Itararé;4126306;Sengés;2;4;6;40
4104303;Campo Mourão;4125001;São João do Ivaí;2;4;6;58
4122404;Rolândia;4123907;Santa Mariana;2;4;6;89
3304110;Porto Real;4120804;Quatro Barras;2;4;6;576
4104303;Campo Mourão;4117602;Palmas;2;4;6;276
4107157;Diamante d'Oeste;4115804;Medianeira;2;4;6;39
4104303;Campo Mourão;4114500;Manoel Ribas;2;4;6;90
2408102;Natal;4113700;Londrina;2;4;6;2484
3205200;Vila Velha;4113700;Londrina;2;4;6;1140
3303906;Petrópolis;4113700;Londrina;2;4;6;814
3550308;São Paulo;4112108;Jandaia do Sul;2;4;6;510
4105508;Cianorte;4109906;Icaraíma;2;4;6;122
3549102;São João da Boa Vista;4106902;Curitiba;2;4;6;457
4104303;Campo Mourão;4106506;Coronel Vivida;2;4;6;217
3553807;Taquarituba;4101606;Arapoti;2;4;6;91
3525904;Jundiaí;3557006;Votorantim;2;4;6;63
3505708;Barueri;3556701;Vinhedo;2;4;6;54
3552205;Sorocaba;3556206;Valinhos;2;4;6;77
3549904;São José dos Campos;3554805;Tremembé;2;4;6;44
2111300;São Luís;3552809;Taboão da Serra;2;4;6;2343
2911105;Formosa do Rio Preto;3550308;São Paulo;2;4;6;1404
3109402;Buritizeiro;3550308;São Paulo;2;4;6;716
3112604;Capinópolis;3550308;São Paulo;2;4;6;622
3114204;Carmo do Cajuru;3550308;São Paulo;2;4;6;428
3152709;Prados;3550308;São Paulo;2;4;6;387
3302700;Maricá;3550308;São Paulo;2;4;6;398
3507753;Brejo Alegre;3550308;São Paulo;2;4;6;454
3526605;Lavrinhas;3550308;São Paulo;2;4;6;214
3531704;Monteiro Lobato;3550308;São Paulo;2;4;6;113
3532306;Natividade da Serra;3550308;São Paulo;2;4;6;127
3538204;Pinhalzinho;3550308;São Paulo;2;4;6;97
3523404;Itatiba;3549904;São José dos Campos;2;4;6;100
3537404;Pereira Barreto;3549805;São José do Rio Preto;2;4;6;177
2933307;Vitória da Conquista;3548807;São Caetano do Sul;2;4;6;1123
3503208;Araraquara;3548500;Santos;2;4;6;297
3529302;Matão;3548500;Santos;2;4;6;328
2100501;Alto Parnaíba;3543402;Ribeirão Preto;2;4;6;1347
3106200;Belo Horizonte;3543303;Ribeirão Pires;2;4;6;487
3534401;Osasco;3543303;Ribeirão Pires;2;4;6;41
3529302;Matão;3542503;Reginópolis;2;4;6;91
3304557;Rio de Janeiro;3541000;Praia Grande;2;4;6;342
3506102;Bebedouro;3539301;Pirassununga;2;4;6;164
3521804;Itaí;3538709;Piracicaba;2;4;6;166
3522406;Itapeva;3538709;Piracicaba;2;4;6;187
3509502;Campinas;3537800;Piedade;2;4;6;98
3505906;Batatais;3536307;Patrocínio Paulista;2;4;6;43
3504008;Assis;3535309;Palmital;2;4;6;27
3106200;Belo Horizonte;3534708;Ourinhos;2;4;6;691
1500800;Ananindeua;3534401;Osasco;2;4;6;2456
1505536;Parauapebas;3534401;Osasco;2;4;6;1962
1702109;Araguaína;3534401;Osasco;2;4;6;1813
2504009;Campina Grande;3534401;Osasco;2;4;6;2097
2914802;Itabuna;3534401;Osasco;2;4;6;1222
3143302;Montes Claros;3534401;Osasco;2;4;6;807
3143906;Muriaé;3534401;Osasco;2;4;6;527
3167202;Sete Lagoas;3534401;Osasco;2;4;6;521
3504107;Atibaia;3534401;Osasco;2;4;6;52
3506102;Bebedouro;3534401;Osasco;2;4;6;338
3518404;Guaratinguetá;3534401;Osasco;2;4;6;183
3523107;Itaquaquecetuba;3534401;Osasco;2;4;6;46
3525706;José Bonifácio;3531001;Monções;2;4;6;48
3506102;Bebedouro;3530805;Moji-Mirim;2;4;6;231
3118601;Contagem;3530607;Moji das Cruzes;2;4;6;455
3505104;Barbosa;3525706;José Bonifácio;2;4;6;38
3509502;Campinas;3523206;Itararé;2;4;6;267
3511102;Catanduva;3521507;Irapuã;2;4;6;46
2307304;Juazeiro do Norte;3516200;Franca;2;4;6;1685
3509502;Campinas;3515509;Fernandópolis;2;4;6;444
3159605;Santa Rita do Sapucaí;3513801;Diadema;2;4;6;184
3304904;São Gonçalo;3513009;Cotia;2;4;6;402
3119302;Coromandel;3509502;Campinas;2;4;6;491
3131307;Ipatinga;3505708;Barueri;2;4;6;625
3121258;Delta;3503307;Araras;2;4;6;271
3304904;São Gonçalo;3305802;Teresópolis;2;4;6;40
3302403;Macaé;3305109;São João de Meriti;2;4;6;159
3106705;Betim;3301702;Duque de Caxias;2;4;6;323
2919553;Luís Eduardo magalhães;3205309;Vitória;2;4;6;1063
3200201;Alegre;3205309;Vitória;2;4;6;144
3203403;Mimoso do Sul;3205309;Vitória;2;4;6;143
3204500;Santa Leopoldina;3205309;Vitória;2;4;6;28
3143302;Montes Claros;3205200;Vila Velha;2;4;6;539
3167202;Sete Lagoas;3205200;Vila Velha;2;4;6;415
2616407;Vitória de Santo Antão;3203205;Linhares;2;4;6;1335
3141405;Medina;3201209;Cachoeiro de Itapemirim;2;4;6;512
3134004;Itinga;3200904;Barra de São Francisco;2;4;6;254
3170107;Uberaba;3171105;Veríssimo;2;4;6;42
3159803;Santa Vitória;3170206;Uberlândia;2;4;6;195
3143104;Monte Carmelo;3170107;Uberaba;2;4;6;121
3108008;Bom Sucesso;3165008;São Tiago;2;4;6;29
3139508;Manhumirim;3154150;Reduto;2;4;6;16
3121605;Diamantina;3151206;Pirapora;2;4;6;170
3125705;Felixlândia;3147105;Pará de Minas;2;4;6;125
3111507;Campos Altos;3143104;Monte Carmelo;2;4;6;178
3114204;Carmo do Cajuru;3140704;Mateus Leme;2;4;6;42
3136306;João Pinheiro;3140506;Martinho Campos;2;4;6;202
3102803;Andrelândia;3138609;Lima Duarte;2;4;6;58
3104502;Arinos;3133808;Itaúna;2;4;6;489
3111408;Campo Florido;3117306;Conceição das Alagoas;2;4;6;26
3106200;Belo Horizonte;3109907;Caetanópolis;2;4;6;81
2931350;Teixeira de Freitas;3109402;Buritizeiro;2;4;6;559
1508001;Tomé-Açu;3106200;Belo Horizonte;2;4;6;1983
2905800;Camamu;2932903;Valença;2;4;6;66
2922508;Nazaré;2932903;Valença;2;4;6;35
2925758;Presidente Tancredo Neves;2932903;Valença;2;4;6;35
2911857;Heliópolis;2926509;Ribeira do Amparo;2;4;6;43
2612208;Salgueiro;2924009;Paulo Afonso;2;4;6;169
2907509;Catu;2921005;Mata de São João;2;4;6;20
2612208;Salgueiro;2918407;Juazeiro;2;4;6;211
2804805;Nossa Senhora do Socorro;2806701;São Cristóvão;2;4;6;14
2800308;Aracaju;2804003;Maruim;2;4;6;19
2609006;Macaparana;2611606;Recife;2;4;6;85
2601201;Arcoverde;2611200;Poção;2;4;6;50
2603603;Camutanga;2607653;Itambé;2;4;6;19
2601706;Belo Jardim;2606002;Garanhuns;2;4;6;55
2400208;Açu;2409407;Pau dos Ferros;2;4;6;157
1501402;Belém;2307700;Maranguape;2;4;6;1117
2305506;Iguatu;2307502;Lavras da Mangabeira;2;4;6;60
1200401;Rio Branco;2304400;Fortaleza;2;4;6;3343
1501402;Belém;2303709;Caucaia;2;4;6;1114
1501402;Belém;2111201;São José de Ribamar;2;4;6;504
2101608;Barra do Corda;2104800;Grajaú;2;4;6;106
1303403;Parintins;1505304;Oriximiná;2;4;6;146
1500602;Altamira;1505031;Novo Progresso;2;4;6;562
1300508;Barreirinha;1303403;Parintins;2;4;6;39
1303007;Nhamundá;1303403;Parintins;2;4;6;52
1301308;Codajás;1302603;Manaus;2;4;6;236
4204301;Concórdia;5107925;Sorriso;1;5;6;1678
4107256;Douradina;5104807;Jaciara;1;5;6;843
4118204;Paranaguá;5102686;Campos de Júlio;1;5;6;1752
4204301;Concórdia;5102678;Campo Verde;1;5;6;1342
3554300;Teodoro Sampaio;5006200;Nova Andradina;1;5;6;129
4115804;Medianeira;5003702;Dourados;1;5;6;347
3305802;Teresópolis;5003207;Corumbá;1;5;6;1603
3548807;São Caetano do Sul;5002704;Campo Grande;1;5;6;923
4104303;Campo Mourão;5001243;Aral Moreira;1;5;6;356
4208203;Itajaí;4323002;Viamão;1;5;6;409
3534401;Osasco;4318705;São Leopoldo;1;5;6;802
4309209;Gravataí;4318408;São Jerônimo;1;5;6;71
4313060;Nova Hartz;4316808;Santa Cruz do Sul;1;5;6;149
4308201;Flores da Cunha;4313409;Novo Hamburgo;1;5;6;73
4204350;Cordilheira Alta;4208203;Itajaí;1;5;6;386
3550308;São Paulo;4128708;Vitorino;1;5;6;672
3532207;Narandiba;4124509;Santo Inácio;1;5;6;43
2800308;Aracaju;4113700;Londrina;1;5;6;1953
1200401;Rio Branco;4109708;Ibaiti;1;5;6;2312
1200203;Cruzeiro do Sul;4107256;Douradina;1;5;6;2579
3525706;José Bonifácio;3557154;Zacarias;1;5;6;38
3545605;Santa Adélia;3553401;Tanabi;1;5;6;112
3149309;Pedro Leopoldo;3552205;Sorocaba;1;5;6;551
3547502;Santa Rita do Passa Quatro;3551405;Serra Azul;1;5;6;45
1502764;Cumaru do Norte;3550308;São Paulo;1;5;6;1797
2306306;Itapagé;3550308;São Paulo;1;5;6;2313
3142205;Miraí;3550308;São Paulo;1;5;6;491
3164431;São Sebastião da Vargem Alegre;3550308;São Paulo;1;5;6;496
2927408;Salvador;3550001;São Luís do Paraitinga;1;5;6;1320
3520608;Indiana;3541406;Presidente Prudente;1;5;6;15
1200401;Rio Branco;3534401;Osasco;1;5;6;2556
2105302;Imperatriz;3534401;Osasco;1;5;6;1995
3131307;Ipatinga;3534401;Osasco;1;5;6;621
3509502;Campinas;3530300;Mirassol;1;5;6;346
2927408;Salvador;3522307;Itapetininga;1;5;6;1507
3513009;Cotia;3518800;Guarulhos;1;5;6;41
2612505;Santa Cruz do Capibaribe;3304557;Rio de Janeiro;1;5;6;1792
3301009;Campos dos Goytacazes;3303203;Nilópolis;1;5;6;243
2607901;Jaboatão dos Guararapes;2933307;Vitória da Conquista;1;5;6;968
2902054;Araças;2925204;Pojuca;1;5;6;27
2304400;Fortaleza;2404705;Ipanguaçu;1;5;6;267
2304400;Fortaleza;2402501;Carnaubais;1;5;6;257
2111300;São Luís;2306306;Itapagé;1;5;6;532
1501402;Belém;2105401;Itapecuru Mirim;1;5;6;510
1100080;Costa Marques;5300108;Brasília;2;3;5;1775
1100809;Candeias do Jamari;5300108;Brasília;2;3;5;1836
1200385;Plácido de Castro;5300108;Brasília;2;3;5;2127
1301852;Iranduba;5300108;Brasília;2;3;5;1894
1504406;Marapanim;5300108;Brasília;2;3;5;1669
1506708;Santana do Araguaia;5300108;Brasília;2;3;5;763
1508001;Tomé-Açu;5300108;Brasília;2;3;5;1485
1508308;Viseu;5300108;Brasília;2;3;5;1628
1600204;Calçoene;5300108;Brasília;2;3;5;2051
2211100;União;5300108;Brasília;2;3;5;1350
2301000;Aquiraz;5300108;Brasília;2;3;5;1654
2307254;Jijoca de Jericoacoara;5300108;Brasília;2;3;5;1634
2311702;Reriutaba;5300108;Brasília;2;3;5;1503
2311900;Saboeiro;5300108;Brasília;2;3;5;1329
2312304;São Benedito;5300108;Brasília;2;3;5;1498
2312403;São Gonçalo do Amarante;5300108;Brasília;2;3;5;1644
2701407;Campo Alegre;5300108;Brasília;2;3;5;1394
2902104;Araci;5300108;Brasília;2;3;5;1074
2928901;São Desidério;5300108;Brasília;2;3;5;494
3301603;Duas Barras;5300108;Brasília;2;3;5;908
3302601;Mangaratiba;5300108;Brasília;2;3;5;892
3303856;Paty do Alferes;5300108;Brasília;2;3;5;882
3304409;Rio Claro;5300108;Brasília;2;3;5;870
3501004;Altinópolis;5300108;Brasília;2;3;5;580
3501301;Álvares Machado;5300108;Brasília;2;3;5;795
3501707;Américo Brasiliense;5300108;Brasília;2;3;5;655
3502200;Angatuba;5300108;Brasília;2;3;5;852
3504206;Auriflama;5300108;Brasília;2;3;5;611
3505609;Barrinha;5300108;Brasília;2;3;5;597
3508009;Buri;5300108;Brasília;2;3;5;887
3508108;Buritama;5300108;Brasília;2;3;5;630
3508801;Cafelândia;5300108;Brasília;2;3;5;688
3509304;Cajobi;5300108;Brasília;2;3;5;569
3510708;Cardoso;5300108;Brasília;2;3;5;522
3511706;Charqueada;5300108;Brasília;2;3;5;742
3512209;Conchal;5300108;Brasília;2;3;5;726
3512308;Conchas;5300108;Brasília;2;3;5;798
3513900;Divinolândia;5300108;Brasília;2;3;5;660
3514106;Dois Córregos;5300108;Brasília;2;3;5;727
3514502;Duartina;5300108;Brasília;2;3;5;749
3514908;Elias Fausto;5300108;Brasília;2;3;5;803
3516002;Flórida Paulista;5300108;Brasília;2;3;5;734
3517000;Getulina;5300108;Brasília;2;3;5;698
3517505;Guapiaçu;5300108;Brasília;2;3;5;570
3517703;Guará;5300108;Brasília;2;3;5;511
3518305;Guararema;5300108;Brasília;2;3;5;867
3519105;Iacanga;5300108;Brasília;2;3;5;684
3519303;Ibaté;5300108;Brasília;2;3;5;680
3521309;Ipuã;5300108;Brasília;2;3;5;512
3521804;Itaí;5300108;Brasília;2;3;5;852
3521903;Itajobi;5300108;Brasília;2;3;5;622
3525201;Jarinu;5300108;Brasília;2;3;5;818
3526001;Junqueirópolis;5300108;Brasília;2;3;5;738
3528007;Macatuba;5300108;Brasília;2;3;5;746
3528809;Maracaí;5300108;Brasília;2;3;5;810
3529203;Martinópolis;5300108;Brasília;2;3;5;786
3529708;Miguelópolis;5300108;Brasília;2;3;5;484
3532603;Nhandeara;5300108;Brasília;2;3;5;587
3533601;Nuporanga;5300108;Brasília;2;3;5;545
3534757;Ouroeste;5300108;Brasília;2;3;5;537
3534906;Pacaembu;5300108;Brasília;2;3;5;733
3535408;Panorama;5300108;Brasília;2;3;5;754
3535804;Paranapanema;5300108;Brasília;2;3;5;844
3536307;Patrocínio Paulista;5300108;Brasília;2;3;5;539
3537008;Pedregulho;5300108;Brasília;2;3;5;495
3538600;Piracaia;5300108;Brasília;2;3;5;820
3539004;Pirangi;5300108;Brasília;2;3;5;590
3539202;Pirapozinho;5300108;Brasília;2;3;5;815
3539400;Piratininga;5300108;Brasília;2;3;5;743
3540804;Potirendaba;5300108;Brasília;2;3;5;600
3541208;Presidente Bernardes;5300108;Brasília;2;3;5;792
3542404;Regente Feijó;5300108;Brasília;2;3;5;800
3542909;Ribeirão Bonito;5300108;Brasília;2;3;5;693
3543808;Rinópolis;5300108;Brasília;2;3;5;722
3544251;Rosana;5300108;Brasília;2;3;5;936
3545605;Santa Adélia;5300108;Brasília;2;3;5;609
3548005;Santo Antônio de Posse;5300108;Brasília;2;3;5;760
3550209;São Miguel Arcanjo;5300108;Brasília;2;3;5;893
3550803;São Sebastião da Grama;5300108;Brasília;2;3;5;664
3552601;Tabapuã;5300108;Brasília;2;3;5;583
3553401;Tanabi;5300108;Brasília;2;3;5;565
3553609;Tapiratiba;5300108;Brasília;2;3;5;639
3555109;Tupi Paulista;5300108;Brasília;2;3;5;733
3555604;Uchoa;5300108;Brasília;2;3;5;585
3556305;Valparaíso;5300108;Brasília;2;3;5;680
3556800;Viradouro;5300108;Brasília;2;3;5;562
3556909;Vista Alegre do Alto;5300108;Brasília;2;3;5;598
3557204;Chavantes;5300108;Brasília;2;3;5;824
4119954;Pontal do Paraná;5300108;Brasília;2;3;5;1094
4200507;Águas de Chapecó;5300108;Brasília;2;3;5;1367
4202206;Benedito Novo;5300108;Brasília;2;3;5;1226
4204251;Cocal do Sul;5300108;Brasília;2;3;5;1425
4205704;Garopaba;5300108;Brasília;2;3;5;1355
4205803;Garuva;5300108;Brasília;2;3;5;1136
4206405;Guaraciaba;5300108;Brasília;2;3;5;1346
4208104;Itaiópolis;5300108;Brasília;2;3;5;1186
4208401;Itapiranga;5300108;Brasília;2;3;5;1412
4213500;Porto Belo;5300108;Brasília;2;3;5;1259
4213807;Praia Grande;5300108;Brasília;2;3;5;1500
4214706;Rio dos Cedros;5300108;Brasília;2;3;5;1219
4216107;São Domingos;5300108;Brasília;2;3;5;1295
4217006;São Ludgero;5300108;Brasília;2;3;5;1393
4217204;São Miguel do Oeste;5300108;Brasília;2;3;5;1357
4217907;Tangará;5300108;Brasília;2;3;5;1304
4219606;Xavantina;5300108;Brasília;2;3;5;1339
5000856;Angélica;5300108;Brasília;2;3;5;949
5003256;Costa Rica;5300108;Brasília;2;3;5;640
5104609;Itiquira;5300108;Brasília;2;3;5;687
5218789;Rio Quente;5300108;Brasília;2;3;5;236
5208608;Goianésia;5222302;Vila Propício;2;3;5;29
5200258;Águas Lindas de Goiás;5221858;Valparaíso de Goiás;2;3;5;47
3170206;Uberlândia;5220405;São Simão;2;3;5;240
5215702;Palmeiras de Goiás;5220108;São Luís de Montes Belos;2;3;5;56
3526902;Limeira;5218805;Rio Verde;2;3;5;651
5204409;Caiapônia;5218805;Rio Verde;2;3;5;134
5209952;Indiara;5218805;Rio Verde;2;3;5;124
5213103;Mineiros;5218102;Portelândia;2;3;5;26
3170206;Uberlândia;5216403;Paraúna;2;3;5;319
5205109;Catalão;5215504;Ouvidor;2;3;5;14
5210208;Iporá;5211909;Jataí;2;3;5;172
3169604;Tupaciguara;5211503;Itumbiara;2;3;5;63
3534401;Osasco;5211503;Itumbiara;2;3;5;628
5207402;Edéia;5211503;Itumbiara;2;3;5;135
5208707;Goiânia;5210307;Israelândia;2;3;5;179
3303906;Petrópolis;5208707;Goiânia;2;3;5;922
4313409;Novo Hamburgo;5208707;Goiânia;2;3;5;1454
5206305;Cristianópolis;5208707;Goiânia;2;3;5;84
5201405;Aparecida de Goiânia;5208608;Goianésia;2;3;5;166
3505708;Barueri;5208004;Formosa;2;3;5;884
3170206;Uberlândia;5207402;Edéia;2;3;5;247
3148004;Patos de Minas;5206206;Cristalina;2;3;5;232
3534302;Orlândia;5206206;Cristalina;2;3;5;432
3143104;Monte Carmelo;5205109;Catalão;2;3;5;78
3147006;Paracatu;5205109;Catalão;2;3;5;148
3534302;Orlândia;5205109;Catalão;2;3;5;284
3548500;Santos;5205109;Catalão;2;3;5;658
3170206;Uberlândia;5204250;Cachoeira Dourada;2;3;5;136
3552809;Taboão da Serra;5201405;Aparecida de Goiânia;2;3;5;798
4113700;Londrina;5201405;Aparecida de Goiânia;2;3;5;747
3548807;São Caetano do Sul;5201108;Anápolis;2;3;5;849
1500602;Altamira;5108402;Várzea Grande;2;3;5;1442
4209102;Joinville;5108402;Várzea Grande;2;3;5;1428
5001003;Aparecida do Taboado;5108402;Várzea Grande;2;3;5;737
5107800;Santo Antônio do Leverger;5108402;Várzea Grande;2;3;5;22
5107040;Primavera do Leste;5107958;Tangará da Serra;2;3;5;354
3541406;Presidente Prudente;5107909;Sinop;2;3;5;1226
5107602;Rondonópolis;5107800;Santo Antônio do Leverger;2;3;5;164
3205101;Viana;5107602;Rondonópolis;2;3;5;1587
3301702;Duque de Caxias;5107602;Rondonópolis;2;3;5;1421
4128708;Vitorino;5107602;Rondonópolis;2;3;5;1111
5103403;Cuiabá;5107008;Poxoréo;2;3;5;186
5100508;Alto Paraguai;5106224;Nova Mutum;2;3;5;86
5103379;Cotriguaçu;5105176;Juruena;2;3;5;50
1100049;Cacoal;5103403;Cuiabá;2;3;5;731
1505536;Parauapebas;5103403;Cuiabá;2;3;5;1245
2408102;Natal;5103403;Cuiabá;2;3;5;2448
3170107;Uberaba;5103403;Cuiabá;2;3;5;1001
4109708;Ibaiti;5103403;Cuiabá;2;3;5;1125
4202404;Blumenau;5103403;Cuiabá;2;3;5;1483
4211900;Palhoça;5103403;Cuiabá;2;3;5;1570
5102686;Campos de Júlio;5103403;Cuiabá;2;3;5;374
3548807;São Caetano do Sul;5103304;Comodoro;2;3;5;1836
3304557;Rio de Janeiro;5103007;Chapada dos Guimarães;2;3;5;1596
3550308;São Paulo;5102686;Campos de Júlio;2;3;5;1757
4200556;Águas Frias;5102686;Campos de Júlio;2;3;5;1599
3516200;Franca;5008305;Três Lagoas;2;3;5;451
5000203;Água Clara;5008008;Terenos;2;3;5;209
4106902;Curitiba;5007406;Rio Verde de Mato Grosso;2;3;5;939
4106902;Curitiba;5006358;Paranhos;2;3;5;652
3502101;Andradina;5006200;Nova Andradina;2;3;5;251
4203006;Caçador;5006200;Nova Andradina;2;3;5;560
3539004;Pirangi;5004403;Inocência;2;3;5;377
3550308;São Paulo;5004304;Iguatemi;2;3;5;808
5002704;Campo Grande;5003751;Eldorado;2;3;5;374
3516200;Franca;5003702;Dourados;2;3;5;780
4117909;Palotina;5003702;Dourados;2;3;5;251
5002704;Campo Grande;5003157;Coronel Sapucaia;2;3;5;327
5002704;Campo Grande;5002902;Cassilândia;2;3;5;338
3530300;Mirassol;5002704;Campo Grande;2;3;5;538
3550308;São Paulo;5000906;Antônio João;2;3;5;980
4128104;Umuarama;5000609;Amambaí;2;3;5;211
4310330;Imbé;4323804;Xangri-lá;2;3;5;20
4321006;Tapera;4323200;Victor Graeff;2;3;5;14
4303103;Cachoeirinha;4323002;Viamão;2;3;5;17
4318408;São Jerônimo;4323002;Viamão;2;3;5;69
4303103;Cachoeirinha;4322608;Venâncio Aires;2;3;5;112
4320800;Soledade;4322152;Tunas;2;3;5;49
4305207;Cerro Largo;4321808;Três de Maio;2;3;5;66
4314100;Passo Fundo;4321808;Três de Maio;2;3;5;191
4310108;Igrejinha;4321451;Teutônia;2;3;5;100
4314753;Poço das Antas;4321451;Teutônia;2;3;5;13
4313508;Osório;4321436;Terra de Areia;2;3;5;38
4314100;Passo Fundo;4321303;Taquari;2;3;5;179
4314100;Passo Fundo;4321105;Tapes;2;3;5;283
4305603;Colorado;4321006;Tapera;2;3;5;17
4305108;Caxias do Sul;4320800;Soledade;2;3;5;140
4309951;Ibirapuitã;4320800;Soledade;2;3;5;24
4312427;Mormaço;4320800;Soledade;2;3;5;21
4311403;Lajeado;4320453;Sério;2;3;5;24
4313466;Novo Xingu;4320107;Sarandi;2;3;5;25
4303905;Campo Bom;4320008;Sapucaia do Sul;2;3;5;20
4318408;São Jerônimo;4319901;Sapiranga;2;3;5;78
4314100;Passo Fundo;4319604;São Sepé;2;3;5;241
4301602;Bagé;4318705;São Leopoldo;2;3;5;337
4303004;Cachoeira do Sul;4318705;São Leopoldo;2;3;5;173
4313201;Nova Petrópolis;4318705;São Leopoldo;2;3;5;43
4313300;Nova Prata;4318705;São Leopoldo;2;3;5;117
4317509;Santo Ângelo;4318705;São Leopoldo;2;3;5;341
4308300;Fontoura Xavier;4318465;São José do Herval;2;3;5;8
4309902;Ibiraiaras;4318440;São Jorge;2;3;5;16
4303905;Campo Bom;4318408;São Jerônimo;2;3;5;72
4316808;Santa Cruz do Sul;4318408;São Jerônimo;2;3;5;73
4314100;Passo Fundo;4318101;São Francisco de Assis;2;3;5;301
4305207;Cerro Largo;4318002;São Borja;2;3;5;136
4303301;Caibaté;4317509;Santo Ângelo;2;3;5;37
4307831;Eugênio de Castro;4317509;Santo Ângelo;2;3;5;27
4307906;Farroupilha;4317509;Santo Ângelo;2;3;5;306
4314100;Passo Fundo;4317301;Santa Vitória do Palmar;2;3;5;590
4315602;Rio Grande;4317103;Santana do Livramento;2;3;5;345
4309308;Guaíba;4317004;Santana da Boa Vista;2;3;5;189
4306767;Eldorado do Sul;4316907;Santa Maria;2;3;5;218
4113700;Londrina;4316808;Santa Cruz do Sul;2;3;5;722
4307906;Farroupilha;4316758;Santa Clara do Sul;2;3;5;80
4314902;Porto Alegre;4316758;Santa Clara do Sul;2;3;5;111
4305207;Cerro Largo;4316477;Salvador das Missões;2;3;5;11
4301602;Bagé;4316402;Rosário do Sul;2;3;5;144
4314100;Passo Fundo;4316402;Rosário do Sul;2;3;5;330
4212106;Palmitos;4315909;Rodeio Bonito;2;3;5;45
4314100;Passo Fundo;4315701;Rio Pardo;2;3;5;183
4303103;Cachoeirinha;4315602;Rio Grande;2;3;5;257
4314100;Passo Fundo;4315305;Quaraí;2;3;5;451
2503209;Cabedelo;4314902;Porto Alegre;2;3;5;2943
2604106;Caruaru;4314902;Porto Alegre;2;3;5;2774
3138203;Lavras;4314902;Porto Alegre;2;3;5;1134
3300407;Barra Mansa;4314902;Porto Alegre;2;3;5;1059
3301900;Itaboraí;4314902;Porto Alegre;2;3;5;1124
3504008;Assis;4314902;Porto Alegre;2;3;5;822
3505302;Barra Bonita;4314902;Porto Alegre;2;3;5;873
3513405;Cruzeiro;4314902;Porto Alegre;2;3;5;1013
3522604;Itapira;4314902;Porto Alegre;2;3;5;938
3533908;Olímpia;4314902;Porto Alegre;2;3;5;1053
3549409;São Joaquim da Barra;4314902;Porto Alegre;2;3;5;1092
3550605;São Roque;4314902;Porto Alegre;2;3;5;817
4106407;Cornélio Procópio;4314902;Porto Alegre;2;3;5;763
4119509;Piraquara;4314902;Porto Alegre;2;3;5;549
4211603;Nova Veneza;4314902;Porto Alegre;2;3;5;226
4219176;Vargem Bonita;4314902;Porto Alegre;2;3;5;342
4310801;Ivoti;4314803;Portão;2;3;5;15
4312476;Morro Reuter;4314423;Picada Café;2;3;5;12
4313409;Novo Hamburgo;4314423;Picada Café;2;3;5;27
3548807;São Caetano do Sul;4314407;Pelotas;2;3;5;1044
4303103;Cachoeirinha;4314407;Pelotas;2;3;5;230
4204806;Curitibanos;4314100;Passo Fundo;2;3;5;207
4209102;Joinville;4314100;Passo Fundo;2;3;5;408
4301305;Arroio Grande;4314100;Passo Fundo;2;3;5;445
4304507;Canguçu;4314100;Passo Fundo;2;3;5;350
4305207;Cerro Largo;4314100;Passo Fundo;2;3;5;229
4306601;Dom Pedrito;4314100;Passo Fundo;2;3;5;375
4308201;Flores da Cunha;4314100;Passo Fundo;2;3;5;147
4309100;Gramado;4314100;Passo Fundo;2;3;5;194
4306106;Cruz Alta;4313706;Palmeira das Missões;2;3;5;86
2504009;Campina Grande;4313409;Novo Hamburgo;2;3;5;2846
3548807;São Caetano do Sul;4313409;Novo Hamburgo;2;3;5;799
4304804;Carlos Barbosa;4313359;Nova Roma do Sul;2;3;5;35
4307054;Ernestina;4312658;Não-Me-Toque;2;3;5;25
4311270;Lagoa dos Três Cantos;4312658;Não-Me-Toque;2;3;5;13
4303103;Cachoeirinha;4312401;Montenegro;2;3;5;49
3524808;Jales;4311809;Marau;2;3;5;918
4310207;Ijuí;4311759;Manoel Viana;2;3;5;199
4201406;Araranguá;4311403;Lajeado;2;3;5;251
4204202;Chapecó;4311304;Lagoa Vermelha;2;3;5;162
4305009;Catuípe;4311155;Jóia;2;3;5;45
4301602;Bagé;4311007;Jaguarão;2;3;5;153
4217303;Saudades;4310801;Ivoti;2;3;5;344
4301602;Bagé;4310207;Ijuí;2;3;5;327
4303103;Cachoeirinha;4310207;Ijuí;2;3;5;327
4305207;Cerro Largo;4310207;Ijuí;2;3;5;84
4306403;Dois Irmãos;4310108;Igrejinha;2;3;5;29
4307906;Farroupilha;4309407;Guaporé;2;3;5;70
4305108;Caxias do Sul;4309308;Guaíba;2;3;5;107
4308201;Flores da Cunha;4309100;Gramado;2;3;5;49
4300570;Alto Feliz;4308102;Feliz;2;3;5;8
3501608;Americana;4307906;Farroupilha;2;3;5;812
3549904;São José dos Campos;4307906;Farroupilha;2;3;5;844
4104303;Campo Mourão;4307906;Farroupilha;2;3;5;583
4109401;Guarapuava;4307906;Farroupilha;2;3;5;425
4115200;Maringá;4307906;Farroupilha;2;3;5;644
4205407;Florianópolis;4307906;Farroupilha;2;3;5;327
4209300;Lages;4307906;Farroupilha;2;3;5;185
4303905;Campo Bom;4307906;Farroupilha;2;3;5;58
4305454;Cidreira;4307708;Esteio;2;3;5;97
3304557;Rio de Janeiro;4307005;Erechim;2;3;5;1019
4217501;Seara;4307005;Erechim;2;3;5;54
4304606;Canoas;4307005;Erechim;2;3;5;275
4106902;Curitiba;4306106;Cruz Alta;2;3;5;546
4302220;Boa Vista do Cadeado;4306106;Cruz Alta;2;3;5;22
4304804;Carlos Barbosa;4305959;Cotiporã;2;3;5;39
1501402;Belém;4305108;Caxias do Sul;2;3;5;3083
2800308;Aracaju;4305108;Caxias do Sul;2;3;5;2400
3548807;São Caetano do Sul;4305108;Caxias do Sul;2;3;5;754
4304606;Canoas;4304705;Carazinho;2;3;5;239
4209300;Lages;4304606;Canoas;2;3;5;247
4218202;Timbó;4304606;Canoas;2;3;5;386
4301008;Arroio do Meio;4304606;Canoas;2;3;5;92
4301602;Bagé;4304606;Canoas;2;3;5;324
2311405;Quixeramobim;4303905;Campo Bom;2;3;5;2912
4302105;Bento Gonçalves;4303103;Cachoeirinha;2;3;5;95
4302709;Butiá;4303004;Cachoeira do Sul;2;3;5;92
4202008;Balneário Camboriú;4302352;Bom Princípio;2;3;5;377
4209300;Lages;4302303;Bom Jesus;2;3;5;97
3304557;Rio de Janeiro;4300406;Alegrete;2;3;5;1401
4208203;Itajaí;4219507;Xanxerê;2;3;5;364
4211207;Morro da Fumaça;4219002;Urussanga;2;3;5;22
3550308;São Paulo;4218004;Tijucas;2;3;5;442
4203204;Camboriú;4218004;Tijucas;2;3;5;24
4203006;Caçador;4217204;São Miguel do Oeste;2;3;5;244
4208203;Itajaí;4217204;São Miguel do Oeste;2;3;5;478
4216107;São Domingos;4216909;São Lourenço do Oeste;2;3;5;40
2304400;Fortaleza;4216602;São José;2;3;5;2798
4202602;Bom Retiro;4216602;São José;2;3;5;83
4215802;São Bento do Sul;4216602;São José;2;3;5;161
4209102;Joinville;4216305;São João Batista;2;3;5;110
4204202;Chapecó;4216107;São Domingos;2;3;5;62
3170701;Varginha;4215802;São Bento do Sul;2;3;5;655
4208708;Jacinto Machado;4215653;Santa Rosa do Sul;2;3;5;14
4212700;Petrolândia;4214805;Rio do Sul;2;3;5;34
4208708;Jacinto Machado;4213807;Praia Grande;2;3;5;29
4202008;Balneário Camboriú;4213203;Pomerode;2;3;5;56
4208203;Itajaí;4213203;Pomerode;2;3;5;48
2507507;João Pessoa;4211603;Nova Veneza;2;3;5;2729
4207502;Indaial;4211306;Navegantes;2;3;5;55
3550308;São Paulo;4211207;Morro da Fumaça;2;3;5;605
4207007;Içara;4210407;Maracajá;2;3;5;21
4204301;Concórdia;4210035;Luzerna;2;3;5;53
4208500;Ituporanga;4209805;Leoberto Leal;2;3;5;33
2611606;Recife;4209607;Lauro Muller;2;3;5;2611
4113700;Londrina;4209300;Lages;2;3;5;505
3549805;São José do Rio Preto;4209102;Joinville;2;3;5;606
3549904;São José dos Campos;4209102;Joinville;2;3;5;450
4204301;Concórdia;4209102;Joinville;2;3;5;333
4205209;Erval Velho;4209003;Joaçaba;2;3;5;17
4208609;Jaborá;4209003;Joaçaba;2;3;5;19
3525904;Jundiaí;4208906;Jaraguá do Sul;2;3;5;424
3547809;Santo André;4208906;Jaraguá do Sul;2;3;5;402
4203006;Caçador;4208906;Jaraguá do Sul;2;3;5;204
2408102;Natal;4208203;Itajaí;2;3;5;2659
2927408;Salvador;4208203;Itajaí;2;3;5;1826
4202404;Blumenau;4207007;Içara;2;3;5;197
4204202;Chapecó;4206603;Guarujá do Sul;2;3;5;121
4202909;Brusque;4206207;Gravatal;2;3;5;138
4109401;Guarapuava;4205902;Gaspar;2;3;5;300
4119905;Ponta Grossa;4205902;Gaspar;2;3;5;235
4115309;Mariópolis;4205605;Galvão;2;3;5;17
3305505;Saquarema;4205407;Florianópolis;2;3;5;787
4107603;Faxinal;4205407;Florianópolis;2;3;5;481
3550308;São Paulo;4205001;Dionísio Cerqueira;2;3;5;749
4124400;Santo Antônio do Sudoeste;4205001;Dionísio Cerqueira;2;3;5;25
4202404;Blumenau;4204806;Curitibanos;2;3;5;155
4203808;Canoinhas;4204806;Curitibanos;2;3;5;120
2304400;Fortaleza;4204608;Criciúma;2;3;5;2929
4202305;Biguaçu;4204608;Criciúma;2;3;5;146
3548500;Santos;4204301;Concórdia;2;3;5;665
3545209;Salto;4204202;Chapecó;2;3;5;677
4105805;Colombo;4204202;Chapecó;2;3;5;391
4200556;Águas Frias;4204202;Chapecó;2;3;5;36
4203501;Campo Erê;4204202;Chapecó;2;3;5;91
4107801;Floraí;4202909;Brusque;2;3;5;533
4117503;Paiçandu;4202909;Brusque;2;3;5;506
4202107;Barra Velha;4202909;Brusque;2;3;5;55
3525904;Jundiaí;4202404;Blumenau;2;3;5;469
3547809;Santo André;4202404;Blumenau;2;3;5;443
4202008;Balneário Camboriú;4202107;Barra Velha;2;3;5;40
4118204;Paranaguá;4202008;Balneário Camboriú;2;3;5;156
4118501;Pato Branco;4202008;Balneário Camboriú;2;3;5;402
4104303;Campo Mourão;4200101;Abelardo Luz;2;3;5;279
4104808;Cascavel;4128559;Vera Cruz do Oeste;2;3;5;44
4113700;Londrina;4128401;Uraí;2;3;5;38
4118709;Paulo Frontin;4128203;União da Vitória;2;3;5;41
4118857;Perobal;4128104;Umuarama;2;3;5;20
4116802;Nova Cantu;4128005;Ubiratã;2;3;5;44
4104303;Campo Mourão;4127957;Tupãssi;2;3;5;129
4104808;Cascavel;4127858;Três Barras do Paraná;2;3;5;59
3534401;Osasco;4127700;Toledo;2;3;5;714
4104808;Cascavel;4127403;Terra Roxa;2;3;5;109
4122404;Rolândia;4126678;Tamarana;2;3;5;53
4113700;Londrina;4126405;Sertaneja;2;3;5;43
4106902;Curitiba;4126306;Sengés;2;3;5;147
4114203;Mandaguari;4125803;São Pedro do Ivaí;2;3;5;37
4110953;Itaipulândia;4125704;São Miguel do Iguaçu;2;3;5;25
4101200;Antonina;4125506;São José dos Pinhais;2;3;5;50
4101408;Apucarana;4125506;São José dos Pinhais;2;3;5;315
4120804;Quatro Barras;4125506;São José dos Pinhais;2;3;5;22
4124806;São João;4125209;São Jorge d'Oeste;2;3;5;24
4122404;Rolândia;4124707;São Jerônimo da Serra;2;3;5;79
4104501;Capanema;4124400;Santo Antônio do Sudoeste;2;3;5;43
4104808;Cascavel;4124400;Santo Antônio do Sudoeste;2;3;5;127
4121406;Realeza;4123808;Santa Izabel do Oeste;2;3;5;8
4117107;Nova Londrina;4123709;Santa Isabel do Ivaí;2;3;5;36
4122404;Rolândia;4123204;Santa Cecília do Pavão;2;3;5;64
4105508;Cianorte;4122602;Rondon;2;3;5;33
4100806;Alvorada do Sul;4122404;Rolândia;2;3;5;60
4119657;Pitangueiras;4122404;Rolândia;2;3;5;24
4120507;Primeiro de Maio;4122404;Rolândia;2;3;5;60
4115804;Medianeira;4121257;Ramilândia;2;3;5;20
4117107;Nova Londrina;4121000;Querência do Norte;2;3;5;62
3504008;Assis;4119905;Ponta Grossa;2;3;5;272
3507159;Bom Sucesso de Itararé;4119905;Ponta Grossa;2;3;5;135
3542602;Registro;4119905;Ponta Grossa;2;3;5;239
4119509;Piraquara;4119905;Ponta Grossa;2;3;5;117
4119608;Pitanga;4119905;Ponta Grossa;2;3;5;164
4115200;Maringá;4119657;Pitangueiras;2;3;5;42
3200607;Aracruz;4119152;Pinhais;2;3;5;1077
3534401;Osasco;4119152;Pinhais;2;3;5;320
4115309;Mariópolis;4118501;Pato Branco;2;3;5;17
3534401;Osasco;4118204;Paranaguá;2;3;5;287
4101507;Arapongas;4118204;Paranaguá;2;3;5;375
4113700;Londrina;4118105;Paranacity;2;3;5;110
4113700;Londrina;4117305;Ortigueira;2;3;5;103
4108205;Formosa do Oeste;4116703;Nova Aurora;2;3;5;27
4105508;Cianorte;4116109;Moreira Sales;2;3;5;61
4113700;Londrina;4115804;Medianeira;2;3;5;368
3550308;São Paulo;4115754;Mauá da Serra;2;3;5;467
3507506;Botucatu;4115200;Maringá;2;3;5;361
3549904;São José dos Campos;4115200;Maringá;2;3;5;618
4101903;Assaí;4115200;Maringá;2;3;5;111
4110409;Indianópolis;4115200;Maringá;2;3;5;79
4111902;Jaguapitã;4115200;Maringá;2;3;5;54
4113700;Londrina;4114906;Marilândia do Sul;2;3;5;52
4106506;Coronel Vivida;4114401;Mangueirinha;2;3;5;38
3550308;São Paulo;4114302;Mandirituba;2;3;5;355
4107603;Faxinal;4114203;Mandaguari;2;3;5;64
3303500;Nova Iguaçu;4113700;Londrina;2;3;5;787
3552809;Taboão da Serra;4113700;Londrina;2;3;5;450
4105904;Colorado;4113700;Londrina;2;3;5;98
4112108;Jandaia do Sul;4113429;Lidianópolis;2;3;5;56
4104303;Campo Mourão;4112108;Jandaia do Sul;2;3;5;90
4101507;Arapongas;4111803;Jacarezinho;2;3;5;149
4103453;Cafelândia;4110656;Iracema do Oeste;2;3;5;21
3534401;Osasco;4109401;Guarapuava;2;3;5;510
4101507;Arapongas;4109401;Guarapuava;2;3;5;219
3550308;São Paulo;4108809;Guaíra;2;3;5;772
4104303;Campo Mourão;4107553;Farol;2;3;5;25
3306305;Volta Redonda;4106902;Curitiba;2;3;5;610
4100202;Adrianópolis;4106902;Curitiba;2;3;5;89
4106571;Cruzeiro do Iguaçu;4106902;Curitiba;2;3;5;387
1100049;Cacoal;4104808;Cascavel;2;3;5;1686
1100189;Pimenta Bueno;4104808;Cascavel;2;3;5;1649
1100304;Vilhena;4104808;Cascavel;2;3;5;1494
1400100;Boa Vista;4104808;Cascavel;2;3;5;3153
3515400;Fartura;4104709;Carlópolis;2;3;5;22
3550308;São Paulo;4104659;Carambeí;2;3;5;374
4102752;Bela Vista da Caroba;4104501;Capanema;2;3;5;26
1100049;Cacoal;4101507;Arapongas;2;3;5;1655
3539202;Pirapozinho;4101507;Arapongas;2;3;5;126
3551306;Sebastianópolis do Sul;3557105;Votuporanga;2;3;5;25
3125101;Extrema;3556206;Valinhos;2;3;5;71
3547809;Santo André;3556206;Valinhos;2;3;5;89
3552809;Taboão da Serra;3556206;Valinhos;2;3;5;73
3550308;São Paulo;3555109;Tupi Paulista;2;3;5;573
3541000;Praia Grande;3554102;Taubaté;2;3;5;140
3530706;Mogi Guaçu;3553807;Taquarituba;2;3;5;269
2611606;Recife;3553609;Tapiratiba;2;3;5;1893
3503208;Araraquara;3553302;Tambaú;2;3;5;93
3518404;Guaratinguetá;3552502;Suzano;2;3;5;141
3548708;São Bernardo do Campo;3552502;Suzano;2;3;5;34
1600303;Macapá;3552205;Sorocaba;2;3;5;2629
2707701;Rio Largo;3552205;Sorocaba;2;3;5;1927
3511508;Cerquilho;3552205;Sorocaba;2;3;5;43
3542602;Registro;3552205;Sorocaba;2;3;5;121
3550209;São Miguel Arcanjo;3552205;Sorocaba;2;3;5;67
3550308;São Paulo;3552007;Silveiras;2;3;5;215
3506102;Bebedouro;3551900;Severínia;2;3;5;31
3506102;Bebedouro;3551702;Sertãozinho;2;3;5;61
3511102;Catanduva;3551702;Sertãozinho;2;3;5;103
3540705;Porto Ferreira;3551702;Sertãozinho;2;3;5;95
3506359;Bertioga;3551009;São Vicente;2;3;5;33
3545209;Salto;3551009;São Vicente;2;3;5;119
1200203;Cruzeiro do Sul;3550308;São Paulo;2;3;5;3104
1500503;Almeirim;3550308;São Paulo;2;3;5;2518
1600279;Laranjal do Jari;3550308;São Paulo;2;3;5;2547
1722081;Wanderlândia;3550308;São Paulo;2;3;5;1862
2304103;Crateús;3550308;São Paulo;2;3;5;2126
2926202;Riachão das Neves;3550308;São Paulo;2;3;5;1329
3110004;Caeté;3550308;São Paulo;2;3;5;514
3124500;Estiva;3550308;São Paulo;2;3;5;147
3126307;Fortaleza de Minas;3550308;São Paulo;2;3;5;310
3138401;Leopoldina;3550308;São Paulo;2;3;5;465
3153400;Presidente Olegário;3550308;São Paulo;2;3;5;580
3155504;Rio Paranaíba;3550308;São Paulo;2;3;5;495
3168903;Tiros;3550308;São Paulo;2;3;5;519
3300258;Arraial do Cabo;3550308;São Paulo;2;3;5;477
3301306;Casimiro de Abreu;3550308;São Paulo;2;3;5;470
3302601;Mangaratiba;3550308;São Paulo;2;3;5;279
3305000;São João da Barra;3550308;São Paulo;2;3;5;606
3502002;Analândia;3550308;São Paulo;2;3;5;198
3504909;Bananal;3550308;São Paulo;2;3;5;260
3508306;Cabrália Paulista;3550308;São Paulo;2;3;5;303
3514700;Echaporã;3550308;São Paulo;2;3;5;385
3515608;Fernando Prestes;3550308;São Paulo;2;3;5;335
3520202;Igaratá;3550308;São Paulo;2;3;5;71
3536570;Paulistânia;3550308;São Paulo;2;3;5;304
3537156;Pedrinhas Paulista;3550308;São Paulo;2;3;5;431
3540200;Pontal;3550308;São Paulo;2;3;5;323
3543600;Rifaina;3550308;São Paulo;2;3;5;401
3503901;Arujá;3549904;São José dos Campos;2;3;5;50
3545209;Salto;3549904;São José dos Campos;2;3;5;144
3503307;Araras;3549805;São José do Rio Preto;2;3;5;271
3507506;Botucatu;3549805;São José do Rio Preto;2;3;5;248
3521903;Itajobi;3549805;São José do Rio Preto;2;3;5;65
3530805;Moji-Mirim;3549706;São José do Rio Pardo;2;3;5;93
3537107;Pedreira;3549706;São José do Rio Pardo;2;3;5;127
3520103;Igarapava;3549409;São Joaquim da Barra;2;3;5;62
3534401;Osasco;3549102;São João da Boa Vista;2;3;5;174
3205002;Serra;3548807;São Caetano do Sul;2;3;5;739
3302502;Magé;3548807;São Caetano do Sul;2;3;5;372
3306008;Três Rios;3548807;São Caetano do Sul;2;3;5;379
3303302;Niterói;3548708;São Bernardo do Campo;2;3;5;366
3516200;Franca;3548708;São Bernardo do Campo;2;3;5;361
3521002;Iperó;3548708;São Bernardo do Campo;2;3;5;120
3525003;Jandira;3548708;São Bernardo do Campo;2;3;5;39
3531100;Mongaguá;3548708;São Bernardo do Campo;2;3;5;41
3545803;Santa Bárbara d'Oeste;3548708;São Bernardo do Campo;2;3;5;136
3520509;Indaiatuba;3548500;Santos;2;3;5;127
3529005;Marília;3548500;Santos;2;3;5;409
2910057;Dias d'Ávila;3547809;Santo André;2;3;5;1467
3524402;Jacareí;3547809;Santo André;2;3;5;70
3534708;Ourinhos;3547809;Santo André;2;3;5;351
3513702;Descalvado;3547601;Santa Rosa de Viterbo;2;3;5;55
3503208;Araraquara;3547502;Santa Rita do Passa Quatro;2;3;5;72
3503307;Araras;3547502;Santa Rita do Passa Quatro;2;3;5;73
3531803;Monte Mor;3545803;Santa Bárbara d'Oeste;2;3;5;24
2927408;Salvador;3543907;Rio Claro;2;3;5;1384
3512704;Corumbataí;3543907;Rio Claro;2;3;5;22
3530805;Moji-Mirim;3543907;Rio Claro;2;3;5;61
3102605;Andradas;3543402;Ribeirão Preto;2;3;5;163
3115102;Cássia;3543402;Ribeirão Preto;2;3;5;111
3507605;Bragança Paulista;3543402;Ribeirão Preto;2;3;5;237
3505708;Barueri;3543303;Ribeirão Pires;2;3;5;50
3536307;Patrocínio Paulista;3542701;Restinga;2;3;5;19
3522208;Itapecerica da Serra;3542602;Registro;2;3;5;137
3539202;Pirapozinho;3542404;Regente Feijó;2;3;5;21
3538907;Pirajuí;3541604;Promissão;2;3;5;66
3513009;Cotia;3541000;Praia Grande;2;3;5;69
3538006;Pindamonhangaba;3541000;Praia Grande;2;3;5;153
3520509;Indaiatuba;3540606;Porto Feliz;2;3;5;32
3534401;Osasco;3540606;Porto Feliz;2;3;5;83
2611606;Recife;3539806;Poá;2;3;5;2038
3503802;Artur Nogueira;3538709;Piracicaba;2;3;5;52
3513009;Cotia;3538709;Piracicaba;2;3;5;120
3510302;Capela do Alto;3537909;Pilar do Sul;2;3;5;38
3521705;Itaberá;3537909;Pilar do Sul;2;3;5;145
3522307;Itapetininga;3537909;Pilar do Sul;2;3;5;43
3534401;Osasco;3537602;Peruíbe;2;3;5;87
3106200;Belo Horizonte;3536505;Paulínia;2;3;5;452
3502200;Angatuba;3535804;Paranapanema;2;3;5;37
3534401;Osasco;3534708;Ourinhos;2;3;5;325
3534401;Osasco;3534609;Osvaldo Cruz;2;3;5;467
2307304;Juazeiro do Norte;3534401;Osasco;2;3;5;1947
2611101;Petrolina;3534401;Osasco;2;3;5;1690
2903201;Barreiras;3534401;Osasco;2;3;5;1266
2913606;Ilhéus;3534401;Osasco;2;3;5;1232
3201209;Cachoeiro de Itapemirim;3534401;Osasco;2;3;5;650
3300407;Barra Mansa;3534401;Osasco;2;3;5;286
3302205;Itaperuna;3534401;Osasco;2;3;5;563
3503802;Artur Nogueira;3534401;Osasco;2;3;5;113
3510500;Caraguatatuba;3534401;Osasco;2;3;5;136
3512803;Cosmópolis;3534401;Osasco;2;3;5;107
3520301;Iguape;3534401;Osasco;2;3;5;152
3522208;Itapecerica da Serra;3534401;Osasco;2;3;5;21
3530805;Moji-Mirim;3534401;Osasco;2;3;5;124
3169604;Tupaciguara;3534302;Orlândia;2;3;5;250
3509502;Campinas;3534302;Orlândia;2;3;5;257
3503208;Araraquara;3533502;Novo Horizonte;2;3;5;115
3516853;Gavião Peixoto;3532900;Nova Europa;2;3;5;10
1500503;Almeirim;3532827;Nova Campina;2;3;5;2528
3504107;Atibaia;3532405;Nazaré Paulista;2;3;5;17
3506102;Bebedouro;3531308;Monte Alto;2;3;5;39
3523107;Itaquaquecetuba;3531308;Monte Alto;2;3;5;330
3132404;Itajubá;3530706;Mogi Guaçu;2;3;5;153
2930709;Simões Filho;3530607;Moji das Cruzes;2;3;5;1419
3106705;Betim;3530607;Moji das Cruzes;2;3;5;447
3508504;Caçapava;3530607;Moji das Cruzes;2;3;5;71
3101607;Alfenas;3530508;Mococa;2;3;5;112
3514106;Dois Córregos;3529807;Mineiros do Tietê;2;3;5;9
3513702;Descalvado;3529302;Matão;2;3;5;87
3506102;Bebedouro;3529005;Marília;2;3;5;203
3516200;Franca;3529005;Marília;2;3;5;320
3523404;Itatiba;3526902;Limeira;2;3;5;75
3509502;Campinas;3526407;Laranjal Paulista;2;3;5;82
3500105;Adamantina;3526001;Junqueirópolis;2;3;5;40
3518800;Guarulhos;3525003;Jandira;2;3;5;36
3520103;Igarapava;3524105;Ituverava;2;3;5;34
3507506;Botucatu;3523909;Itu;2;3;5;125
3513504;Cubatão;3523909;Itu;2;3;5;112
3505708;Barueri;3523107;Itaquaquecetuba;2;3;5;54
3106200;Belo Horizonte;3522505;Itapevi;2;3;5;502
3513801;Diadema;3522505;Itapevi;2;3;5;37
3304557;Rio de Janeiro;3522307;Itapetininga;2;3;5;494
3506102;Bebedouro;3519600;Ibitinga;2;3;5;96
3503208;Araraquara;3518859;Guatapará;2;3;5;35
1100122;Ji-Paraná;3518800;Guarulhos;2;3;5;2051
3202603;Iconha;3518800;Guarulhos;2;3;5;652
3501608;Americana;3518800;Guarulhos;2;3;5;110
3513405;Cruzeiro;3518800;Guarulhos;2;3;5;189
3127107;Frutal;3517406;Guaíra;2;3;5;73
2312908;Sobral;3516200;Franca;2;3;5;1996
2513703;Santa Rita;3516200;Franca;2;3;5;1942
2611101;Petrolina;3516200;Franca;2;3;5;1425
2918001;Jequié;3516200;Franca;2;3;5;1057
3509502;Campinas;3515186;Espírito Santo do Pinhal;2;3;5;85
3511102;Catanduva;3514924;Elisiário;2;3;5;13
3506508;Birigui;3511904;Clementina;2;3;5;30
3148004;Patos de Minas;3509502;Campinas;2;3;5;482
3201209;Cachoeiro de Itapemirim;3509502;Campinas;2;3;5;650
3500303;Aguaí;3509502;Campinas;2;3;5;93
1501501;Benevides;3509205;Cajamar;2;3;5;2436
3127107;Frutal;3506102;Bebedouro;2;3;5;102
2604106;Caruaru;3505708;Barueri;2;3;5;1995
3147907;Passos;3505708;Barueri;2;3;5;312
3148004;Patos de Minas;3505708;Barueri;2;3;5;547
3154606;Ribeirão das Neves;3505708;Barueri;2;3;5;501
3152808;Prata;3503208;Araraquara;2;3;5;286
2307650;Maracanaú;3501608;Americana;2;3;5;2257
3164704;São Sebastião do Paraíso;3501004;Altinópolis;2;3;5;42
3304904;São Gonçalo;3306305;Volta Redonda;2;3;5;111
3305109;São João de Meriti;3306305;Volta Redonda;2;3;5;81
3101508;Além Paraíba;3306008;Três Rios;2;3;5;61
3304706;Santo Antônio de Pádua;3306008;Três Rios;2;3;5;124
3301009;Campos dos Goytacazes;3305802;Teresópolis;2;3;5;187
3305109;São João de Meriti;3305802;Teresópolis;2;3;5;55
3302106;Itaocara;3305307;São Sebastião do Alto;2;3;5;29
3304524;Rio das Ostras;3304904;São Gonçalo;2;3;5;120
1502152;Canaã dos Carajás;3304557;Rio de Janeiro;2;3;5;1926
1505437;Ourilândia do Norte;3304557;Rio de Janeiro;2;3;5;1943
2302503;Brejo Santo;3304557;Rio de Janeiro;2;3;5;1754
2601102;Araripina;3304557;Rio de Janeiro;2;3;5;1717
2609907;Ouricuri;3304557;Rio de Janeiro;2;3;5;1688
3104205;Arcos;3304557;Rio de Janeiro;2;3;5;368
3161700;São Gonçalo do Abaeté;3304557;Rio de Janeiro;2;3;5;566
3162948;São José da Barra;3304557;Rio de Janeiro;2;3;5;392
3300209;Araruama;3304524;Rio das Ostras;2;3;5;62
3205309;Vitória;3303906;Petrópolis;2;3;5;390
3302106;Itaocara;3303401;Nova Friburgo;2;3;5;85
3300704;Cabo Frio;3302502;Magé;2;3;5;106
3205309;Vitória;3301900;Itaboraí;2;3;5;379
2704302;Maceió;3301702;Duque de Caxias;2;3;5;1635
3202900;Itarana;3205309;Vitória;2;3;5;72
3201506;Colatina;3205150;Vila Pavão;2;3;5;104
3170701;Varginha;3205101;Viana;2;3;5;521
3201902;Domingos Martins;3204559;Santa Maria de Jetibá;2;3;5;37
3201704;Conceição do Castelo;3203700;Muniz Freire;2;3;5;21
2910727;Eunápolis;3203205;Linhares;2;3;5;334
3200201;Alegre;3203106;Jerônimo Monteiro;2;3;5;18
2910727;Eunápolis;3202405;Guarapari;2;3;5;483
3201407;Castelo;3201506;Colatina;2;3;5;134
2910727;Eunápolis;3201209;Cachoeiro de Itapemirim;2;3;5;517
3113404;Caratinga;3201209;Cachoeiro de Itapemirim;2;3;5;161
3151107;Pirapetinga;3172103;Volta Grande;2;3;5;24
3136702;Juiz de Fora;3172004;Visconde do Rio Branco;2;3;5;97
3107307;Bocaiúva;3170800;Várzea da Palma;2;3;5;113
3113909;Carmo da Cachoeira;3170701;Varginha;2;3;5;19
3131307;Ipatinga;3170701;Varginha;2;3;5;371
3106200;Belo Horizonte;3170529;Urucuia;2;3;5;458
3114303;Carmo do Paranaíba;3170206;Uberlândia;2;3;5;201
3120706;Cruzeiro da Fortaleza;3170206;Uberlândia;2;3;5;168
3130200;Igaratinga;3170206;Uberlândia;2;3;5;394
3137106;Lagamar;3170206;Uberlândia;2;3;5;173
3143203;Monte Santo de Minas;3170206;Uberlândia;2;3;5;284
3126109;Formiga;3170107;Uberaba;2;3;5;274
3167202;Sete Lagoas;3170107;Uberaba;2;3;5;387
3106200;Belo Horizonte;3169703;Turmalina;2;3;5;319
3106507;Berilo;3169703;Turmalina;2;3;5;46
3113909;Carmo da Cachoeira;3169406;Três Pontas;2;3;5;32
3138203;Lavras;3169406;Três Pontas;2;3;5;55
3111200;Campo Belo;3169307;Três Corações;2;3;5;86
3131703;Itabira;3168705;Timóteo;2;3;5;63
3136702;Juiz de Fora;3167202;Sete Lagoas;2;3;5;274
3152709;Prados;3162500;São João del Rei;2;3;5;24
3159605;Santa Rita do Sapucaí;3162005;São Gonçalo do Sapucaí;2;3;5;41
3133402;Itapagipe;3161304;São Francisco de Sales;2;3;5;41
3131703;Itabira;3161007;São Domingos do Prata;2;3;5;39
3118304;Conselheiro Lafaiete;3160900;São Brás do Suaçuí;2;3;5;17
3111507;Campos Altos;3159704;Santa Rosa da Serra;2;3;5;28
3118403;Conselheiro Pena;3159506;Santa Rita do Itueto;2;3;5;23
3118601;Contagem;3158003;Santa Maria de Itabira;2;3;5;115
3120870;Curral de Dentro;3157005;Salinas;2;3;5;55
3151206;Pirapora;3156502;Rubelita;2;3;5;301
3144805;Nova Lima;3153905;Raposos;2;3;5;8
3109402;Buritizeiro;3152808;Prata;2;3;5;472
2304400;Fortaleza;3152501;Pouso Alegre;2;3;5;2168
3139409;Manhuaçu;3152105;Ponte Nova;2;3;5;90
3136702;Juiz de Fora;3151800;Poços de Caldas;2;3;5;332
3118601;Contagem;3151206;Pirapora;2;3;5;300
3135100;Janaúba;3151206;Pirapora;2;3;5;237
3147006;Paracatu;3151206;Pirapora;2;3;5;214
3106200;Belo Horizonte;3150604;Piracema;2;3;5;85
3106309;Belo Oriente;3149952;Periquito;2;3;5;27
3104205;Arcos;3149903;Perdões;2;3;5;98
3146909;Papagaios;3149606;Pequi;2;3;5;22
3105905;Barroso;3149309;Pedro Leopoldo;2;3;5;174
3114501;Carmópolis de Minas;3147709;Passa Tempo;2;3;5;19
3140506;Martinho Campos;3146909;Papagaios;2;3;5;53
3106705;Betim;3146107;Ouro Preto;2;3;5;82
3131703;Itabira;3144706;Nova Era;2;3;5;26
2304400;Fortaleza;3143302;Montes Claros;2;3;5;1538
2910800;Feira de Santana;3143302;Montes Claros;2;3;5;714
3104304;Areado;3143005;Monte Belo;2;3;5;23
3130101;Igarapé;3140704;Mateus Leme;2;3;5;14
3136702;Juiz de Fora;3140209;Maripá de Minas;2;3;5;39
3106200;Belo Horizonte;3139508;Manhumirim;2;3;5;217
3106200;Belo Horizonte;3138302;Leandro Ferreira;2;3;5;111
3104007;Araxá;3137205;Lagoa da Prata;2;3;5;155
3101607;Alfenas;3136702;Juiz de Fora;2;3;5;274
3118007;Congonhas;3136702;Juiz de Fora;2;3;5;151
3106200;Belo Horizonte;3135803;Jequitinhonha;2;3;5;497
3103504;Araguari;3134202;Ituiutaba;2;3;5;137
3116605;Cláudio;3132206;Itaguara;2;3;5;30
3106309;Belo Oriente;3128006;Guanhães;2;3;5;71
3100906;Águas Formosas;3127701;Governador Valadares;2;3;5;217
3118403;Conselheiro Pena;3127305;Galiléia;2;3;5;20
3116605;Cláudio;3122306;Divinópolis;2;3;5;34
3107307;Bocaiúva;3120904;Curvelo;2;3;5;193
3109402;Buritizeiro;3120904;Curvelo;2;3;5;163
3101102;Aimorés;3118403;Conselheiro Pena;2;3;5;56
3113305;Carangola;3113404;Caratinga;2;3;5;104
3106200;Belo Horizonte;3112802;Capitólio;2;3;5;229
3106200;Belo Horizonte;3111507;Campos Altos;2;3;5;231
3103900;Araújos;3107406;Bom Despacho;2;3;5;25
1709500;Gurupi;3106200;Belo Horizonte;2;3;5;1046
2306405;Itapipoca;2933307;Vitória da Conquista;2;3;5;1264
2900702;Alagoinhas;2933307;Vitória da Conquista;2;3;5;398
2913507;Iguaí;2933307;Vitória da Conquista;2;3;5;82
2918407;Juazeiro;2933307;Vitória da Conquista;2;3;5;597
2921906;Mucugê;2933307;Vitória da Conquista;2;3;5;213
2902401;Aurelino Leal;2932200;Ubaitaba;2;3;5;6
2905206;Caetité;2931053;Tanque Novo;2;3;5;59
2927408;Salvador;2931053;Tanque Novo;2;3;5;439
2919405;Licínio de Almeida;2930709;Simões Filho;2;3;5;494
2928208;Santana;2930303;Serra Dourada;2;3;5;24
2910859;Filadélfia;2930105;Senhor do Bonfim;2;3;5;34
2927408;Salvador;2929602;Sapeaçu;2;3;5;82
2904704;Buerarema;2927408;Salvador;2;3;5;236
2912707;Ibirapitanga;2927408;Salvador;2;3;5;163
2918209;Jiquiriçá;2927408;Salvador;2;3;5;123
2921401;Mirangaba;2927408;Salvador;2;3;5;320
2804805;Nossa Senhora do Socorro;2926608;Ribeira do Pombal;2;3;5;154
2906873;Capim Grosso;2926301;Riachão do Jacuípe;2;3;5;86
2917003;Itiúba;2925253;Ponto Novo;2;3;5;41
2700300;Arapiraca;2924009;Paulo Afonso;2;3;5;184
2910701;Euclides da Cunha;2921500;Monte Santo;2;3;5;34
2918001;Jequié;2920502;Maracás;2;3;5;55
2903904;Bom Jesus da Lapa;2919553;Luís Eduardo magalhães;2;3;5;296
2906501;Candeias;2919553;Luís Eduardo magalhães;2;3;5;795
2304400;Fortaleza;2919207;Lauro de Freitas;2;3;5;1008
2211001;Teresina;2918407;Juazeiro;2;3;5;545
2910909;Firmino Alves;2916401;Itapetinga;2;3;5;48
2914802;Itabuna;2915403;Itaju do Colônia;2;3;5;62
2914802;Itabuna;2914901;Itacaré;2;3;5;64
2611101;Petrolina;2914604;Irecê;2;3;5;268
2913200;Ibotirama;2914604;Irecê;2;3;5;174
1501402;Belém;2910800;Feira de Santana;2;3;5;1577
2111300;São Luís;2910800;Feira de Santana;2;3;5;1218
2507507;João Pessoa;2910800;Feira de Santana;2;3;5;717
2910701;Euclides da Cunha;2910800;Feira de Santana;2;3;5;197
2910727;Eunápolis;2910800;Feira de Santana;2;3;5;457
2612604;Santa Maria da Boa Vista;2909901;Curaçá;2;3;5;29
2704302;Maceió;2905701;Camaçari;2;3;5;438
2904605;Brumado;2905008;Caculé;2;3;5;73
2804805;Nossa Senhora do Socorro;2807402;Tobias Barreto;2;3;5;103
2801405;Carira;2802908;Itabaiana;2;3;5;41
2611101;Petrolina;2800308;Aracaju;2;3;5;414
2708105;Santana do Mundaú;2709301;União dos Palmares;2;3;5;14
2707305;Porto Calvo;2708501;São Luís do Quitunde;2;3;5;35
2702306;Coruripe;2706703;Penedo;2;3;5;44
2211001;Teresina;2704302;Maceió;2;3;5;919
2611606;Recife;2702405;Delmiro Gouveia;2;3;5;363
2507507;João Pessoa;2700300;Arapiraca;2;3;5;348
2601904;Bezerros;2612505;Santa Cruz do Capibaribe;2;3;5;54
2605202;Escada;2612505;Santa Cruz do Capibaribe;2;3;5;117
1500800;Ananindeua;2611606;Recife;2;3;5;1651
2608057;Jatobá;2611606;Recife;2;3;5;386
2611309;Pombos;2611606;Recife;2;3;5;51
2602902;Cabo de Santo Agostinho;2610004;Palmares;2;3;5;77
2605004;Cupira;2610004;Palmares;2;3;5;40
2604007;Carpina;2609709;Orobó;2;3;5;42
2604007;Carpina;2609105;Machados;2;3;5;34
2602209;Bom Jardim;2604007;Carpina;2;3;5;38
2507309;Jacaraú;2512721;Pedro Régis;2;3;5;2
2403103;Currais Novos;2511400;Picuí;2;3;5;37
2508901;Mamanguape;2510808;Patos;2;3;5;236
2503902;Camalaú;2509701;Monteiro;2;3;5;38
2501302;Aroeiras;2507200;Itatuba;2;3;5;21
1501402;Belém;2504009;Campina Grande;2;3;5;1521
2406601;Lagoa Salgada;2408102;Natal;2;3;5;44
2402006;Caicó;2405702;Jardim do Seridó;2;3;5;40
2401404;Baía Formosa;2403251;Parnamirim;2;3;5;58
2401008;Apodi;2403103;Currais Novos;2;3;5;158
2402006;Caicó;2403004;Cruzeta;2;3;5;38
2304236;Croatá;2313401;Tianguá;2;3;5;75
2305506;Iguatu;2313401;Tianguá;2;3;5;343
2308708;Morada Nova;2313104;Tabuleiro do Norte;2;3;5;30
2304509;Frecheirinha;2312908;Sobral;2;3;5;51
2305001;Guaraciaba do Norte;2312304;São Benedito;2;3;5;18
2304103;Crateús;2311801;Russas;2;3;5;299
2307304;Juazeiro do Norte;2311801;Russas;2;3;5;294
2307700;Maranguape;2311306;Quixadá;2;3;5;125
2308500;Mombaça;2310506;Pedra Branca;2;3;5;29
2111300;São Luís;2307809;Marco;2;3;5;459
2303709;Caucaia;2307700;Maranguape;2;3;5;18
2303204;Caririaçu;2307304;Juazeiro do Norte;2;3;5;20
2304103;Crateús;2306405;Itapipoca;2;3;5;220
2305506;Iguatu;2306405;Itapipoca;2;3;5;316
2304400;Fortaleza;2306256;Itaitinga;2;3;5;22
2304400;Fortaleza;2306108;Irauçuba;2;3;5;138
2301109;Aracati;2305233;Horizonte;2;3;5;98
2302602;Camocim;2303907;Chaval;2;3;5;42
2206209;Miguel Alves;2211100;União;2;3;5;45
2104800;Grajaú;2211001;Teresina;2;3;5;379
2201150;Baixa Grande do Ribeiro;2208908;Ribeiro Gonçalves;2;3;5;31
2207900;Pedro II;2208304;Piracuruca;2;3;5;62
2202901;Corrente;2208007;Picos;2;3;5;553
2100055;Açailândia;2111052;São João do Paraíso;2;3;5;172
2103307;Codó;2110005;Santa Luzia;2;3;5;204
2105302;Imperatriz;2108603;Pinheiro;2;3;5;421
2106326;Maracaçumé;2108603;Pinheiro;2;3;5;106
1502400;Castanhal;2105302;Imperatriz;2;3;5;469
1508100;Tucuruí;2105302;Imperatriz;2;3;5;320
2103000;Caxias;2105302;Imperatriz;2;3;5;462
2103307;Codó;2105302;Imperatriz;2;3;5;404
1302603;Manaus;1721000;Palmas;2;3;5;1498
1700251;Abreulândia;1707108;Divinópolis do Tocantins;2;3;5;21
1508100;Tucuruí;1702109;Araguaína;2;3;5;416
1507300;São Félix do Xingu;1508407;Xinguara;2;3;5;224
1501402;Belém;1507102;São Caetano de Odivelas;2;3;5;83
1501402;Belém;1506401;Santa Cruz do Arari;2;3;5;115
1501402;Belém;1505700;Ponta de Pedras;2;3;5;49
1501402;Belém;1504703;Moju;2;3;5;70
1502939;Dom Eliseu;1504208;Marabá;2;3;5;204
1500107;Abaetetuba;1503804;Jacundá;2;3;5;298
1501402;Belém;1503101;Gurupá;2;3;5;354
1501402;Belém;1503002;Faro;2;3;5;920
1501402;Belém;1502509;Chaves;2;3;5;218
1501303;Barcarena;1502103;Cametá;2;3;5;128
1302603;Manaus;1303601;Santa Isabel do Rio Negro;2;3;5;630
1301902;Itacoatiara;1302702;Manicoré;2;3;5;435
1300029;Alvarães;1302603;Manaus;2;3;5;532
1300409;Barcelos;1302603;Manaus;2;3;5;400
1100122;Ji-Paraná;1101005;Governador Jorge Teixeira;2;3;5;95
5218805;Rio Verde;5221551;Turvelândia;1;4;5;68
5219712;Santo Antônio da Barra;5221551;Turvelândia;1;4;5;48
5201108;Anápolis;5219308;Santa Helena de Goiás;1;4;5;240
3534401;Osasco;5218805;Rio Verde;1;4;5;777
3148103;Patrocínio;5215702;Palmeiras de Goiás;1;4;5;395
4208203;Itajaí;5213103;Mineiros;1;4;5;1119
1703842;Campos Lindos;5208707;Goiânia;1;4;5;992
3534302;Orlândia;5200134;Acreúna;1;4;5;455
4204301;Concórdia;5108402;Várzea Grande;1;4;5;1361
4118204;Paranaguá;5107925;Sorriso;1;4;5;1654
4107256;Douradina;5107909;Sinop;1;4;5;1299
4107256;Douradina;5107602;Rondonópolis;1;4;5;785
5102504;Cáceres;5107206;Rio Branco;1;4;5;99
3502804;Araçatuba;5106653;Pontal do Araguaia;1;4;5;621
4205902;Gaspar;5106224;Nova Mutum;1;4;5;1655
4126504;Sertanópolis;5007935;Sonora;1;4;5;731
4115804;Medianeira;5006606;Ponta Porã;1;4;5;349
3534401;Osasco;5003702;Dourados;1;4;5;842
4115804;Medianeira;5001243;Aral Moreira;1;4;5;306
4311809;Marau;4320800;Soledade;1;4;5;55
4208203;Itajaí;4320404;Serafina Corrêa;1;4;5;366
4304606;Canoas;4317509;Santo Ângelo;1;4;5;353
4305009;Catuípe;4317509;Santo Ângelo;1;4;5;26
4311205;Júlio de Castilhos;4315321;Quevedos;1;4;5;40
3144805;Nova Lima;4314902;Porto Alegre;1;4;5;1303
3504107;Atibaia;4314902;Porto Alegre;1;4;5;883
3507506;Botucatu;4314902;Porto Alegre;1;4;5;836
3525300;Jaú;4314902;Porto Alegre;1;4;5;896
3527108;Lins;4314902;Porto Alegre;1;4;5;937
4313011;Nova Candelária;4314902;Porto Alegre;1;4;5;388
3534401;Osasco;4314407;Pelotas;1;4;5;1041
4306809;Encantado;4314407;Pelotas;1;4;5;280
4203808;Canoinhas;4314100;Passo Fundo;1;4;5;298
4217501;Seara;4314100;Passo Fundo;1;4;5;123
4106902;Curitiba;4313201;Nova Petrópolis;1;4;5;470
3547809;Santo André;4305108;Caxias do Sul;1;4;5;753
4101507;Arapongas;4304606;Canoas;1;4;5;720
4300406;Alegrete;4304606;Canoas;1;4;5;441
3516200;Franca;4216602;São José;1;4;5;789
4212106;Palmitos;4216255;São João do Oeste;1;4;5;44
4204202;Chapecó;4212007;Palma Sola;1;4;5;107
2111300;São Luís;4211603;Nova Veneza;1;4;5;2928
2611606;Recife;4211603;Nova Veneza;1;4;5;2637
3106200;Belo Horizonte;4211603;Nova Veneza;1;4;5;1099
3534401;Osasco;4208906;Jaraguá do Sul;1;4;5;397
2910800;Feira de Santana;4208203;Itajaí;1;4;5;1868
4206702;Herval d'Oeste;4208203;Itajaí;1;4;5;274
2306306;Itapagé;4202404;Blumenau;1;4;5;2723
3550308;São Paulo;4128401;Uraí;1;4;5;428
3534401;Osasco;4128104;Umuarama;1;4;5;665
1600303;Macapá;4113700;Londrina;1;4;5;2585
2211001;Teresina;4113700;Londrina;1;4;5;2174
3131307;Ipatinga;4113700;Londrina;1;4;5;967
3301009;Campos dos Goytacazes;4113700;Londrina;1;4;5;1014
3170107;Uberaba;4113205;Lapa;1;4;5;690
3516200;Franca;4109807;Ibiporã;1;4;5;477
3534401;Osasco;4108304;Foz do Iguaçu;1;4;5;799
1100304;Vilhena;4107256;Douradina;1;4;5;1354
1506807;Santarém;4107256;Douradina;1;4;5;2317
4101804;Araucária;4105201;Cerro Azul;1;4;5;86
1200203;Cruzeiro do Sul;4101507;Arapongas;1;4;5;2718
3508504;Caçapava;3555406;Ubatuba;1;4;5;68
3525706;José Bonifácio;3555208;Turiúba;1;4;5;46
3537503;Pereiras;3554508;Tietê;1;4;5;27
2927408;Salvador;3552502;Suzano;1;4;5;1402
3538709;Piracicaba;3551009;São Vicente;1;4;5;180
3512001;Colina;3549805;São José do Rio Preto;1;4;5;90
3522000;Itaju;3548906;São Carlos;1;4;5;94
3510609;Carapicuíba;3548708;São Bernardo do Campo;1;4;5;34
3509205;Cajamar;3548500;Santos;1;4;5;80
2303709;Caucaia;3547809;Santo André;1;4;5;2333
3508009;Buri;3545209;Salto;1;4;5;149
3523503;Itatinga;3545209;Salto;1;4;5;136
2927408;Salvador;3545001;Salesópolis;1;4;5;1376
3530904;Mombuca;3544004;Rio das Pedras;1;4;5;10
2101400;Balsas;3543402;Ribeirão Preto;1;4;5;1520
3538709;Piracicaba;3541000;Praia Grande;1;4;5;187
2927408;Salvador;3537909;Pilar do Sul;1;4;5;1505
1400100;Boa Vista;3534401;Osasco;1;4;5;3218
1504208;Marabá;3534401;Osasco;1;4;5;2022
3506508;Birigui;3534401;Osasco;1;4;5;436
3528858;Marapoama;3529500;Mendonça;1;4;5;48
3517505;Guapiaçu;3522307;Itapetininga;1;4;5;330
3509502;Campinas;3522109;Itanhaém;1;4;5;145
2905701;Camaçari;3515004;Embu;1;4;5;1476
2927408;Salvador;3506607;Biritiba-Mirim;1;4;5;1390
3500907;Altair;3506102;Bebedouro;1;4;5;71
3303500;Nova Iguaçu;3304607;Santa Maria Madalena;1;4;5;176
3129400;Ibertioga;3304557;Rio de Janeiro;1;4;5;176
3201308;Cariacica;3303302;Niterói;1;4;5;397
3110004;Caeté;3300407;Barra Mansa;1;4;5;298
2927408;Salvador;3201605;Conceição da Barra;1;4;5;633
3135076;Jampruca;3201506;Colatina;1;4;5;173
3106200;Belo Horizonte;3200300;Alfredo Chaves;1;4;5;346
3168002;Taiobeiras;3170800;Várzea da Palma;1;4;5;333
2101400;Balsas;3170206;Uberlândia;1;4;5;1281
3157807;Santa Luzia;3170107;Uberaba;1;4;5;426
2927408;Salvador;3169703;Turmalina;1;4;5;653
3133006;Itamonte;3151800;Poços de Caldas;1;4;5;183
2933307;Vitória da Conquista;3143104;Monte Carmelo;1;4;5;816
2804805;Nossa Senhora do Socorro;3136702;Juiz de Fora;1;4;5;1358
3132107;Itacarambi;3135050;Jaíba;1;4;5;48
3106705;Betim;3120904;Curvelo;1;4;5;136
3107505;Bom Jardim de Minas;3110004;Caeté;1;4;5;235
2306306;Itapagé;3106200;Belo Horizonte;1;4;5;1848
2504009;Campina Grande;2933307;Vitória da Conquista;1;4;5;996
2211001;Teresina;2903201;Barreiras;1;4;5;822
2803500;Lagarto;2804805;Nossa Senhora do Socorro;1;4;5;64
2306306;Itapagé;2607901;Jaboatão dos Guararapes;1;4;5;700
2408003;Mossoró;2504009;Campina Grande;1;4;5;275
2200905;Aroazes;2304400;Fortaleza;1;4;5;446
1506807;Santarém;2111300;São Luís;1;4;5;1167
1500800;Ananindeua;2105401;Itapecuru Mirim;1;4;5;504
1303403;Parintins;1507979;Terra Santa;1;4;5;69
1100031;Cabixi;5300108;Brasília;2;2;4;1370
1100056;Cerejeiras;5300108;Brasília;2;2;4;1405
1100064;Colorado do Oeste;5300108;Brasília;2;2;4;1376
1100072;Corumbiara;5300108;Brasília;2;2;4;1416
1100098;Espigão d'Oeste;5300108;Brasília;2;2;4;1469
1100296;Santa Luzia d'Oeste;5300108;Brasília;2;2;4;1535
1100320;São Miguel do Guaporé;5300108;Brasília;2;2;4;1637
1100338;Nova Mamoré;5300108;Brasília;2;2;4;1939
1100346;Alvorada d'Oeste;5300108;Brasília;2;2;4;1606
1100403;Alto Paraíso;5300108;Brasília;2;2;4;1761
1100502;Novo Horizonte do Oeste;5300108;Brasília;2;2;4;1562
1100601;Cacaulândia;5300108;Brasília;2;2;4;1697
1100700;Campo Novo de Rondônia;5300108;Brasília;2;2;4;1758
1101203;Ministro Andreazza;5300108;Brasília;2;2;4;1534
1101302;Mirante da Serra;5300108;Brasília;2;2;4;1649
1101401;Monte Negro;5300108;Brasília;2;2;4;1742
1101492;São Francisco do Guaporé;5300108;Brasília;2;2;4;1714
1101500;Seringueiras;5300108;Brasília;2;2;4;1664
1101708;Urupá;5300108;Brasília;2;2;4;1617
1200013;Acrelândia;5300108;Brasília;2;2;4;2113
1200104;Brasiléia;5300108;Brasília;2;2;4;2271
1200302;Feijó;5300108;Brasília;2;2;4;2512
1200336;Mâncio Lima;5300108;Brasília;2;2;4;2788
1200344;Manoel Urbano;5300108;Brasília;2;2;4;2384
1200450;Senador Guiomard;5300108;Brasília;2;2;4;2190
1200708;Xapuri;5300108;Brasília;2;2;4;2254
1300706;Boca do Acre;5300108;Brasília;2;2;4;2197
1300805;Borba;5300108;Brasília;2;2;4;1757
1301001;Carauari;5300108;Brasília;2;2;4;2329
1301407;Eirunepé;5300108;Brasília;2;2;4;2526
1301704;Humaitá;5300108;Brasília;2;2;4;1840
1302405;Lábrea;5300108;Brasília;2;2;4;2008
1303569;Rio Preto da Eva;5300108;Brasília;2;2;4;1900
1400308;Mucajaí;5300108;Brasília;2;2;4;2429
1400472;Rorainópolis;5300108;Brasília;2;2;4;2267
1400506;São João da Baliza;5300108;Brasília;2;2;4;2236
1500206;Acará;5300108;Brasília;2;2;4;1536
1500305;Afuá;5300108;Brasília;2;2;4;1748
1500404;Alenquer;5300108;Brasília;2;2;4;1692
1500909;Augusto Corrêa;5300108;Brasília;2;2;4;1641
1501204;Baião;5300108;Brasília;2;2;4;1452
1501501;Benevides;5300108;Brasília;2;2;4;1598
1501576;Bom Jesus do Tocantins;5300108;Brasília;2;2;4;1192
1501725;Brasil Novo;5300108;Brasília;2;2;4;1465
1501782;Breu Branco;5300108;Brasília;2;2;4;1315
1502152;Canaã dos Carajás;5300108;Brasília;2;2;4;1050
1502301;Capitão Poço;5300108;Brasília;2;2;4;1558
1502772;Curionópolis;5300108;Brasília;2;2;4;1092
1502905;Curuçá;5300108;Brasília;2;2;4;1666
1502939;Dom Eliseu;5300108;Brasília;2;2;4;1272
1503093;Goianésia do Pará;5300108;Brasília;2;2;4;1329
1503200;Igarapé-Açu;5300108;Brasília;2;2;4;1623
1503309;Igarapé-Miri;5300108;Brasília;2;2;4;1533
1503457;Ipixuna do Pará;5300108;Brasília;2;2;4;1466
1503507;Irituia;5300108;Brasília;2;2;4;1553
1503705;Itupiranga;5300108;Brasília;2;2;4;1191
1503754;Jacareacanga;5300108;Brasília;2;2;4;1482
1503804;Jacundá;5300108;Brasília;2;2;4;1266
1503903;Juruti;5300108;Brasília;2;2;4;1731
1504059;Mãe do Rio;5300108;Brasília;2;2;4;1524
1504455;Medicilândia;5300108;Brasília;2;2;4;1465
1504604;Mocajuba;5300108;Brasília;2;2;4;1473
1504802;Monte Alegre;5300108;Brasília;2;2;4;1662
1505007;Nova Timboteua;5300108;Brasília;2;2;4;1616
1505031;Novo Progresso;5300108;Brasília;2;2;4;1240
1505064;Novo Repartimento;5300108;Brasília;2;2;4;1296
1505106;Óbidos;5300108;Brasília;2;2;4;1736
1505403;Ourém;5300108;Brasília;2;2;4;1579
1505437;Ourilândia do Norte;5300108;Brasília;2;2;4;1055
1505809;Portel;5300108;Brasília;2;2;4;1561
1505908;Porto de Moz;5300108;Brasília;2;2;4;1620
1506161;Rio Maria;5300108;Brasília;2;2;4;966
1506187;Rondon do Pará;5300108;Brasília;2;2;4;1218
1506195;Rurópolis;5300108;Brasília;2;2;4;1489
1506500;Santa Isabel do Pará;5300108;Brasília;2;2;4;1605
1507003;Santo Antônio do Tauá;5300108;Brasília;2;2;4;1621
1507151;São Domingos do Araguaia;5300108;Brasília;2;2;4;1140
1507201;São Domingos do Capim;5300108;Brasília;2;2;4;1563
1507409;São Francisco do Pará;5300108;Brasília;2;2;4;1619
1507458;São Geraldo do Araguaia;5300108;Brasília;2;2;4;1047
1507607;São Miguel do Guamá;5300108;Brasília;2;2;4;1572
1507904;Soure;5300108;Brasília;2;2;4;1670
1507953;Tailândia;5300108;Brasília;2;2;4;1426
1508084;Tucumã;5300108;Brasília;2;2;4;1059
1508126;Ulianópolis;5300108;Brasília;2;2;4;1335
1508209;Vigia;5300108;Brasília;2;2;4;1651
1600055;Serra do Navio;5300108;Brasília;2;2;4;1897
1600154;Pedra Branca do Amaparí;5300108;Brasília;2;2;4;1881
1600238;Ferreira Gomes;5300108;Brasília;2;2;4;1872
1600501;Oiapoque;5300108;Brasília;2;2;4;2205
1600535;Porto Grande;5300108;Brasília;2;2;4;1862
1600709;Tartarugalzinho;5300108;Brasília;2;2;4;1940
1700350;Aliança do Tocantins;5300108;Brasília;2;2;4;510
1700707;Alvorada;5300108;Brasília;2;2;4;392
1701002;Ananás;5300108;Brasília;2;2;4;1044
1702000;Araguaçu;5300108;Brasília;2;2;4;378
1702307;Arapoema;5300108;Brasília;2;2;4;910
1702406;Arraias;5300108;Brasília;2;2;4;332
1702554;Augustinópolis;5300108;Brasília;2;2;4;1147
1703701;Brejinho de Nazaré;5300108;Brasília;2;2;4;535
1705557;Combinado;5300108;Brasília;2;2;4;365
1706100;Cristalândia;5300108;Brasília;2;2;4;591
1707108;Divinópolis do Tocantins;5300108;Brasília;2;2;4;679
1707553;Fátima;5300108;Brasília;2;2;4;568
1707652;Figueirópolis;5300108;Brasília;2;2;4;429
1707702;Filadélfia;5300108;Brasília;2;2;4;938
1709005;Goiatins;5300108;Brasília;2;2;4;897
1709302;Guaraí;5300108;Brasília;2;2;4;769
1711902;Lagoa da Confusão;5300108;Brasília;2;2;4;583
1713304;Miranorte;5300108;Brasília;2;2;4;700
1714880;Nova Olinda;5300108;Brasília;2;2;4;906
1715754;Palmeirópolis;5300108;Brasília;2;2;4;310
1716505;Pedro Afonso;5300108;Brasília;2;2;4;753
1716604;Peixe;5300108;Brasília;2;2;4;423
1716703;Colméia;5300108;Brasília;2;2;4;788
1718865;Santa Fé do Araguaia;5300108;Brasília;2;2;4;964
1720309;São Sebastião do Tocantins;5300108;Brasília;2;2;4;1165
1720655;Silvanópolis;5300108;Brasília;2;2;4;516
1720903;Taguatinga;5300108;Brasília;2;2;4;408
1722081;Wanderlândia;5300108;Brasília;2;2;4;989
1722107;Xambioá;5300108;Brasília;2;2;4;1040
2100204;Alcântara;5300108;Brasília;2;2;4;1530
2100303;Aldeias Altas;5300108;Brasília;2;2;4;1322
2100600;Amarante do Maranhão;5300108;Brasília;2;2;4;1136
2100907;Araioses;5300108;Brasília;2;2;4;1560
2101301;Bacuri;5300108;Brasília;2;2;4;1587
2101509;Barão de Grajaú;5300108;Brasília;2;2;4;1131
2101707;Barreirinhas;5300108;Brasília;2;2;4;1537
2102002;Bom Jardim;5300108;Brasília;2;2;4;1380
2102101;Brejo;5300108;Brasília;2;2;4;1447
2102200;Buriti;5300108;Brasília;2;2;4;1413
2102325;Buriticupu;5300108;Brasília;2;2;4;1278
2102705;Cantanhede;5300108;Brasília;2;2;4;1397
2102903;Carutapera;5300108;Brasília;2;2;4;1625
2103505;Colinas;5300108;Brasília;2;2;4;1146
2103604;Coroatá;5300108;Brasília;2;2;4;1348
2103703;Cururupu;5300108;Brasília;2;2;4;1580
2103802;Dom Pedro;5300108;Brasília;2;2;4;1245
2104008;Esperantinópolis;5300108;Brasília;2;2;4;1255
2104057;Estreito;5300108;Brasília;2;2;4;1024
2104107;Fortaleza dos Nogueiras;5300108;Brasília;2;2;4;996
2104404;Gonçalves Dias;5300108;Brasília;2;2;4;1237
2104503;Governador Archer;5300108;Brasília;2;2;4;1253
2104602;Governador Eugênio Barros;5300108;Brasília;2;2;4;1222
2104677;Governador Nunes Freire;5300108;Brasília;2;2;4;1528
2104800;Grajaú;5300108;Brasília;2;2;4;1122
2105005;Humberto de Campos;5300108;Brasília;2;2;4;1534
2105203;Igarapé Grande;5300108;Brasília;2;2;4;1283
2105401;Itapecuru Mirim;5300108;Brasília;2;2;4;1424
2105427;Itinga do Maranhão;5300108;Brasília;2;2;4;1257
2105500;João Lisboa;5300108;Brasília;2;2;4;1147
2105708;Lago da Pedra;5300108;Brasília;2;2;4;1278
2106003;Lima Campos;5300108;Brasília;2;2;4;1300
2106607;Matões;5300108;Brasília;2;2;4;1242
2106706;Mirador;5300108;Brasília;2;2;4;1109
2106805;Mirinzal;5300108;Brasília;2;2;4;1553
2107407;Olho d'Água das Cunhãs;5300108;Brasília;2;2;4;1331
2107704;Paraibano;5300108;Brasília;2;2;4;1121
2107803;Parnarama;5300108;Brasília;2;2;4;1227
2107902;Passagem Franca;5300108;Brasília;2;2;4;1151
2108108;Paulo Ramos;5300108;Brasília;2;2;4;1290
2108702;Pio XII;5300108;Brasília;2;2;4;1355
2108900;Poção de Pedras;5300108;Brasília;2;2;4;1268
2109502;Riachão;5300108;Brasília;2;2;4;943
2109601;Rosário;5300108;Brasília;2;2;4;1477
2109700;Sambaíba;5300108;Brasília;2;2;4;997
2109809;Santa Helena;5300108;Brasília;2;2;4;1523
2110005;Santa Luzia;5300108;Brasília;2;2;4;1329
2110203;Santa Rita;5300108;Brasília;2;2;4;1461
2110302;Santo Antônio dos Lopes;5300108;Brasília;2;2;4;1267
2110500;São Bento;5300108;Brasília;2;2;4;1486
2110708;São Domingos do Maranhão;5300108;Brasília;2;2;4;1190
2110906;São Francisco do Maranhão;5300108;Brasília;2;2;4;1183
2111003;São João Batista;5300108;Brasília;2;2;4;1459
2111409;São Luís Gonzaga do Maranhão;5300108;Brasília;2;2;4;1309
2111508;São Mateus do Maranhão;5300108;Brasília;2;2;4;1351
2111607;São Raimundo das Mangabeiras;5300108;Brasília;2;2;4;1010
2112001;Tasso Fragoso;5300108;Brasília;2;2;4;840
2112100;Timbiras;5300108;Brasília;2;2;4;1347
2112233;Trizidela do Vale;5300108;Brasília;2;2;4;1294
2112308;Tuntum;5300108;Brasília;2;2;4;1216
2112506;Tutóia;5300108;Brasília;2;2;4;1555
2112704;Vargem Grande;5300108;Brasília;2;2;4;1422
2112902;Vitória do Mearim;5300108;Brasília;2;2;4;1403
2113009;Vitorino Freire;5300108;Brasília;2;2;4;1327
2200202;Água Branca;5300108;Brasília;2;2;4;1230
2200400;Altos;5300108;Brasília;2;2;4;1321
2200509;Amarante;5300108;Brasília;2;2;4;1184
2200608;Angical do Piauí;5300108;Brasília;2;2;4;1206
2201507;Batalha;5300108;Brasília;2;2;4;1441
2202000;Buriti dos Lopes;5300108;Brasília;2;2;4;1533
2202307;Canto do Buriti;5300108;Brasília;2;2;4;1005
2202604;Castelo do Piauí;5300108;Brasília;2;2;4;1336
2202703;Cocal;5300108;Brasília;2;2;4;1519
2203107;Cristino Castro;5300108;Brasília;2;2;4;866
2203206;Curimatá;5300108;Brasília;2;2;4;745
2203503;Elesbão Veloso;5300108;Brasília;2;2;4;1223
2203701;Esperantina;5300108;Brasília;2;2;4;1448
2204204;Francisco Santos;5300108;Brasília;2;2;4;1209
2204303;Fronteiras;5300108;Brasília;2;2;4;1235
2204402;Gilbués;5300108;Brasília;2;2;4;715
2204501;Guadalupe;5300108;Brasília;2;2;4;1099
2204709;Inhuma;5300108;Brasília;2;2;4;1202
2205102;Itaueira;5300108;Brasília;2;2;4;1041
2205201;Jaicós;5300108;Brasília;2;2;4;1172
2205508;José de Freitas;5300108;Brasília;2;2;4;1345
2205706;Luís Correia;5300108;Brasília;2;2;4;1572
2205805;Luzilândia;5300108;Brasília;2;2;4;1481
2206209;Miguel Alves;5300108;Brasília;2;2;4;1390
2206506;Monsenhor Hipólito;5300108;Brasília;2;2;4;1216
2207900;Pedro II;5300108;Brasília;2;2;4;1430
2208205;Pio IX;5300108;Brasília;2;2;4;1257
2208304;Piracuruca;5300108;Brasília;2;2;4;1465
2208809;Regeneração;5300108;Brasília;2;2;4;1192
2208908;Ribeiro Gonçalves;5300108;Brasília;2;2;4;954
2209104;Santa Cruz do Piauí;5300108;Brasília;2;2;4;1151
2210003;São João do Piauí;5300108;Brasília;2;2;4;1016
2210409;São Miguel do Tapuio;5300108;Brasília;2;2;4;1333
2210508;São Pedro do Piauí;5300108;Brasília;2;2;4;1223
2210805;Simplício Mendes;5300108;Brasília;2;2;4;1083
2211308;Valença do Piauí;5300108;Brasília;2;2;4;1225
2300309;Acopiara;5300108;Brasília;2;2;4;1396
2300408;Aiuaba;5300108;Brasília;2;2;4;1311
2300705;Alto Santo;5300108;Brasília;2;2;4;1525
2300754;Amontada;5300108;Brasília;2;2;4;1617
2300804;Antonina do Norte;5300108;Brasília;2;2;4;1303
2301208;Aracoiaba;5300108;Brasília;2;2;4;1586
2301307;Araripe;5300108;Brasília;2;2;4;1257
2301604;Assaré;5300108;Brasília;2;2;4;1303
2301703;Aurora;5300108;Brasília;2;2;4;1362
2301851;Banabuiú;5300108;Brasília;2;2;4;1497
2301950;Barreira;5300108;Brasília;2;2;4;1604
2302008;Barro;5300108;Brasília;2;2;4;1356
2302206;Beberibe;5300108;Brasília;2;2;4;1646
2302305;Bela Cruz;5300108;Brasília;2;2;4;1627
2302404;Boa Viagem;5300108;Brasília;2;2;4;1457
2302701;Campos Sales;5300108;Brasília;2;2;4;1252
2302909;Capistrano;5300108;Brasília;2;2;4;1573
2303105;Cariré;5300108;Brasília;2;2;4;1527
2303204;Caririaçu;5300108;Brasília;2;2;4;1330
2303303;Cariús;5300108;Brasília;2;2;4;1356
2303402;Carnaubal;5300108;Brasília;2;2;4;1481
2303600;Catarina;5300108;Brasília;2;2;4;1365
2303659;Catunda;5300108;Brasília;2;2;4;1477
2303808;Cedro;5300108;Brasília;2;2;4;1381
2303907;Chaval;5300108;Brasília;2;2;4;1577
2303956;Chorozinho;5300108;Brasília;2;2;4;1612
2304004;Coreaú;5300108;Brasília;2;2;4;1557
2304236;Croatá;5300108;Brasília;2;2;4;1461
2304251;Cruz;5300108;Brasília;2;2;4;1641
2304301;Farias Brito;5300108;Brasília;2;2;4;1319
2304350;Forquilha;5300108;Brasília;2;2;4;1553
2304459;Fortim;5300108;Brasília;2;2;4;1646
2304509;Frecheirinha;5300108;Brasília;2;2;4;1527
2304657;Graça;5300108;Brasília;2;2;4;1503
2304707;Granja;5300108;Brasília;2;2;4;1586
2304954;Guaiúba;5300108;Brasília;2;2;4;1626
2305209;Hidrolândia;5300108;Brasília;2;2;4;1486
2305357;Icapuí;5300108;Brasília;2;2;4;1653
2305605;Independência;5300108;Brasília;2;2;4;1400
2306009;Iracema;5300108;Brasília;2;2;4;1499
2306108;Irauçuba;5300108;Brasília;2;2;4;1584
2306207;Itaiçaba;5300108;Brasília;2;2;4;1626
2306256;Itaitinga;5300108;Brasília;2;2;4;1639
2306504;Itapiúna;5300108;Brasília;2;2;4;1562
2306553;Itarema;5300108;Brasília;2;2;4;1654
2306702;Jaguaretama;5300108;Brasília;2;2;4;1481
2306801;Jaguaribara;5300108;Brasília;2;2;4;1489
2307007;Jaguaruana;5300108;Brasília;2;2;4;1615
2307106;Jardim;5300108;Brasília;2;2;4;1287
2307403;Jucás;5300108;Brasília;2;2;4;1355
2307502;Lavras da Mangabeira;5300108;Brasília;2;2;4;1375
2307635;Madalena;5300108;Brasília;2;2;4;1495
2308005;Massapê;5300108;Brasília;2;2;4;1574
2308104;Mauriti;5300108;Brasília;2;2;4;1341
2308203;Meruoca;5300108;Brasília;2;2;4;1567
2308302;Milagres;5300108;Brasília;2;2;4;1334
2308351;Milhã;5300108;Brasília;2;2;4;1449
2308401;Missão Velha;5300108;Brasília;2;2;4;1324
2308500;Mombaça;5300108;Brasília;2;2;4;1418
2308609;Monsenhor Tabosa;5300108;Brasília;2;2;4;1472
2308906;Morrinhos;5300108;Brasília;2;2;4;1614
2309003;Mucambo;5300108;Brasília;2;2;4;1516
2309102;Mulungu;5300108;Brasília;2;2;4;1580
2309201;Nova Olinda;5300108;Brasília;2;2;4;1298
2309300;Nova Russas;5300108;Brasília;2;2;4;1452
2309409;Novo Oriente;5300108;Brasília;2;2;4;1363
2309458;Ocara;5300108;Brasília;2;2;4;1589
2309508;Orós;5300108;Brasília;2;2;4;1419
2309706;Pacatuba;5300108;Brasília;2;2;4;1632
2309805;Pacoti;5300108;Brasília;2;2;4;1592
2309904;Pacujá;5300108;Brasília;2;2;4;1511
2310001;Palhano;5300108;Brasília;2;2;4;1610
2310209;Paracuru;5300108;Brasília;2;2;4;1659
2310258;Paraipaba;5300108;Brasília;2;2;4;1649
2310506;Pedra Branca;5300108;Brasília;2;2;4;1434
2310704;Pentecoste;5300108;Brasília;2;2;4;1610
2310803;Pereiro;5300108;Brasília;2;2;4;1469
2310852;Pindoretama;5300108;Brasília;2;2;4;1648
2310902;Piquet Carneiro;5300108;Brasília;2;2;4;1422
2311108;Porteiras;5300108;Brasília;2;2;4;1304
2311207;Potengi;5300108;Brasília;2;2;4;1274
2311504;Quixeré;5300108;Brasília;2;2;4;1581
2311603;Redenção;5300108;Brasília;2;2;4;1606
2312007;Santana do Acaraú;5300108;Brasília;2;2;4;1589
2312106;Santana do Cariri;5300108;Brasília;2;2;4;1286
2312205;Santa Quitéria;5300108;Brasília;2;2;4;1509
2312502;São João do Jaguaribe;5300108;Brasília;2;2;4;1545
2312601;São Luís do Curu;5300108;Brasília;2;2;4;1622
2313005;Solonópole;5300108;Brasília;2;2;4;1456
2313104;Tabuleiro do Norte;5300108;Brasília;2;2;4;1557
2313351;Tejuçuoca;5300108;Brasília;2;2;4;1573
2313500;Trairi;5300108;Brasília;2;2;4;1660
2313559;Tururu;5300108;Brasília;2;2;4;1619
2313609;Ubajara;5300108;Brasília;2;2;4;1513
2313757;Umirim;5300108;Brasília;2;2;4;1615
2313807;Uruburetama;5300108;Brasília;2;2;4;1611
2313906;Uruoca;5300108;Brasília;2;2;4;1584
2314003;Várzea Alegre;5300108;Brasília;2;2;4;1349
2314102;Viçosa do Ceará;5300108;Brasília;2;2;4;1532
2400109;Acari;5300108;Brasília;2;2;4;1577
2400307;Afonso Bezerra;5300108;Brasília;2;2;4;1656
2400505;Alexandria;5300108;Brasília;2;2;4;1472
2400703;Alto do Rodrigues;5300108;Brasília;2;2;4;1652
2400802;Angicos;5300108;Brasília;2;2;4;1629
2401453;Baraúna;5300108;Brasília;2;2;4;1607
2402204;Canguaretama;5300108;Brasília;2;2;4;1703
2402303;Caraúbas;5300108;Brasília;2;2;4;1555
2402402;Carnaúba dos Dantas;5300108;Brasília;2;2;4;1572
2403806;Florânia;5300108;Brasília;2;2;4;1585
2404309;Governador Dix-Sept Rosado;5300108;Brasília;2;2;4;1584
2404507;Guamaré;5300108;Brasília;2;2;4;1699
2404705;Ipanguaçu;5300108;Brasília;2;2;4;1629
2405702;Jardim do Seridó;5300108;Brasília;2;2;4;1556
2406106;Jucurutu;5300108;Brasília;2;2;4;1580
2406700;Lajes;5300108;Brasília;2;2;4;1655
2407401;Martins;5300108;Brasília;2;2;4;1505
2407807;Monte Alegre;5300108;Brasília;2;2;4;1708
2408904;Parelhas;5300108;Brasília;2;2;4;1557
2409308;Patu;5300108;Brasília;2;2;4;1525
2409704;Pedro Avelino;5300108;Brasília;2;2;4;1663
2411403;Santana do Matos;5300108;Brasília;2;2;4;1610
2411502;Santo Antônio;5300108;Brasília;2;2;4;1679
2412203;São José de Mipibu;5300108;Brasília;2;2;4;1712
2412302;São José do Campestre;5300108;Brasília;2;2;4;1658
2412500;São Miguel;5300108;Brasília;2;2;4;1454
2412609;São Paulo do Potengi;5300108;Brasília;2;2;4;1685
2413359;Serra do Mel;5300108;Brasília;2;2;4;1642
2414407;Touros;5300108;Brasília;2;2;4;1755
2414506;Umarizal;5300108;Brasília;2;2;4;1520
2500304;Alagoa Grande;5300108;Brasília;2;2;4;1619
2500403;Alagoa Nova;5300108;Brasília;2;2;4;1605
2500601;Alhandra;5300108;Brasília;2;2;4;1655
2500700;São João do Rio do Peixe;5300108;Brasília;2;2;4;1416
2500809;Araçagi;5300108;Brasília;2;2;4;1651
2500908;Arara;5300108;Brasília;2;2;4;1621
2501005;Araruna;5300108;Brasília;2;2;4;1641
2501302;Aroeiras;5300108;Brasília;2;2;4;1579
2501575;Barra de Santana;5300108;Brasília;2;2;4;1556
2501609;Barra de Santa Rosa;5300108;Brasília;2;2;4;1604
2502409;Bonito de Santa Fé;5300108;Brasília;2;2;4;1366
2502508;Boqueirão;5300108;Brasília;2;2;4;1547
2502805;Brejo do Cruz;5300108;Brasília;2;2;4;1516
2503001;Caaporã;5300108;Brasília;2;2;4;1651
2503100;Cabaceiras;5300108;Brasília;2;2;4;1534
2503506;Cacimba de Dentro;5300108;Brasília;2;2;4;1631
2503605;Caiçara;5300108;Brasília;2;2;4;1668
2504405;Conceição;5300108;Brasília;2;2;4;1351
2504801;Coremas;5300108;Brasília;2;2;4;1434
2504900;Cruz do Espírito Santo;5300108;Brasília;2;2;4;1658
2505105;Cuité;5300108;Brasília;2;2;4;1613
2506103;Fagundes;5300108;Brasília;2;2;4;1586
2506400;Gurinhém;5300108;Brasília;2;2;4;1630
2506806;Ingá;5300108;Brasília;2;2;4;1605
2507101;Itapororoca;5300108;Brasília;2;2;4;1664
2507309;Jacaraú;5300108;Brasília;2;2;4;1674
2507705;Juazeirinho;5300108;Brasília;2;2;4;1534
2508208;Lagoa de Dentro;5300108;Brasília;2;2;4;1663
2508307;Lagoa Seca;5300108;Brasília;2;2;4;1591
2509107;Mari;5300108;Brasília;2;2;4;1643
2509404;Mogeiro;5300108;Brasília;2;2;4;1614
2509503;Montadas;5300108;Brasília;2;2;4;1589
2510907;Paulista;5300108;Brasília;2;2;4;1488
2511202;Pedras de Fogo;5300108;Brasília;2;2;4;1641
2511301;Piancó;5300108;Brasília;2;2;4;1417
2511400;Picuí;5300108;Brasília;2;2;4;1591
2511509;Pilar;5300108;Brasília;2;2;4;1635
2511806;Pirpirituba;5300108;Brasília;2;2;4;1646
2512002;Pocinhos;5300108;Brasília;2;2;4;1580
2512309;Princesa Isabel;5300108;Brasília;2;2;4;1376
2512507;Queimadas;5300108;Brasília;2;2;4;1577
2512705;Remígio;5300108;Brasília;2;2;4;1610
2512903;Rio Tinto;5300108;Brasília;2;2;4;1683
2513109;Salgado de São Félix;5300108;Brasília;2;2;4;1614
2513406;Santa Luzia;5300108;Brasília;2;2;4;1524
2513901;São Bento;5300108;Brasília;2;2;4;1510
2514503;São José de Piranhas;5300108;Brasília;2;2;4;1382
2514909;São Mamede;5300108;Brasília;2;2;4;1505
2515500;Serra Branca;5300108;Brasília;2;2;4;1502
2515906;Serraria;5300108;Brasília;2;2;4;1631
2516003;Solânea;5300108;Brasília;2;2;4;1630
2516102;Soledade;5300108;Brasília;2;2;4;1556
2516300;Sumé;5300108;Brasília;2;2;4;1472
2516409;Campo de Santana;5300108;Brasília;2;2;4;1654
2516508;Taperoá;5300108;Brasília;2;2;4;1508
2516607;Tavares;5300108;Brasília;2;2;4;1393
2516706;Teixeira;5300108;Brasília;2;2;4;1472
2516904;Uiraúna;5300108;Brasília;2;2;4;1435
2600203;Afrânio;5300108;Brasília;2;2;4;1084
2600302;Agrestina;5300108;Brasília;2;2;4;1504
2600401;Água Preta;5300108;Brasília;2;2;4;1527
2600500;Águas Belas;5300108;Brasília;2;2;4;1360
2600609;Alagoinha;5300108;Brasília;2;2;4;1430
2600708;Aliança;5300108;Brasília;2;2;4;1617
2600807;Altinho;5300108;Brasília;2;2;4;1492
2600906;Amaraji;5300108;Brasília;2;2;4;1552
2601508;Belém de Maria;5300108;Brasília;2;2;4;1507
2601607;Belém de São Francisco;5300108;Brasília;2;2;4;1232
2602001;Bodocó;5300108;Brasília;2;2;4;1224
2602209;Bom Jardim;5300108;Brasília;2;2;4;1574
2602308;Bonito;5300108;Brasília;2;2;4;1522
2602407;Brejão;5300108;Brasília;2;2;4;1415
2602605;Brejo da Madre de Deus;5300108;Brasília;2;2;4;1485
2602704;Buenos Aires;5300108;Brasília;2;2;4;1601
2602803;Buíque;5300108;Brasília;2;2;4;1389
2603108;Cachoeirinha;5300108;Brasília;2;2;4;1476
2603504;Camocim de São Félix;5300108;Brasília;2;2;4;1526
2603702;Canhotinho;5300108;Brasília;2;2;4;1457
2603801;Capoeiras;5300108;Brasília;2;2;4;1427
2603900;Carnaíba;5300108;Brasília;2;2;4;1388
2604304;Cedro;5300108;Brasília;2;2;4;1280
2604502;Chã Grande;5300108;Brasília;2;2;4;1559
2604601;Condado;5300108;Brasília;2;2;4;1629
2604700;Correntes;5300108;Brasília;2;2;4;1431
2604908;Cumaru;5300108;Brasília;2;2;4;1552
2605004;Cupira;5300108;Brasília;2;2;4;1494
2605301;Exu;5300108;Brasília;2;2;4;1257
2605400;Feira Nova;5300108;Brasília;2;2;4;1583
2605608;Flores;5300108;Brasília;2;2;4;1369
2605707;Floresta;5300108;Brasília;2;2;4;1268
2605806;Frei Miguelinho;5300108;Brasília;2;2;4;1537
2605905;Gameleira;5300108;Brasília;2;2;4;1546
2606101;Glória do Goitá;5300108;Brasília;2;2;4;1588
2606507;Iati;5300108;Brasília;2;2;4;1389
2606606;Ibimirim;5300108;Brasília;2;2;4;1348
2606903;Iguaraci;5300108;Brasília;2;2;4;1408
2607000;Inajá;5300108;Brasília;2;2;4;1309
2607307;Ipubi;5300108;Brasília;2;2;4;1219
2607505;Itaíba;5300108;Brasília;2;2;4;1344
2607604;Ilha de Itamaracá;5300108;Brasília;2;2;4;1641
2607703;Itapetim;5300108;Brasília;2;2;4;1466
2608008;Jataúba;5300108;Brasília;2;2;4;1484
2608057;Jatobá;5300108;Brasília;2;2;4;1256
2608107;João Alfredo;5300108;Brasília;2;2;4;1571
2608404;Jurema;5300108;Brasília;2;2;4;1472
2608503;Lagoa do Itaenga;5300108;Brasília;2;2;4;1592
2608701;Lagoa dos Gatos;5300108;Brasília;2;2;4;1496
2608750;Lagoa Grande;5300108;Brasília;2;2;4;1105
2609006;Macaparana;5300108;Brasília;2;2;4;1601
2609105;Machados;5300108;Brasília;2;2;4;1586
2609303;Mirandiba;5300108;Brasília;2;2;4;1289
2609402;Moreno;5300108;Brasília;2;2;4;1598
2609709;Orobó;5300108;Brasília;2;2;4;1576
2609808;Orocó;5300108;Brasília;2;2;4;1192
2610103;Palmeirina;5300108;Brasília;2;2;4;1438
2610202;Panelas;5300108;Brasília;2;2;4;1486
2610400;Parnamirim;5300108;Brasília;2;2;4;1226
2610509;Passira;5300108;Brasília;2;2;4;1563
2610806;Pedra;5300108;Brasília;2;2;4;1414
2611002;Petrolândia;5300108;Brasília;2;2;4;1260
2611200;Poção;5300108;Brasília;2;2;4;1454
2611309;Pombos;5300108;Brasília;2;2;4;1571
2611507;Quipapá;5300108;Brasília;2;2;4;1475
2611705;Riacho das Almas;5300108;Brasília;2;2;4;1529
2611804;Ribeirão;5300108;Brasília;2;2;4;1550
2611903;Rio Formoso;5300108;Brasília;2;2;4;1561
2612000;Sairé;5300108;Brasília;2;2;4;1532
2612307;Saloá;5300108;Brasília;2;2;4;1407
2612406;Sanharó;5300108;Brasília;2;2;4;1455
2612604;Santa Maria da Boa Vista;5300108;Brasília;2;2;4;1157
2612802;Santa Terezinha;5300108;Brasília;2;2;4;1441
2613008;São Bento do Una;5300108;Brasília;2;2;4;1452
2613107;São Caitano;5300108;Brasília;2;2;4;1494
2613206;São João;5300108;Brasília;2;2;4;1442
2613305;São Joaquim do Monte;5300108;Brasília;2;2;4;1518
2613503;São José do Belmonte;5300108;Brasília;2;2;4;1301
2613800;São Vicente Ferrer;5300108;Brasília;2;2;4;1595
2614006;Serrita;5300108;Brasília;2;2;4;1260
2614204;Sirinhaém;5300108;Brasília;2;2;4;1567
2614303;Moreilândia;5300108;Brasília;2;2;4;1264
2614600;Tabira;5300108;Brasília;2;2;4;1423
2614808;Tacaratu;5300108;Brasília;2;2;4;1272
2614857;Tamandaré;5300108;Brasília;2;2;4;1559
2615003;Taquaritinga do Norte;5300108;Brasília;2;2;4;1527
2615201;Terra Nova;5300108;Brasília;2;2;4;1230
2615607;Trindade;5300108;Brasília;2;2;4;1198
2615706;Triunfo;5300108;Brasília;2;2;4;1360
2615805;Tupanatinga;5300108;Brasília;2;2;4;1363
2615904;Tuparetama;5300108;Brasília;2;2;4;1439
2616001;Venturosa;5300108;Brasília;2;2;4;1415
2616209;Vertentes;5300108;Brasília;2;2;4;1533
2616308;Vicência;5300108;Brasília;2;2;4;1606
2700102;Água Branca;5300108;Brasília;2;2;4;1280
2700201;Anadia;5300108;Brasília;2;2;4;1404
2700607;Barra de São Miguel;5300108;Brasília;2;2;4;1433
2700706;Batalha;5300108;Brasília;2;2;4;1329
2701001;Boca da Mata;5300108;Brasília;2;2;4;1414
2701209;Cacimbinhas;5300108;Brasília;2;2;4;1356
2701506;Campo Grande;5300108;Brasília;2;2;4;1344
2701605;Canapi;5300108;Brasília;2;2;4;1317
2701704;Capela;5300108;Brasília;2;2;4;1439
2702108;Colônia Leopoldina;5300108;Brasília;2;2;4;1499
2702504;Dois Riachos;5300108;Brasília;2;2;4;1347
2702603;Feira Grande;5300108;Brasília;2;2;4;1358
2702900;Girau do Ponciano;5300108;Brasília;2;2;4;1345
2703007;Ibateguara;5300108;Brasília;2;2;4;1475
2703106;Igaci;5300108;Brasília;2;2;4;1381
2703205;Igreja Nova;5300108;Brasília;2;2;4;1348
2704005;Junqueiro;5300108;Brasília;2;2;4;1376
2704104;Lagoa da Canoa;5300108;Brasília;2;2;4;1356
2704203;Limoeiro de Anadia;5300108;Brasília;2;2;4;1382
2704401;Major Isidoro;5300108;Brasília;2;2;4;1349
2704609;Maravilha;5300108;Brasília;2;2;4;1333
2704708;Marechal Deodoro;5300108;Brasília;2;2;4;1440
2704807;Maribondo;5300108;Brasília;2;2;4;1409
2705002;Mata Grande;5300108;Brasília;2;2;4;1307
2705101;Matriz de Camaragibe;5300108;Brasília;2;2;4;1504
2705606;Novo Lino;5300108;Brasília;2;2;4;1505
2705705;Olho d'Água das Flores;5300108;Brasília;2;2;4;1321
2706000;Olivença;5300108;Brasília;2;2;4;1331
2706406;Pão de Açúcar;5300108;Brasília;2;2;4;1296
2706604;Paulo Jacinto;5300108;Brasília;2;2;4;1414
2706802;Piaçabuçu;5300108;Brasília;2;2;4;1356
2707107;Piranhas;5300108;Brasília;2;2;4;1275
2707206;Poço das Trincheiras;5300108;Brasília;2;2;4;1335
2707602;Quebrangulo;5300108;Brasília;2;2;4;1408
2708303;São José da Laje;5300108;Brasília;2;2;4;1462
2708501;São Luís do Quitunde;5300108;Brasília;2;2;4;1492
2708808;São Sebastião;5300108;Brasília;2;2;4;1367
2709103;Taquarana;5300108;Brasília;2;2;4;1388
2709202;Traipu;5300108;Brasília;2;2;4;1324
2800209;Aquidabã;5300108;Brasília;2;2;4;1306
2800407;Arauá;5300108;Brasília;2;2;4;1203
2800670;Boquim;5300108;Brasília;2;2;4;1208
2801009;Campo do Brito;5300108;Brasília;2;2;4;1240
2801207;Canindé de São Francisco;5300108;Brasília;2;2;4;1266
2801306;Capela;5300108;Brasília;2;2;4;1290
2801405;Carira;5300108;Brasília;2;2;4;1239
2801504;Carmópolis;5300108;Brasília;2;2;4;1292
2803302;Japaratuba;5300108;Brasília;2;2;4;1299
2803708;Macambira;5300108;Brasília;2;2;4;1238
2804003;Maruim;5300108;Brasília;2;2;4;1278
2804102;Moita Bonita;5300108;Brasília;2;2;4;1262
2804201;Monte Alegre de Sergipe;5300108;Brasília;2;2;4;1270
2804706;Nossa Senhora de Lourdes;5300108;Brasília;2;2;4;1313
2804904;Pacatuba;5300108;Brasília;2;2;4;1333
2805505;Poço Verde;5300108;Brasília;2;2;4;1177
2805604;Porto da Folha;5300108;Brasília;2;2;4;1300
2805802;Riachão do Dantas;5300108;Brasília;2;2;4;1202
2806008;Ribeirópolis;5300108;Brasília;2;2;4;1257
2806206;Salgado;5300108;Brasília;2;2;4;1228
2806800;São Domingos;5300108;Brasília;2;2;4;1230
2807501;Tomar do Geru;5300108;Brasília;2;2;4;1177
2900108;Abaíra;5300108;Brasília;2;2;4;724
2900306;Acajutiba;5300108;Brasília;2;2;4;1148
2900355;Adustina;5300108;Brasília;2;2;4;1193
2900405;Água Fria;5300108;Brasília;2;2;4;1066
2901106;Amélia Rodrigues;5300108;Brasília;2;2;4;1045
2901155;América Dourada;5300108;Brasília;2;2;4;840
2901205;Anagé;5300108;Brasília;2;2;4;735
2901353;Andorinha;5300108;Brasília;2;2;4;1049
2901403;Angical;5300108;Brasília;2;2;4;543
2901601;Antas;5300108;Brasília;2;2;4;1179
2901908;Aporá;5300108;Brasília;2;2;4;1141
2902203;Aramari;5300108;Brasília;2;2;4;1083
2902500;Baianópolis;5300108;Brasília;2;2;4;529
2902609;Baixa Grande;5300108;Brasília;2;2;4;927
2902658;Banzaê;5300108;Brasília;2;2;4;1144
2902708;Barra;5300108;Brasília;2;2;4;730
2902807;Barra da Estiva;5300108;Brasília;2;2;4;743
2902906;Barra do Choça;5300108;Brasília;2;2;4;792
2903003;Barra do Mendes;5300108;Brasília;2;2;4;766
2903235;Barro Alto;5300108;Brasília;2;2;4;778
2903276;Barrocas;5300108;Brasília;2;2;4;1053
2903409;Belmonte;5300108;Brasília;2;2;4;961
2903508;Belo Campo;5300108;Brasília;2;2;4;718
2903607;Biritinga;5300108;Brasília;2;2;4;1074
2903706;Boa Nova;5300108;Brasília;2;2;4;839
2903805;Boa Vista do Tupim;5300108;Brasília;2;2;4;853
2904001;Boninal;5300108;Brasília;2;2;4;734
2904100;Boquira;5300108;Brasília;2;2;4;644
2904209;Botuporã;5300108;Brasília;2;2;4;635
2904704;Buerarema;5300108;Brasília;2;2;4;926
2905008;Caculé;5300108;Brasília;2;2;4;623
2905107;Caém;5300108;Brasília;2;2;4;951
2905305;Cafarnaum;5300108;Brasília;2;2;4;823
2905503;Caldeirão Grande;5300108;Brasília;2;2;4;966
2905909;Campo Alegre de Lourdes;5300108;Brasília;2;2;4;869
2906105;Canápolis;5300108;Brasília;2;2;4;499
2906204;Canarana;5300108;Brasília;2;2;4;797
2906303;Canavieiras;5300108;Brasília;2;2;4;952
2906402;Candeal;5300108;Brasília;2;2;4;1035
2906600;Candiba;5300108;Brasília;2;2;4;562
2906709;Cândido Sales;5300108;Brasília;2;2;4;715
2906824;Canudos;5300108;Brasília;2;2;4;1132
2906857;Capela do Alto Alegre;5300108;Brasília;2;2;4;973
2906873;Capim Grosso;5300108;Brasília;2;2;4;972
2907004;Cardeal da Silva;5300108;Brasília;2;2;4;1143
2907103;Carinhanha;5300108;Brasília;2;2;4;471
2907202;Casa Nova;5300108;Brasília;2;2;4;1048
2907608;Central;5300108;Brasília;2;2;4;807
2907806;Cícero Dantas;5300108;Brasília;2;2;4;1158
2907905;Cipó;5300108;Brasília;2;2;4;1126
2908002;Coaraci;5300108;Brasília;2;2;4;907
2908101;Cocos;5300108;Brasília;2;2;4;404
2908200;Conceição da Feira;5300108;Brasília;2;2;4;1017
2908309;Conceição do Almeida;5300108;Brasília;2;2;4;990
2908507;Conceição do Jacuípe;5300108;Brasília;2;2;4;1046
2908606;Conde;5300108;Brasília;2;2;4;1181
2908705;Condeúba;5300108;Brasília;2;2;4;644
2908903;Coração de Maria;5300108;Brasília;2;2;4;1052
2909109;Coribe;5300108;Brasília;2;2;4;424
2909208;Coronel João Sá;5300108;Brasília;2;2;4;1223
2909604;Crisópolis;5300108;Brasília;2;2;4;1141
2909901;Curaçá;5300108;Brasília;2;2;4;1135
2910404;Encruzilhada;5300108;Brasília;2;2;4;752
2910859;Filadélfia;5300108;Brasília;2;2;4;998
2911105;Formosa do Rio Preto;5300108;Brasília;2;2;4;604
2911303;Gentio do Ouro;5300108;Brasília;2;2;4;752
2911600;Governador Mangabeira;5300108;Brasília;2;2;4;1009
2911808;Guaratinga;5300108;Brasília;2;2;4;880
2911907;Iaçu;5300108;Brasília;2;2;4;890
2912004;Ibiassucê;5300108;Brasília;2;2;4;629
2912301;Ibicuí;5300108;Brasília;2;2;4;855
2912707;Ibirapitanga;5300108;Brasília;2;2;4;931
2912806;Ibirapuã;5300108;Brasília;2;2;4;867
2912905;Ibirataia;5300108;Brasília;2;2;4;905
2913002;Ibitiara;5300108;Brasília;2;2;4;700
2913101;Ibititá;5300108;Brasília;2;2;4;788
2913408;Igaporã;5300108;Brasília;2;2;4;599
2913507;Iguaí;5300108;Brasília;2;2;4;845
2913705;Inhambupe;5300108;Brasília;2;2;4;1110
2914109;Ipupiara;5300108;Brasília;2;2;4;719
2914307;Iramaia;5300108;Brasília;2;2;4;793
2914406;Iraquara;5300108;Brasília;2;2;4;777
2914505;Irará;5300108;Brasília;2;2;4;1058
2914653;Itabela;5300108;Brasília;2;2;4;903
2914901;Itacaré;5300108;Brasília;2;2;4;967
2915007;Itaeté;5300108;Brasília;2;2;4;801
2915106;Itagi;5300108;Brasília;2;2;4;865
2915205;Itagibá;5300108;Brasília;2;2;4;879
2915502;Itajuípe;5300108;Brasília;2;2;4;922
2915809;Itambé;5300108;Brasília;2;2;4;783
2916005;Itanhém;5300108;Brasília;2;2;4;830
2916104;Itaparica;5300108;Brasília;2;2;4;1035
2916203;Itapé;5300108;Brasília;2;2;4;915
2916500;Itapicuru;5300108;Brasília;2;2;4;1145
2916609;Itapitanga;5300108;Brasília;2;2;4;906
2916708;Itaquara;5300108;Brasília;2;2;4;890
2916807;Itarantim;5300108;Brasília;2;2;4;842
2917003;Itiúba;5300108;Brasília;2;2;4;1030
2917102;Itororó;5300108;Brasília;2;2;4;845
2917300;Ituberá;5300108;Brasília;2;2;4;964
2917334;Iuiú;5300108;Brasília;2;2;4;492
2917409;Jacaraci;5300108;Brasília;2;2;4;596
2918100;Jeremoabo;5300108;Brasília;2;2;4;1196
2918308;Jitaúna;5300108;Brasília;2;2;4;882
2918357;João Dourado;5300108;Brasília;2;2;4;827
2918506;Jussara;5300108;Brasília;2;2;4;822
2918605;Jussiape;5300108;Brasília;2;2;4;721
2918753;Lagoa Real;5300108;Brasília;2;2;4;647
2918803;Laje;5300108;Brasília;2;2;4;951
2919058;Lajedo do Tabocal;5300108;Brasília;2;2;4;860
2919157;Lapão;5300108;Brasília;2;2;4;811
2919306;Lençóis;5300108;Brasília;2;2;4;780
2919405;Licínio de Almeida;5300108;Brasília;2;2;4;592
2919603;Macajuba;5300108;Brasília;2;2;4;901
2919702;Macarani;5300108;Brasília;2;2;4;804
2919926;Madre de Deus;5300108;Brasília;2;2;4;1047
2920106;Mairi;5300108;Brasília;2;2;4;942
2920205;Malhada;5300108;Brasília;2;2;4;472
2920452;Mansidão;5300108;Brasília;2;2;4;698
2920502;Maracás;5300108;Brasília;2;2;4;842
2920601;Maragogipe;5300108;Brasília;2;2;4;1011
2921104;Medeiros Neto;5300108;Brasília;2;2;4;847
2921203;Miguel Calmon;5300108;Brasília;2;2;4;916
2921401;Mirangaba;5300108;Brasília;2;2;4;946
2921500;Monte Santo;5300108;Brasília;2;2;4;1087
2921708;Morro do Chapéu;5300108;Brasília;2;2;4;859
2921807;Mortugaba;5300108;Brasília;2;2;4;600
2921906;Mucugê;5300108;Brasília;2;2;4;763
2922102;Mundo Novo;5300108;Brasília;2;2;4;909
2922300;Muritiba;5300108;Brasília;2;2;4;1012
2922409;Mutuípe;5300108;Brasília;2;2;4;941
2922656;Nordestina;5300108;Brasília;2;2;4;1056
2922706;Nova Canaã;5300108;Brasília;2;2;4;839
2922904;Nova Soure;5300108;Brasília;2;2;4;1122
2923100;Olindina;5300108;Brasília;2;2;4;1130
2923209;Oliveira dos Brejinhos;5300108;Brasília;2;2;4;658
2923605;Paramirim;5300108;Brasília;2;2;4;658
2923704;Paratinga;5300108;Brasília;2;2;4;609
2923803;Paripiranga;5300108;Brasília;2;2;4;1206
2923902;Pau Brasil;5300108;Brasília;2;2;4;887
2924405;Pilão Arcado;5300108;Brasília;2;2;4;865
2924603;Pindobaçu;5300108;Brasília;2;2;4;977
2924801;Piritiba;5300108;Brasília;2;2;4;903
2925006;Planalto;5300108;Brasília;2;2;4;801
2925105;Poções;5300108;Brasília;2;2;4;822
2925253;Ponto Novo;5300108;Brasília;2;2;4;991
2925501;Prado;5300108;Brasília;2;2;4;945
2925600;Presidente Dutra;5300108;Brasília;2;2;4;804
2925758;Presidente Tancredo Neves;5300108;Brasília;2;2;4;943
2925808;Queimadas;5300108;Brasília;2;2;4;1031
2926103;Retirolândia;5300108;Brasília;2;2;4;1020
2926202;Riachão das Neves;5300108;Brasília;2;2;4;552
2926301;Riachão do Jacuípe;5300108;Brasília;2;2;4;1014
2926400;Riacho de Santana;5300108;Brasília;2;2;4;581
2926509;Ribeira do Amparo;5300108;Brasília;2;2;4;1136
2926707;Rio de Contas;5300108;Brasília;2;2;4;697
2926806;Rio do Antônio;5300108;Brasília;2;2;4;643
2927002;Rio Real;5300108;Brasília;2;2;4;1167
2927200;Ruy Barbosa;5300108;Brasília;2;2;4;880
2927309;Salinas da Margarida;5300108;Brasília;2;2;4;1027
2927507;Santa Bárbara;5300108;Brasília;2;2;4;1042
2927705;Santa Cruz Cabrália;5300108;Brasília;2;2;4;950
2928000;Santaluz;5300108;Brasília;2;2;4;1038
2928307;Santanópolis;5300108;Brasília;2;2;4;1050
2928406;Santa Rita de Cássia;5300108;Brasília;2;2;4;644
2928950;São Domingos;5300108;Brasília;2;2;4;1009
2929008;São Félix;5300108;Brasília;2;2;4;1012
2929107;São Felipe;5300108;Brasília;2;2;4;996
2929255;São Gabriel;5300108;Brasília;2;2;4;815
2929404;São Miguel das Matas;5300108;Brasília;2;2;4;952
2929503;São Sebastião do Passé;5300108;Brasília;2;2;4;1067
2929602;Sapeaçu;5300108;Brasília;2;2;4;991
2929701;Sátiro Dias;5300108;Brasília;2;2;4;1094
2929800;Saúde;5300108;Brasília;2;2;4;959
2930006;Sebastião Laranjeiras;5300108;Brasília;2;2;4;550
2930154;Serra do Ramalho;5300108;Brasília;2;2;4;523
2930204;Sento Sé;5300108;Brasília;2;2;4;913
2930600;Serrolândia;5300108;Brasília;2;2;4;944
2930774;Sobradinho;5300108;Brasília;2;2;4;1026
2931004;Tanhaçu;5300108;Brasília;2;2;4;741
2931053;Tanque Novo;5300108;Brasília;2;2;4;631
2931103;Tanquinho;5300108;Brasília;2;2;4;1028
2931202;Taperoá;5300108;Brasília;2;2;4;970
2931400;Teodoro Sampaio;5300108;Brasília;2;2;4;1062
2931509;Teofilândia;5300108;Brasília;2;2;4;1061
2931707;Terra Nova;5300108;Brasília;2;2;4;1059
2931806;Tremedal;5300108;Brasília;2;2;4;703
2932002;Uauá;5300108;Brasília;2;2;4;1110
2932101;Ubaíra;5300108;Brasília;2;2;4;924
2932309;Ubatã;5300108;Brasília;2;2;4;914
2932408;Uibaí;5300108;Brasília;2;2;4;789
2932507;Una;5300108;Brasília;2;2;4;946
2932606;Urandi;5300108;Brasília;2;2;4;575
2932705;Uruçuca;5300108;Brasília;2;2;4;933
2932804;Utinga;5300108;Brasília;2;2;4;837
2933000;Valente;5300108;Brasília;2;2;4;1021
2933059;Várzea da Roça;5300108;Brasília;2;2;4;948
2933158;Várzea Nova;5300108;Brasília;2;2;4;896
2933455;Wanderley;5300108;Brasília;2;2;4;592
2933505;Wenceslau Guimarães;5300108;Brasília;2;2;4;931
3100104;Abadia dos Dourados;5300108;Brasília;2;2;4;302
3100302;Abre Campo;5300108;Brasília;2;2;4;772
3101904;Alpinópolis;5300108;Brasília;2;2;4;584
3102001;Alterosa;5300108;Brasília;2;2;4;632
3102308;Alvinópolis;5300108;Brasília;2;2;4;711
3102803;Andrelândia;5300108;Brasília;2;2;4;762
3102902;Antônio Carlos;5300108;Brasília;2;2;4;760
3103900;Araújos;5300108;Brasília;2;2;4;545
3104106;Arceburgo;5300108;Brasília;2;2;4;624
3104304;Areado;5300108;Brasília;2;2;4;644
3104601;Astolfo Dutra;5300108;Brasília;2;2;4;820
3104700;Ataléia;5300108;Brasília;2;2;4;775
3104908;Baependi;5300108;Brasília;2;2;4;756
3105707;Barra Longa;5300108;Brasília;2;2;4;725
3105905;Barroso;5300108;Brasília;2;2;4;734
3106507;Berilo;5300108;Brasília;2;2;4;600
3107505;Bom Jardim de Minas;5300108;Brasília;2;2;4;792
3107604;Bom Jesus da Penha;5300108;Brasília;2;2;4;596
3108107;Bonfim;5300108;Brasília;2;2;4;640
3108206;Bonfinópolis de Minas;5300108;Brasília;2;2;4;224
3108404;Botelhos;5300108;Brasília;2;2;4;666
3108602;Brasília de Minas;5300108;Brasília;2;2;4;379
3108909;Brasópolis;5300108;Brasília;2;2;4;780
3109105;Bueno Brandão;5300108;Brasília;2;2;4;754
3109204;Buenópolis;5300108;Brasília;2;2;4;463
3109402;Buritizeiro;5300108;Brasília;2;2;4;360
3109501;Cabo Verde;5300108;Brasília;2;2;4;648
3109709;Cachoeira de Minas;5300108;Brasília;2;2;4;761
3109907;Caetanópolis;5300108;Brasília;2;2;4;541
3110707;Cambuquira;5300108;Brasília;2;2;4;728
3111309;Campo do Meio;5300108;Brasília;2;2;4;629
3111408;Campo Florido;5300108;Brasília;2;2;4;443
3111804;Canápolis;5300108;Brasília;2;2;4;351
3112000;Candeias;5300108;Brasília;2;2;4;620
3112703;Capitão Enéas;5300108;Brasília;2;2;4;452
3113008;Caraí;5300108;Brasília;2;2;4;687
3114006;Carmo da Mata;5300108;Brasília;2;2;4;621
3114402;Carmo do Rio Claro;5300108;Brasília;2;2;4;605
3114501;Carmópolis de Minas;5300108;Brasília;2;2;4;634
3114600;Carrancas;5300108;Brasília;2;2;4;723
3115359;Catas Altas;5300108;Brasília;2;2;4;680
3115706;Central de Minas;5300108;Brasília;2;2;4;786
3115805;Centralina;5300108;Brasília;2;2;4;337
3116001;Chalé;5300108;Brasília;2;2;4;822
3116159;Chapada Gaúcha;5300108;Brasília;2;2;4;253
3116704;Coimbra;5300108;Brasília;2;2;4;788
3117009;Comercinho;5300108;Brasília;2;2;4;660
3117108;Conceição da Aparecida;5300108;Brasília;2;2;4;614
3117603;Conceição do Pará;5300108;Brasília;2;2;4;546
3118205;Conquista;5300108;Brasília;2;2;4;459
3118700;Coqueiral;5300108;Brasília;2;2;4;654
3118809;Coração de Jesus;5300108;Brasília;2;2;4;394
3118908;Cordisburgo;5300108;Brasília;2;2;4;534
3119203;Coroaci;5300108;Brasília;2;2;4;684
3120201;Cristais;5300108;Brasília;2;2;4;619
3120805;Cruzília;5300108;Brasília;2;2;4;749
3121308;Descoberto;5300108;Brasília;2;2;4;826
3121803;Dionísio;5300108;Brasília;2;2;4;714
3122009;Divino;5300108;Brasília;2;2;4;822
3122405;Divisa Nova;5300108;Brasília;2;2;4;659
3122702;Dom Silvério;5300108;Brasília;2;2;4;721
3123908;Entre Rios de Minas;5300108;Brasília;2;2;4;682
3124005;Ervália;5300108;Brasília;2;2;4;798
3124302;Espinosa;5300108;Brasília;2;2;4;556
3124500;Estiva;5300108;Brasília;2;2;4;765
3124807;Estrela do Sul;5300108;Brasília;2;2;4;326
3125903;Ferros;5300108;Brasília;2;2;4;651
3126505;Francisco Badaró;5300108;Brasília;2;2;4;613
3126703;Francisco Sá;5300108;Brasília;2;2;4;480
3127008;Fronteira;5300108;Brasília;2;2;4;512
3127305;Galiléia;5300108;Brasília;2;2;4;775
3127404;Gonçalves;5300108;Brasília;2;2;4;791
3127800;Grão Mogol;5300108;Brasília;2;2;4;547
3128402;Guarani;5300108;Brasília;2;2;4;811
3128808;Guidoval;5300108;Brasília;2;2;4;813
3128907;Guimarânia;5300108;Brasília;2;2;4;357
3129004;Guiricema;5300108;Brasília;2;2;4;807
3129202;Heliodora;5300108;Brasília;2;2;4;740
3129301;Iapu;5300108;Brasília;2;2;4;736
3129707;Ibiraci;5300108;Brasília;2;2;4;522
3130606;Inconfidentes;5300108;Brasília;2;2;4;741
3130705;Indianópolis;5300108;Brasília;2;2;4;357
3131158;Ipaba;5300108;Brasília;2;2;4;717
3131208;Ipanema;5300108;Brasília;2;2;4;805
3131505;Ipuiúna;5300108;Brasília;2;2;4;721
3131802;Itabirinha de Mantena;5300108;Brasília;2;2;4;784
3132107;Itacarambi;5300108;Brasília;2;2;4;416
3132206;Itaguara;5300108;Brasília;2;2;4;629
3132503;Itamarandiba;5300108;Brasília;2;2;4;591
3132701;Itambacuri;5300108;Brasília;2;2;4;716
3133204;Itanhomi;5300108;Brasília;2;2;4;753
3133303;Itaobim;5300108;Brasília;2;2;4;688
3133402;Itapagipe;5300108;Brasília;2;2;4;480
3134004;Itinga;5300108;Brasília;2;2;4;667
3134608;Jaboticatubas;5300108;Brasília;2;2;4;610
3134707;Jacinto;5300108;Brasília;2;2;4;819
3134806;Jacuí;5300108;Brasília;2;2;4;591
3135050;Jaíba;5300108;Brasília;2;2;4;455
3135506;Jequeri;5300108;Brasília;2;2;4;768
3135803;Jequitinhonha;5300108;Brasília;2;2;4;747
3136009;Joaíma;5300108;Brasília;2;2;4;741
3136900;Juruaia;5300108;Brasília;2;2;4;620
3137007;Ladainha;5300108;Brasília;2;2;4;696
3137106;Lagamar;5300108;Brasília;2;2;4;288
3137403;Lagoa Dourada;5300108;Brasília;2;2;4;703
3137502;Lagoa Formosa;5300108;Brasília;2;2;4;367
3137700;Lajinha;5300108;Brasília;2;2;4;835
3138500;Liberdade;5300108;Brasília;2;2;4;793
3138609;Lima Duarte;5300108;Brasília;2;2;4;805
3139201;Malacacheta;5300108;Brasília;2;2;4;669
3139300;Manga;5300108;Brasília;2;2;4;440
3140506;Martinho Campos;5300108;Brasília;2;2;4;486
3140803;Matias Barbosa;5300108;Brasília;2;2;4;838
3140902;Matipó;5300108;Brasília;2;2;4;782
3141009;Mato Verde;5300108;Brasília;2;2;4;543
3141603;Mercês;5300108;Brasília;2;2;4;777
3141702;Mesquita;5300108;Brasília;2;2;4;688
3141801;Minas Novas;5300108;Brasília;2;2;4;594
3141900;Minduri;5300108;Brasília;2;2;4;742
3142007;Mirabela;5300108;Brasília;2;2;4;406
3142106;Miradouro;5300108;Brasília;2;2;4;825
3142205;Miraí;5300108;Brasília;2;2;4;830
3142304;Moeda;5300108;Brasília;2;2;4;653
3142908;Monte Azul;5300108;Brasília;2;2;4;545
3143005;Monte Belo;5300108;Brasília;2;2;4;634
3144003;Mutum;5300108;Brasília;2;2;4;830
3145000;Nova Ponte;5300108;Brasília;2;2;4;369
3145109;Nova Resende;5300108;Brasília;2;2;4;611
3145307;Novo Cruzeiro;5300108;Brasília;2;2;4;676
3145505;Olímpio Noronha;5300108;Brasília;2;2;4;750
3146305;Padre Paraíso;5300108;Brasília;2;2;4;701
3146503;Pains;5300108;Brasília;2;2;4;561
3147204;Paraguaçu;5300108;Brasília;2;2;4;678
3147709;Passa Tempo;5300108;Brasília;2;2;4;652
3148608;Peçanha;5300108;Brasília;2;2;4;654
3148707;Pedra Azul;5300108;Brasília;2;2;4;712
3149101;Pedralva;5300108;Brasília;2;2;4;761
3149200;Pedrinópolis;5300108;Brasília;2;2;4;382
3149507;Pequeri;5300108;Brasília;2;2;4;848
3149804;Perdizes;5300108;Brasília;2;2;4;398
3150604;Piracema;5300108;Brasília;2;2;4;640
3150802;Piranga;5300108;Brasília;2;2;4;737
3151107;Pirapetinga;5300108;Brasília;2;2;4;888
3151305;Piraúba;5300108;Brasília;2;2;4;806
3151602;Planura;5300108;Brasília;2;2;4;486
3151701;Poço Fundo;5300108;Brasília;2;2;4;695
3152204;Porteirinha;5300108;Brasília;2;2;4;526
3152402;Poté;5300108;Brasília;2;2;4;697
3152907;Pratápolis;5300108;Brasília;2;2;4;558
3153400;Presidente Olegário;5300108;Brasília;2;2;4;331
3154200;Resende Costa;5300108;Brasília;2;2;4;693
3154309;Resplendor;5300108;Brasília;2;2;4;823
3154457;Riachinho;5300108;Brasília;2;2;4;212
3154507;Riacho dos Machados;5300108;Brasília;2;2;4;523
3155405;Rio Novo;5300108;Brasília;2;2;4;815
3155504;Rio Paranaíba;5300108;Brasília;2;2;4;416
3155603;Rio Pardo de Minas;5300108;Brasília;2;2;4;577
3155702;Rio Piracicaba;5300108;Brasília;2;2;4;685
3155900;Rio Preto;5300108;Brasília;2;2;4;820
3156304;Rodeiro;5300108;Brasília;2;2;4;812
3156403;Romaria;5300108;Brasília;2;2;4;342
3156601;Rubim;5300108;Brasília;2;2;4;794
3156809;Sabinópolis;5300108;Brasília;2;2;4;611
3157104;Salto da Divisa;5300108;Brasília;2;2;4;854
3157708;Santa Juliana;5300108;Brasília;2;2;4;390
3157906;Santa Margarida;5300108;Brasília;2;2;4;797
3158201;Santa Maria do Suaçuí;5300108;Brasília;2;2;4;649
3158300;Santana da Vargem;5300108;Brasília;2;2;4;657
3158805;Santana do Jacaré;5300108;Brasília;2;2;4;640
3159209;Santa Rita de Caldas;5300108;Brasília;2;2;4;710
3159902;Santo Antônio do Amparo;5300108;Brasília;2;2;4;656
3160306;Santo Antônio do Jacinto;5300108;Brasília;2;2;4;836
3161007;São Domingos do Prata;5300108;Brasília;2;2;4;700
3161700;São Gonçalo do Abaeté;5300108;Brasília;2;2;4;359
3161908;São Gonçalo do Rio Abaixo;5300108;Brasília;2;2;4;665
3162401;São João da Ponte;5300108;Brasília;2;2;4;419
3162609;São João do Oriente;5300108;Brasília;2;2;4;734
3162708;São João do Paraíso;5300108;Brasília;2;2;4;634
3162807;São João Evangelista;5300108;Brasília;2;2;4;630
3162948;São José da Barra;5300108;Brasília;2;2;4;571
3163904;São Pedro da União;5300108;Brasília;2;2;4;606
3164001;São Pedro dos Ferros;5300108;Brasília;2;2;4;759
3164209;São Romão;5300108;Brasília;2;2;4;308
3164407;São Sebastião da Bela Vista;5300108;Brasília;2;2;4;742
3165008;São Tiago;5300108;Brasília;2;2;4;676
3165107;São Tomás de Aquino;5300108;Brasília;2;2;4;558
3165305;São Vicente de Minas;5300108;Brasília;2;2;4;753
3165404;Sapucaí-Mirim;5300108;Brasília;2;2;4;804
3165701;Senador Firmino;5300108;Brasília;2;2;4;771
3166808;Serra do Salitre;5300108;Brasília;2;2;4;389
3167103;Serro;5300108;Brasília;2;2;4;580
3167400;Silvianópolis;5300108;Brasília;2;2;4;725
3167608;Simonésia;5300108;Brasília;2;2;4;798
3168408;Tarumirim;5300108;Brasília;2;2;4;746
3168507;Teixeiras;5300108;Brasília;2;2;4;768
3169000;Tocantins;5300108;Brasília;2;2;4;798
3169703;Turmalina;5300108;Brasília;2;2;4;582
3170008;Ubaí;5300108;Brasília;2;2;4;342
3170909;Varzelândia;5300108;Brasília;2;2;4;418
3171006;Vazante;5300108;Brasília;2;2;4;263
3171709;Virgínia;5300108;Brasília;2;2;4;785
3171808;Virginópolis;5300108;Brasília;2;2;4;655
3171907;Virgolândia;5300108;Brasília;2;2;4;674
3200300;Alfredo Chaves;5300108;Brasília;2;2;4;944
3201001;Boa Esperança;5300108;Brasília;2;2;4;877
3201159;Brejetuba;5300108;Brasília;2;2;4;865
3201704;Conceição do Castelo;5300108;Brasília;2;2;4;883
3202108;Ecoporanga;5300108;Brasília;2;2;4;814
3202454;Ibatiba;5300108;Brasília;2;2;4;851
3202504;Ibiraçu;5300108;Brasília;2;2;4;931
3202900;Itarana;5300108;Brasília;2;2;4;886
3203056;Jaguaré;5300108;Brasília;2;2;4;914
3203353;Marilândia;5300108;Brasília;2;2;4;893
3204005;Pancas;5300108;Brasília;2;2;4;853
3204054;Pedro Canário;5300108;Brasília;2;2;4;873
3204203;Piúma;5300108;Brasília;2;2;4;958
3204302;Presidente Kennedy;5300108;Brasília;2;2;4;950
3204351;Rio Bananal;5300108;Brasília;2;2;4;906
3204401;Rio Novo do Sul;5300108;Brasília;2;2;4;943
3204500;Santa Leopoldina;5300108;Brasília;2;2;4;932
3204955;São Roque do Canaã;5300108;Brasília;2;2;4;899
3205010;Sooretama;5300108;Brasília;2;2;4;925
3205036;Vargem Alta;5300108;Brasília;2;2;4;924
3205176;Vila Valério;5300108;Brasília;2;2;4;887
3300225;Areal;5300108;Brasília;2;2;4;882
3300258;Arraial do Cabo;5300108;Brasília;2;2;4;1021
3300902;Cambuci;5300108;Brasília;2;2;4;910
3300936;Carapebus;5300108;Brasília;2;2;4;982
3300951;Comendador Levy Gasparian;5300108;Brasília;2;2;4;858
3301207;Carmo;5300108;Brasília;2;2;4;892
3301405;Conceição de Macabu;5300108;Brasília;2;2;4;959
3301504;Cordeiro;5300108;Brasília;2;2;4;918
3301801;Engenheiro Paulo de Frontin;5300108;Brasília;2;2;4;878
3301876;Iguaba Grande;5300108;Brasília;2;2;4;992
3302056;Italva;5300108;Brasília;2;2;4;920
3302452;Macuco;5300108;Brasília;2;2;4;922
3303955;Pinheiral;5300108;Brasília;2;2;4;857
3304128;Quatis;5300108;Brasília;2;2;4;833
3304151;Quissamã;5300108;Brasília;2;2;4;990
3304607;Santa Maria Madalena;5300108;Brasília;2;2;4;937
3305133;São José de Ubá;5300108;Brasília;2;2;4;895
3305158;São José do Vale do Rio Preto;5300108;Brasília;2;2;4;889
3305406;Sapucaia;5300108;Brasília;2;2;4;876
3305604;Silva Jardim;5300108;Brasília;2;2;4;969
3305703;Sumidouro;5300108;Brasília;2;2;4;897
3305752;Tanguá;5300108;Brasília;2;2;4;953
3306156;Varre-Sai;5300108;Brasília;2;2;4;868
3500402;Águas da Prata;5300108;Brasília;2;2;4;691
3500550;Águas de Santa Bárbara;5300108;Brasília;2;2;4;796
3500808;Alfredo Marcondes;5300108;Brasília;2;2;4;779
3501103;Alto Alegre;5300108;Brasília;2;2;4;684
3501202;Álvares Florence;5300108;Brasília;2;2;4;544
3501400;Álvaro de Carvalho;5300108;Brasília;2;2;4;722
3501509;Alvinlândia;5300108;Brasília;2;2;4;761
3502309;Anhembi;5300108;Brasília;2;2;4;774
3502408;Anhumas;5300108;Brasília;2;2;4;811
3502705;Apiaí;5300108;Brasília;2;2;4;968
3502754;Araçariguama;5300108;Brasília;2;2;4;850
3502903;Araçoiaba da Serra;5300108;Brasília;2;2;4;853
3503406;Arealva;5300108;Brasília;2;2;4;697
3503604;Areiópolis;5300108;Brasília;2;2;4;764
3503703;Ariranha;5300108;Brasília;2;2;4;603
3504305;Avaí;5300108;Brasília;2;2;4;718
3504404;Avanhandava;5300108;Brasília;2;2;4;663
3504602;Bady Bassitt;5300108;Brasília;2;2;4;589
3504800;Bálsamo;5300108;Brasília;2;2;4;574
3504909;Bananal;5300108;Brasília;2;2;4;857
3506409;Bilac;5300108;Brasília;2;2;4;680
3506805;Bocaina;5300108;Brasília;2;2;4;703
3507407;Borborema;5300108;Brasília;2;2;4;655
3508306;Cabrália Paulista;5300108;Brasília;2;2;4;752
3508702;Caconde;5300108;Brasília;2;2;4;648
3509452;Campina do Monte Alegre;5300108;Brasília;2;2;4;864
3509809;Campos Novos Paulista;5300108;Brasília;2;2;4;786
3510104;Cândido Rodrigues;5300108;Brasília;2;2;4;615
3510302;Capela do Alto;5300108;Brasília;2;2;4;848
3511300;Cedral;5300108;Brasília;2;2;4;582
3511607;Cesário Lange;5300108;Brasília;2;2;4;821
3512506;Coroados;5300108;Brasília;2;2;4;665
3512704;Corumbataí;5300108;Brasília;2;2;4;710
3513306;Cruzália;5300108;Brasília;2;2;4;828
3513603;Cunha;5300108;Brasília;2;2;4;867
3514601;Dumont;5300108;Brasília;2;2;4;601
3514700;Echaporã;5300108;Brasília;2;2;4;774
3515152;Engenheiro Coelho;5300108;Brasília;2;2;4;743
3515350;Euclides da Cunha Paulista;5300108;Brasília;2;2;4;905
3515608;Fernando Prestes;5300108;Brasília;2;2;4;609
3516903;General Salgado;5300108;Brasília;2;2;4;597
3517109;Glicério;5300108;Brasília;2;2;4;665
3517604;Guapiara;5300108;Brasília;2;2;4;930
3517802;Guaraçaí;5300108;Brasília;2;2;4;679
3518107;Guarantã;5300108;Brasília;2;2;4;698
3518503;Guareí;5300108;Brasília;2;2;4;838
3519006;Herculândia;5300108;Brasília;2;2;4;736
3519253;Iaras;5300108;Brasília;2;2;4;793
3519402;Ibirá;5300108;Brasília;2;2;4;601
3519501;Ibirarema;5300108;Brasília;2;2;4;811
3519808;Icém;5300108;Brasília;2;2;4;520
3519907;Iepê;5300108;Brasília;2;2;4;833
3520004;Igaraçu do Tietê;5300108;Brasília;2;2;4;745
3520202;Igaratá;5300108;Brasília;2;2;4;841
3520707;Indiaporã;5300108;Brasília;2;2;4;528
3520806;Inúbia Paulista;5300108;Brasília;2;2;4;738
3520905;Ipaussu;5300108;Brasília;2;2;4;824
3521002;Iperó;5300108;Brasília;2;2;4;835
3521101;Ipeúna;5300108;Brasília;2;2;4;734
3521507;Irapuã;5300108;Brasília;2;2;4;627
3521705;Itaberá;5300108;Brasília;2;2;4;901
3522000;Itaju;5300108;Brasília;2;2;4;690
3522802;Itaporanga;5300108;Brasília;2;2;4;891
3522901;Itapuí;5300108;Brasília;2;2;4;716
3523503;Itatinga;5300108;Brasília;2;2;4;811
3523602;Itirapina;5300108;Brasília;2;2;4;713
3523701;Itirapuã;5300108;Brasília;2;2;4;540
3524501;Jaci;5300108;Brasília;2;2;4;589
3524907;Jambeiro;5300108;Brasília;2;2;4;860
3525409;Jeriquara;5300108;Brasília;2;2;4;500
3525607;João Ramalho;5300108;Brasília;2;2;4;778
3525805;Júlio Mesquita;5300108;Brasília;2;2;4;716
3525854;Jumirim;5300108;Brasília;2;2;4;806
3526100;Juquiá;5300108;Brasília;2;2;4;941
3526308;Lagoinha;5300108;Brasília;2;2;4;860
3527504;Lucianópolis;5300108;Brasília;2;2;4;753
3527603;Luís Antônio;5300108;Brasília;2;2;4;636
3527801;Lupércio;5300108;Brasília;2;2;4;760
3528106;Macaubal;5300108;Brasília;2;2;4;596
3528601;Manduri;5300108;Brasília;2;2;4;811
3528700;Marabá Paulista;5300108;Brasília;2;2;4;825
3528858;Marapoama;5300108;Brasília;2;2;4;617
3528908;Mariápolis;5300108;Brasília;2;2;4;752
3529807;Mineiros do Tietê;5300108;Brasília;2;2;4;733
3529906;Miracatu;5300108;Brasília;2;2;4;939
3530201;Mirante do Paranapanema;5300108;Brasília;2;2;4;839
3531704;Monteiro Lobato;5300108;Brasília;2;2;4;823
3532504;Neves Paulista;5300108;Brasília;2;2;4;587
3532702;Nipoã;5300108;Brasília;2;2;4;600
3532801;Nova Aliança;5300108;Brasília;2;2;4;601
3532900;Nova Europa;5300108;Brasília;2;2;4;664
3533106;Nova Guataporanga;5300108;Brasília;2;2;4;734
3533700;Ocauçu;5300108;Brasília;2;2;4;766
3534005;Onda Verde;5300108;Brasília;2;2;4;551
3534104;Oriente;5300108;Brasília;2;2;4;741
3535002;Palestina;5300108;Brasília;2;2;4;534
3535200;Palmeira d'Oeste;5300108;Brasília;2;2;4;596
3535606;Paraibuna;5300108;Brasília;2;2;4;875
3535705;Paraíso;5300108;Brasília;2;2;4;584
3536000;Parapuã;5300108;Brasília;2;2;4;731
3536208;Pariquera-Açu;5300108;Brasília;2;2;4;986
3536604;Paulo de Faria;5300108;Brasília;2;2;4;493
3537156;Pedrinhas Paulista;5300108;Brasília;2;2;4;837
3537206;Pedro de Toledo;5300108;Brasília;2;2;4;940
3537503;Pereiras;5300108;Brasília;2;2;4;804
3537701;Piacatu;5300108;Brasília;2;2;4;703
3538204;Pinhalzinho;5300108;Brasília;2;2;4;785
3538303;Piquerobi;5300108;Brasília;2;2;4;788
3539103;Pirapora do Bom Jesus;5300108;Brasília;2;2;4;846
3539608;Planalto;5300108;Brasília;2;2;4;618
3539707;Platina;5300108;Brasília;2;2;4;796
3539905;Poloni;5300108;Brasília;2;2;4;588
3540101;Pongaí;5300108;Brasília;2;2;4;675
3541703;Quatá;5300108;Brasília;2;2;4;774
3542008;Quintana;5300108;Brasília;2;2;4;740
3542305;Redenção da Serra;5300108;Brasília;2;2;4;866
3542503;Reginópolis;5300108;Brasília;2;2;4;688
3543006;Ribeirão Branco;5300108;Brasília;2;2;4;936
3543105;Ribeirão Corrente;5300108;Brasília;2;2;4;516
3543709;Rincão;5300108;Brasília;2;2;4;640
3544103;Rio Grande da Serra;5300108;Brasília;2;2;4;893
3544301;Roseira;5300108;Brasília;2;2;4;835
3544400;Rubiácea;5300108;Brasília;2;2;4;680
3544608;Sabino;5300108;Brasília;2;2;4;651
3544707;Sagres;5300108;Brasília;2;2;4;749
3545100;Salmourão;5300108;Brasília;2;2;4;719
3545159;Saltinho;5300108;Brasília;2;2;4;780
3545308;Salto de Pirapora;5300108;Brasília;2;2;4;869
3545407;Salto Grande;5300108;Brasília;2;2;4;816
3546009;Santa Branca;5300108;Brasília;2;2;4;869
3546108;Santa Clara d'Oeste;5300108;Brasília;2;2;4;576
3546504;Santa Ernestina;5300108;Brasília;2;2;4;628
3548203;Santo Antônio do Pinhal;5300108;Brasília;2;2;4;815
3548609;São Bento do Sapucaí;5300108;Brasília;2;2;4;798
3549300;São João do Pau d'Alho;5300108;Brasília;2;2;4;729
3549508;São José da Bela Vista;5300108;Brasília;2;2;4;530
3549607;São José do Barreiro;5300108;Brasília;2;2;4;840
3549953;São Lourenço da Serra;5300108;Brasília;2;2;4;897
3550001;São Luís do Paraitinga;5300108;Brasília;2;2;4;869
3551108;Sarapuí;5300108;Brasília;2;2;4;867
3551207;Sarutaiá;5300108;Brasília;2;2;4;844
3551306;Sebastianópolis do Sul;5300108;Brasília;2;2;4;578
3551405;Serra Azul;5300108;Brasília;2;2;4;610
3551801;Sete Barras;5300108;Brasília;2;2;4;950
3551900;Severínia;5300108;Brasília;2;2;4;562
3552304;Sud Mennucci;5300108;Brasília;2;2;4;631
3552700;Tabatinga;5300108;Brasília;2;2;4;659
3553203;Taiúva;5300108;Brasília;2;2;4;591
3553955;Tarumã;5300108;Brasília;2;2;4;821
3554300;Teodoro Sampaio;5300108;Brasília;2;2;4;879
3554607;Timburi;5300108;Brasília;2;2;4;839
3554706;Torrinha;5300108;Brasília;2;2;4;733
3554904;Três Fronteiras;5300108;Brasília;2;2;4;586
3555505;Ubirajara;5300108;Brasília;2;2;4;767
3555802;Urânia;5300108;Brasília;2;2;4;574
3556107;Valentim Gentil;5300108;Brasília;2;2;4;562
3556354;Vargem;5300108;Brasília;2;2;4;801
3556602;Vera Cruz;5300108;Brasília;2;2;4;739
3557303;Estiva Gerbi;5300108;Brasília;2;2;4;720
4100103;Abatiá;5300108;Brasília;2;2;4;870
4100608;Alto Paraná;5300108;Brasília;2;2;4;942
4100707;Alto Piquiri;5300108;Brasília;2;2;4;1093
4100806;Alvorada do Sul;5300108;Brasília;2;2;4;852
4101002;Ampére;5300108;Brasília;2;2;4;1276
4101101;Andirá;5300108;Brasília;2;2;4;840
4101705;Araruna;5300108;Brasília;2;2;4;1030
4102307;Balsa Nova;5300108;Brasília;2;2;4;1098
4102505;Barbosa Ferraz;5300108;Brasília;2;2;4;1015
4102802;Bela Vista do Paraíso;5300108;Brasília;2;2;4;872
4102901;Bituruna;5300108;Brasília;2;2;4;1214
4103008;Boa Esperança;5300108;Brasília;2;2;4;1076
4103107;Bocaiúva do Sul;5300108;Brasília;2;2;4;1049
4103305;Borrazópolis;5300108;Brasília;2;2;4;986
4103909;Campina da Lagoa;5300108;Brasília;2;2;4;1110
4104253;Campo Magro;5300108;Brasília;2;2;4;1072
4104402;Cândido de Abreu;5300108;Brasília;2;2;4;1039
4104428;Candói;5300108;Brasília;2;2;4;1187
4104451;Cantagalo;5300108;Brasília;2;2;4;1156
4104600;Capitão Leônidas Marques;5300108;Brasília;2;2;4;1241
4104659;Carambeí;5300108;Brasília;2;2;4;1036
4104709;Carlópolis;5300108;Brasília;2;2;4;866
4105003;Catanduvas;5300108;Brasília;2;2;4;1189
4105102;Centenário do Sul;5300108;Brasília;2;2;4;874
4105201;Cerro Azul;5300108;Brasília;2;2;4;1009
4105300;Céu Azul;5300108;Brasília;2;2;4;1223
4105706;Clevelândia;5300108;Brasília;2;2;4;1275
4106209;Contenda;5300108;Brasília;2;2;4;1107
4106506;Coronel Vivida;5300108;Brasília;2;2;4;1238
4106803;Cruz Machado;5300108;Brasília;2;2;4;1192
4107009;Curiúva;5300108;Brasília;2;2;4;952
4107504;Engenheiro Beltrão;5300108;Brasília;2;2;4;1004
4107538;Entre Rios do Oeste;5300108;Brasília;2;2;4;1205
4107603;Faxinal;5300108;Brasília;2;2;4;981
4108007;Florestópolis;5300108;Brasília;2;2;4;868
4108205;Formosa do Oeste;5300108;Brasília;2;2;4;1110
4108502;General Carneiro;5300108;Brasília;2;2;4;1234
4108700;Grandes Rios;5300108;Brasília;2;2;4;1003
4109302;Guaraniaçu;5300108;Brasília;2;2;4;1166
4109906;Icaraíma;5300108;Brasília;2;2;4;1052
4110003;Iguaraçu;5300108;Brasília;2;2;4;923
4110078;Imbaú;5300108;Brasília;2;2;4;1006
4110201;Inácio Martins;5300108;Brasília;2;2;4;1135
4110508;Ipiranga;5300108;Brasília;2;2;4;1061
4110805;Iretama;5300108;Brasília;2;2;4;1059
4110953;Itaipulândia;5300108;Brasília;2;2;4;1249
4111100;Itambé;5300108;Brasília;2;2;4;977
4111407;Ivaí;5300108;Brasília;2;2;4;1069
4111902;Jaguapitã;5300108;Brasília;2;2;4;900
4112207;Janiópolis;5300108;Brasília;2;2;4;1065
4112405;Japurá;5300108;Brasília;2;2;4;988
4112504;Jardim Alegre;5300108;Brasília;2;2;4;1015
4112702;Jataizinho;5300108;Brasília;2;2;4;889
4112751;Jesuítas;5300108;Brasília;2;2;4;1123
4112801;Joaquim Távora;5300108;Brasília;2;2;4;878
4112959;Juranda;5300108;Brasília;2;2;4;1096
4113601;Lobato;5300108;Brasília;2;2;4;910
4113809;Lupionópolis;5300108;Brasília;2;2;4;870
4113908;Mallet;5300108;Brasília;2;2;4;1160
4114104;Mandaguaçu;5300108;Brasília;2;2;4;952
4114302;Mandirituba;5300108;Brasília;2;2;4;1115
4114401;Mangueirinha;5300108;Brasília;2;2;4;1216
4114500;Manoel Ribas;5300108;Brasília;2;2;4;1048
4114906;Marilândia do Sul;5300108;Brasília;2;2;4;954
4115101;Mariluz;5300108;Brasília;2;2;4;1073
4115309;Mariópolis;5300108;Brasília;2;2;4;1275
4115358;Maripá;5300108;Brasília;2;2;4;1153
4115408;Marmeleiro;5300108;Brasília;2;2;4;1276
4115606;Matelândia;5300108;Brasília;2;2;4;1241
4116059;Missal;5300108;Brasília;2;2;4;1241
4116109;Moreira Sales;5300108;Brasília;2;2;4;1070
4116703;Nova Aurora;5300108;Brasília;2;2;4;1129
4116802;Nova Cantu;5300108;Brasília;2;2;4;1106
4117057;Nova Laranjeiras;5300108;Brasília;2;2;4;1168
4117222;Nova Santa Rosa;5300108;Brasília;2;2;4;1165
4117255;Nova Prata do Iguaçu;5300108;Brasília;2;2;4;1241
4117305;Ortigueira;5300108;Brasília;2;2;4;987
4117800;Palmital;5300108;Brasília;2;2;4;1110
4118105;Paranacity;5300108;Brasília;2;2;4;914
4118808;Peabiru;5300108;Brasília;2;2;4;1020
4118907;Pérola;5300108;Brasília;2;2;4;1087
4119103;Piên;5300108;Brasília;2;2;4;1151
4119301;Pinhão;5300108;Brasília;2;2;4;1170
4119509;Piraquara;5300108;Brasília;2;2;4;1074
4119806;Planalto;5300108;Brasília;2;2;4;1272
4120200;Porto Rico;5300108;Brasília;2;2;4;967
4120507;Primeiro de Maio;5300108;Brasília;2;2;4;851
4120853;Quatro Pontes;5300108;Brasília;2;2;4;1177
4120903;Quedas do Iguaçu;5300108;Brasília;2;2;4;1200
4121000;Querência do Norte;5300108;Brasília;2;2;4;1009
4121208;Quitandinha;5300108;Brasília;2;2;4;1128
4121505;Rebouças;5300108;Brasília;2;2;4;1128
4121703;Reserva;5300108;Brasília;2;2;4;1030
4121752;Reserva do Iguaçu;5300108;Brasília;2;2;4;1199
4121901;Ribeirão do Pinhal;5300108;Brasília;2;2;4;882
4122008;Rio Azul;5300108;Brasília;2;2;4;1143
4122156;Rio Bonito do Iguaçu;5300108;Brasília;2;2;4;1186
4122172;Rio Branco do Ivaí;5300108;Brasília;2;2;4;1013
4122503;Roncador;5300108;Brasília;2;2;4;1085
4122602;Rondon;5300108;Brasília;2;2;4;994
4123006;Salto do Lontra;5300108;Brasília;2;2;4;1254
4123204;Santa Cecília do Pavão;5300108;Brasília;2;2;4;909
4123303;Santa Cruz de Monte Castelo;5300108;Brasília;2;2;4;985
4123402;Santa Fé;5300108;Brasília;2;2;4;906
4123709;Santa Isabel do Ivaí;5300108;Brasília;2;2;4;985
4123808;Santa Izabel do Oeste;5300108;Brasília;2;2;4;1267
4123857;Santa Maria do Oeste;5300108;Brasília;2;2;4;1100
4123907;Santa Mariana;5300108;Brasília;2;2;4;861
4124020;Santa Tereza do Oeste;5300108;Brasília;2;2;4;1201
4124053;Santa Terezinha de Itaipu;5300108;Brasília;2;2;4;1286
4124400;Santo Antônio do Sudoeste;5300108;Brasília;2;2;4;1304
4124509;Santo Inácio;5300108;Brasília;2;2;4;872
4124707;São Jerônimo da Serra;5300108;Brasília;2;2;4;929
4124806;São João;5300108;Brasília;2;2;4;1229
4125001;São João do Ivaí;5300108;Brasília;2;2;4;1000
4125100;São João do Triunfo;5300108;Brasília;2;2;4;1124
4125209;São Jorge d'Oeste;5300108;Brasília;2;2;4;1226
4125308;São Jorge do Ivaí;5300108;Brasília;2;2;4;971
4125357;São Jorge do Patrocínio;5300108;Brasília;2;2;4;1097
4125753;São Pedro do Iguaçu;5300108;Brasília;2;2;4;1203
4125803;São Pedro do Ivaí;5300108;Brasília;2;2;4;991
4126306;Sengés;5300108;Brasília;2;2;4;935
4126405;Sertaneja;5300108;Brasília;2;2;4;861
4126504;Sertanópolis;5300108;Brasília;2;2;4;872
4126678;Tamarana;5300108;Brasília;2;2;4;943
4126801;Tapejara;5300108;Brasília;2;2;4;1031
4127007;Teixeira Soares;5300108;Brasília;2;2;4;1095
4127205;Terra Boa;5300108;Brasília;2;2;4;1011
4127304;Terra Rica;5300108;Brasília;2;2;4;920
4127403;Terra Roxa;5300108;Brasília;2;2;4;1146
4127502;Tibagi;5300108;Brasília;2;2;4;1001
4127601;Tijucas do Sul;5300108;Brasília;2;2;4;1129
4127809;Tomazina;5300108;Brasília;2;2;4;910
4127858;Três Barras do Paraná;5300108;Brasília;2;2;4;1211
4127908;Tuneiras do Oeste;5300108;Brasília;2;2;4;1045
4127957;Tupãssi;5300108;Brasília;2;2;4;1150
4127965;Turvo;5300108;Brasília;2;2;4;1097
4128401;Uraí;5300108;Brasília;2;2;4;876
4128559;Vera Cruz do Oeste;5300108;Brasília;2;2;4;1216
4128609;Verê;5300108;Brasília;2;2;4;1243
4200051;Abdon Batista;5300108;Brasília;2;2;4;1351
4200200;Agrolândia;5300108;Brasília;2;2;4;1302
4200309;Agronômica;5300108;Brasília;2;2;4;1285
4200408;Água Doce;5300108;Brasília;2;2;4;1303
4200606;Águas Mornas;5300108;Brasília;2;2;4;1320
4200705;Alfredo Wagner;5300108;Brasília;2;2;4;1326
4200804;Anchieta;5300108;Brasília;2;2;4;1330
4200903;Angelina;5300108;Brasília;2;2;4;1307
4201000;Anita Garibaldi;5300108;Brasília;2;2;4;1363
4201109;Anitápolis;5300108;Brasília;2;2;4;1346
4201257;Apiúna;5300108;Brasília;2;2;4;1254
4201307;Araquari;5300108;Brasília;2;2;4;1174
4201505;Armazém;5300108;Brasília;2;2;4;1384
4201604;Arroio Trinta;5300108;Brasília;2;2;4;1288
4201703;Ascurra;5300108;Brasília;2;2;4;1245
4201802;Atalanta;5300108;Brasília;2;2;4;1302
4201901;Aurora;5300108;Brasília;2;2;4;1288
4202057;Balneário Barra do Sul;5300108;Brasília;2;2;4;1183
4202073;Balneário Gaivota;5300108;Brasília;2;2;4;1489
4202503;Bom Jardim da Serra;5300108;Brasília;2;2;4;1400
4202602;Bom Retiro;5300108;Brasília;2;2;4;1339
4202701;Botuverá;5300108;Brasília;2;2;4;1267
4203105;Caibi;5300108;Brasília;2;2;4;1381
4203303;Campo Alegre;5300108;Brasília;2;2;4;1159
4203402;Campo Belo do Sul;5300108;Brasília;2;2;4;1375
4203501;Campo Erê;5300108;Brasília;2;2;4;1303
4203709;Canelinha;5300108;Brasília;2;2;4;1272
4204103;Caxambu do Sul;5300108;Brasília;2;2;4;1372
4204152;Celso Ramos;5300108;Brasília;2;2;4;1363
4204400;Coronel Freitas;5300108;Brasília;2;2;4;1338
4204558;Correia Pinto;5300108;Brasília;2;2;4;1332
4204707;Cunha Porã;5300108;Brasília;2;2;4;1358
4204905;Descanso;5300108;Brasília;2;2;4;1367
4205100;Dona Emma;5300108;Brasília;2;2;4;1253
4205159;Doutor Pedrinho;5300108;Brasília;2;2;4;1220
4205209;Erval Velho;5300108;Brasília;2;2;4;1328
4205308;Faxinal dos Guedes;5300108;Brasília;2;2;4;1314
4205605;Galvão;5300108;Brasília;2;2;4;1291
4206009;Governador Celso Ramos;5300108;Brasília;2;2;4;1276
4206108;Grão Pará;5300108;Brasília;2;2;4;1378
4206207;Gravatal;5300108;Brasília;2;2;4;1392
4206306;Guabiruba;5300108;Brasília;2;2;4;1254
4206603;Guarujá do Sul;5300108;Brasília;2;2;4;1325
4206801;Ibicaré;5300108;Brasília;2;2;4;1306
4207106;Ilhota;5300108;Brasília;2;2;4;1232
4207205;Imaruí;5300108;Brasília;2;2;4;1389
4207403;Imbuia;5300108;Brasília;2;2;4;1304
4207601;Ipira;5300108;Brasília;2;2;4;1351
4207650;Iporã do Oeste;5300108;Brasília;2;2;4;1385
4207684;Ipuaçu;5300108;Brasília;2;2;4;1299
4207700;Ipumirim;5300108;Brasília;2;2;4;1332
4207759;Iraceminha;5300108;Brasília;2;2;4;1357
4207809;Irani;5300108;Brasília;2;2;4;1318
4207908;Irineópolis;5300108;Brasília;2;2;4;1198
4208005;Itá;5300108;Brasília;2;2;4;1362
4208609;Jaborá;5300108;Brasília;2;2;4;1328
4208708;Jacinto Machado;5300108;Brasília;2;2;4;1475
4209151;José Boiteux;5300108;Brasília;2;2;4;1249
4209201;Lacerdópolis;5300108;Brasília;2;2;4;1331
4209508;Laurentino;5300108;Brasília;2;2;4;1279
4209607;Lauro Muller;5300108;Brasília;2;2;4;1403
4209706;Lebon Régis;5300108;Brasília;2;2;4;1269
4209805;Leoberto Leal;5300108;Brasília;2;2;4;1304
4209854;Lindóia do Sul;5300108;Brasília;2;2;4;1327
4209904;Lontras;5300108;Brasília;2;2;4;1270
4210001;Luiz Alves;5300108;Brasília;2;2;4;1213
4210035;Luzerna;5300108;Brasília;2;2;4;1314
4210209;Major Gercino;5300108;Brasília;2;2;4;1290
4210308;Major Vieira;5300108;Brasília;2;2;4;1199
4210407;Maracajá;5300108;Brasília;2;2;4;1454
4210555;Marema;5300108;Brasília;2;2;4;1324
4210605;Massaranduba;5300108;Brasília;2;2;4;1202
4210704;Matos Costa;5300108;Brasília;2;2;4;1233
4210803;Meleiro;5300108;Brasília;2;2;4;1454
4210902;Modelo;5300108;Brasília;2;2;4;1341
4211009;Mondaí;5300108;Brasília;2;2;4;1392
4211058;Monte Carlo;5300108;Brasília;2;2;4;1308
4211108;Monte Castelo;5300108;Brasília;2;2;4;1207
4211405;Nova Erechim;5300108;Brasília;2;2;4;1347
4211454;Nova Itaberaba;5300108;Brasília;2;2;4;1346
4211504;Nova Trento;5300108;Brasília;2;2;4;1276
4211801;Ouro;5300108;Brasília;2;2;4;1339
4212007;Palma Sola;5300108;Brasília;2;2;4;1308
4212205;Papanduva;5300108;Brasília;2;2;4;1195
4212239;Paraíso;5300108;Brasília;2;2;4;1355
4212254;Passo de Torres;5300108;Brasília;2;2;4;1503
4212270;Passos Maia;5300108;Brasília;2;2;4;1298
4212304;Paulo Lopes;5300108;Brasília;2;2;4;1348
4212403;Pedras Grandes;5300108;Brasília;2;2;4;1405
4212601;Peritiba;5300108;Brasília;2;2;4;1354
4212700;Petrolândia;5300108;Brasília;2;2;4;1313
4212809;Piçarras;5300108;Brasília;2;2;4;1215
4213005;Pinheiro Preto;5300108;Brasília;2;2;4;1298
4213104;Piratuba;5300108;Brasília;2;2;4;1355
4213302;Ponte Alta;5300108;Brasília;2;2;4;1321
4213351;Ponte Alta do Norte;5300108;Brasília;2;2;4;1288
4213401;Ponte Serrada;5300108;Brasília;2;2;4;1306
4213708;Pouso Redondo;5300108;Brasília;2;2;4;1287
4213906;Presidente Castelo Branco;5300108;Brasília;2;2;4;1335
4214003;Presidente Getúlio;5300108;Brasília;2;2;4;1259
4214102;Presidente Nereu;5300108;Brasília;2;2;4;1280
4214201;Quilombo;5300108;Brasília;2;2;4;1320
4214300;Rancho Queimado;5300108;Brasília;2;2;4;1319
4214409;Rio das Antas;5300108;Brasília;2;2;4;1276
4214508;Rio do Campo;5300108;Brasília;2;2;4;1258
4214607;Rio do Oeste;5300108;Brasília;2;2;4;1277
4214904;Rio Fortuna;5300108;Brasília;2;2;4;1371
4215075;Riqueza;5300108;Brasília;2;2;4;1384
4215109;Rodeio;5300108;Brasília;2;2;4;1241
4215208;Romelândia;5300108;Brasília;2;2;4;1344
4215307;Salete;5300108;Brasília;2;2;4;1258
4215406;Salto Veloso;5300108;Brasília;2;2;4;1288
4215505;Santa Cecília;5300108;Brasília;2;2;4;1268
4215604;Santa Rosa de Lima;5300108;Brasília;2;2;4;1361
4215653;Santa Rosa do Sul;5300108;Brasília;2;2;4;1488
4215901;São Bonifácio;5300108;Brasília;2;2;4;1343
4216008;São Carlos;5300108;Brasília;2;2;4;1369
4216057;São Cristovão do Sul;5300108;Brasília;2;2;4;1299
4216255;São João do Oeste;5300108;Brasília;2;2;4;1399
4216404;São João do Sul;5300108;Brasília;2;2;4;1500
4216800;São José do Cerrito;5300108;Brasília;2;2;4;1345
4217105;São Martinho;5300108;Brasília;2;2;4;1373
4217303;Saudades;5300108;Brasília;2;2;4;1353
4217402;Schroeder;5300108;Brasília;2;2;4;1181
4217550;Serra Alta;5300108;Brasília;2;2;4;1335
4218103;Timbé do Sul;5300108;Brasília;2;2;4;1458
4218251;Timbó Grande;5300108;Brasília;2;2;4;1234
4218301;Três Barras;5300108;Brasília;2;2;4;1170
4218400;Treze de Maio;5300108;Brasília;2;2;4;1418
4218509;Treze Tílias;5300108;Brasília;2;2;4;1298
4218608;Trombudo Central;5300108;Brasília;2;2;4;1289
4218756;Tunápolis;5300108;Brasília;2;2;4;1389
4218855;União do Oeste;5300108;Brasília;2;2;4;1330
4218905;Urubici;5300108;Brasília;2;2;4;1364
4218954;Urupema;5300108;Brasília;2;2;4;1362
4219101;Vargeão;5300108;Brasília;2;2;4;1311
4219200;Vidal Ramos;5300108;Brasília;2;2;4;1292
4219358;Vitor Meireles;5300108;Brasília;2;2;4;1244
4219408;Witmarsum;5300108;Brasília;2;2;4;1248
4300059;Água Santa;5300108;Brasília;2;2;4;1444
4300208;Ajuricaba;5300108;Brasília;2;2;4;1523
4300307;Alecrim;5300108;Brasília;2;2;4;1516
4300505;Alpestre;5300108;Brasília;2;2;4;1388
4300901;Aratiba;5300108;Brasília;2;2;4;1372
4301107;Arroio dos Ratos;5300108;Brasília;2;2;4;1636
4301206;Arroio do Tigre;5300108;Brasília;2;2;4;1605
4301305;Arroio Grande;5300108;Brasília;2;2;4;1908
4301503;Augusto Pestana;5300108;Brasília;2;2;4;1561
4301552;Áurea;5300108;Brasília;2;2;4;1394
4301800;Barracão;5300108;Brasília;2;2;4;1371
4301909;Barra do Ribeiro;5300108;Brasília;2;2;4;1649
4302006;Barros Cassal;5300108;Brasília;2;2;4;1560
4302204;Boa Vista do Buricá;5300108;Brasília;2;2;4;1482
4302303;Bom Jesus;5300108;Brasília;2;2;4;1451
4302352;Bom Princípio;5300108;Brasília;2;2;4;1563
4302402;Bom Retiro do Sul;5300108;Brasília;2;2;4;1593
4302451;Boqueirão do Leão;5300108;Brasília;2;2;4;1577
4302501;Bossoroca;5300108;Brasília;2;2;4;1629
4302659;Brochier;5300108;Brasília;2;2;4;1576
4302907;Cacequi;5300108;Brasília;2;2;4;1741
4303301;Caibaté;5300108;Brasília;2;2;4;1575
4303673;Campestre da Serra;5300108;Brasília;2;2;4;1481
4304002;Campo Novo;5300108;Brasília;2;2;4;1467
4304309;Cândido Godói;5300108;Brasília;2;2;4;1544
4304358;Candiota;5300108;Brasília;2;2;4;1861
4304671;Capivari do Sul;5300108;Brasília;2;2;4;1614
4304689;Capela de Santana;5300108;Brasília;2;2;4;1585
4305009;Catuípe;5300108;Brasília;2;2;4;1535
4305124;Cerrito;5300108;Brasília;2;2;4;1857
4305173;Cerro Grande do Sul;5300108;Brasília;2;2;4;1692
4305306;Chapada;5300108;Brasília;2;2;4;1472
4305355;Charqueadas;5300108;Brasília;2;2;4;1620
4305439;Chuí;5300108;Brasília;2;2;4;2076
4305447;Chuvisca;5300108;Brasília;2;2;4;1717
4305454;Cidreira;5300108;Brasília;2;2;4;1610
4305603;Colorado;5300108;Brasília;2;2;4;1517
4305702;Condor;5300108;Brasília;2;2;4;1506
4305900;Coronel Bicaco;5300108;Brasília;2;2;4;1466
4306056;Cristal;5300108;Brasília;2;2;4;1745
4306304;David Canabarro;5300108;Brasília;2;2;4;1460
4306452;Dois Lajeados;5300108;Brasília;2;2;4;1523
4306502;Dom Feliciano;5300108;Brasília;2;2;4;1715
4306734;Doutor Maurício Cardoso;5300108;Brasília;2;2;4;1479
4306932;Entre-Ijuís;5300108;Brasília;2;2;4;1559
4307302;Erval Seco;5300108;Brasília;2;2;4;1440
4307401;Esmeralda;5300108;Brasília;2;2;4;1404
4307815;Estrela Velha;5300108;Brasília;2;2;4;1592
4307864;Fagundes Varela;5300108;Brasília;2;2;4;1507
4308300;Fontoura Xavier;5300108;Brasília;2;2;4;1540
4308409;Formigueiro;5300108;Brasília;2;2;4;1691
4308458;Fortaleza dos Valos;5300108;Brasília;2;2;4;1555
4308706;Gaurama;5300108;Brasília;2;2;4;1384
4308805;General Câmara;5300108;Brasília;2;2;4;1619
4309803;Ibiaçá;5300108;Brasília;2;2;4;1425
4309902;Ibiraiaras;5300108;Brasília;2;2;4;1451
4310306;Ilópolis;5300108;Brasília;2;2;4;1526
4310330;Imbé;5300108;Brasília;2;2;4;1587
4310405;Independência;5300108;Brasília;2;2;4;1502
4310439;Ipê;5300108;Brasília;2;2;4;1487
4310462;Ipiranga do Sul;5300108;Brasília;2;2;4;1433
4310504;Iraí;5300108;Brasília;2;2;4;1392
4310751;Ivorá;5300108;Brasília;2;2;4;1645
4311122;Jaquirana;5300108;Brasília;2;2;4;1473
4311502;Lavras do Sul;5300108;Brasília;2;2;4;1792
4311700;Machadinho;5300108;Brasília;2;2;4;1367
4311908;Marcelino Ramos;5300108;Brasília;2;2;4;1366
4312104;Mata;5300108;Brasília;2;2;4;1690
4312203;Maximiliano de Almeida;5300108;Brasília;2;2;4;1378
4312385;Monte Belo do Sul;5300108;Brasília;2;2;4;1535
4312500;Mostardas;5300108;Brasília;2;2;4;1727
4312609;Muçum;5300108;Brasília;2;2;4;1541
4312708;Nonoai;5300108;Brasília;2;2;4;1388
4312757;Nova Alvorada;5300108;Brasília;2;2;4;1501
4313003;Nova Bréscia;5300108;Brasília;2;2;4;1554
4313037;Nova Esperança do Sul;5300108;Brasília;2;2;4;1693
4313060;Nova Hartz;5300108;Brasília;2;2;4;1561
4313086;Nova Pádua;5300108;Brasília;2;2;4;1512
4313102;Nova Palma;5300108;Brasília;2;2;4;1635
4313359;Nova Roma do Sul;5300108;Brasília;2;2;4;1510
4313656;Palmares do Sul;5300108;Brasília;2;2;4;1626
4313706;Palmeira das Missões;5300108;Brasília;2;2;4;1468
4313805;Palmitinho;5300108;Brasília;2;2;4;1423
4313953;Pantano Grande;5300108;Brasília;2;2;4;1669
4314001;Paraí;5300108;Brasília;2;2;4;1480
4314027;Paraíso do Sul;5300108;Brasília;2;2;4;1642
4314076;Passo do Sobrado;5300108;Brasília;2;2;4;1619
4314159;Paverama;5300108;Brasília;2;2;4;1580
4314209;Pedro Osório;5300108;Brasília;2;2;4;1862
4314308;Pejuçara;5300108;Brasília;2;2;4;1536
4314423;Picada Café;5300108;Brasília;2;2;4;1552
4314472;Pinhal Grande;5300108;Brasília;2;2;4;1615
4314506;Pinheiro Machado;5300108;Brasília;2;2;4;1852
4314555;Pirapó;5300108;Brasília;2;2;4;1578
4314605;Piratini;5300108;Brasília;2;2;4;1828
4314704;Planalto;5300108;Brasília;2;2;4;1397
4315107;Porto Xavier;5300108;Brasília;2;2;4;1561
4315131;Pouso Novo;5300108;Brasília;2;2;4;1555
4315156;Progresso;5300108;Brasília;2;2;4;1566
4315404;Redentora;5300108;Brasília;2;2;4;1458
4315453;Relvado;5300108;Brasília;2;2;4;1544
4315800;Roca Sales;5300108;Brasília;2;2;4;1556
4316105;Ronda Alta;5300108;Brasília;2;2;4;1431
4316204;Rondinha;5300108;Brasília;2;2;4;1442
4316303;Roque Gonzales;5300108;Brasília;2;2;4;1577
4316436;Saldanha Marinho;5300108;Brasília;2;2;4;1508
4316451;Salto do Jacuí;5300108;Brasília;2;2;4;1585
4316501;Salvador do Sul;5300108;Brasília;2;2;4;1561
4316709;Santa Bárbara do Sul;5300108;Brasília;2;2;4;1511
4316758;Santa Clara do Sul;5300108;Brasília;2;2;4;1583
4317004;Santana da Boa Vista;5300108;Brasília;2;2;4;1767
4318101;São Francisco de Assis;5300108;Brasília;2;2;4;1723
4318440;São Jorge;5300108;Brasília;2;2;4;1467
4318507;São José do Norte;5300108;Brasília;2;2;4;1853
4318606;São José do Ouro;5300108;Brasília;2;2;4;1386
4318622;São José dos Ausentes;5300108;Brasília;2;2;4;1452
4319109;São Martinho;5300108;Brasília;2;2;4;1479
4319158;São Miguel das Missões;5300108;Brasília;2;2;4;1594
4319208;São Nicolau;5300108;Brasília;2;2;4;1595
4319703;São Valentim;5300108;Brasília;2;2;4;1398
4319802;São Vicente do Sul;5300108;Brasília;2;2;4;1713
4320206;Seberi;5300108;Brasília;2;2;4;1428
4320305;Selbach;5300108;Brasília;2;2;4;1526
4320503;Sertão;5300108;Brasília;2;2;4;1431
4320602;Severiano de Almeida;5300108;Brasília;2;2;4;1369
4320677;Sinimbu;5300108;Brasília;2;2;4;1605
4321006;Tapera;5300108;Brasília;2;2;4;1523
4321402;Tenente Portela;5300108;Brasília;2;2;4;1435
4321436;Terra de Areia;5300108;Brasília;2;2;4;1544
4321667;Três Cachoeiras;5300108;Brasília;2;2;4;1526
4321857;Três Palmeiras;5300108;Brasília;2;2;4;1417
4322103;Tucunduva;5300108;Brasília;2;2;4;1498
4322251;Tupandi;5300108;Brasília;2;2;4;1563
4322301;Tuparendi;5300108;Brasília;2;2;4;1510
4322533;Vale do Sol;5300108;Brasília;2;2;4;1618
4322558;Vanini;5300108;Brasília;2;2;4;1469
4322905;Viadutos;5300108;Brasília;2;2;4;1379
4323200;Victor Graeff;5300108;Brasília;2;2;4;1511
4323408;Vila Maria;5300108;Brasília;2;2;4;1486
4323457;Vila Nova do Sul;5300108;Brasília;2;2;4;1743
4323705;Vista Gaúcha;5300108;Brasília;2;2;4;1424
5000203;Água Clara;5300108;Brasília;2;2;4;741
5000708;Anastácio;5300108;Brasília;2;2;4;1000
5000807;Anaurilândia;5300108;Brasília;2;2;4;876
5000906;Antônio João;5300108;Brasília;2;2;4;1125
5001003;Aparecida do Taboado;5300108;Brasília;2;2;4;585
5001243;Aral Moreira;5300108;Brasília;2;2;4;1153
5001508;Bandeirantes;5300108;Brasília;2;2;4;839
5001904;Bataguassu;5300108;Brasília;2;2;4;819
5002001;Batayporã;5300108;Brasília;2;2;4;926
5002100;Bela Vista;5300108;Brasília;2;2;4;1171
5002159;Bodoquena;5300108;Brasília;2;2;4;1088
5002209;Bonito;5300108;Brasília;2;2;4;1105
5002308;Brasilândia;5300108;Brasília;2;2;4;751
5002407;Caarapó;5300108;Brasília;2;2;4;1068
5002605;Camapuã;5300108;Brasília;2;2;4;781
5003454;Deodápolis;5300108;Brasília;2;2;4;989
5003488;Dois Irmãos do Buriti;5300108;Brasília;2;2;4;965
5003504;Douradina;5300108;Brasília;2;2;4;1004
5003751;Eldorado;5300108;Brasília;2;2;4;1125
5003900;Figueirão;5300108;Brasília;2;2;4;694
5004007;Glória de Dourados;5300108;Brasília;2;2;4;1006
5004106;Guia Lopes da Laguna;5300108;Brasília;2;2;4;1088
5004304;Iguatemi;5300108;Brasília;2;2;4;1135
5004403;Inocência;5300108;Brasília;2;2;4;612
5004502;Itaporã;5300108;Brasília;2;2;4;1021
5004601;Itaquiraí;5300108;Brasília;2;2;4;1091
5005103;Jateí;5300108;Brasília;2;2;4;1015
5005152;Juti;5300108;Brasília;2;2;4;1069
5005202;Ladário;5300108;Brasília;2;2;4;1106
5005251;Laguna Carapã;5300108;Brasília;2;2;4;1086
5005608;Miranda;5300108;Brasília;2;2;4;1039
5005681;Mundo Novo;5300108;Brasília;2;2;4;1139
5005806;Nioaque;5300108;Brasília;2;2;4;1045
5006002;Nova Alvorada do Sul;5300108;Brasília;2;2;4;941
5006358;Paranhos;5300108;Brasília;2;2;4;1216
5006408;Pedro Gomes;5300108;Brasília;2;2;4;758
5006903;Porto Murtinho;5300108;Brasília;2;2;4;1265
5007109;Ribas do Rio Pardo;5300108;Brasília;2;2;4;815
5007307;Rio Negro;5300108;Brasília;2;2;4;864
5007406;Rio Verde de Mato Grosso;5300108;Brasília;2;2;4;826
5007554;Santa Rita do Pardo;5300108;Brasília;2;2;4;809
5007703;Sete Quedas;5300108;Brasília;2;2;4;1193
5007802;Selvíria;5300108;Brasília;2;2;4;631
5007935;Sonora;5300108;Brasília;2;2;4;763
5007950;Tacuru;5300108;Brasília;2;2;4;1166
5008008;Terenos;5300108;Brasília;2;2;4;910
5008404;Vicentina;5300108;Brasília;2;2;4;1019
5100409;Alto Garças;5300108;Brasília;2;2;4;620
5100508;Alto Paraguai;5300108;Brasília;2;2;4;925
5100607;Alto Taquari;5300108;Brasília;2;2;4;620
5100805;Apiacás;5300108;Brasília;2;2;4;1224
5101258;Araputanga;5300108;Brasília;2;2;4;1119
5101308;Arenápolis;5300108;Brasília;2;2;4;965
5101407;Aripuanã;5300108;Brasília;2;2;4;1364
5101902;Brasnorte;5300108;Brasília;2;2;4;1143
5102603;Campinápolis;5300108;Brasília;2;2;4;550
5102686;Campos de Júlio;5300108;Brasília;2;2;4;1216
5102702;Canarana;5300108;Brasília;2;2;4;527
5103007;Chapada dos Guimarães;5300108;Brasília;2;2;4;839
5103254;Colniza;5300108;Brasília;2;2;4;1387
5103304;Comodoro;5300108;Brasília;2;2;4;1287
5103379;Cotriguaçu;5300108;Brasília;2;2;4;1289
5103452;Denise;5300108;Brasília;2;2;4;983
5103601;Dom Aquino;5300108;Brasília;2;2;4;749
5103700;Feliz Natal;5300108;Brasília;2;2;4;835
5103858;Gaúcha do Norte;5300108;Brasília;2;2;4;618
5104203;Guiratinga;5300108;Brasília;2;2;4;628
5104526;Ipiranga do Norte;5300108;Brasília;2;2;4;959
5104559;Itaúba;5300108;Brasília;2;2;4;940
5105002;Jauru;5300108;Brasília;2;2;4;1171
5105200;Juscimeira;5300108;Brasília;2;2;4;749
5105580;Marcelândia;5300108;Brasília;2;2;4;868
5105606;Matupá;5300108;Brasília;2;2;4;970
5105622;Mirassol d'Oeste;5300108;Brasília;2;2;4;1090
5106000;Nortelândia;5300108;Brasília;2;2;4;959
5106216;Nova Canaã do Norte;5300108;Brasília;2;2;4;1004
5106232;Nova Olímpia;5300108;Brasília;2;2;4;1007
5106240;Nova Ubiratã;5300108;Brasília;2;2;4;840
5106257;Nova Xavantina;5300108;Brasília;2;2;4;495
5106281;Novo São Joaquim;5300108;Brasília;2;2;4;554
5106299;Paranaíta;5300108;Brasília;2;2;4;1131
5106307;Paranatinga;5300108;Brasília;2;2;4;671
5106372;Pedra Preta;5300108;Brasília;2;2;4;710
5106422;Peixoto de Azevedo;5300108;Brasília;2;2;4;969
5106505;Poconé;5300108;Brasília;2;2;4;937
5106802;Porto dos Gaúchos;5300108;Brasília;2;2;4;1109
5106828;Porto Esperidião;5300108;Brasília;2;2;4;1129
5107008;Poxoréo;5300108;Brasília;2;2;4;693
5107065;Querência;5300108;Brasília;2;2;4;600
5107107;São José dos Quatro Marcos;5300108;Brasília;2;2;4;1098
5107180;Ribeirão Cascalheira;5300108;Brasília;2;2;4;522
5107198;Ribeirãozinho;5300108;Brasília;2;2;4;517
5107206;Rio Branco;5300108;Brasília;2;2;4;1094
5107305;São José do Rio Claro;5300108;Brasília;2;2;4;975
5107701;Rosário Oeste;5300108;Brasília;2;2;4;919
5107792;Santo Antônio do Leste;5300108;Brasília;2;2;4;621
5107800;Santo Antônio do Leverger;5300108;Brasília;2;2;4;873
5107859;São Félix do Araguaia;5300108;Brasília;2;2;4;550
5107875;Sapezal;5300108;Brasília;2;2;4;1196
5107941;Tabaporã;5300108;Brasília;2;2;4;1071
5108006;Tapurah;5300108;Brasília;2;2;4;978
5108055;Terra Nova do Norte;5300108;Brasília;2;2;4;971
5108204;Torixoréu;5300108;Brasília;2;2;4;504
5108501;Vera;5300108;Brasília;2;2;4;875
5108600;Vila Rica;5300108;Brasília;2;2;4;728
5108907;Nova Maringá;5300108;Brasília;2;2;4;1022
5108956;Nova Monte Verde;5300108;Brasília;2;2;4;1200
5200134;Acreúna;5300108;Brasília;2;2;4;317
5200555;Alto Horizonte;5300108;Brasília;2;2;4;234
5201454;Aparecida do Rio Doce;5300108;Brasília;2;2;4;443
5201504;Aporé;5300108;Brasília;2;2;4;551
5203302;Bela Vista de Goiás;5300108;Brasília;2;2;4;170
5203401;Bom Jardim de Goiás;5300108;Brasília;2;2;4;458
5203906;Buriti Alegre;5300108;Brasília;2;2;4;285
5204102;Cachoeira Alta;5300108;Brasília;2;2;4;462
5204300;Caçu;5300108;Brasília;2;2;4;463
5204409;Caiapônia;5300108;Brasília;2;2;4;439
5204557;Caldazinha;5300108;Brasília;2;2;4;153
5204706;Campinorte;5300108;Brasília;2;2;4;213
5204805;Campo Alegre de Goiás;5300108;Brasília;2;2;4;203
5204854;Campo Limpo de Goiás;5300108;Brasília;2;2;4;136
5205000;Carmo do Rio Verde;5300108;Brasília;2;2;4;197
5205307;Cavalcante;5300108;Brasília;2;2;4;228
5205471;Chapadão do Céu;5300108;Brasília;2;2;4;576
5205901;Corumbaíba;5300108;Brasília;2;2;4;267
5206404;Crixás;5300108;Brasília;2;2;4;260
5207253;Doverlândia;5300108;Brasília;2;2;4;483
5207402;Edéia;5300108;Brasília;2;2;4;276
5207600;Fazenda Nova;5300108;Brasília;2;2;4;309
5207808;Firminópolis;5300108;Brasília;2;2;4;270
5207907;Flores de Goiás;5300108;Brasília;2;2;4;178
5208301;Divinópolis de Goiás;5300108;Brasília;2;2;4;322
5208400;Goianápolis;5300108;Brasília;2;2;4;141
5208509;Goiandira;5300108;Brasília;2;2;4;258
5209150;Gouvelândia;5300108;Brasília;2;2;4;390
5209200;Guapó;5300108;Brasília;2;2;4;206
5209705;Hidrolândia;5300108;Brasília;2;2;4;190
5209937;Inaciolândia;5300108;Brasília;2;2;4;371
5209952;Indiara;5300108;Brasília;2;2;4;266
5210604;Itaguaru;5300108;Brasília;2;2;4;183
5210802;Itajá;5300108;Brasília;2;2;4;532
5211008;Itapirapuã;5300108;Brasília;2;2;4;289
5212105;Joviânia;5300108;Brasília;2;2;4;286
5212808;Mara Rosa;5300108;Brasília;2;2;4;239
5212956;Matrinchã;5300108;Brasília;2;2;4;305
5213707;Montes Claros de Goiás;5300108;Brasília;2;2;4;372
5213756;Montividiu;5300108;Brasília;2;2;4;394
5214804;Nova Aurora;5300108;Brasília;2;2;4;252
5214838;Nova Crixás;5300108;Brasília;2;2;4;321
5215009;Nova Veneza;5300108;Brasília;2;2;4;162
5216809;Petrolina de Goiás;5300108;Brasília;2;2;4;155
5217203;Piranhas;5300108;Brasília;2;2;4;421
5218102;Portelândia;5300108;Brasília;2;2;4;539
5218607;Rialma;5300108;Brasília;2;2;4;184
5218706;Rianápolis;5300108;Brasília;2;2;4;174
5219001;Sanclerlândia;5300108;Brasília;2;2;4;260
5219704;Santa Terezinha de Goiás;5300108;Brasília;2;2;4;250
5219712;Santo Antônio da Barra;5300108;Brasília;2;2;4;350
5219803;São Domingos;5300108;Brasília;2;2;4;314
5220009;São João d'Aliança;5300108;Brasília;2;2;4;129
5220504;Serranópolis;5300108;Brasília;2;2;4;516
5220686;Simolândia;5300108;Brasília;2;2;4;215
5221080;Teresina de Goiás;5300108;Brasília;2;2;4;234
5221304;Três Ranchos;5300108;Brasília;2;2;4;282
5222005;Vianópolis;5300108;Brasília;2;2;4;121
5222054;Vicentinópolis;5300108;Brasília;2;2;4;294
5222203;Vila Boa;5300108;Brasília;2;2;4;126
3550308;São Paulo;5222054;Vicentinópolis;2;2;4;738
5209101;Goiatuba;5222054;Vicentinópolis;2;2;4;55
5211503;Itumbiara;5222054;Vicentinópolis;2;2;4;93
3550308;São Paulo;5222005;Vianópolis;2;2;4;792
5212501;Luziânia;5222005;Vianópolis;2;2;4;81
5215306;Orizona;5222005;Vianópolis;2;2;4;40
5208707;Goiânia;5221908;Varjão;2;2;4;54
3548807;São Caetano do Sul;5221858;Valparaíso de Goiás;2;2;4;849
5211206;Itapuranga;5221700;Uruana;2;2;4;29
3534302;Orlândia;5221601;Uruaçu;2;2;4;701
5204706;Campinorte;5221601;Uruaçu;2;2;4;23
5204904;Campos Belos;5221601;Uruaçu;2;2;4;311
5208608;Goianésia;5221601;Uruaçu;2;2;4;89
5214408;Nazário;5221502;Turvânia;2;2;4;27
3550308;São Paulo;5221403;Trindade;2;2;4;833
5210406;Itaberaí;5221403;Trindade;2;2;4;77
5211503;Itumbiara;5221403;Trindade;2;2;4;193
5218805;Rio Verde;5221403;Trindade;2;2;4;197
5208707;Goiânia;5221007;Taquaral de Goiás;2;2;4;79
5209903;Iaciara;5220686;Simolândia;2;2;4;38
5211909;Jataí;5220603;Silvânia;2;2;4;359
5215306;Orizona;5220603;Silvânia;2;2;4;53
2111300;São Luís;5220454;Senador Canedo;2;2;4;1647
2607208;Ipojuca;5220454;Senador Canedo;2;2;4;1734
3552205;Sorocaba;5220454;Senador Canedo;2;2;4;770
4106902;Curitiba;5220454;Senador Canedo;2;2;4;966
5107040;Primavera do Leste;5220454;Senador Canedo;2;2;4;574
5108402;Várzea Grande;5220454;Senador Canedo;2;2;4;762
5201108;Anápolis;5220454;Senador Canedo;2;2;4;46
5211503;Itumbiara;5220454;Senador Canedo;2;2;4;188
5204102;Cachoeira Alta;5220405;São Simão;2;2;4;49
5204300;Caçu;5220405;São Simão;2;2;4;78
5213103;Mineiros;5220405;São Simão;2;2;4;264
1702000;Araguaçu;5220207;São Miguel do Araguaia;2;2;4;52
3550308;São Paulo;5220207;São Miguel do Araguaia;2;2;4;1213
5205406;Ceres;5220207;São Miguel do Araguaia;2;2;4;228
5208608;Goianésia;5220207;São Miguel do Araguaia;2;2;4;253
5210406;Itaberaí;5220207;São Miguel do Araguaia;2;2;4;309
5201108;Anápolis;5220108;São Luís de Montes Belos;2;2;4;154
5208905;Goiás;5220108;São Luís de Montes Belos;2;2;4;65
3550308;São Paulo;5220009;São João d'Aliança;2;2;4;995
3550308;São Paulo;5219803;São Domingos;2;2;4;1132
5200258;Águas Lindas de Goiás;5219753;Santo Antônio do Descoberto;2;2;4;20
5208707;Goiânia;5219704;Santa Terezinha de Goiás;2;2;4;260
5208103;Formoso;5219605;Santa Tereza de Goiás;2;2;4;21
5208608;Goianésia;5219456;Santa Rita do Novo Destino;2;2;4;20
5213103;Mineiros;5219407;Santa Rita do Araguaia;2;2;4;73
5208608;Goianésia;5219357;Santa Isabel;2;2;4;33
5213756;Montividiu;5219308;Santa Helena de Goiás;2;2;4;73
5218003;Porangatu;5219308;Santa Helena de Goiás;2;2;4;506
5208707;Goiânia;5219100;Santa Bárbara de Goiás;2;2;4;46
5214408;Nazário;5219100;Santa Bárbara de Goiás;2;2;4;20
5207808;Firminópolis;5219001;Sanclerlândia;2;2;4;43
3550308;São Paulo;5218904;Rubiataba;2;2;4;1005
5205000;Carmo do Rio Verde;5218904;Rubiataba;2;2;4;26
5210901;Itapaci;5218904;Rubiataba;2;2;4;35
5211800;Jaraguá;5218904;Rubiataba;2;2;4;85
5214002;Mozarlândia;5218904;Rubiataba;2;2;4;94
1505536;Parauapebas;5218805;Rio Verde;2;2;4;1309
1721000;Palmas;5218805;Rio Verde;2;2;4;865
3103751;Araporã;5218805;Rio Verde;2;2;4;199
3143104;Monte Carmelo;5218805;Rio Verde;2;2;4;379
3543402;Ribeirão Preto;5218805;Rio Verde;2;2;4;501
3548807;São Caetano do Sul;5218805;Rio Verde;2;2;4;798
3552601;Tabapuã;5218805;Rio Verde;2;2;4;406
4311809;Marau;5218805;Rio Verde;2;2;4;1188
4314902;Porto Alegre;5218805;Rio Verde;2;2;4;1358
5002704;Campo Grande;5218805;Rio Verde;2;2;4;492
5103403;Cuiabá;5218805;Rio Verde;2;2;4;598
5108402;Várzea Grande;5218805;Rio Verde;2;2;4;600
5205109;Catalão;5218805;Rio Verde;2;2;4;321
5207402;Edéia;5218805;Rio Verde;2;2;4;116
3304557;Rio de Janeiro;5218607;Rialma;2;2;4;1088
3550308;São Paulo;5218607;Rialma;2;2;4;980
5205406;Ceres;5218607;Rialma;2;2;4;8
5208707;Goiânia;5218607;Rialma;2;2;4;158
3134202;Ituiutaba;5218508;Quirinópolis;2;2;4;120
3503307;Araras;5218508;Quirinópolis;2;2;4;543
4106902;Curitiba;5218508;Quirinópolis;2;2;4;783
5204102;Cachoeira Alta;5218508;Quirinópolis;2;2;4;62
5204250;Cachoeira Dourada;5218508;Quirinópolis;2;2;4;104
5211305;Itarumã;5218508;Quirinópolis;2;2;4;101
5216304;Paranaiguara;5218508;Quirinópolis;2;2;4;55
2927408;Salvador;5218300;Posse;2;2;4;859
5208707;Goiânia;5218300;Posse;2;2;4;428
5209903;Iaciara;5218300;Posse;2;2;4;24
5212709;Mambaí;5218300;Posse;2;2;4;52
5207501;Estrela do Norte;5218003;Porangatu;2;2;4;50
5213087;Minaçu;5218003;Porangatu;2;2;4;106
5214606;Niquelândia;5218003;Porangatu;2;2;4;138
5215256;Novo Planalto;5218003;Porangatu;2;2;4;41
5205901;Corumbaíba;5217708;Pontalina;2;2;4;117
5213806;Morrinhos;5217708;Pontalina;2;2;4;42
3550308;São Paulo;5217401;Pires do Rio;2;2;4;727
5201108;Anápolis;5217401;Pires do Rio;2;2;4;128
5206206;Cristalina;5217401;Pires do Rio;2;2;4;83
5205513;Cocalzinho de Goiás;5217302;Pirenópolis;2;2;4;21
5208608;Goianésia;5217302;Pirenópolis;2;2;4;63
3550308;São Paulo;5217203;Piranhas;2;2;4;976
5204409;Caiapônia;5217203;Piranhas;2;2;4;56
5209101;Goiatuba;5217104;Piracanjuba;2;2;4;86
3550308;São Paulo;5216809;Petrolina de Goiás;2;2;4;887
5211909;Jataí;5216452;Perolândia;2;2;4;57
5213103;Mineiros;5216452;Perolândia;2;2;4;53
5200134;Acreúna;5216403;Paraúna;2;2;4;50
5207808;Firminópolis;5216403;Paraúna;2;2;4;45
5208707;Goiânia;5216403;Paraúna;2;2;4;129
3170206;Uberlândia;5216304;Paranaiguara;2;2;4;251
5204300;Caçu;5216304;Paranaiguara;2;2;4;64
5211909;Jataí;5216304;Paranaiguara;2;2;4;157
3534302;Orlândia;5216007;Panamá;2;2;4;322
5201405;Aparecida de Goiânia;5215702;Palmeiras de Goiás;2;2;4;71
5214606;Niquelândia;5215603;Padre Bernardo;2;2;4;77
3550308;São Paulo;5215306;Orizona;2;2;4;755
5204508;Caldas Novas;5215306;Orizona;2;2;4;85
3548807;São Caetano do Sul;5215231;Novo Gama;2;2;4;851
5205497;Cidade Ocidental;5215231;Novo Gama;2;2;4;12
5212501;Luziânia;5215231;Novo Gama;2;2;4;24
3304557;Rio de Janeiro;5214838;Nova Crixás;2;2;4;1248
3550308;São Paulo;5214838;Nova Crixás;2;2;4;1134
5201108;Anápolis;5214838;Nova Crixás;2;2;4;288
5201108;Anápolis;5214507;Nerópolis;2;2;4;30
5201405;Aparecida de Goiânia;5214507;Nerópolis;2;2;4;45
5210000;Inhumas;5214507;Nerópolis;2;2;4;34
4313037;Nova Esperança do Sul;5214408;Nazário;2;2;4;1523
5202155;Araguapaz;5214002;Mozarlândia;2;2;4;43
5205406;Ceres;5214002;Mozarlândia;2;2;4;119
5208707;Goiânia;5214002;Mozarlândia;2;2;4;258
5201108;Anápolis;5213806;Morrinhos;2;2;4;157
5205109;Catalão;5213806;Morrinhos;2;2;4;134
5205901;Corumbaíba;5213806;Morrinhos;2;2;4;75
5209101;Goiatuba;5213806;Morrinhos;2;2;4;41
5210208;Iporá;5213707;Montes Claros de Goiás;2;2;4;56
5211909;Jataí;5213707;Montes Claros de Goiás;2;2;4;212
3106200;Belo Horizonte;5213103;Mineiros;2;2;4;953
4106902;Curitiba;5213103;Mineiros;2;2;4;941
4204004;Catanduvas;5213103;Mineiros;2;2;4;1057
5008305;Três Lagoas;5213103;Mineiros;2;2;4;366
5108402;Várzea Grande;5213103;Mineiros;2;2;4;436
5201108;Anápolis;5213103;Mineiros;2;2;4;407
5201405;Aparecida de Goiânia;5213103;Mineiros;2;2;4;360
5205406;Ceres;5213087;Minaçu;2;2;4;247
5212808;Mara Rosa;5213087;Minaçu;2;2;4;118
5205901;Corumbaíba;5212907;Marzagão;2;2;4;20
5208707;Goiânia;5212600;Mairipotaba;2;2;4;71
3170206;Uberlândia;5212501;Luziânia;2;2;4;295
3505708;Barueri;5212501;Luziânia;2;2;4;811
3548807;São Caetano do Sul;5212501;Luziânia;2;2;4;828
4106902;Curitiba;5212501;Luziânia;2;2;4;1027
5211503;Itumbiara;5212501;Luziânia;2;2;4;276
3550308;São Paulo;5212303;Leopoldo de Bulhões;2;2;4;811
5201108;Anápolis;5212303;Leopoldo de Bulhões;2;2;4;40
3550308;São Paulo;5212105;Joviânia;2;2;4;722
3106200;Belo Horizonte;5211909;Jataí;2;2;4;852
3551702;Sertãozinho;5211909;Jataí;2;2;4;535
4119905;Ponta Grossa;5211909;Jataí;2;2;4;815
5100607;Alto Taquari;5211909;Jataí;2;2;4;170
5107040;Primavera do Leste;5211909;Jataí;2;2;4;383
5107065;Querência;5211909;Jataí;2;2;4;605
5201405;Aparecida de Goiânia;5211909;Jataí;2;2;4;285
5205109;Catalão;5211909;Jataí;2;2;4;400
1302603;Manaus;5211800;Jaraguá;2;2;4;1792
3534401;Osasco;5211800;Jaraguá;2;2;4;905
5210000;Inhumas;5211800;Jaraguá;2;2;4;72
5210406;Itaberaí;5211800;Jaraguá;2;2;4;60
1721000;Palmas;5211503;Itumbiara;2;2;4;894
3109402;Buritizeiro;5211503;Itumbiara;2;2;4;466
3118601;Contagem;5211503;Itumbiara;2;2;4;574
3303500;Nova Iguaçu;5211503;Itumbiara;2;2;4;786
3503208;Araraquara;5211503;Itumbiara;2;2;4;393
3518800;Guarulhos;5211503;Itumbiara;2;2;4;629
3540705;Porto Ferreira;5211503;Itumbiara;2;2;4;427
3543907;Rio Claro;5211503;Itumbiara;2;2;4;480
3547809;Santo André;5211503;Itumbiara;2;2;4;651
3551702;Sertãozinho;5211503;Itumbiara;2;2;4;332
4113700;Londrina;5211503;Itumbiara;2;2;4;580
4115200;Maringá;5211503;Itumbiara;2;2;4;627
4119905;Ponta Grossa;5211503;Itumbiara;2;2;4;749
4316808;Santa Cruz do Sul;5211503;Itumbiara;2;2;4;1302
5201108;Anápolis;5211503;Itumbiara;2;2;4;233
5209937;Inaciolândia;5211503;Itumbiara;2;2;4;78
5204102;Cachoeira Alta;5211305;Itarumã;2;2;4;43
3550308;São Paulo;5211206;Itapuranga;2;2;4;971
3550308;São Paulo;5210901;Itapaci;2;2;4;1017
5205471;Chapadão do Céu;5210802;Itajá;2;2;4;130
5208707;Goiânia;5210562;Itaguari;2;2;4;92
3550308;São Paulo;5210406;Itaberaí;2;2;4;911
3550308;São Paulo;5210208;Iporá;2;2;4;935
5101803;Barra do Garças;5210208;Iporá;2;2;4;141
5201405;Aparecida de Goiânia;5210208;Iporá;2;2;4;203
3503307;Araras;5210109;Ipameri;2;2;4;519
5201108;Anápolis;5210109;Ipameri;2;2;4;178
3550308;São Paulo;5210000;Inhumas;2;2;4;864
5201405;Aparecida de Goiânia;5210000;Inhumas;2;2;4;55
3543907;Rio Claro;5209952;Indiara;2;2;4;639
5200134;Acreúna;5209952;Indiara;2;2;4;50
5207402;Edéia;5209952;Indiara;2;2;4;24
5208707;Goiânia;5209952;Indiara;2;2;4;90
5209150;Gouvelândia;5209937;Inaciolândia;2;2;4;19
5200803;Alvorada do Norte;5209903;Iaciara;2;2;4;42
5208004;Formosa;5209903;Iaciara;2;2;4;176
3550308;São Paulo;5209705;Hidrolândia;2;2;4;792
5208707;Goiânia;5209606;Heitoraí;2;2;4;123
3550308;São Paulo;5209150;Gouvelândia;2;2;4;669
3103504;Araguari;5209101;Goiatuba;2;2;4;142
3143104;Monte Carmelo;5209101;Goiatuba;2;2;4;213
3534401;Osasco;5209101;Goiatuba;2;2;4;672
5207402;Edéia;5209101;Goiatuba;2;2;4;94
1500602;Altamira;5208707;Goiânia;2;2;4;1528
1503606;Itaituba;5208707;Goiânia;2;2;4;1546
1703206;Bernardo Sayão;5208707;Goiânia;2;2;4;976
1705508;Colinas do Tocantins;5208707;Goiânia;2;2;4;959
1718204;Porto Nacional;5208707;Goiânia;2;2;4;670
2100055;Açailândia;5208707;Goiânia;2;2;4;1312
2109007;Porto Franco;5208707;Goiânia;2;2;4;1161
2112209;Timon;5208707;Goiânia;2;2;4;1444
2609600;Olinda;5208707;Goiânia;2;2;4;1788
2800308;Aracaju;5208707;Goiânia;2;2;4;1435
2905701;Camaçari;5208707;Goiânia;2;2;4;1240
3106705;Betim;5208707;Goiânia;2;2;4;657
3144805;Nova Lima;5208707;Goiânia;2;2;4;691
3148004;Patos de Minas;5208707;Goiânia;2;2;4;364
3151800;Poços de Caldas;5208707;Goiânia;2;2;4;635
3164704;São Sebastião do Paraíso;5208707;Goiânia;2;2;4;530
3205002;Serra;5208707;Goiânia;2;2;4;1039
3303302;Niterói;5208707;Goiânia;2;2;4;959
3303500;Nova Iguaçu;5208707;Goiânia;2;2;4;921
3505203;Bariri;5208707;Goiânia;2;2;4;599
3512803;Cosmópolis;5208707;Goiânia;2;2;4;697
3515004;Embu;5208707;Goiânia;2;2;4;814
3518404;Guaratinguetá;5208707;Goiânia;2;2;4;812
3520509;Indaiatuba;5208707;Goiânia;2;2;4;742
3529005;Marília;5208707;Goiânia;2;2;4;616
3530300;Mirassol;5208707;Goiânia;2;2;4;457
3533908;Olímpia;5208707;Goiânia;2;2;4;451
3541406;Presidente Prudente;5208707;Goiânia;2;2;4;644
3548500;Santos;5208707;Goiânia;2;2;4;859
3548906;São Carlos;5208707;Goiânia;2;2;4;609
3551702;Sertãozinho;5208707;Goiânia;2;2;4;511
3552403;Sumaré;5208707;Goiânia;2;2;4;713
3556206;Valinhos;5208707;Goiânia;2;2;4;738
3556701;Vinhedo;5208707;Goiânia;2;2;4;745
4108304;Foz do Iguaçu;5208707;Goiânia;2;2;4;1131
4119152;Pinhais;5208707;Goiânia;2;2;4;969
4119905;Ponta Grossa;5208707;Goiânia;2;2;4;936
4218004;Tijucas;5208707;Goiânia;2;2;4;1170
4304705;Carazinho;5208707;Goiânia;2;2;4;1342
4314100;Passo Fundo;5208707;Goiânia;2;2;4;1326
4316808;Santa Cruz do Sul;5208707;Goiânia;2;2;4;1485
5008305;Três Lagoas;5208707;Goiânia;2;2;4;523
5102678;Campo Verde;5208707;Goiânia;2;2;4;639
5103353;Confresa;5208707;Goiânia;2;2;4;711
5105101;Juara;5208707;Goiânia;2;2;4;1054
5105259;Lucas do Rio Verde;5208707;Goiânia;2;2;4;807
5106224;Nova Mutum;5208707;Goiânia;2;2;4;787
5107909;Sinop;5208707;Goiânia;2;2;4;846
5200308;Alexânia;5208707;Goiânia;2;2;4;107
5200803;Alvorada do Norte;5208707;Goiânia;2;2;4;383
5200852;Americano do Brasil;5208707;Goiânia;2;2;4;89
5202502;Aruanã;5208707;Goiânia;2;2;4;275
5203807;Britânia;5208707;Goiânia;2;2;4;256
5203906;Buriti Alegre;5208707;Goiânia;2;2;4;163
5204706;Campinorte;5208707;Goiânia;2;2;4;264
5205208;Caturaí;5208707;Goiânia;2;2;4;35
5205802;Corumbá de Goiás;5208707;Goiânia;2;2;4;99
3304557;Rio de Janeiro;5208608;Goianésia;2;2;4;1055
4106902;Curitiba;5208608;Goianésia;2;2;4;1120
5205109;Catalão;5208509;Goiandira;2;2;4;16
5201108;Anápolis;5208400;Goianápolis;2;2;4;23
3170206;Uberlândia;5208103;Formoso;2;2;4;582
5201405;Aparecida de Goiânia;5208004;Formosa;2;2;4;252
3100104;Abadia dos Dourados;5206909;Davinópolis;2;2;4;41
3147006;Paracatu;5206206;Cristalina;2;2;4;94
5204508;Caldas Novas;5205901;Corumbaíba;2;2;4;45
3304557;Rio de Janeiro;5205521;Colinas do Sul;2;2;4;1103
3543907;Rio Claro;5205455;Cezarina;2;2;4;647
3304557;Rio de Janeiro;5205406;Ceres;2;2;4;1094
3550308;São Paulo;5205406;Ceres;2;2;4;984
3106705;Betim;5205109;Catalão;2;2;4;446
3152501;Pouso Alegre;5205109;Catalão;2;2;4;497
3205101;Viana;5205109;Catalão;2;2;4;824
3509502;Campinas;5205109;Catalão;2;2;4;533
3513108;Cravinhos;5205109;Catalão;2;2;4;353
3516200;Franca;5205109;Catalão;2;2;4;270
3518800;Guarulhos;5205109;Catalão;2;2;4;603
3520103;Igarapava;5205109;Catalão;2;2;4;210
3525102;Jardinópolis;5205109;Catalão;2;2;4;317
3534401;Osasco;5205109;Catalão;2;2;4;608
3550803;São Sebastião da Grama;5205109;Catalão;2;2;4;411
4106902;Curitiba;5205109;Catalão;2;2;4;819
5103403;Cuiabá;5205109;Catalão;2;2;4;905
5201405;Aparecida de Goiânia;5205109;Catalão;2;2;4;204
5204805;Campo Alegre de Goiás;5205109;Catalão;2;2;4;60
1702406;Arraias;5204904;Campos Belos;2;2;4;26
3550308;São Paulo;5204904;Campos Belos;2;2;4;1177
5201108;Anápolis;5204854;Campo Limpo de Goiás;2;2;4;15
3550308;São Paulo;5204805;Campo Alegre de Goiás;2;2;4;677
3550308;São Paulo;5204706;Campinorte;2;2;4;1071
3143104;Monte Carmelo;5204508;Caldas Novas;2;2;4;161
3543402;Ribeirão Preto;5204508;Caldas Novas;2;2;4;388
5201108;Anápolis;5204508;Caldas Novas;2;2;4;161
5201454;Aparecida do Rio Doce;5204300;Caçu;2;2;4;31
5203500;Bom Jesus de Goiás;5204250;Cachoeira Dourada;2;2;4;45
3550308;São Paulo;5204102;Cachoeira Alta;2;2;4;710
3170206;Uberlândia;5203906;Buriti Alegre;2;2;4;118
3506102;Bebedouro;5203807;Britânia;2;2;4;692
3550308;São Paulo;5203302;Bela Vista de Goiás;2;2;4;781
3304557;Rio de Janeiro;5203203;Barro Alto;2;2;4;1074
3550308;São Paulo;5202502;Aruanã;2;2;4;1084
5202155;Araguapaz;5202502;Aruanã;2;2;4;50
5101803;Barra do Garças;5201702;Aragarças;2;2;4;8
5201405;Aparecida de Goiânia;5201702;Aragarças;2;2;4;337
1702109;Araguaína;5201405;Aparecida de Goiânia;2;2;4;1070
2111201;São José de Ribamar;5201405;Aparecida de Goiânia;2;2;4;1670
2600054;Abreu e Lima;5201405;Aparecida de Goiânia;2;2;4;1797
2910800;Feira de Santana;5201405;Aparecida de Goiânia;2;2;4;1196
3165537;Sarzedo;5201405;Aparecida de Goiânia;2;2;4;656
3205309;Vitória;5201405;Aparecida de Goiânia;2;2;4;1036
3300407;Barra Mansa;5201405;Aparecida de Goiânia;2;2;4;838
3301702;Duque de Caxias;5201405;Aparecida de Goiânia;2;2;4;922
3502804;Araçatuba;5201405;Aparecida de Goiânia;2;2;4;505
3504602;Bady Bassitt;5201405;Aparecida de Goiânia;2;2;4;455
3507506;Botucatu;5201405;Aparecida de Goiânia;2;2;4;677
3509205;Cajamar;5201405;Aparecida de Goiânia;2;2;4;769
3513009;Cotia;5201405;Aparecida de Goiânia;2;2;4;794
3513801;Diadema;5201405;Aparecida de Goiânia;2;2;4;813
3515004;Embu;5201405;Aparecida de Goiânia;2;2;4;801
3543402;Ribeirão Preto;5201405;Aparecida de Goiânia;2;2;4;506
3549805;São José do Rio Preto;5201405;Aparecida de Goiânia;2;2;4;444
4201307;Araquari;5201405;Aparecida de Goiânia;2;2;4;1060
4209102;Joinville;5201405;Aparecida de Goiânia;2;2;4;1049
4302105;Bento Gonçalves;5201405;Aparecida de Goiânia;2;2;4;1390
4305108;Caxias do Sul;5201405;Aparecida de Goiânia;2;2;4;1384
5008305;Três Lagoas;5201405;Aparecida de Goiânia;2;2;4;512
5101803;Barra do Garças;5201405;Aparecida de Goiânia;2;2;4;338
5108402;Várzea Grande;5201405;Aparecida de Goiânia;2;2;4;745
5200308;Alexânia;5201405;Aparecida de Goiânia;2;2;4;114
5200852;Americano do Brasil;5201306;Anicuns;2;2;4;26
1400100;Boa Vista;5201108;Anápolis;2;2;4;2448
1504208;Marabá;5201108;Anápolis;2;2;4;1211
1702109;Araguaína;5201108;Anápolis;2;2;4;1012
3118601;Contagem;5201108;Anápolis;2;2;4;659
3303906;Petrópolis;5201108;Anápolis;2;2;4;928
3304904;São Gonçalo;5201108;Anápolis;2;2;4;961
3509502;Campinas;5201108;Anápolis;2;2;4;758
3536505;Paulínia;5201108;Anápolis;2;2;4;740
3543402;Ribeirão Preto;5201108;Anápolis;2;2;4;550
4207007;Içara;5201108;Anápolis;2;2;4;1374
3550308;São Paulo;5200803;Alvorada do Norte;2;2;4;1015
3524006;Itupeva;5200308;Alexânia;2;2;4;799
3534401;Osasco;5200308;Alexânia;2;2;4;846
3550308;São Paulo;5200134;Acreúna;2;2;4;802
5003256;Costa Rica;5200134;Acreúna;2;2;4;322
3550308;São Paulo;5200100;Abadiânia;2;2;4;855
3550308;São Paulo;5108956;Nova Monte Verde;2;2;4;1945
5103403;Cuiabá;5108907;Nova Maringá;2;2;4;299
5105259;Lucas do Rio Verde;5108907;Nova Maringá;2;2;4;127
3106200;Belo Horizonte;5108600;Vila Rica;2;2;4;1359
5101803;Barra do Garças;5108600;Vila Rica;2;2;4;654
5107909;Sinop;5108501;Vera;2;2;4;54
5107925;Sorriso;5108501;Vera;2;2;4;55
5108402;Várzea Grande;5108501;Vera;2;2;4;382
1100304;Vilhena;5108402;Várzea Grande;2;2;4;530
1505031;Novo Progresso;5108402;Várzea Grande;2;2;4;944
1506807;Santarém;5108402;Várzea Grande;2;2;4;1465
1702109;Araguaína;5108402;Várzea Grande;2;2;4;1258
2919553;Luís Eduardo magalhães;5108402;Várzea Grande;2;2;4;1170
3106200;Belo Horizonte;5108402;Várzea Grande;2;2;4;1403
3170206;Uberlândia;5108402;Várzea Grande;2;2;4;927
3205002;Serra;5108402;Várzea Grande;2;2;4;1792
3505708;Barueri;5108402;Várzea Grande;2;2;4;1340
3509502;Campinas;5108402;Várzea Grande;2;2;4;1280
3543402;Ribeirão Preto;5108402;Várzea Grande;2;2;4;1096
3548807;São Caetano do Sul;5108402;Várzea Grande;2;2;4;1373
3552403;Sumaré;5108402;Várzea Grande;2;2;4;1257
4101408;Apucarana;5108402;Várzea Grande;2;2;4;1017
4101804;Araucária;5108402;Várzea Grande;2;2;4;1330
4104808;Cascavel;5108402;Várzea Grande;2;2;4;1071
4115200;Maringá;5108402;Várzea Grande;2;2;4;978
4127700;Toledo;5108402;Várzea Grande;2;2;4;1039
4209003;Joaçaba;5108402;Várzea Grande;2;2;4;1372
4314902;Porto Alegre;5108402;Várzea Grande;2;2;4;1689
5100201;Água Boa;5108402;Várzea Grande;2;2;4;461
5101407;Aripuanã;5108402;Várzea Grande;2;2;4;694
5101704;Barra do Bugres;5108402;Várzea Grande;2;2;4;128
5104104;Guarantã do Norte;5108402;Várzea Grande;2;2;4;644
5105150;Juína;5108402;Várzea Grande;2;2;4;545
5106232;Nova Olímpia;5108402;Várzea Grande;2;2;4;153
5107107;São José dos Quatro Marcos;5108402;Várzea Grande;2;2;4;214
5105002;Jauru;5108352;Vale de São  Domingos;2;2;4;23
5105580;Marcelândia;5108303;União do Sul;2;2;4;54
4106902;Curitiba;5108006;Tapurah;2;2;4;1621
5104542;Itanhangá;5108006;Tapurah;2;2;4;68
5106240;Nova Ubiratã;5108006;Tapurah;2;2;4;143
1100056;Cerejeiras;5107958;Tangará da Serra;2;2;4;393
1100304;Vilhena;5107958;Tangará da Serra;2;2;4;351
3541406;Presidente Prudente;5107958;Tangará da Serra;2;2;4;1068
4104808;Cascavel;5107958;Tangará da Serra;2;2;4;1227
4106902;Curitiba;5107958;Tangará da Serra;2;2;4;1504
5101803;Barra do Garças;5107958;Tangará da Serra;2;2;4;579
5104807;Jaciara;5107958;Tangará da Serra;2;2;4;306
5106752;Pontes e Lacerda;5107958;Tangará da Serra;2;2;4;212
5107263;Santo Afonso;5107958;Tangará da Serra;2;2;4;53
5105150;Juína;5107941;Tabaporã;2;2;4;212
5105259;Lucas do Rio Verde;5107941;Tabaporã;2;2;4;226
1100205;Porto Velho;5107925;Sorriso;2;2;4;971
3526902;Limeira;5107925;Sorriso;2;2;4;1448
4108403;Francisco Beltrão;5107925;Sorriso;2;2;4;1529
4113700;Londrina;5107925;Sorriso;2;2;4;1296
4204202;Chapecó;5107925;Sorriso;2;2;4;1651
4314100;Passo Fundo;5107925;Sorriso;2;2;4;1780
5002704;Campo Grande;5107925;Sorriso;2;2;4;881
5102678;Campo Verde;5107925;Sorriso;2;2;4;335
5103056;Cláudia;5107925;Sorriso;2;2;4;148
3525904;Jundiaí;5107909;Sinop;2;2;4;1580
4104808;Cascavel;5107909;Sinop;2;2;4;1466
4113700;Londrina;5107909;Sinop;2;2;4;1356
4122404;Rolândia;5107909;Sinop;2;2;4;1349
4125506;São José dos Pinhais;5107909;Sinop;2;2;4;1673
4305108;Caxias do Sul;5107909;Sinop;2;2;4;1978
4314902;Porto Alegre;5107909;Sinop;2;2;4;2073
5100805;Apiacás;5107909;Sinop;2;2;4;334
5101407;Aripuanã;5107909;Sinop;2;2;4;462
5101803;Barra do Garças;5107909;Sinop;2;2;4;563
5103379;Cotriguaçu;5107909;Sinop;2;2;4;385
5104542;Itanhangá;5107909;Sinop;2;2;4;134
5105176;Juruena;5107909;Sinop;2;2;4;355
5106265;Novo Mundo;5107909;Sinop;2;2;4;214
5106422;Peixoto de Azevedo;5107909;Sinop;2;2;4;186
1100304;Vilhena;5107875;Sapezal;2;2;4;153
4106902;Curitiba;5107875;Sapezal;2;2;4;1739
5103304;Comodoro;5107875;Sapezal;2;2;4;133
5103502;Diamantino;5107875;Sapezal;2;2;4;298
5104609;Itiquira;5107875;Sapezal;2;2;4;688
5106752;Pontes e Lacerda;5107875;Sapezal;2;2;4;259
5103353;Confresa;5107859;São Félix do Araguaia;2;2;4;142
4106902;Curitiba;5107800;Santo Antônio do Leverger;2;2;4;1300
5106281;Novo São Joaquim;5107792;Santo Antônio do Leste;2;2;4;68
3550308;São Paulo;5107768;Santa Rita do Trivelato;2;2;4;1450
5101258;Araputanga;5107750;Salto do Céu;2;2;4;42
5107206;Rio Branco;5107750;Salto do Céu;2;2;4;13
2101400;Balsas;5107602;Rondonópolis;2;2;4;1337
2304400;Fortaleza;5107602;Rondonópolis;2;2;4;2190
2803609;Laranjeiras;5107602;Rondonópolis;2;2;4;1949
3148004;Patos de Minas;5107602;Rondonópolis;2;2;4;909
3518800;Guarulhos;5107602;Rondonópolis;2;2;4;1177
3535507;Paraguaçu Paulista;5107602;Rondonópolis;2;2;4;796
3536505;Paulínia;5107602;Rondonópolis;2;2;4;1078
3543808;Rinópolis;5107602;Rondonópolis;2;2;4;727
3548807;São Caetano do Sul;5107602;Rondonópolis;2;2;4;1190
3549805;São José do Rio Preto;5107602;Rondonópolis;2;2;4;750
3549904;São José dos Campos;5107602;Rondonópolis;2;2;4;1216
4115408;Marmeleiro;5107602;Rondonópolis;2;2;4;1092
4118501;Pato Branco;5107602;Rondonópolis;2;2;4;1108
4209300;Lages;5107602;Rondonópolis;2;2;4;1348
4310603;Itaqui;5107602;Rondonópolis;2;2;4;1427
5003702;Dourados;5107602;Rondonópolis;2;2;4;643
5102504;Cáceres;5107602;Rondonópolis;2;2;4;323
5102637;Campo Novo do Parecis;5107602;Rondonópolis;2;2;4;458
5103502;Diamantino;5107602;Rondonópolis;2;2;4;291
5105622;Mirassol d'Oeste;5107602;Rondonópolis;2;2;4;374
5107065;Querência;5107602;Rondonópolis;2;2;4;500
5103353;Confresa;5107354;São José do Xingu;2;2;4;130
3550308;São Paulo;5107198;Ribeirãozinho;2;2;4;1031
5100201;Água Boa;5107180;Ribeirão Cascalheira;2;2;4;128
5101803;Barra do Garças;5107180;Ribeirão Cascalheira;2;2;4;321
5102702;Canarana;5107180;Ribeirão Cascalheira;2;2;4;82
5101258;Araputanga;5107156;Reserva do Cabaçal;2;2;4;40
5103403;Cuiabá;5107156;Reserva do Cabaçal;2;2;4;260
3550308;São Paulo;5107107;São José dos Quatro Marcos;2;2;4;1546
2611606;Recife;5107040;Primavera do Leste;2;2;4;2211
3133105;Itanhandu;5107040;Primavera do Leste;2;2;4;1273
3304557;Rio de Janeiro;5107040;Primavera do Leste;2;2;4;1462
3543402;Ribeirão Preto;5107040;Primavera do Leste;2;2;4;947
4115200;Maringá;5107040;Primavera do Leste;2;2;4;914
5002951;Chapadão do Sul;5107040;Primavera do Leste;2;2;4;407
5101852;Bom Jesus do Araguaia;5107040;Primavera do Leste;2;2;4;479
5103858;Gaúcha do Norte;5107040;Primavera do Leste;2;2;4;287
5103908;General Carneiro;5107040;Primavera do Leste;2;2;4;169
5106240;Nova Ubiratã;5107040;Primavera do Leste;2;2;4;297
5106257;Nova Xavantina;5107040;Primavera do Leste;2;2;4;227
5101258;Araputanga;5106828;Porto Esperidião;2;2;4;46
5106752;Pontes e Lacerda;5106828;Porto Esperidião;2;2;4;114
3543402;Ribeirão Preto;5106802;Porto dos Gaúchos;2;2;4;1509
5105101;Juara;5106802;Porto dos Gaúchos;2;2;4;32
5105259;Lucas do Rio Verde;5106802;Porto dos Gaúchos;2;2;4;234
5102694;CanaBrava do Norte;5106778;Porto Alegre do Norte;2;2;4;27
4316808;Santa Cruz do Sul;5106752;Pontes e Lacerda;2;2;4;1779
5103304;Comodoro;5106752;Pontes e Lacerda;2;2;4;184
5105507;Vila Bela da Santíssima Trindade;5106752;Pontes e Lacerda;2;2;4;69
3550308;São Paulo;5106653;Pontal do Araguaia;2;2;4;1058
5102504;Cáceres;5106505;Poconé;2;2;4;113
5102678;Campo Verde;5106455;Planalto da Serra;2;2;4;104
1500602;Altamira;5106422;Peixoto de Azevedo;2;2;4;840
5100250;Alta Floresta;5106422;Peixoto de Azevedo;2;2;4;125
3550308;São Paulo;5106372;Pedra Preta;2;2;4;1155
5103502;Diamantino;5106372;Pedra Preta;2;2;4;321
5103205;Colíder;5106299;Paranaíta;2;2;4;168
5101803;Barra do Garças;5106281;Novo São Joaquim;2;2;4;129
3550308;São Paulo;5106240;Nova Ubiratã;2;2;4;1521
5002704;Campo Grande;5106240;Nova Ubiratã;2;2;4;825
5106224;Nova Mutum;5106240;Nova Ubiratã;2;2;4;130
3304557;Rio de Janeiro;5106224;Nova Mutum;2;2;4;1737
4101507;Arapongas;5106224;Nova Mutum;2;2;4;1178
4106902;Curitiba;5106224;Nova Mutum;2;2;4;1491
4118204;Paranaguá;5106224;Nova Mutum;2;2;4;1548
4314902;Porto Alegre;5106224;Nova Mutum;2;2;4;1879
3516200;Franca;5106216;Nova Canaã do Norte;2;2;4;1437
5103205;Colíder;5106190;Nova Santa Helena;2;2;4;31
5100250;Alta Floresta;5106158;Nova Bandeirantes;2;2;4;197
5103379;Cotriguaçu;5106158;Nova Bandeirantes;2;2;4;58
5105150;Juína;5106158;Nova Bandeirantes;2;2;4;198
3550308;São Paulo;5106000;Nortelândia;2;2;4;1514
3550308;São Paulo;5105903;Nobres;2;2;4;1460
3549805;São José do Rio Preto;5105622;Mirassol d'Oeste;2;2;4;1104
5101407;Aripuanã;5105622;Mirassol d'Oeste;2;2;4;622
5103437;Curvelândia;5105622;Mirassol d'Oeste;2;2;4;21
5105002;Jauru;5105622;Mirassol d'Oeste;2;2;4;90
5105101;Juara;5105622;Mirassol d'Oeste;2;2;4;492
3550308;São Paulo;5105606;Matupá;2;2;4;1761
5103205;Colíder;5105606;Matupá;2;2;4;91
5105259;Lucas do Rio Verde;5105606;Matupá;2;2;4;336
1718204;Porto Nacional;5105259;Lucas do Rio Verde;2;2;4;855
3170206;Uberlândia;5105259;Lucas do Rio Verde;2;2;4;1059
4113700;Londrina;5105259;Lucas do Rio Verde;2;2;4;1250
5002704;Campo Grande;5105259;Lucas do Rio Verde;2;2;4;826
5102637;Campo Novo do Parecis;5105259;Lucas do Rio Verde;2;2;4;227
5103700;Feliz Natal;5105259;Lucas do Rio Verde;2;2;4;130
5105101;Juara;5105259;Lucas do Rio Verde;2;2;4;264
5103403;Cuiabá;5105200;Juscimeira;2;2;4;139
1100304;Vilhena;5105150;Juína;2;2;4;220
5101902;Brasnorte;5105101;Juara;2;2;4;111
5102637;Campo Novo do Parecis;5105101;Juara;2;2;4;269
2611606;Recife;5105002;Jauru;2;2;4;2658
5103809;Figueirópolis d'Oeste;5105002;Jauru;2;2;4;17
1302603;Manaus;5104807;Jaciara;2;2;4;1515
5103601;Dom Aquino;5104807;Jaciara;2;2;4;18
4115200;Maringá;5104609;Itiquira;2;2;4;730
3550308;São Paulo;5104526;Ipiranga do Norte;2;2;4;1651
5100409;Alto Garças;5104203;Guiratinga;2;2;4;72
3304557;Rio de Janeiro;5104104;Guarantã do Norte;2;2;4;1942
5103403;Cuiabá;5104104;Guarantã do Norte;2;2;4;633
3550308;São Paulo;5103908;General Carneiro;2;2;4;1108
5102678;Campo Verde;5103601;Dom Aquino;2;2;4;42
4104808;Cascavel;5103502;Diamantino;2;2;4;1212
5101704;Barra do Bugres;5103502;Diamantino;2;2;4;106
5101308;Arenápolis;5103452;Denise;2;2;4;40
5101704;Barra do Bugres;5103452;Denise;2;2;4;35
1400100;Boa Vista;5103403;Cuiabá;2;2;4;2093
1505031;Novo Progresso;5103403;Cuiabá;2;2;4;933
1506807;Santarém;5103403;Cuiabá;2;2;4;1454
2105302;Imperatriz;5103403;Cuiabá;2;2;4;1437
2304285;Eusébio;5103403;Cuiabá;2;2;4;2261
2307650;Maracanaú;5103403;Cuiabá;2;2;4;2246
2607901;Jaboatão dos Guararapes;5103403;Cuiabá;2;2;4;2375
2609600;Olinda;5103403;Cuiabá;2;2;4;2393
2903201;Barreiras;5103403;Cuiabá;2;2;4;1241
3143302;Montes Claros;5103403;Cuiabá;2;2;4;1322
3201209;Cachoeiro de Itapemirim;5103403;Cuiabá;2;2;4;1736
3501608;Americana;5103403;Cuiabá;2;2;4;1246
3503307;Araras;5103403;Cuiabá;2;2;4;1215
3504008;Assis;5103403;Cuiabá;2;2;4;1001
3526704;Leme;5103403;Cuiabá;2;2;4;1202
3526902;Limeira;5103403;Cuiabá;2;2;4;1229
3538709;Piracicaba;5103403;Cuiabá;2;2;4;1221
3539806;Poá;5103403;Cuiabá;2;2;4;1386
3547809;Santo André;5103403;Cuiabá;2;2;4;1381
3552205;Sorocaba;5103403;Cuiabá;2;2;4;1289
3556206;Valinhos;5103403;Cuiabá;2;2;4;1292
3557105;Votuporanga;5103403;Cuiabá;2;2;4;857
4101804;Araucária;5103403;Cuiabá;2;2;4;1335
4104204;Campo Largo;5103403;Cuiabá;2;2;4;1315
4122701;Sabáudia;5103403;Cuiabá;2;2;4;993
4125506;São José dos Pinhais;5103403;Cuiabá;2;2;4;1344
4204202;Chapecó;5103403;Cuiabá;2;2;4;1336
4205407;Florianópolis;5103403;Cuiabá;2;2;4;1578
4208203;Itajaí;5103403;Cuiabá;2;2;4;1502
4217600;Siderópolis;5103403;Cuiabá;2;2;4;1624
4313904;Panambi;5103403;Cuiabá;2;2;4;1438
5100300;Alto Araguaia;5103403;Cuiabá;2;2;4;365
5101258;Araputanga;5103403;Cuiabá;2;2;4;243
5101407;Aripuanã;5103403;Cuiabá;2;2;4;688
5101902;Brasnorte;5103403;Cuiabá;2;2;4;426
5103254;Colniza;5103403;Cuiabá;2;2;4;752
4305108;Caxias do Sul;5103361;Conquista D'Oeste;2;2;4;1874
5101258;Araputanga;5103361;Conquista D'Oeste;2;2;4;162
5100201;Água Boa;5103353;Confresa;2;2;4;382
5101803;Barra do Garças;5103353;Confresa;2;2;4;577
1100205;Porto Velho;5103304;Comodoro;2;2;4;695
3502804;Araçatuba;5103304;Comodoro;2;2;4;1326
3550308;São Paulo;5103304;Comodoro;2;2;4;1831
4108403;Francisco Beltrão;5103304;Comodoro;2;2;4;1568
5101258;Araputanga;5103304;Comodoro;2;2;4;249
5102686;Campos de Júlio;5103304;Comodoro;2;2;4;74
4106902;Curitiba;5103205;Colíder;2;2;4;1762
5101407;Aripuanã;5103205;Colíder;2;2;4;435
5102793;Carlinda;5103205;Colíder;2;2;4;103
5101407;Aripuanã;5102850;Castanheira;2;2;4;130
3539301;Pirassununga;5102702;Canarana;2;2;4;1079
5002704;Campo Grande;5102678;Campo Verde;2;2;4;546
5101803;Barra do Garças;5102678;Campo Verde;2;2;4;313
5102504;Cáceres;5102678;Campo Verde;2;2;4;275
3304557;Rio de Janeiro;5102637;Campo Novo do Parecis;2;2;4;1917
4106902;Curitiba;5102504;Cáceres;2;2;4;1392
5101258;Araputanga;5102504;Cáceres;2;2;4;99
4101804;Araucária;5101902;Brasnorte;2;2;4;1773
4106902;Curitiba;5101902;Brasnorte;2;2;4;1766
3134400;Iturama;5101803;Barra do Garças;2;2;4;489
3304557;Rio de Janeiro;5101803;Barra do Garças;2;2;4;1258
3502804;Araçatuba;5101803;Barra do Garças;2;2;4;631
3548906;São Carlos;5101803;Barra do Garças;2;2;4;837
5000203;Água Clara;5101803;Barra do Garças;2;2;4;516
5100300;Alto Araguaia;5101803;Barra do Garças;2;2;4;196
5101308;Arenápolis;5101704;Barra do Bugres;2;2;4;75
1100122;Ji-Paraná;5101407;Aripuanã;2;2;4;287
4125506;São José dos Pinhais;5101407;Aripuanã;2;2;4;2056
3549805;São José do Rio Preto;5101258;Araputanga;2;2;4;1145
4106902;Curitiba;5101258;Araputanga;2;2;4;1494
4113700;Londrina;5100607;Alto Taquari;2;2;4;649
5100300;Alto Araguaia;5100607;Alto Taquari;2;2;4;56
3550308;São Paulo;5100409;Alto Garças;2;2;4;1055
3304557;Rio de Janeiro;5100300;Alto Araguaia;2;2;4;1242
4113700;Londrina;5100300;Alto Araguaia;2;2;4;700
1505031;Novo Progresso;5100250;Alta Floresta;2;2;4;312
5002704;Campo Grande;5100250;Alta Floresta;2;2;4;1177
3205309;Vitória;5008305;Três Lagoas;2;2;4;1190
3306305;Volta Redonda;5008305;Três Lagoas;2;2;4;823
3500105;Adamantina;5008305;Três Lagoas;2;2;4;122
3504008;Assis;5008305;Três Lagoas;2;2;4;250
3519071;Hortolândia;5008305;Três Lagoas;2;2;4;527
3519600;Ibitinga;5008305;Três Lagoas;2;2;4;322
3527603;Luís Antônio;5008305;Três Lagoas;2;2;4;430
3530607;Moji das Cruzes;5008305;Três Lagoas;2;2;4;660
3536505;Paulínia;5008305;Três Lagoas;2;2;4;529
3537305;Penápolis;5008305;Três Lagoas;2;2;4;189
3537404;Pereira Barreto;5008305;Três Lagoas;2;2;4;70
3541505;Presidente Venceslau;5008305;Três Lagoas;2;2;4;121
3548807;São Caetano do Sul;5008305;Três Lagoas;2;2;4;628
3550902;São Simão;5008305;Três Lagoas;2;2;4;444
3556305;Valparaíso;5008305;Três Lagoas;2;2;4;104
4101507;Arapongas;5008305;Três Lagoas;2;2;4;295
4113700;Londrina;5008305;Três Lagoas;2;2;4;287
4206504;Guaramirim;5008305;Três Lagoas;2;2;4;696
5001102;Aquidauana;5008305;Três Lagoas;2;2;4;422
5006200;Nova Andradina;5008305;Três Lagoas;2;2;4;239
5006606;Ponta Porã;5008305;Três Lagoas;2;2;4;458
5004908;Jaraguari;5008008;Terenos;2;2;4;58
5002001;Batayporã;5007976;Taquarussu;2;2;4;22
4104808;Cascavel;5007950;Tacuru;2;2;4;217
5002704;Campo Grande;5007950;Tacuru;2;2;4;359
5007208;Rio Brilhante;5007901;Sidrolândia;2;2;4;108
3537305;Penápolis;5007802;Selvíria;2;2;4;184
5001003;Aparecida do Taboado;5007802;Selvíria;2;2;4;46
4107256;Douradina;5007703;Sete Quedas;2;2;4;189
5002704;Campo Grande;5007703;Sete Quedas;2;2;4;393
4106902;Curitiba;5007695;São Gabriel do Oeste;2;2;4;875
4204400;Coronel Freitas;5007695;São Gabriel do Oeste;2;2;4;855
5001508;Bandeirantes;5007695;São Gabriel do Oeste;2;2;4;62
5002605;Camapuã;5007695;São Gabriel do Oeste;2;2;4;56
5003256;Costa Rica;5007695;São Gabriel do Oeste;2;2;4;178
3550308;São Paulo;5007554;Santa Rita do Pardo;2;2;4;697
3534401;Osasco;5007208;Rio Brilhante;2;2;4;831
4115200;Maringá;5007208;Rio Brilhante;2;2;4;328
5005707;Naviraí;5007208;Rio Brilhante;2;2;4;141
3502804;Araçatuba;5007109;Ribas do Rio Pardo;2;2;4;357
4101408;Apucarana;5007109;Ribas do Rio Pardo;2;2;4;424
5000203;Água Clara;5007109;Ribas do Rio Pardo;2;2;4;95
1302603;Manaus;5006606;Ponta Porã;2;2;4;2189
4108809;Guaíra;5006606;Ponta Porã;2;2;4;231
4314902;Porto Alegre;5006606;Ponta Porã;2;2;4;961
5000906;Antônio João;5006606;Ponta Porã;2;2;4;47
5001243;Aral Moreira;5006606;Ponta Porã;2;2;4;46
5002100;Bela Vista;5006606;Ponta Porã;2;2;4;101
5004106;Guia Lopes da Laguna;5006606;Ponta Porã;2;2;4;126
5005251;Laguna Carapã;5006606;Ponta Porã;2;2;4;56
5005400;Maracaju;5006606;Ponta Porã;2;2;4;114
5006309;Paranaíba;5006606;Ponta Porã;2;2;4;558
3550308;São Paulo;5006408;Pedro Gomes;2;2;4;1050
4106902;Curitiba;5006408;Pedro Gomes;2;2;4;992
5002704;Campo Grande;5006408;Pedro Gomes;2;2;4;258
5003306;Coxim;5006408;Pedro Gomes;2;2;4;43
5000609;Amambaí;5006358;Paranhos;2;2;4;87
3524808;Jales;5006309;Paranaíba;2;2;4;97
3546603;Santa Fé do Sul;5006309;Paranaíba;2;2;4;66
4114609;Marechal Cândido Rondon;5006259;Novo Horizonte do Sul;2;2;4;210
5006200;Nova Andradina;5006259;Novo Horizonte do Sul;2;2;4;67
3541307;Presidente Epitácio;5006200;Nova Andradina;2;2;4;143
3542206;Rancharia;5006200;Nova Andradina;2;2;4;258
4106902;Curitiba;5006200;Nova Andradina;2;2;4;556
4122404;Rolândia;5006200;Nova Andradina;2;2;4;241
5000807;Anaurilândia;5006200;Nova Andradina;2;2;4;68
5002951;Chapadão do Sul;5006200;Nova Andradina;2;2;4;389
3518800;Guarulhos;5006002;Nova Alvorada do Sul;2;2;4;845
4106902;Curitiba;5006002;Nova Alvorada do Sul;2;2;4;693
3550308;São Paulo;5005806;Nioaque;2;2;4;1002
5005004;Jardim;5005806;Nioaque;2;2;4;54
4108809;Guaíra;5005707;Naviraí;2;2;4;120
4113700;Londrina;5005707;Naviraí;2;2;4;314
4115200;Maringá;5005707;Naviraí;2;2;4;238
4314902;Porto Alegre;5005707;Naviraí;2;2;4;841
5004502;Itaporã;5005707;Naviraí;2;2;4;120
3550308;São Paulo;5005681;Mundo Novo;2;2;4;778
4105508;Cianorte;5005681;Mundo Novo;2;2;4;175
4107256;Douradina;5005681;Mundo Novo;2;2;4;119
5002704;Campo Grande;5005681;Mundo Novo;2;2;4;390
5004304;Iguatemi;5005681;Mundo Novo;2;2;4;40
3106200;Belo Horizonte;5005608;Miranda;2;2;4;1295
3304557;Rio de Janeiro;5005608;Miranda;2;2;4;1414
5002159;Bodoquena;5005608;Miranda;2;2;4;49
3534401;Osasco;5005400;Maracaju;2;2;4;902
4106902;Curitiba;5005400;Maracaju;2;2;4;751
4115200;Maringá;5005400;Maracaju;2;2;4;396
3550308;São Paulo;5005251;Laguna Carapã;2;2;4;887
5002704;Campo Grande;5005251;Laguna Carapã;2;2;4;240
3550308;São Paulo;5005202;Ladário;2;2;4;1279
5002704;Campo Grande;5005152;Juti;2;2;4;270
3541406;Presidente Prudente;5005103;Jateí;2;2;4;301
5003801;Fátima do Sul;5005103;Jateí;2;2;4;25
5004007;Glória de Dourados;5005103;Jateí;2;2;4;10
5001102;Aquidauana;5005004;Jardim;2;2;4;127
5003207;Corumbá;5005004;Jardim;2;2;4;310
5003751;Eldorado;5004601;Itaquiraí;2;2;4;36
3550308;São Paulo;5004502;Itaporã;2;2;4;863
5003504;Douradina;5004502;Itaporã;2;2;4;19
5002704;Campo Grande;5004403;Inocência;2;2;4;297
5002704;Campo Grande;5004304;Iguatemi;2;2;4;360
5003702;Dourados;5004304;Iguatemi;2;2;4;162
5003751;Eldorado;5004304;Iguatemi;2;2;4;32
5002704;Campo Grande;5004007;Glória de Dourados;2;2;4;222
5003454;Deodápolis;5004007;Glória de Dourados;2;2;4;17
5000252;Alcinópolis;5003900;Figueirão;2;2;4;40
3550308;São Paulo;5003801;Fátima do Sul;2;2;4;826
5000856;Angélica;5003801;Fátima do Sul;2;2;4;81
5003454;Deodápolis;5003801;Fátima do Sul;2;2;4;38
4127403;Terra Roxa;5003751;Eldorado;2;2;4;45
4128104;Umuarama;5003751;Eldorado;2;2;4;99
3529005;Marília;5003702;Dourados;2;2;4;500
3551702;Sertãozinho;5003702;Dourados;2;2;4;710
4127700;Toledo;5003702;Dourados;2;2;4;297
4219309;Videira;5003702;Dourados;2;2;4;653
5001243;Aral Moreira;5003702;Dourados;2;2;4;116
3550308;São Paulo;5003488;Dois Irmãos do Buriti;2;2;4;968
5001102;Aquidauana;5003488;Dois Irmãos do Buriti;2;2;4;57
5000856;Angélica;5003454;Deodápolis;2;2;4;44
5002704;Campo Grande;5003454;Deodápolis;2;2;4;211
5000252;Alcinópolis;5003256;Costa Rica;2;2;4;59
3146107;Ouro Preto;5003207;Corumbá;2;2;4;1500
3518800;Guarulhos;5003207;Corumbá;2;2;4;1280
3549805;São José do Rio Preto;5003207;Corumbá;2;2;4;895
4314902;Porto Alegre;5003207;Corumbá;2;2;4;1409
4203006;Caçador;5003157;Coronel Sapucaia;2;2;4;604
5001003;Aparecida do Taboado;5002951;Chapadão do Sul;2;2;4;216
3106200;Belo Horizonte;5002902;Cassilândia;2;2;4;824
5001003;Aparecida do Taboado;5002902;Cassilândia;2;2;4;125
1100023;Ariquemes;5002704;Campo Grande;2;2;4;1441
1100304;Vilhena;5002704;Campo Grande;2;2;4;1014
1502152;Canaã dos Carajás;5002704;Campo Grande;2;2;4;1615
2111300;São Luís;5002704;Campo Grande;2;2;4;2240
2607901;Jaboatão dos Guararapes;5002704;Campo Grande;2;2;4;2410
2905701;Camaçari;5002704;Campo Grande;2;2;4;1876
2928901;São Desidério;5002704;Campo Grande;2;2;4;1332
3125101;Extrema;5002704;Campo Grande;2;2;4;917
3201308;Cariacica;5002704;Campo Grande;2;2;4;1483
3205002;Serra;5002704;Campo Grande;2;2;4;1497
3205200;Vila Velha;5002704;Campo Grande;2;2;4;1492
3302403;Macaé;5002704;Campo Grande;2;2;4;1358
3507506;Botucatu;5002704;Campo Grande;2;2;4;708
3509007;Caieiras;5002704;Campo Grande;2;2;4;895
3511102;Catanduva;5002704;Campo Grande;2;2;4;598
3515202;Estrela d'Oeste;5002704;Campo Grande;2;2;4;444
3518206;Guararapes;5002704;Campo Grande;2;2;4;429
3525904;Jundiaí;5002704;Campo Grande;2;2;4;871
3526704;Leme;5002704;Campo Grande;2;2;4;786
3529005;Marília;5002704;Campo Grande;2;2;4;532
3530102;Mirandópolis;5002704;Campo Grande;2;2;4;379
3538709;Piracicaba;5002704;Campo Grande;2;2;4;781
3544905;Sales Oliveira;5002704;Campo Grande;2;2;4;713
3548500;Santos;5002704;Campo Grande;2;2;4;957
4102604;Barracão;5002704;Campo Grande;2;2;4;653
4103701;Cambé;5002704;Campo Grande;2;2;4;477
4114807;Marialva;5002704;Campo Grande;2;2;4;453
4117909;Palotina;5002704;Campo Grande;2;2;4;438
4119509;Piraquara;5002704;Campo Grande;2;2;4;813
4119905;Ponta Grossa;5002704;Campo Grande;2;2;4;704
4127700;Toledo;5002704;Campo Grande;2;2;4;485
4201307;Araquari;5002704;Campo Grande;2;2;4;908
4204202;Chapecó;5002704;Campo Grande;2;2;4;771
4302105;Bento Gonçalves;5002704;Campo Grande;2;2;4;1025
4306106;Cruz Alta;5002704;Campo Grande;2;2;4;917
4314100;Passo Fundo;5002704;Campo Grande;2;2;4;900
4314407;Pelotas;5002704;Campo Grande;2;2;4;1276
5000807;Anaurilândia;5002704;Campo Grande;2;2;4;275
5000856;Angélica;5002704;Campo Grande;2;2;4;212
5001243;Aral Moreira;5002704;Campo Grande;2;2;4;295
5002308;Brasilândia;5002704;Campo Grande;2;2;4;286
4104303;Campo Mourão;5002407;Caarapó;2;2;4;297
4128104;Umuarama;5002407;Caarapó;2;2;4;199
3555109;Tupi Paulista;5002308;Brasilândia;2;2;4;53
5002100;Bela Vista;5002209;Bonito;2;2;4;107
3550308;São Paulo;5002001;Batayporã;2;2;4;702
4113700;Londrina;5002001;Batayporã;2;2;4;246
3541505;Presidente Venceslau;5001904;Bataguassu;2;2;4;60
4106902;Curitiba;5001904;Bataguassu;2;2;4;528
3170206;Uberlândia;5001003;Aparecida do Taboado;2;2;4;323
3534401;Osasco;5001003;Aparecida do Taboado;2;2;4;595
3556305;Valparaíso;5001003;Aparecida do Taboado;2;2;4;129
4106902;Curitiba;5000609;Amambaí;2;2;4;667
3148004;Patos de Minas;5000203;Água Clara;2;2;4;691
3543402;Ribeirão Preto;5000203;Água Clara;2;2;4;536
4313201;Nova Petrópolis;4323804;Xangri-lá;2;2;4;111
4318705;São Leopoldo;4323804;Xangri-lá;2;2;4;104
4305207;Cerro Largo;4323754;Vitória das Missões;2;2;4;32
4312179;Mato Queimado;4323754;Vitória das Missões;2;2;4;16
3550308;São Paulo;4323507;Vista Alegre;2;2;4;785
4301602;Bagé;4323457;Vila Nova do Sul;2;2;4;112
4302808;Caçapava do Sul;4323457;Vila Nova do Sul;2;2;4;45
4305108;Caxias do Sul;4323309;Vila Flores;2;2;4;48
4322806;Veranópolis;4323309;Vila Flores;2;2;4;8
4304705;Carazinho;4323200;Victor Graeff;2;2;4;30
4307005;Erechim;4323200;Victor Graeff;2;2;4;113
4314902;Porto Alegre;4323200;Victor Graeff;2;2;4;225
4314902;Porto Alegre;4323101;Vicente Dutra;2;2;4;389
4211900;Palhoça;4323002;Viamão;2;2;4;345
4305108;Caxias do Sul;4323002;Viamão;2;2;4;103
4309308;Guaíba;4323002;Viamão;2;2;4;31
4313409;Novo Hamburgo;4323002;Viamão;2;2;4;44
4321600;Tramandaí;4323002;Viamão;2;2;4;84
4314902;Porto Alegre;4322905;Viadutos;2;2;4;287
4306452;Dois Lajeados;4322855;Vespasiano Correa;2;2;4;10
2928703;Santo Antônio de Jesus;4322806;Veranópolis;2;2;4;2099
3518800;Guarulhos;4322806;Veranópolis;2;2;4;772
4307906;Farroupilha;4322806;Veranópolis;2;2;4;38
4311403;Lajeado;4322806;Veranópolis;2;2;4;72
4311809;Marau;4322806;Veranópolis;2;2;4;83
4314100;Passo Fundo;4322806;Veranópolis;2;2;4;112
4300109;Agudo;4322707;Vera Cruz;2;2;4;71
4306908;Encruzilhada do Sul;4322707;Vera Cruz;2;2;4;88
4311403;Lajeado;4322707;Vera Cruz;2;2;4;56
4315701;Rio Pardo;4322707;Vera Cruz;2;2;4;25
4320800;Soledade;4322707;Vera Cruz;2;2;4;98
4122008;Rio Azul;4322608;Venâncio Aires;2;2;4;449
4125506;São José dos Pinhais;4322608;Venâncio Aires;2;2;4;533
4303004;Cachoeira do Sul;4322608;Venâncio Aires;2;2;4;83
4303509;Camaquã;4322608;Venâncio Aires;2;2;4;142
4305173;Cerro Grande do Sul;4322608;Venâncio Aires;2;2;4;118
4314076;Passo do Sobrado;4322608;Venâncio Aires;2;2;4;18
4316758;Santa Clara do Sul;4322608;Venâncio Aires;2;2;4;17
4319505;São Sebastião do Caí;4322608;Venâncio Aires;2;2;4;79
4304903;Casca;4322558;Vanini;2;2;4;16
4319505;São Sebastião do Caí;4322541;Vale Real;2;2;4;25
4309571;Herveiras;4322533;Vale do Sol;2;2;4;22
4315701;Rio Pardo;4322525;Vale Verde;2;2;4;22
3534401;Osasco;4322509;Vacaria;2;2;4;680
4216503;São Joaquim;4322509;Vacaria;2;2;4;99
4219309;Videira;4322509;Vacaria;2;2;4;168
4303103;Cachoeirinha;4322509;Vacaria;2;2;4;161
4307906;Farroupilha;4322509;Vacaria;2;2;4;89
3518800;Guarulhos;4322400;Uruguaiana;2;2;4;1214
3548500;Santos;4322400;Uruguaiana;2;2;4;1203
4113700;Londrina;4322400;Uruguaiana;2;2;4;910
4301875;Barra do Quaraí;4322400;Uruguaiana;2;2;4;65
4305108;Caxias do Sul;4322400;Uruguaiana;2;2;4;573
4314407;Pelotas;4322400;Uruguaiana;2;2;4;506
4317202;Santa Rosa;4322400;Uruguaiana;2;2;4;329
4305207;Cerro Largo;4322343;Ubiretama;2;2;4;13
4314407;Pelotas;4322327;Turuçu;2;2;4;39
4318804;São Lourenço do Sul;4322327;Turuçu;2;2;4;19
4305207;Cerro Largo;4322301;Tuparendi;2;2;4;51
4306734;Doutor Maurício Cardoso;4322301;Tuparendi;2;2;4;30
4314902;Porto Alegre;4322301;Tuparendi;2;2;4;414
4305108;Caxias do Sul;4322251;Tupandi;2;2;4;42
4312401;Montenegro;4322251;Tupandi;2;2;4;22
4314902;Porto Alegre;4322251;Tupandi;2;2;4;67
4315602;Rio Grande;4322251;Tupandi;2;2;4;298
4305108;Caxias do Sul;4322202;Tupanciretã;2;2;4;261
4310009;Ibirubá;4322202;Tupanciretã;2;2;4;90
4316808;Santa Cruz do Sul;4322202;Tupanciretã;2;2;4;156
4305207;Cerro Largo;4322103;Tucunduva;2;2;4;62
4309001;Giruá;4322103;Tucunduva;2;2;4;42
4314902;Porto Alegre;4322103;Tucunduva;2;2;4;418
4321808;Três de Maio;4322103;Tucunduva;2;2;4;22
3301702;Duque de Caxias;4322004;Triunfo;2;2;4;1115
3509502;Campinas;4322004;Triunfo;2;2;4;890
4302709;Butiá;4322004;Triunfo;2;2;4;34
4303103;Cachoeirinha;4322004;Triunfo;2;2;4;57
4305108;Caxias do Sul;4322004;Triunfo;2;2;4;98
4314902;Porto Alegre;4321956;Trindade do Sul;2;2;4;328
4320909;Tapejara;4321956;Trindade do Sul;2;2;4;106
3550308;São Paulo;4321907;Três Passos;2;2;4;825
4301602;Bagé;4321907;Três Passos;2;2;4;430
4303004;Cachoeira do Sul;4321907;Três Passos;2;2;4;300
4303103;Cachoeirinha;4321907;Três Passos;2;2;4;395
4303509;Camaquã;4321907;Três Passos;2;2;4;431
4305207;Cerro Largo;4321907;Três Passos;2;2;4;110
4307450;Esperança do Sul;4321907;Três Passos;2;2;4;13
4308508;Frederico Westphalen;4321907;Três Passos;2;2;4;56
4309605;Horizontina;4321907;Três Passos;2;2;4;40
4311205;Júlio de Castilhos;4321907;Três Passos;2;2;4;197
4311403;Lajeado;4321907;Três Passos;2;2;4;290
4313904;Panambi;4321907;Três Passos;2;2;4;101
4316808;Santa Cruz do Sul;4321907;Três Passos;2;2;4;293
4317400;Santiago;4321907;Três Passos;2;2;4;213
4313904;Panambi;4321808;Três de Maio;2;2;4;94
4317806;Santo Augusto;4321808;Três de Maio;2;2;4;48
4317905;Santo Cristo;4321808;Três de Maio;2;2;4;42
4303905;Campo Bom;4321709;Três Coroas;2;2;4;32
4304606;Canoas;4321709;Três Coroas;2;2;4;59
4314100;Passo Fundo;4321709;Três Coroas;2;2;4;210
4314902;Porto Alegre;4321709;Três Coroas;2;2;4;72
4316808;Santa Cruz do Sul;4321709;Três Coroas;2;2;4;162
4318200;São Francisco de Paula;4321709;Três Coroas;2;2;4;20
4301057;Arroio do Sal;4321667;Três Cachoeiras;2;2;4;11
3550308;São Paulo;4321600;Tramandaí;2;2;4;774
4302105;Bento Gonçalves;4321600;Tramandaí;2;2;4;159
4304408;Canela;4321600;Tramandaí;2;2;4;95
4312401;Montenegro;4321600;Tramandaí;2;2;4;134
4314100;Passo Fundo;4321600;Tramandaí;2;2;4;288
4314423;Picada Café;4321600;Tramandaí;2;2;4;112
4315149;Presidente Lucena;4321600;Tramandaí;2;2;4;111
4316907;Santa Maria;4321600;Tramandaí;2;2;4;355
4318408;São Jerônimo;4321600;Tramandaí;2;2;4;151
4321501;Torres;4321600;Tramandaí;2;2;4;81
4201406;Araranguá;4321501;Torres;2;2;4;51
4306403;Dois Irmãos;4321501;Torres;2;2;4;128
4306551;Dom Pedro de Alcântara;4321501;Torres;2;2;4;7
4313409;Novo Hamburgo;4321501;Torres;2;2;4;135
4306007;Crissiumal;4321477;Tiradentes do Sul;2;2;4;11
1100205;Porto Velho;4321451;Teutônia;2;2;4;2538
4301602;Bagé;4321451;Teutônia;2;2;4;307
4302451;Boqueirão do Leão;4321451;Teutônia;2;2;4;62
4304200;Candelária;4321451;Teutônia;2;2;4;102
4304804;Carlos Barbosa;4321451;Teutônia;2;2;4;34
4305108;Caxias do Sul;4321451;Teutônia;2;2;4;69
4306205;Cruzeiro do Sul;4321451;Teutônia;2;2;4;22
4306809;Encantado;4321451;Teutônia;2;2;4;26
4308607;Garibaldi;4321451;Teutônia;2;2;4;34
4309555;Harmonia;4321451;Teutônia;2;2;4;39
4315800;Roca Sales;4321451;Teutônia;2;2;4;19
4318408;São Jerônimo;4321451;Teutônia;2;2;4;57
4317608;Santo Antônio da Patrulha;4321436;Terra de Areia;2;2;4;51
4208401;Itapiranga;4321402;Tenente Portela;2;2;4;23
4314902;Porto Alegre;4321402;Tenente Portela;2;2;4;392
4308508;Frederico Westphalen;4321329;Taquaruçu do Sul;2;2;4;9
4302402;Bom Retiro do Sul;4321303;Taquari;2;2;4;23
4304606;Canoas;4321303;Taquari;2;2;4;67
4315602;Rio Grande;4321303;Taquari;2;2;4;255
4304630;Capão da Canoa;4321204;Taquara;2;2;4;72
4306403;Dois Irmãos;4321204;Taquara;2;2;4;30
4307708;Esteio;4321204;Taquara;2;2;4;44
4313060;Nova Hartz;4321204;Taquara;2;2;4;14
4317608;Santo Antônio da Patrulha;4321204;Taquara;2;2;4;31
4300851;Arambaré;4321105;Tapes;2;2;4;29
4305355;Charqueadas;4321105;Tapes;2;2;4;82
4208203;Itajaí;4321006;Tapera;2;2;4;441
4304705;Carazinho;4321006;Tapera;2;2;4;38
4313904;Panambi;4321006;Tapera;2;2;4;73
4314100;Passo Fundo;4321006;Tapera;2;2;4;62
3534401;Osasco;4320909;Tapejara;2;2;4;711
4202537;Bom Jesus;4320909;Tapejara;2;2;4;153
4304622;Capão Bonito do Sul;4320909;Tapejara;2;2;4;61
4304903;Casca;4320909;Tapejara;2;2;4;55
4305371;Charrua;4320909;Tapejara;2;2;4;13
4305975;Coxilha;4320909;Tapejara;2;2;4;28
4307005;Erechim;4320909;Tapejara;2;2;4;55
4311403;Lajeado;4320909;Tapejara;2;2;4;151
4320107;Sarandi;4320909;Tapejara;2;2;4;90
4204202;Chapecó;4320800;Soledade;2;2;4;191
4304705;Carazinho;4320800;Soledade;2;2;4;64
4306809;Encantado;4320800;Soledade;2;2;4;77
4307807;Estrela;4320800;Soledade;2;2;4;94
4308508;Frederico Westphalen;4320800;Soledade;2;2;4;182
4312757;Nova Alvorada;4320800;Soledade;2;2;4;41
4313409;Novo Hamburgo;4320800;Soledade;2;2;4;169
4316808;Santa Cruz do Sul;4320800;Soledade;2;2;4;100
4304200;Candelária;4320701;Sobradinho;2;2;4;36
4311403;Lajeado;4320701;Sobradinho;2;2;4;97
4314068;Passa Sete;4320701;Sobradinho;2;2;4;7
4314100;Passo Fundo;4320701;Sobradinho;2;2;4;143
4316451;Salto do Jacuí;4320701;Sobradinho;2;2;4;41
4319901;Sapiranga;4320701;Sobradinho;2;2;4;198
4320263;Segredo;4320701;Sobradinho;2;2;4;17
4314902;Porto Alegre;4320677;Sinimbu;2;2;4;140
4314902;Porto Alegre;4320651;Silveira Martins;2;2;4;236
4314902;Porto Alegre;4320602;Severiano de Almeida;2;2;4;304
4303509;Camaquã;4320552;Sertão Santana;2;2;4;46
4311981;Mariana Pimentel;4320552;Sertão Santana;2;2;4;12
4314902;Porto Alegre;4320503;Sertão;2;2;4;253
4209102;Joinville;4320404;Serafina Corrêa;2;2;4;401
4303103;Cachoeirinha;4320404;Serafina Corrêa;2;2;4;159
4305108;Caxias do Sul;4320404;Serafina Corrêa;2;2;4;90
4301909;Barra do Ribeiro;4320354;Sentinela do Sul;2;2;4;43
4314902;Porto Alegre;4320354;Sentinela do Sul;2;2;4;72
4317202;Santa Rosa;4320321;Senador Salgado Filho;2;2;4;20
4305603;Colorado;4320305;Selbach;2;2;4;12
4314902;Porto Alegre;4320305;Selbach;2;2;4;234
4314902;Porto Alegre;4320206;Seberi;2;2;4;360
4305108;Caxias do Sul;4320107;Sarandi;2;2;4;219
4306924;Engenho Velho;4320107;Sarandi;2;2;4;26
4309126;Gramado dos Loureiros;4320107;Sarandi;2;2;4;55
4313904;Panambi;4320107;Sarandi;2;2;4;68
4315552;Rio dos Índios;4320107;Sarandi;2;2;4;72
4316428;Sagrada Família;4320107;Sarandi;2;2;4;34
4318457;São José das Missões;4320107;Sarandi;2;2;4;27
3534401;Osasco;4320008;Sapucaia do Sul;2;2;4;809
4106902;Curitiba;4320008;Sapucaia do Sul;2;2;4;519
4202909;Brusque;4320008;Sapucaia do Sul;2;2;4;372
4209102;Joinville;4320008;Sapucaia do Sul;2;2;4;450
4300604;Alvorada;4320008;Sapucaia do Sul;2;2;4;18
4303509;Camaquã;4320008;Sapucaia do Sul;2;2;4;128
4311403;Lajeado;4320008;Sapucaia do Sul;2;2;4;96
4316808;Santa Cruz do Sul;4320008;Sapucaia do Sul;2;2;4;125
2302800;Canindé;4319901;Sapiranga;2;2;4;2992
3518800;Guarulhos;4319901;Sapiranga;2;2;4;805
4105508;Cianorte;4319901;Sapiranga;2;2;4;679
4303509;Camaquã;4319901;Sapiranga;2;2;4;154
4305108;Caxias do Sul;4319901;Sapiranga;2;2;4;55
4307609;Estância Velha;4319901;Sapiranga;2;2;4;16
4307906;Farroupilha;4319901;Sapiranga;2;2;4;56
4309209;Gravataí;4319901;Sapiranga;2;2;4;34
4313508;Osório;4319901;Sapiranga;2;2;4;76
4316808;Santa Cruz do Sul;4319901;Sapiranga;2;2;4;138
4302907;Cacequi;4319802;São Vicente do Sul;2;2;4;27
4316907;Santa Maria;4319802;São Vicente do Sul;2;2;4;83
4317400;Santiago;4319802;São Vicente do Sul;2;2;4;58
4317806;Santo Augusto;4319737;São Valério do Sul;2;2;4;17
4307906;Farroupilha;4319711;São Valentim do Sul;2;2;4;46
4301602;Bagé;4319604;São Sepé;2;2;4;138
3550308;São Paulo;4319505;São Sebastião do Caí;2;2;4;794
4302105;Bento Gonçalves;4319505;São Sebastião do Caí;2;2;4;49
4306809;Encantado;4319505;São Sebastião do Caí;2;2;4;65
4314100;Passo Fundo;4319505;São Sebastião do Caí;2;2;4;177
4314407;Pelotas;4319505;São Sebastião do Caí;2;2;4;256
3550308;São Paulo;4319356;São Pedro da Serra;2;2;4;787
4304804;Carlos Barbosa;4319356;São Pedro da Serra;2;2;4;14
4305207;Cerro Largo;4319208;São Nicolau;2;2;4;53
4306353;Dezesseis de Novembro;4319208;São Nicolau;2;2;4;20
4314555;Pirapó;4319208;São Nicolau;2;2;4;17
4314902;Porto Alegre;4319208;São Nicolau;2;2;4;453
4306932;Entre-Ijuís;4319158;São Miguel das Missões;2;2;4;36
4313102;Nova Palma;4319125;São Martinho da Serra;2;2;4;38
4316907;Santa Maria;4319125;São Martinho da Serra;2;2;4;18
4306007;Crissiumal;4319109;São Martinho;2;2;4;26
4314902;Porto Alegre;4319109;São Martinho;2;2;4;379
4304606;Canoas;4319000;São Marcos;2;2;4;105
4307906;Farroupilha;4319000;São Marcos;2;2;4;39
4314100;Passo Fundo;4319000;São Marcos;2;2;4;152
4310603;Itaqui;4318903;São Luiz Gonzaga;2;2;4;176
3550308;São Paulo;4318804;São Lourenço do Sul;2;2;4;982
4304606;Canoas;4318804;São Lourenço do Sul;2;2;4;175
2304400;Fortaleza;4318705;São Leopoldo;2;2;4;3094
3106705;Betim;4318705;São Leopoldo;2;2;4;1263
3509502;Campinas;4318705;São Leopoldo;2;2;4;851
3524709;Jaguariúna;4318705;São Leopoldo;2;2;4;874
3543907;Rio Claro;4318705;São Leopoldo;2;2;4;881
3552809;Taboão da Serra;4318705;São Leopoldo;2;2;4;797
4125506;São José dos Pinhais;4318705;São Leopoldo;2;2;4;503
4208203;Itajaí;4318705;São Leopoldo;2;2;4;387
4304689;Capela de Santana;4318705;São Leopoldo;2;2;4;18
4304705;Carazinho;4318705;São Leopoldo;2;2;4;226
4305355;Charqueadas;4318705;São Leopoldo;2;2;4;51
4314050;Parobé;4318705;São Leopoldo;2;2;4;33
4309555;Harmonia;4318614;São José do Sul;2;2;4;7
4312401;Montenegro;4318614;São José do Sul;2;2;4;15
4316501;Salvador do Sul;4318614;São José do Sul;2;2;4;10
4312203;Maximiliano de Almeida;4318606;São José do Ouro;2;2;4;26
4314902;Porto Alegre;4318606;São José do Ouro;2;2;4;256
4302204;Boa Vista do Buricá;4318499;São José do Inhacorá;2;2;4;6
4310801;Ivoti;4318481;São José do Hortêncio;2;2;4;13
4314902;Porto Alegre;4318481;São José do Hortêncio;2;2;4;59
4314902;Porto Alegre;4318440;São Jorge;2;2;4;179
4314902;Porto Alegre;4318424;São João da Urtiga;2;2;4;255
4302105;Bento Gonçalves;4318408;São Jerônimo;2;2;4;91
4304200;Candelária;4318408;São Jerônimo;2;2;4;110
4306767;Eldorado do Sul;4318408;São Jerônimo;2;2;4;17
4307906;Farroupilha;4318408;São Jerônimo;2;2;4;89
4309407;Guaporé;4318408;São Jerônimo;2;2;4;125
4315701;Rio Pardo;4318408;São Jerônimo;2;2;4;63
4316907;Santa Maria;4318408;São Jerônimo;2;2;4;204
4208906;Jaraguá do Sul;4318309;São Gabriel;2;2;4;652
4302907;Cacequi;4318309;São Gabriel;2;2;4;71
4303509;Camaquã;4318309;São Gabriel;2;2;4;246
4306106;Cruz Alta;4318309;São Gabriel;2;2;4;199
4306767;Eldorado do Sul;4318309;São Gabriel;2;2;4;259
4307906;Farroupilha;4318309;São Gabriel;2;2;4;308
4311403;Lajeado;4318309;São Gabriel;2;2;4;239
4316972;Santa Margarida do Sul;4318309;São Gabriel;2;2;4;19
4304606;Canoas;4318200;São Francisco de Paula;2;2;4;78
4314100;Passo Fundo;4318200;São Francisco de Paula;2;2;4;219
4311106;Jaguari;4318101;São Francisco de Assis;2;2;4;38
4314902;Porto Alegre;4318101;São Francisco de Assis;2;2;4;387
4306304;David Canabarro;4318051;São Domingos do Sul;2;2;4;16
4301602;Bagé;4318002;São Borja;2;2;4;352
4304606;Canoas;4318002;São Borja;2;2;4;494
4304309;Cândido Godói;4317905;Santo Cristo;2;2;4;17
4314902;Porto Alegre;4317905;Santo Cristo;2;2;4;424
4315073;Porto Vera Cruz;4317905;Santo Cristo;2;2;4;25
4300208;Ajuricaba;4317806;Santo Augusto;2;2;4;43
4313706;Palmeira das Missões;4317806;Santo Augusto;2;2;4;45
4316808;Santa Cruz do Sul;4317806;Santo Augusto;2;2;4;247
4304705;Carazinho;4317756;Santo Antônio do Planalto;2;2;4;14
4305207;Cerro Largo;4317707;Santo Antônio das Missões;2;2;4;62
4314902;Porto Alegre;4317707;Santo Antônio das Missões;2;2;4;432
4317400;Santiago;4317707;Santo Antônio das Missões;2;2;4;84
4301636;Balneário Pinhal;4317608;Santo Antônio da Patrulha;2;2;4;53
4303103;Cachoeirinha;4317608;Santo Antônio da Patrulha;2;2;4;59
4304606;Canoas;4317608;Santo Antônio da Patrulha;2;2;4;65
4305108;Caxias do Sul;4317608;Santo Antônio da Patrulha;2;2;4;96
4306403;Dois Irmãos;4317608;Santo Antônio da Patrulha;2;2;4;61
4306767;Eldorado do Sul;4317608;Santo Antônio da Patrulha;2;2;4;110
4316808;Santa Cruz do Sul;4317608;Santo Antônio da Patrulha;2;2;4;185
4304903;Casca;4317558;Santo Antônio do Palma;2;2;4;8
3106200;Belo Horizonte;4317509;Santo Ângelo;2;2;4;1349
3518800;Guarulhos;4317509;Santo Ângelo;2;2;4;916
4106902;Curitiba;4317509;Santo Ângelo;2;2;4;578
4203006;Caçador;4317509;Santo Ângelo;2;2;4;352
4204202;Chapecó;4317509;Santo Ângelo;2;2;4;208
4205407;Florianópolis;4317509;Santo Ângelo;2;2;4;568
4209003;Joaçaba;4317509;Santo Ângelo;2;2;4;295
4308508;Frederico Westphalen;4317509;Santo Ângelo;2;2;4;135
4311155;Jóia;4317509;Santo Ângelo;2;2;4;40
4311403;Lajeado;4317509;Santo Ângelo;2;2;4;254
4302501;Bossoroca;4317400;Santiago;2;2;4;52
4307906;Farroupilha;4317400;Santiago;2;2;4;343
4317103;Santana do Livramento;4317400;Santiago;2;2;4;195
4317202;Santa Rosa;4317400;Santiago;2;2;4;152
3518800;Guarulhos;4317202;Santa Rosa;2;2;4;908
4125605;São Mateus do Sul;4317202;Santa Rosa;2;2;4;457
4304606;Canoas;4317202;Santa Rosa;2;2;4;396
4306734;Doutor Maurício Cardoso;4317202;Santa Rosa;2;2;4;41
4306932;Entre-Ijuís;4317202;Santa Rosa;2;2;4;58
4307906;Farroupilha;4317202;Santa Rosa;2;2;4;344
4311403;Lajeado;4317202;Santa Rosa;2;2;4;297
4314407;Pelotas;4317202;Santa Rosa;2;2;4;476
4315602;Rio Grande;4317202;Santa Rosa;2;2;4;520
4106902;Curitiba;4317103;Santana do Livramento;2;2;4;834
4307906;Farroupilha;4317103;Santana do Livramento;2;2;4;434
4316808;Santa Cruz do Sul;4317103;Santana do Livramento;2;2;4;317
4316907;Santa Maria;4317103;Santana do Livramento;2;2;4;205
4304507;Canguçu;4317004;Santana da Boa Vista;2;2;4;72
4314902;Porto Alegre;4317004;Santana da Boa Vista;2;2;4;204
4314902;Porto Alegre;4316972;Santa Margarida do Sul;2;2;4;280
4313201;Nova Petrópolis;4316956;Santa Maria do Herval;2;2;4;18
2304400;Fortaleza;4316907;Santa Maria;2;2;4;3186
4202909;Brusque;4316907;Santa Maria;2;2;4;551
4209300;Lages;4316907;Santa Maria;2;2;4;395
4211900;Palhoça;4316907;Santa Maria;2;2;4;537
4300109;Agudo;4316907;Santa Maria;2;2;4;56
4304705;Carazinho;4316907;Santa Maria;2;2;4;185
4306403;Dois Irmãos;4316907;Santa Maria;2;2;4;265
4307005;Erechim;4316907;Santa Maria;2;2;4;273
4307708;Esteio;4316907;Santa Maria;2;2;4;257
4308409;Formigueiro;4316907;Santa Maria;2;2;4;45
4313102;Nova Palma;4316907;Santa Maria;2;2;4;42
4313409;Novo Hamburgo;4316907;Santa Maria;2;2;4;260
2930709;Simões Filho;4316808;Santa Cruz do Sul;2;2;4;2271
3118601;Contagem;4316808;Santa Cruz do Sul;2;2;4;1335
3505708;Barueri;4316808;Santa Cruz do Sul;2;2;4;864
4110706;Irati;4316808;Santa Cruz do Sul;2;2;4;500
4119905;Ponta Grossa;4316808;Santa Cruz do Sul;2;2;4;555
4201257;Apiúna;4316808;Santa Cruz do Sul;2;2;4;416
4202008;Balneário Camboriú;4316808;Santa Cruz do Sul;2;2;4;469
4212908;Pinhalzinho;4316808;Santa Cruz do Sul;2;2;4;323
4216602;São José;4316808;Santa Cruz do Sul;2;2;4;430
4217204;São Miguel do Oeste;4316808;Santa Cruz do Sul;2;2;4;351
4217709;Sombrio;4316808;Santa Cruz do Sul;2;2;4;276
4300406;Alegrete;4316808;Santa Cruz do Sul;2;2;4;322
4306809;Encantado;4316808;Santa Cruz do Sul;2;2;4;75
4306908;Encruzilhada do Sul;4316808;Santa Cruz do Sul;2;2;4;88
4307500;Espumoso;4316808;Santa Cruz do Sul;2;2;4;118
4307609;Estância Velha;4316808;Santa Cruz do Sul;2;2;4;122
4307708;Esteio;4316808;Santa Cruz do Sul;2;2;4;122
4309308;Guaíba;4316808;Santa Cruz do Sul;2;2;4;115
4309605;Horizontina;4316808;Santa Cruz do Sul;2;2;4;294
4310009;Ibirubá;4316808;Santa Cruz do Sul;2;2;4;137
4310801;Ivoti;4316808;Santa Cruz do Sul;2;2;4;124
4311205;Júlio de Castilhos;4316808;Santa Cruz do Sul;2;2;4;133
4311304;Lagoa Vermelha;4316808;Santa Cruz do Sul;2;2;4;189
4313201;Nova Petrópolis;4316808;Santa Cruz do Sul;2;2;4;133
4313508;Osório;4316808;Santa Cruz do Sul;2;2;4;210
4314050;Parobé;4316808;Santa Cruz do Sul;2;2;4;155
4315305;Quaraí;4316808;Santa Cruz do Sul;2;2;4;396
4301008;Arroio do Meio;4316758;Santa Clara do Sul;2;2;4;18
4306205;Cruzeiro do Sul;4316758;Santa Clara do Sul;2;2;4;10
4305702;Condor;4316709;Santa Bárbara do Sul;2;2;4;29
4306106;Cruz Alta;4316709;Santa Bárbara do Sul;2;2;4;47
4312658;Não-Me-Toque;4316709;Santa Bárbara do Sul;2;2;4;43
4203600;Campos Novos;4316600;Sananduva;2;2;4;82
4303202;Cacique Doble;4316600;Sananduva;2;2;4;25
4304903;Casca;4316600;Sananduva;2;2;4;70
4307401;Esmeralda;4316600;Sananduva;2;2;4;62
4106902;Curitiba;4316501;Salvador do Sul;2;2;4;491
4302105;Bento Gonçalves;4316501;Salvador do Sul;2;2;4;31
4304804;Carlos Barbosa;4316501;Salvador do Sul;2;2;4;16
4311403;Lajeado;4316501;Salvador do Sul;2;2;4;50
4307815;Estrela Velha;4316451;Salto do Jacuí;2;2;4;11
4305603;Colorado;4316436;Saldanha Marinho;2;2;4;18
4312658;Não-Me-Toque;4316436;Saldanha Marinho;2;2;4;28
4305207;Cerro Largo;4316303;Roque Gonzales;2;2;4;29
4314902;Porto Alegre;4316204;Rondinha;2;2;4;300
4314100;Passo Fundo;4316105;Ronda Alta;2;2;4;67
4314100;Passo Fundo;4316006;Rolante;2;2;4;234
4300505;Alpestre;4315909;Rodeio Bonito;2;2;4;28
4305157;Cerro Grande;4315909;Rodeio Bonito;2;2;4;15
4306072;Cristal do Sul;4315909;Rodeio Bonito;2;2;4;8
4307302;Erval Seco;4315909;Rodeio Bonito;2;2;4;34
4313441;Novo Tiradentes;4315909;Rodeio Bonito;2;2;4;10
4302659;Brochier;4315800;Roca Sales;2;2;4;38
4307807;Estrela;4315800;Roca Sales;2;2;4;26
4311403;Lajeado;4315800;Roca Sales;2;2;4;23
4313060;Nova Hartz;4315750;Riozinho;2;2;4;44
4314902;Porto Alegre;4315750;Riozinho;2;2;4;86
4304606;Canoas;4315701;Rio Pardo;2;2;4;114
4306908;Encruzilhada do Sul;4315701;Rio Pardo;2;2;4;69
4307906;Farroupilha;4315701;Rio Pardo;2;2;4;125
2408102;Natal;4315602;Rio Grande;2;2;4;3266
3106200;Belo Horizonte;4315602;Rio Grande;2;2;4;1537
3301702;Duque de Caxias;4315602;Rio Grande;2;2;4;1308
3518800;Guarulhos;4315602;Rio Grande;2;2;4;1085
3552809;Taboão da Serra;4315602;Rio Grande;2;2;4;1061
4209300;Lages;4315602;Rio Grande;2;2;4;504
4211306;Navegantes;4315602;Rio Grande;2;2;4;661
4216206;São Francisco do Sul;4315602;Rio Grande;2;2;4;720
4303509;Camaquã;4315602;Rio Grande;2;2;4;142
4305439;Chuí;4315602;Rio Grande;2;2;4;214
4307708;Esteio;4315602;Rio Grande;2;2;4;265
4311007;Jaguarão;4315602;Rio Grande;2;2;4;118
3550308;São Paulo;4315503;Restinga Seca;2;2;4;931
4303004;Cachoeira do Sul;4315503;Restinga Seca;2;2;4;50
4308409;Formigueiro;4315503;Restinga Seca;2;2;4;24
4306809;Encantado;4315453;Relvado;2;2;4;21
4305900;Coronel Bicaco;4315404;Redentora;2;2;4;8
4314902;Porto Alegre;4315404;Redentora;2;2;4;359
4308458;Fortaleza dos Valos;4315354;Quinze de Novembro;2;2;4;14
4307005;Erechim;4315313;Quatro Irmãos;2;2;4;28
4308904;Getúlio Vargas;4315313;Quatro Irmãos;2;2;4;20
4303103;Cachoeirinha;4315305;Quaraí;2;2;4;514
4305108;Caxias do Sul;4315172;Protásio Alves;2;2;4;53
4309902;Ibiraiaras;4315172;Protásio Alves;2;2;4;46
4301008;Arroio do Meio;4315156;Progresso;2;2;4;40
4310801;Ivoti;4315149;Presidente Lucena;2;2;4;8
4311627;Lindolfo Collor;4315149;Presidente Lucena;2;2;4;10
4305207;Cerro Largo;4315008;Porto Lucena;2;2;4;43
2307304;Juazeiro do Norte;4314902;Porto Alegre;2;2;4;2745
2403251;Parnamirim;4314902;Porto Alegre;2;2;4;3034
2506301;Guarabira;4314902;Porto Alegre;2;2;4;2933
2601904;Bezerros;4314902;Porto Alegre;2;2;4;2787
2606200;Goiana;4314902;Porto Alegre;2;2;4;2887
2607208;Ipojuca;4314902;Porto Alegre;2;2;4;2806
2700300;Arapiraca;4314902;Porto Alegre;2;2;4;2601
2909307;Correntina;4314902;Porto Alegre;2;2;4;1944
2913606;Ilhéus;4314902;Porto Alegre;2;2;4;2018
2918407;Juazeiro;4314902;Porto Alegre;2;2;4;2474
2919553;Luís Eduardo magalhães;4314902;Porto Alegre;2;2;4;2047
3103504;Araguari;4314902;Porto Alegre;2;2;4;1294
3125101;Extrema;4314902;Porto Alegre;2;2;4;919
3145901;Ouro Branco;4314902;Porto Alegre;2;2;4;1265
3148004;Patos de Minas;4314902;Porto Alegre;2;2;4;1342
3156700;Sabará;4314902;Porto Alegre;2;2;4;1318
3159605;Santa Rita do Sapucaí;4314902;Porto Alegre;2;2;4;1005
3200607;Aracruz;4314902;Porto Alegre;2;2;4;1519
3203205;Linhares;4314902;Porto Alegre;2;2;4;1571
3205101;Viana;4314902;Porto Alegre;2;2;4;1453
3300308;Barra do Piraí;4314902;Porto Alegre;2;2;4;1086
3300456;Belford Roxo;4314902;Porto Alegre;2;2;4;1088
3302858;Mesquita;4314902;Porto Alegre;2;2;4;1083
3304110;Porto Real;4314902;Porto Alegre;2;2;4;1063
3306008;Três Rios;4314902;Porto Alegre;2;2;4;1155
3502903;Araçoiaba da Serra;4314902;Porto Alegre;2;2;4;799
3503901;Arujá;4314902;Porto Alegre;2;2;4;868
3507100;Bom Jesus dos Perdões;4314902;Porto Alegre;2;2;4;885
3509601;Campo Limpo Paulista;4314902;Porto Alegre;2;2;4;864
3510609;Carapicuíba;4314902;Porto Alegre;2;2;4;831
3511409;Cerqueira César;4314902;Porto Alegre;2;2;4;800
3515707;Ferraz de Vasconcelos;4314902;Porto Alegre;2;2;4;852
3516408;Franco da Rocha;4314902;Porto Alegre;2;2;4;855
3524600;Jacupiranga;4314902;Porto Alegre;2;2;4;666
3528403;Mairinque;4314902;Porto Alegre;2;2;4;813
3531803;Monte Mor;4314902;Porto Alegre;2;2;4;867
3539806;Poá;4314902;Porto Alegre;2;2;4;855
3541208;Presidente Bernardes;4314902;Porto Alegre;2;2;4;892
3546009;Santa Branca;4314902;Porto Alegre;2;2;4;890
3548005;Santo Antônio de Posse;4314902;Porto Alegre;2;2;4;917
3557006;Votorantim;4314902;Porto Alegre;2;2;4;806
4103701;Cambé;4314902;Porto Alegre;2;2;4;749
4104907;Castro;4314902;Porto Alegre;2;2;4;594
4105508;Cianorte;4314902;Porto Alegre;2;2;4;720
4115804;Medianeira;4314902;Porto Alegre;2;2;4;594
4118402;Paranavaí;4314902;Porto Alegre;2;2;4;779
4122404;Rolândia;4314902;Porto Alegre;2;2;4;747
4201208;Antônio Carlos;4314902;Porto Alegre;2;2;4;362
4202073;Balneário Gaivota;4314902;Porto Alegre;2;2;4;182
4205456;Forquilhinha;4314902;Porto Alegre;2;2;4;220
4211306;Navegantes;4314902;Porto Alegre;2;2;4;426
4213351;Ponte Alta do Norte;4314902;Porto Alegre;2;2;4;328
4215802;São Bento do Sul;4314902;Porto Alegre;2;2;4;455
4218004;Tijucas;4314902;Porto Alegre;2;2;4;396
4300208;Ajuricaba;4314902;Porto Alegre;2;2;4;317
4300307;Alecrim;4314902;Porto Alegre;2;2;4;431
4300505;Alpestre;4314902;Porto Alegre;2;2;4;356
4300638;Amaral Ferrador;4314902;Porto Alegre;2;2;4;137
4300646;Ametista do Sul;4314902;Porto Alegre;2;2;4;353
4300703;Anta Gorda;4314902;Porto Alegre;2;2;4;143
4300901;Aratiba;4314902;Porto Alegre;2;2;4;313
4301206;Arroio do Tigre;4314902;Porto Alegre;2;2;4;199
4301404;Arvorezinha;4314902;Porto Alegre;2;2;4;161
4301651;Barão;4314902;Porto Alegre;2;2;4;80
4301701;Barão de Cotegipe;4314902;Porto Alegre;2;2;4;292
4301750;Barão do Triunfo;4314902;Porto Alegre;2;2;4;63
4301800;Barracão;4314902;Porto Alegre;2;2;4;265
4301958;Barra Funda;4314902;Porto Alegre;2;2;4;294
4302006;Barros Cassal;4314902;Porto Alegre;2;2;4;170
4302204;Boa Vista do Buricá;4314902;Porto Alegre;2;2;4;383
4302378;Bom Progresso;4314902;Porto Alegre;2;2;4;377
4302402;Bom Retiro do Sul;4314902;Porto Alegre;2;2;4;87
4303202;Cacique Doble;4314902;Porto Alegre;2;2;4;257
4303400;Caiçara;4314902;Porto Alegre;2;2;4;374
4303673;Campestre da Serra;4314902;Porto Alegre;2;2;4;140
4303707;Campina das Missões;4314902;Porto Alegre;2;2;4;416
4303806;Campinas do Sul;4314902;Porto Alegre;2;2;4;293
4304002;Campo Novo;4314902;Porto Alegre;2;2;4;362
4304713;Caraá;4314902;Porto Alegre;2;2;4;79
4305009;Catuípe;4314902;Porto Alegre;2;2;4;335
4305124;Cerrito;4314902;Porto Alegre;2;2;4;250
4305173;Cerro Grande do Sul;4314902;Porto Alegre;2;2;4;79
4305504;Ciríaco;4314902;Porto Alegre;2;2;4;200
4305587;Colinas;4314902;Porto Alegre;2;2;4;98
4305702;Condor;4314902;Porto Alegre;2;2;4;299
4305801;Constantina;4314902;Porto Alegre;2;2;4;308
4306007;Crissiumal;4314902;Porto Alegre;2;2;4;395
4306056;Cristal;4314902;Porto Alegre;2;2;4;134
4306304;David Canabarro;4314902;Porto Alegre;2;2;4;195
4306700;Dona Francisca;4314902;Porto Alegre;2;2;4;214
4306932;Entre-Ijuís;4314902;Porto Alegre;2;2;4;348
4306957;Entre Rios do Sul;4314902;Porto Alegre;2;2;4;316
4306973;Erebango;4314902;Porto Alegre;2;2;4;265
4307203;Erval Grande;4314902;Porto Alegre;2;2;4;323
4307831;Eugênio de Castro;4314902;Porto Alegre;2;2;4;329
4308003;Faxinal do Soturno;4314902;Porto Alegre;2;2;4;222
4308300;Fontoura Xavier;4314902;Porto Alegre;2;2;4;162
4308409;Formigueiro;4314902;Porto Alegre;2;2;4;222
4308458;Fortaleza dos Valos;4314902;Porto Alegre;2;2;4;239
4308706;Gaurama;4314902;Porto Alegre;2;2;4;287
4309506;Guarani das Missões;4314902;Porto Alegre;2;2;4;384
4309654;Hulha Negra;4314902;Porto Alegre;2;2;4;299
4309704;Humaitá;4314902;Porto Alegre;2;2;4;382
4310306;Ilópolis;4314902;Porto Alegre;2;2;4;153
4310462;Ipiranga do Sul;4314902;Porto Alegre;2;2;4;262
4310702;Itatiba do Sul;4314902;Porto Alegre;2;2;4;320
4311254;Lagoão;4314902;Porto Alegre;2;2;4;178
4311601;Liberato Salzano;4314902;Porto Alegre;2;2;4;325
4311700;Machadinho;4314902;Porto Alegre;2;2;4;279
4311718;Maçambara;4314902;Porto Alegre;2;2;4;478
4311759;Manoel Viana;4314902;Porto Alegre;2;2;4;416
4311775;Maquiné;4314902;Porto Alegre;2;2;4;104
4311791;Maratá;4314902;Porto Alegre;2;2;4;67
4312005;Mariano Moro;4314902;Porto Alegre;2;2;4;312
4312104;Mata;4314902;Porto Alegre;2;2;4;318
4312153;Mato Leitão;4314902;Porto Alegre;2;2;4;109
4312302;Miraguaí;4314902;Porto Alegre;2;2;4;371
4312757;Nova Alvorada;4314902;Porto Alegre;2;2;4;178
4313037;Nova Esperança do Sul;4314902;Porto Alegre;2;2;4;356
4313060;Nova Hartz;4314902;Porto Alegre;2;2;4;60
4313805;Palmitinho;4314902;Porto Alegre;2;2;4;374
4314076;Passo do Sobrado;4314902;Porto Alegre;2;2;4;109
4314308;Pejuçara;4314902;Porto Alegre;2;2;4;296
4314456;Pinhal;4314902;Porto Alegre;2;2;4;342
4314472;Pinhal Grande;4314902;Porto Alegre;2;2;4;217
4314498;Pinheirinho do Vale;4314902;Porto Alegre;2;2;4;390
4314704;Planalto;4314902;Porto Alegre;2;2;4;350
4114203;Mandaguari;4314803;Portão;2;2;4;682
4302352;Bom Princípio;4314803;Portão;2;2;4;26
4303103;Cachoeirinha;4314803;Portão;2;2;4;30
4306809;Encantado;4314803;Portão;2;2;4;83
4307005;Erechim;4314787;Ponte Preta;2;2;4;21
4300505;Alpestre;4314704;Planalto;2;2;4;9
4300646;Ametista do Sul;4314704;Planalto;2;2;4;13
4305108;Caxias do Sul;4314704;Planalto;2;2;4;277
4301602;Bagé;4314605;Piratini;2;2;4;95
4302808;Caçapava do Sul;4314605;Piratini;2;2;4;111
3550308;São Paulo;4314506;Pinheiro Machado;2;2;4;1073
4304507;Canguçu;4314506;Pinheiro Machado;2;2;4;69
4303400;Caiçara;4314498;Pinheirinho do Vale;2;2;4;19
4307609;Estância Velha;4314423;Picada Café;2;2;4;23
3505708;Barueri;4314407;Pelotas;2;2;4;1039
3549904;São José dos Campos;4314407;Pelotas;2;2;4;1115
4115200;Maringá;4314407;Pelotas;2;2;4;920
4209102;Joinville;4314407;Pelotas;2;2;4;685
4209300;Lages;4314407;Pelotas;2;2;4;474
4300406;Alegrete;4314407;Pelotas;2;2;4;383
4301073;Arroio do Padre;4314407;Pelotas;2;2;4;32
4304705;Carazinho;4314407;Pelotas;2;2;4;382
4305124;Cerrito;4314407;Pelotas;2;2;4;41
4307005;Erechim;4314407;Pelotas;2;2;4;454
4308607;Garibaldi;4314407;Pelotas;2;2;4;285
4309100;Gramado;4314407;Pelotas;2;2;4;292
4309209;Gravataí;4314407;Pelotas;2;2;4;237
4309308;Guaíba;4314407;Pelotas;2;2;4;204
4310207;Ijuí;4314407;Pelotas;2;2;4;397
4310603;Itaqui;4314407;Pelotas;2;2;4;481
4314175;Pedras Altas;4314407;Pelotas;2;2;4;115
4313409;Novo Hamburgo;4314159;Paverama;2;2;4;61
3170206;Uberlândia;4314100;Passo Fundo;2;2;4;1107
3171204;Vespasiano;4314100;Passo Fundo;2;2;4;1242
3505708;Barueri;4314100;Passo Fundo;2;2;4;747
4108304;Foz do Iguaçu;4314100;Passo Fundo;2;2;4;366
4119905;Ponta Grossa;4314100;Passo Fundo;2;2;4;411
4205407;Florianópolis;4314100;Passo Fundo;2;2;4;387
4208203;Itajaí;4314100;Passo Fundo;2;2;4;384
4210506;Maravilha;4314100;Passo Fundo;2;2;4;182
4214805;Rio do Sul;4314100;Passo Fundo;2;2;4;295
4218707;Tubarão;4314100;Passo Fundo;2;2;4;331
4301008;Arroio do Meio;4314100;Passo Fundo;2;2;4;135
4301206;Arroio do Tigre;4314100;Passo Fundo;2;2;4;138
4304200;Candelária;4314100;Passo Fundo;2;2;4;164
4304804;Carlos Barbosa;4314100;Passo Fundo;2;2;4;145
4304903;Casca;4314100;Passo Fundo;2;2;4;53
4304952;Caseiros;4314100;Passo Fundo;2;2;4;70
4305355;Charqueadas;4314100;Passo Fundo;2;2;4;203
4306007;Crissiumal;4314100;Passo Fundo;2;2;4;186
4306767;Eldorado do Sul;4314100;Passo Fundo;2;2;4;217
4309605;Horizontina;4314100;Passo Fundo;2;2;4;199
4310108;Igrejinha;4314100;Passo Fundo;2;2;4;216
4312708;Nonoai;4314100;Passo Fundo;2;2;4;106
4314050;Parobé;4314100;Passo Fundo;2;2;4;217
4106902;Curitiba;4314076;Passo do Sobrado;2;2;4;555
3304557;Rio de Janeiro;4314050;Parobé;2;2;4;1033
3516200;Franca;4314050;Parobé;2;2;4;1056
3550308;São Paulo;4314050;Parobé;2;2;4;771
4304200;Candelária;4314050;Parobé;2;2;4;192
4307708;Esteio;4314050;Parobé;2;2;4;41
4309100;Gramado;4314050;Parobé;2;2;4;27
4302659;Brochier;4314035;Pareci Novo;2;2;4;19
4312401;Montenegro;4314035;Pareci Novo;2;2;4;8
4303004;Cachoeira do Sul;4313953;Pantano Grande;2;2;4;56
4301602;Bagé;4313904;Panambi;2;2;4;344
4307906;Farroupilha;4313904;Panambi;2;2;4;237
4308508;Frederico Westphalen;4313904;Panambi;2;2;4;102
4309605;Horizontina;4313904;Panambi;2;2;4;107
4306429;Dois Irmãos das Missões;4313706;Palmeira das Missões;2;2;4;34
4310850;Jaboticaba;4313706;Palmeira das Missões;2;2;4;31
4311429;Lajeado do Bugre;4313706;Palmeira das Missões;2;2;4;28
4301636;Balneário Pinhal;4313656;Palmares do Sul;2;2;4;24
4305454;Cidreira;4313656;Palmares do Sul;2;2;4;29
3518800;Guarulhos;4313508;Osório;2;2;4;794
3552205;Sorocaba;4313508;Osório;2;2;4;755
4104006;Campina Grande do Sul;4313508;Osório;2;2;4;520
4301636;Balneário Pinhal;4313508;Osório;2;2;4;40
4305108;Caxias do Sul;4313508;Osório;2;2;4;118
4310108;Igrejinha;4313508;Osório;2;2;4;61
4311403;Lajeado;4313508;Osório;2;2;4;177
4311775;Maquiné;4313508;Osório;2;2;4;23
4313409;Novo Hamburgo;4313508;Osório;2;2;4;86
4301958;Barra Funda;4313490;Novo Barreiro;2;2;4;7
4306734;Doutor Maurício Cardoso;4313425;Novo Machado;2;2;4;16
1302603;Manaus;4313409;Novo Hamburgo;2;2;4;3049
2930501;Serrinha;4313409;Novo Hamburgo;2;2;4;2282
3303401;Nova Friburgo;4313409;Novo Hamburgo;2;2;4;1146
3509502;Campinas;4313409;Novo Hamburgo;2;2;4;844
3524006;Itupeva;4313409;Novo Hamburgo;2;2;4;819
3524402;Jacareí;4313409;Novo Hamburgo;2;2;4;858
3525300;Jaú;4313409;Novo Hamburgo;2;2;4;856
3547809;Santo André;4313409;Novo Hamburgo;2;2;4;797
4115200;Maringá;4313409;Novo Hamburgo;2;2;4;697
4202909;Brusque;4313409;Novo Hamburgo;2;2;4;357
4204608;Criciúma;4313409;Novo Hamburgo;2;2;4;203
4208906;Jaraguá do Sul;4313409;Novo Hamburgo;2;2;4;406
4216602;São José;4313409;Novo Hamburgo;2;2;4;331
4301602;Bagé;4313409;Novo Hamburgo;2;2;4;343
4302352;Bom Princípio;4313409;Novo Hamburgo;2;2;4;31
4303509;Camaquã;4313409;Novo Hamburgo;2;2;4;144
4304705;Carazinho;4313409;Novo Hamburgo;2;2;4;222
4308102;Feliz;4313409;Novo Hamburgo;2;2;4;32
4310207;Ijuí;4313409;Novo Hamburgo;2;2;4;305
4310330;Imbé;4313409;Novo Hamburgo;2;2;4;100
2905701;Camaçari;4313375;Nova Santa Rita;2;2;4;2236
3534401;Osasco;4313375;Nova Santa Rita;2;2;4;817
3536505;Paulínia;4313375;Nova Santa Rita;2;2;4;876
4105805;Colombo;4313375;Nova Santa Rita;2;2;4;545
4312401;Montenegro;4313375;Nova Santa Rita;2;2;4;30
4300802;Antônio Prado;4313359;Nova Roma do Sul;2;2;4;19
4308201;Flores da Cunha;4313359;Nova Roma do Sul;2;2;4;22
4305108;Caxias do Sul;4313300;Nova Prata;2;2;4;60
4311304;Lagoa Vermelha;4313300;Nova Prata;2;2;4;64
4312476;Morro Reuter;4313201;Nova Petrópolis;2;2;4;18
4308003;Faxinal do Soturno;4313102;Nova Palma;2;2;4;12
4310108;Igrejinha;4313060;Nova Hartz;2;2;4;11
4310207;Ijuí;4313037;Nova Esperança do Sul;2;2;4;143
4302204;Boa Vista do Buricá;4313011;Nova Candelária;2;2;4;7
4301958;Barra Funda;4312955;Nova Boa Vista;2;2;4;10
4305306;Chapada;4312955;Nova Boa Vista;2;2;4;11
4305108;Caxias do Sul;4312906;Nova Bassano;2;2;4;71
4304606;Canoas;4312807;Nova Araçá;2;2;4;149
4308607;Garibaldi;4312807;Nova Araçá;2;2;4;69
4301404;Arvorezinha;4312757;Nova Alvorada;2;2;4;22
4303558;Camargo;4312757;Nova Alvorada;2;2;4;11
3505708;Barueri;4312708;Nonoai;2;2;4;715
4307005;Erechim;4312708;Nonoai;2;2;4;57
4309951;Ibirapuitã;4312674;Nicolau Vergueiro;2;2;4;11
3550308;São Paulo;4312658;Não-Me-Toque;2;2;4;796
4307500;Espumoso;4312658;Não-Me-Toque;2;2;4;30
4309902;Ibiraiaras;4312625;Muliterno;2;2;4;14
4306809;Encantado;4312609;Muçum;2;2;4;10
4310801;Ivoti;4312476;Morro Reuter;2;2;4;10
4208708;Jacinto Machado;4312443;Morrinhos do Sul;2;2;4;44
3304557;Rio de Janeiro;4312401;Montenegro;2;2;4;1079
3534401;Osasco;4312401;Montenegro;2;2;4;811
4106902;Curitiba;4312401;Montenegro;2;2;4;514
4303509;Camaquã;4312401;Montenegro;2;2;4;133
4307609;Estância Velha;4312401;Montenegro;2;2;4;31
4308102;Feliz;4312401;Montenegro;2;2;4;30
4308201;Flores da Cunha;4312401;Montenegro;2;2;4;77
4309308;Guaíba;4312401;Montenegro;2;2;4;52
4309605;Horizontina;4312401;Montenegro;2;2;4;352
4307005;Erechim;4312203;Maximiliano de Almeida;2;2;4;47
3550308;São Paulo;4312153;Mato Leitão;2;2;4;832
4301008;Arroio do Meio;4312054;Marques de Souza;2;2;4;17
4200754;Alto Bela Vista;4311908;Marcelino Ramos;2;2;4;4
4204301;Concórdia;4311908;Marcelino Ramos;2;2;4;29
3515004;Embu;4311809;Marau;2;2;4;739
3550308;São Paulo;4311809;Marau;2;2;4;752
4302105;Bento Gonçalves;4311809;Marau;2;2;4;104
4305108;Caxias do Sul;4311809;Marau;2;2;4;128
4308508;Frederico Westphalen;4311809;Marau;2;2;4;168
4310009;Ibirubá;4311809;Marau;2;2;4;89
4306007;Crissiumal;4311627;Lindolfo Collor;2;2;4;360
4310801;Ivoti;4311627;Lindolfo Collor;2;2;4;7
4305801;Constantina;4311601;Liberato Salzano;2;2;4;17
4301602;Bagé;4311502;Lavras do Sul;2;2;4;61
3552809;Taboão da Serra;4311403;Lajeado;2;2;4;816
4204202;Chapecó;4311403;Lajeado;2;2;4;264
4204301;Concórdia;4311403;Lajeado;2;2;4;245
4204608;Criciúma;4311403;Lajeado;2;2;4;269
4205407;Florianópolis;4311403;Lajeado;2;2;4;395
4208401;Itapiranga;4311403;Lajeado;2;2;4;298
4208906;Jaraguá do Sul;4311403;Lajeado;2;2;4;432
4218707;Tubarão;4311403;Lajeado;2;2;4;307
4301404;Arvorezinha;4311403;Lajeado;2;2;4;64
4304804;Carlos Barbosa;4311403;Lajeado;2;2;4;53
4307609;Estância Velha;4311403;Lajeado;2;2;4;86
4309001;Giruá;4311403;Lajeado;2;2;4;272
4309308;Guaíba;4311403;Lajeado;2;2;4;101
4203006;Caçador;4311304;Lagoa Vermelha;2;2;4;162
4304705;Carazinho;4311304;Lagoa Vermelha;2;2;4;124
4308904;Getúlio Vargas;4311304;Lagoa Vermelha;2;2;4;80
4208203;Itajaí;4311205;Júlio de Castilhos;2;2;4;538
4305207;Cerro Largo;4311205;Júlio de Castilhos;2;2;4;156
4310751;Ivorá;4311205;Júlio de Castilhos;2;2;4;34
4306106;Cruz Alta;4311155;Jóia;2;2;4;52
4106902;Curitiba;4311007;Jaguarão;2;2;4;868
4307104;Herval;4311007;Jaguarão;2;2;4;58
4307005;Erechim;4310900;Jacutinga;2;2;4;28
3550308;São Paulo;4310801;Ivoti;2;2;4;784
4208203;Itajaí;4310801;Ivoti;2;2;4;373
4303103;Cachoeirinha;4310801;Ivoti;2;2;4;40
4304606;Canoas;4310801;Ivoti;2;2;4;36
4307906;Farroupilha;4310801;Ivoti;2;2;4;44
4307005;Erechim;4310702;Itatiba do Sul;2;2;4;34
4310207;Ijuí;4310603;Itaqui;2;2;4;267
4300646;Ametista do Sul;4310504;Iraí;2;2;4;20
4309001;Giruá;4310405;Independência;2;2;4;27
4304606;Canoas;4310330;Imbé;2;2;4;100
4307708;Esteio;4310330;Imbé;2;2;4;100
3518800;Guarulhos;4310207;Ijuí;2;2;4;895
4204202;Chapecó;4310207;Ijuí;2;2;4;190
4302584;Bozano;4310207;Ijuí;2;2;4;15
4304705;Carazinho;4310207;Ijuí;2;2;4;112
4308508;Frederico Westphalen;4310207;Ijuí;2;2;4;125
4309001;Giruá;4310207;Ijuí;2;2;4;58
3550308;São Paulo;4310108;Igrejinha;2;2;4;764
4304408;Canela;4310108;Igrejinha;2;2;4;26
4304606;Canoas;4310108;Igrejinha;2;2;4;54
4304630;Capão da Canoa;4310108;Igrejinha;2;2;4;75
4307708;Esteio;4310108;Igrejinha;2;2;4;48
4304606;Canoas;4310009;Ibirubá;2;2;4;235
4304952;Caseiros;4309902;Ibiraiaras;2;2;4;12
4305504;Ciríaco;4309902;Ibiraiaras;2;2;4;24
4300109;Agudo;4309753;Ibarama;2;2;4;27
4301206;Arroio do Tigre;4309753;Ibarama;2;2;4;10
4304358;Candiota;4309654;Hulha Negra;2;2;4;25
4304606;Canoas;4309605;Horizontina;2;2;4;401
4306106;Cruz Alta;4309605;Horizontina;2;2;4;133
4309001;Giruá;4309506;Guarani das Missões;2;2;4;24
3550308;São Paulo;4309407;Guaporé;2;2;4;763
4306452;Dois Lajeados;4309407;Guaporé;2;2;4;17
4308300;Fontoura Xavier;4309407;Guaporé;2;2;4;46
3205309;Vitória;4309308;Guaíba;2;2;4;1495
3505708;Barueri;4309308;Guaíba;2;2;4;842
3549904;São José dos Campos;4309308;Guaíba;2;2;4;920
4113700;Londrina;4309308;Guaíba;2;2;4;755
4303103;Cachoeirinha;4309308;Guaíba;2;2;4;28
4304630;Capão da Canoa;4309308;Guaíba;2;2;4;130
4305355;Charqueadas;4309308;Guaíba;2;2;4;33
4307906;Farroupilha;4309308;Guaíba;2;2;4;99
4309100;Gramado;4309308;Guaíba;2;2;4;89
3106200;Belo Horizonte;4309209;Gravataí;2;2;4;1288
3526902;Limeira;4309209;Gravataí;2;2;4;884
3548807;São Caetano do Sul;4309209;Gravataí;2;2;4;815
3549904;São José dos Campos;4309209;Gravataí;2;2;4;887
3552205;Sorocaba;4309209;Gravataí;2;2;4;787
3552403;Sumaré;4309209;Gravataí;2;2;4;862
3556701;Vinhedo;4309209;Gravataí;2;2;4;853
4201307;Araquari;4309209;Gravataí;2;2;4;447
4202008;Balneário Camboriú;4309209;Gravataí;2;2;4;394
4205407;Florianópolis;4309209;Gravataí;2;2;4;351
4207007;Içara;4309209;Gravataí;2;2;4;211
4301057;Arroio do Sal;4309209;Gravataí;2;2;4;114
2304400;Fortaleza;4309100;Gramado;2;2;4;3051
3106200;Belo Horizonte;4309100;Gramado;2;2;4;1235
4106902;Curitiba;4309100;Gramado;2;2;4;465
4205407;Florianópolis;4309100;Gramado;2;2;4;305
4302105;Bento Gonçalves;4309100;Gramado;2;2;4;64
4307708;Esteio;4309100;Gramado;2;2;4;56
4305009;Catuípe;4309001;Giruá;2;2;4;41
4305108;Caxias do Sul;4308904;Getúlio Vargas;2;2;4;178
4306973;Erebango;4308904;Getúlio Vargas;2;2;4;5
3106200;Belo Horizonte;4308607;Garibaldi;2;2;4;1254
4104808;Cascavel;4308607;Garibaldi;2;2;4;512
4122305;Rio Negro;4308607;Garibaldi;2;2;4;387
4204202;Chapecó;4308607;Garibaldi;2;2;4;260
4215802;São Bento do Sul;4308607;Garibaldi;2;2;4;391
4300646;Ametista do Sul;4308508;Frederico Westphalen;2;2;4;21
4306106;Cruz Alta;4308508;Frederico Westphalen;2;2;4;144
4307005;Erechim;4308508;Frederico Westphalen;2;2;4;115
4307302;Erval Seco;4308508;Frederico Westphalen;2;2;4;24
4302238;Boa vista do Incra;4308458;Fortaleza dos Valos;2;2;4;16
4307005;Erechim;4308250;Floriano Peixoto;2;2;4;32
4302402;Bom Retiro do Sul;4308078;Fazenda Vilanova;2;2;4;12
4307005;Erechim;4308052;Faxinalzinho;2;2;4;46
2312908;Sobral;4307906;Farroupilha;2;2;4;2999
3205200;Vila Velha;4307906;Farroupilha;2;2;4;1424
3506003;Bauru;4307906;Farroupilha;2;2;4;792
3516200;Franca;4307906;Farroupilha;2;2;4;1030
3518800;Guarulhos;4307906;Farroupilha;2;2;4;785
3522406;Itapeva;4307906;Farroupilha;2;2;4;626
3524709;Jaguariúna;4307906;Farroupilha;2;2;4;831
3527108;Lins;4307906;Farroupilha;2;2;4;848
3529005;Marília;4307906;Farroupilha;2;2;4;787
3542602;Registro;4307906;Farroupilha;2;2;4;617
3549805;São José do Rio Preto;4307906;Farroupilha;2;2;4;948
3552205;Sorocaba;4307906;Farroupilha;2;2;4;733
3555000;Tupã;4307906;Farroupilha;2;2;4;811
4104808;Cascavel;4307906;Farroupilha;2;2;4;515
4108304;Foz do Iguaçu;4307906;Farroupilha;2;2;4;510
4108403;Francisco Beltrão;4307906;Farroupilha;2;2;4;385
4118204;Paranaguá;4307906;Farroupilha;2;2;4;483
4119905;Ponta Grossa;4307906;Farroupilha;2;2;4;470
4124103;Santo Antônio da Platina;4307906;Farroupilha;2;2;4;667
4128104;Umuarama;4307906;Farroupilha;2;2;4;636
4202305;Biguaçu;4307906;Farroupilha;2;2;4;319
4203006;Caçador;4307906;Farroupilha;2;2;4;270
4204301;Concórdia;4307906;Farroupilha;2;2;4;232
4204608;Criciúma;4307906;Farroupilha;2;2;4;199
4208906;Jaraguá do Sul;4307906;Farroupilha;2;2;4;373
4209003;Joaçaba;4307906;Farroupilha;2;2;4;231
4214805;Rio do Sul;4307906;Farroupilha;2;2;4;276
4215802;São Bento do Sul;4307906;Farroupilha;2;2;4;379
4217204;São Miguel do Oeste;4307906;Farroupilha;2;2;4;351
4300406;Alegrete;4307906;Farroupilha;2;2;4;435
4300802;Antônio Prado;4307906;Farroupilha;2;2;4;41
4301008;Arroio do Meio;4307906;Farroupilha;2;2;4;62
4301057;Arroio do Sal;4307906;Farroupilha;2;2;4;144
4305207;Cerro Largo;4307906;Farroupilha;2;2;4;349
4306106;Cruz Alta;4307906;Farroupilha;2;2;4;228
4306767;Eldorado do Sul;4307906;Farroupilha;2;2;4;99
4306809;Encantado;4307906;Farroupilha;2;2;4;55
4307005;Erechim;4307906;Farroupilha;2;2;4;198
4307609;Estância Velha;4307906;Farroupilha;2;2;4;50
4304804;Carlos Barbosa;4307864;Fagundes Varela;2;2;4;50
4113700;Londrina;4307831;Eugênio de Castro;2;2;4;646
4301008;Arroio do Meio;4307807;Estrela;2;2;4;11
4304705;Carazinho;4307807;Estrela;2;2;4;155
4306205;Cruzeiro do Sul;4307807;Estrela;2;2;4;6
2408102;Natal;4307708;Esteio;2;2;4;3025
3106200;Belo Horizonte;4307708;Esteio;2;2;4;1288
3522505;Itapevi;4307708;Esteio;2;2;4;804
4202305;Biguaçu;4307708;Esteio;2;2;4;352
4208203;Itajaí;4307708;Esteio;2;2;4;396
4304408;Canela;4307708;Esteio;2;2;4;66
4304630;Capão da Canoa;4307708;Esteio;2;2;4;110
4306403;Dois Irmãos;4307708;Esteio;2;2;4;31
3518800;Guarulhos;4307609;Estância Velha;2;2;4;814
4303103;Cachoeirinha;4307609;Estância Velha;2;2;4;34
4304630;Capão da Canoa;4307609;Estância Velha;2;2;4;110
4305975;Coxilha;4307559;Estação;2;2;4;24
4306429;Dois Irmãos das Missões;4307302;Erval Seco;2;2;4;12
4307005;Erechim;4307203;Erval Grande;2;2;4;40
4301602;Bagé;4307104;Herval;2;2;4;101
2911105;Formosa do Rio Preto;4307005;Erechim;2;2;4;1954
3548708;São Bernardo do Campo;4307005;Erechim;2;2;4;702
4113700;Londrina;4307005;Erechim;2;2;4;492
4118204;Paranaguá;4307005;Erechim;2;2;4;429
4118501;Pato Branco;4307005;Erechim;2;2;4;160
4202909;Brusque;4307005;Erechim;2;2;4;337
4203006;Caçador;4307005;Erechim;2;2;4;149
4204004;Catanduvas;4307005;Erechim;2;2;4;85
4209300;Lages;4307005;Erechim;2;2;4;193
4301925;Barra do Rio Azul;4307005;Erechim;2;2;4;28
4302105;Bento Gonçalves;4307005;Erechim;2;2;4;186
4303004;Cachoeira do Sul;4307005;Erechim;2;2;4;270
4304705;Carazinho;4307005;Erechim;2;2;4;89
4305207;Cerro Largo;4306932;Entre-Ijuís;2;2;4;51
4303509;Camaquã;4306908;Encruzilhada do Sul;2;2;4;80
4304200;Candelária;4306908;Encruzilhada do Sul;2;2;4;94
4305355;Charqueadas;4306908;Encruzilhada do Sul;2;2;4;108
4306502;Dom Feliciano;4306908;Encruzilhada do Sul;2;2;4;48
3548708;São Bernardo do Campo;4306809;Encantado;2;2;4;792
4303103;Cachoeirinha;4306809;Encantado;2;2;4;111
4305108;Caxias do Sul;4306809;Encantado;2;2;4;72
3515004;Embu;4306767;Eldorado do Sul;2;2;4;841
3518800;Guarulhos;4306767;Eldorado do Sul;2;2;4;875
4205407;Florianópolis;4306767;Eldorado do Sul;2;2;4;404
4205456;Forquilhinha;4306767;Eldorado do Sul;2;2;4;253
4209102;Joinville;4306767;Eldorado do Sul;2;2;4;496
4211900;Palhoça;4306767;Eldorado do Sul;2;2;4;385
4301909;Barra do Ribeiro;4306767;Eldorado do Sul;2;2;4;39
3304557;Rio de Janeiro;4306601;Dom Pedrito;2;2;4;1381
3550308;São Paulo;4306601;Dom Pedrito;2;2;4;1098
4304606;Canoas;4306601;Dom Pedrito;2;2;4;350
1302603;Manaus;4306403;Dois Irmãos;2;2;4;3039
2304400;Fortaleza;4306403;Dois Irmãos;2;2;4;3075
4204608;Criciúma;4306403;Dois Irmãos;2;2;4;193
4303905;Campo Bom;4306403;Dois Irmãos;2;2;4;11
4305504;Ciríaco;4306304;David Canabarro;2;2;4;6
4302808;Caçapava do Sul;4306106;Cruz Alta;2;2;4;205
4305108;Caxias do Sul;4306106;Cruz Alta;2;2;4;244
4300851;Arambaré;4306056;Cristal;2;2;4;51
4302600;Braga;4305900;Coronel Bicaco;2;2;4;12
4301008;Arroio do Meio;4305587;Colinas;2;2;4;7
4205407;Florianópolis;4305355;Charqueadas;2;2;4;396
4301958;Barra Funda;4305306;Chapada;2;2;4;15
4300307;Alecrim;4305207;Cerro Largo;2;2;4;56
4302501;Bossoroca;4305207;Cerro Largo;2;2;4;66
4304309;Cândido Godói;4305207;Cerro Largo;2;2;4;23
4305009;Catuípe;4305207;Cerro Largo;2;2;4;72
4301750;Barão do Triunfo;4305173;Cerro Grande do Sul;2;2;4;22
2507507;João Pessoa;4305108;Caxias do Sul;2;2;4;2852
2607901;Jaboatão dos Guararapes;4305108;Caxias do Sul;2;2;4;2757
2910800;Feira de Santana;4305108;Caxias do Sul;2;2;4;2179
3136702;Juiz de Fora;4305108;Caxias do Sul;2;2;4;1104
3301009;Campos dos Goytacazes;4305108;Caxias do Sul;2;2;4;1237
3303906;Petrópolis;4305108;Caxias do Sul;2;2;4;1051
3304201;Resende;4305108;Caxias do Sul;2;2;4;973
3503208;Araraquara;4305108;Caxias do Sul;2;2;4;865
3505203;Bariri;4305108;Caxias do Sul;2;2;4;818
3524402;Jacareí;4305108;Caxias do Sul;2;2;4;815
3545209;Salto;4305108;Caxias do Sul;2;2;4;756
3545803;Santa Bárbara d'Oeste;4305108;Caxias do Sul;2;2;4;794
3549904;São José dos Campos;4305108;Caxias do Sul;2;2;4;829
4101804;Araucária;4305108;Caxias do Sul;2;2;4;431
4105805;Colombo;4305108;Caxias do Sul;2;2;4;470
4118204;Paranaguá;4305108;Caxias do Sul;2;2;4;469
4119152;Pinhais;4305108;Caxias do Sul;2;2;4;453
4202008;Balneário Camboriú;4305108;Caxias do Sul;2;2;4;340
4203006;Caçador;4305108;Caxias do Sul;2;2;4;262
4204806;Curitibanos;4305108;Caxias do Sul;2;2;4;216
4211306;Navegantes;4305108;Caxias do Sul;2;2;4;349
4211900;Palhoça;4305108;Caxias do Sul;2;2;4;288
4212254;Passo de Torres;4305108;Caxias do Sul;2;2;4;141
4218707;Tubarão;4305108;Caxias do Sul;2;2;4;220
4219176;Vargem Bonita;4305108;Caxias do Sul;2;2;4;245
4300570;Alto Feliz;4305108;Caxias do Sul;2;2;4;28
4300661;André da Rocha;4305108;Caxias do Sul;2;2;4;70
4303004;Cachoeira do Sul;4305108;Caxias do Sul;2;2;4;194
4106902;Curitiba;4304804;Carlos Barbosa;2;2;4;477
4302253;Boa Vista do Sul;4304804;Carlos Barbosa;2;2;4;18
4303103;Cachoeirinha;4304804;Carlos Barbosa;2;2;4;82
1709500;Gurupi;4304705;Carazinho;2;2;4;1868
3534401;Osasco;4304705;Carazinho;2;2;4;781
4202404;Blumenau;4304705;Carazinho;2;2;4;391
4217204;São Miguel do Oeste;4304705;Carazinho;2;2;4;191
3550308;São Paulo;4304689;Capela de Santana;2;2;4;802
3122306;Divinópolis;4304671;Capivari do Sul;2;2;4;1222
4201406;Araranguá;4304671;Capivari do Sul;2;2;4;165
3304557;Rio de Janeiro;4304630;Capão da Canoa;2;2;4;993
4302105;Bento Gonçalves;4304630;Capão da Canoa;2;2;4;156
4304408;Canela;4304630;Capão da Canoa;2;2;4;87
2607901;Jaboatão dos Guararapes;4304606;Canoas;2;2;4;2821
2704302;Maceió;4304606;Canoas;2;2;4;2645
2930709;Simões Filho;4304606;Canoas;2;2;4;2225
3170206;Uberlândia;4304606;Canoas;2;2;4;1249
3201308;Cariacica;4304606;Canoas;2;2;4;1462
3300407;Barra Mansa;4304606;Canoas;2;2;4;1047
3503901;Arujá;4304606;Canoas;2;2;4;855
3513009;Cotia;4304606;Canoas;2;2;4;806
3513801;Diadema;4304606;Canoas;2;2;4;813
3516200;Franca;4304606;Canoas;2;2;4;1096
3520509;Indaiatuba;4304606;Canoas;2;2;4;841
3530607;Moji das Cruzes;4304606;Canoas;2;2;4;846
3538709;Piracicaba;4304606;Canoas;2;2;4;860
3543402;Ribeirão Preto;4304606;Canoas;2;2;4;1020
3547809;Santo André;4304606;Canoas;2;2;4;820
3548500;Santos;4304606;Canoas;2;2;4;807
3548807;São Caetano do Sul;4304606;Canoas;2;2;4;822
3549805;São José do Rio Preto;4304606;Canoas;2;2;4;1020
4104808;Cascavel;4304606;Canoas;2;2;4;590
4118204;Paranaguá;4304606;Canoas;2;2;4;540
4119152;Pinhais;4304606;Canoas;2;2;4;530
4119905;Ponta Grossa;4304606;Canoas;2;2;4;541
4202008;Balneário Camboriú;4304606;Canoas;2;2;4;402
4202305;Biguaçu;4304606;Canoas;2;2;4;358
4207304;Imbituba;4304606;Canoas;2;2;4;302
4213203;Pomerode;4304606;Canoas;2;2;4;400
4301057;Arroio do Sal;4304606;Canoas;2;2;4;130
4301107;Arroio dos Ratos;4304606;Canoas;2;2;4;56
4301602;Bagé;4304507;Canguçu;2;2;4;135
4303905;Campo Bom;4304200;Candelária;2;2;4;171
4106902;Curitiba;4304002;Campo Novo;2;2;4;506
2308708;Morada Nova;4303905;Campo Bom;2;2;4;2949
2908507;Conceição do Jacuípe;4303905;Campo Bom;2;2;4;2223
3509502;Campinas;4303905;Campo Bom;2;2;4;840
4300877;Araricá;4303905;Campo Bom;2;2;4;13
4303509;Camaquã;4303905;Campo Bom;2;2;4;148
4213807;Praia Grande;4303608;Cambará do Sul;2;2;4;25
2304400;Fortaleza;4303509;Camaquã;2;2;4;3221
3304557;Rio de Janeiro;4303509;Camaquã;2;2;4;1183
3518800;Guarulhos;4303509;Camaquã;2;2;4;953
4300604;Alvorada;4303509;Camaquã;2;2;4;117
2304400;Fortaleza;4303103;Cachoeirinha;2;2;4;3111
3106200;Belo Horizonte;4303103;Cachoeirinha;2;2;4;1294
3106705;Betim;4303103;Cachoeirinha;2;2;4;1279
3149903;Perdões;4303103;Cachoeirinha;2;2;4;1130
3515004;Embu;4303103;Cachoeirinha;2;2;4;804
3530805;Moji-Mirim;4303103;Cachoeirinha;2;2;4;918
3539301;Pirassununga;4303103;Cachoeirinha;2;2;4;944
4118501;Pato Branco;4303103;Cachoeirinha;2;2;4;437
4201406;Araranguá;4303103;Cachoeirinha;2;2;4;191
4203006;Caçador;4303103;Cachoeirinha;2;2;4;349
4204608;Criciúma;4303103;Cachoeirinha;2;2;4;219
4216602;São José;4303103;Cachoeirinha;2;2;4;350
4218707;Tubarão;4303103;Cachoeirinha;2;2;4;256
4219705;Xaxim;4303103;Cachoeirinha;2;2;4;357
4301057;Arroio do Sal;4303103;Cachoeirinha;2;2;4;125
4302709;Butiá;4303103;Cachoeirinha;2;2;4;85
4300109;Agudo;4303004;Cachoeira do Sul;2;2;4;51
4301206;Arroio do Tigre;4303004;Cachoeira do Sul;2;2;4;76
4301602;Bagé;4303004;Cachoeira do Sul;2;2;4;188
4301602;Bagé;4302907;Cacequi;2;2;4;175
3550308;São Paulo;4302402;Bom Retiro do Sul;2;2;4;828
4300570;Alto Feliz;4302352;Bom Princípio;2;2;4;13
3550308;São Paulo;4302303;Bom Jesus;2;2;4;663
1721000;Palmas;4302204;Boa Vista do Buricá;2;2;4;1990
2304285;Eusébio;4302105;Bento Gonçalves;2;2;4;3039
2927408;Salvador;4302105;Bento Gonçalves;2;2;4;2155
2930709;Simões Filho;4302105;Bento Gonçalves;2;2;4;2178
3106200;Belo Horizonte;4302105;Bento Gonçalves;2;2;4;1245
3205101;Viana;4302105;Bento Gonçalves;2;2;4;1413
3304904;São Gonçalo;4302105;Bento Gonçalves;2;2;4;1067
3509502;Campinas;4302105;Bento Gonçalves;2;2;4;812
3515004;Embu;4302105;Bento Gonçalves;2;2;4;754
3545209;Salto;4302105;Bento Gonçalves;2;2;4;772
4113700;Londrina;4302105;Bento Gonçalves;2;2;4;650
4125506;São José dos Pinhais;4302105;Bento Gonçalves;2;2;4;459
4300901;Aratiba;4301925;Barra do Rio Azul;2;2;4;11
3518800;Guarulhos;4301602;Bagé;2;2;4;1116
4204301;Concórdia;4301602;Bagé;2;2;4;496
4301305;Arroio Grande;4301602;Bagé;2;2;4;140
3550308;São Paulo;4300901;Aratiba;2;2;4;689
4204301;Concórdia;4300901;Aratiba;2;2;4;34
4209300;Lages;4300802;Antônio Prado;2;2;4;149
4106902;Curitiba;4300406;Alegrete;2;2;4;780
4204301;Concórdia;4219853;Zortéa;2;2;4;52
1504422;Marituba;4219705;Xaxim;2;2;4;2860
3550308;São Paulo;4219705;Xaxim;2;2;4;683
4204350;Cordilheira Alta;4219705;Xaxim;2;2;4;11
4213401;Ponte Serrada;4219705;Xaxim;2;2;4;52
4217501;Seara;4219606;Xavantina;2;2;4;9
4219507;Xanxerê;4219606;Xavantina;2;2;4;24
4106902;Curitiba;4219507;Xanxerê;2;2;4;346
4107405;Enéas Marques;4219507;Xanxerê;2;2;4;126
4117602;Palmas;4219507;Xanxerê;2;2;4;58
4118501;Pato Branco;4219507;Xanxerê;2;2;4;74
4202008;Balneário Camboriú;4219507;Xanxerê;2;2;4;371
4216909;São Lourenço do Oeste;4219507;Xanxerê;2;2;4;71
4217204;São Miguel do Oeste;4219507;Xanxerê;2;2;4;114
4217501;Seara;4219507;Xanxerê;2;2;4;34
4219309;Videira;4219507;Xanxerê;2;2;4;126
4214003;Presidente Getúlio;4219358;Vitor Meireles;2;2;4;28
3130408;Ijaci;4219309;Videira;2;2;4;885
3509254;Cajati;4219309;Videira;2;2;4;391
3529302;Matão;4219309;Videira;2;2;4;656
4106902;Curitiba;4219309;Videira;2;2;4;253
4108304;Foz do Iguaçu;4219309;Videira;2;2;4;369
4113205;Lapa;4219309;Videira;2;2;4;197
4128203;União da Vitória;4219309;Videira;2;2;4;81
4202404;Blumenau;4219309;Videira;2;2;4;206
4209102;Joinville;4219309;Videira;2;2;4;240
4209706;Lebon Régis;4219309;Videira;2;2;4;46
4210035;Luzerna;4219309;Videira;2;2;4;36
4210100;Mafra;4219309;Videira;2;2;4;161
4211058;Monte Carlo;4219309;Videira;2;2;4;29
4202701;Botuverá;4219200;Vidal Ramos;2;2;4;35
4207403;Imbuia;4219200;Vidal Ramos;2;2;4;13
4204202;Chapecó;4219101;Vargeão;2;2;4;53
4201406;Araranguá;4219002;Urussanga;2;2;4;49
4207007;Içara;4219002;Urussanga;2;2;4;24
4209300;Lages;4219002;Urussanga;2;2;4;122
4202602;Bom Retiro;4218905;Urubici;2;2;4;26
4205407;Florianópolis;4218905;Urubici;2;2;4;115
4208955;Jardinópolis;4218855;União do Oeste;2;2;4;4
4205191;Ermo;4218806;Turvo;2;2;4;7
4207007;Içara;4218806;Turvo;2;2;4;44
4210407;Maracajá;4218806;Turvo;2;2;4;24
4211603;Nova Veneza;4218806;Turvo;2;2;4;37
4218103;Timbé do Sul;4218806;Turvo;2;2;4;20
4218707;Tubarão;4218806;Turvo;2;2;4;79
4215554;Santa Helena;4218756;Tunápolis;2;2;4;4
4216255;São João do Oeste;4218756;Tunápolis;2;2;4;15
3106200;Belo Horizonte;4218707;Tubarão;2;2;4;1065
3201209;Cachoeiro de Itapemirim;4218707;Tubarão;2;2;4;1136
3548708;São Bernardo do Campo;4218707;Tubarão;2;2;4;579
4202305;Biguaçu;4218707;Tubarão;2;2;4;115
4203006;Caçador;4218707;Tubarão;2;2;4;273
4205506;Fraiburgo;4218707;Tubarão;2;2;4;244
4205704;Garopaba;4218707;Tubarão;2;2;4;63
4209607;Lauro Muller;4218707;Tubarão;2;2;4;36
4212403;Pedras Grandes;4218707;Tubarão;2;2;4;15
4214805;Rio do Sul;4218707;Tubarão;2;2;4;149
4215802;São Bento do Sul;4218707;Tubarão;2;2;4;249
4218103;Timbé do Sul;4218707;Tubarão;2;2;4;88
4207700;Ipumirim;4218509;Treze Tílias;2;2;4;73
4212601;Peritiba;4218509;Treze Tílias;2;2;4;64
4212908;Pinhalzinho;4218509;Treze Tílias;2;2;4;158
4216701;São José do Cedro;4218509;Treze Tílias;2;2;4;219
4217907;Tangará;4218509;Treze Tílias;2;2;4;19
4211207;Morro da Fumaça;4218400;Treze de Maio;2;2;4;12
4204608;Criciúma;4218350;Treviso;2;2;4;18
4203006;Caçador;4218251;Timbó Grande;2;2;4;46
4213708;Pouso Redondo;4218251;Timbó Grande;2;2;4;103
4106902;Curitiba;4218202;Timbó;2;2;4;156
4201703;Ascurra;4218202;Timbó;2;2;4;18
4202008;Balneário Camboriú;4218202;Timbó;2;2;4;60
4215802;São Bento do Sul;4218202;Timbó;2;2;4;66
4210803;Meleiro;4218103;Timbé do Sul;2;2;4;21
4217709;Sombrio;4218103;Timbé do Sul;2;2;4;35
2927408;Salvador;4218004;Tijucas;2;2;4;1847
4202305;Biguaçu;4218004;Tijucas;2;2;4;29
4206009;Governador Celso Ramos;4218004;Tijucas;2;2;4;10
4207304;Imbituba;4218004;Tijucas;2;2;4;105
4209102;Joinville;4218004;Tijucas;2;2;4;109
4204707;Cunha Porã;4217956;Tigrinhos;2;2;4;23
3529302;Matão;4217907;Tangará;2;2;4;670
4204806;Curitibanos;4217907;Tangará;2;2;4;67
4205506;Fraiburgo;4217907;Tangará;2;2;4;33
4206702;Herval d'Oeste;4217907;Tangará;2;2;4;27
4206751;Ibiam;4217907;Tangará;2;2;4;8
4213005;Pinheiro Preto;4217907;Tangará;2;2;4;6
4200200;Agrolândia;4217808;Taió;2;2;4;39
4214003;Presidente Getúlio;4217808;Taió;2;2;4;41
4214508;Rio do Campo;4217808;Taió;2;2;4;21
4215505;Santa Cecília;4217808;Taió;2;2;4;46
4215679;Santa Terezinha;4217808;Taió;2;2;4;38
4212908;Pinhalzinho;4217758;Sul Brasil;2;2;4;13
4106902;Curitiba;4217709;Sombrio;2;2;4;408
4128104;Umuarama;4217709;Sombrio;2;2;4;688
4210407;Maracajá;4217709;Sombrio;2;2;4;35
4212254;Passo de Torres;4217709;Sombrio;2;2;4;19
4106902;Curitiba;4217600;Siderópolis;2;2;4;351
4205407;Florianópolis;4217600;Siderópolis;2;2;4;144
4207007;Içara;4217600;Siderópolis;2;2;4;20
4204806;Curitibanos;4217501;Seara;2;2;4;170
3550308;São Paulo;4217402;Schroeder;2;2;4;388
4204509;Corupá;4217402;Schroeder;2;2;4;17
4209102;Joinville;4217402;Schroeder;2;2;4;26
3550308;São Paulo;4217303;Saudades;2;2;4;720
4210902;Modelo;4217303;Saudades;2;2;4;17
4216602;São José;4217253;São Pedro de Alcântara;2;2;4;12
4104808;Cascavel;4217204;São Miguel do Oeste;2;2;4;195
4202081;Bandeirante;4217204;São Miguel do Oeste;2;2;4;12
4207650;Iporã do Oeste;4217204;São Miguel do Oeste;2;2;4;32
4212239;Paraíso;4217204;São Miguel do Oeste;2;2;4;16
4212908;Pinhalzinho;4217204;São Miguel do Oeste;2;2;4;57
4216909;São Lourenço do Oeste;4217204;São Miguel do Oeste;2;2;4;75
4206207;Gravatal;4217105;São Martinho;2;2;4;19
4206108;Grão Pará;4217006;São Ludgero;2;2;4;17
3505708;Barueri;4216909;São Lourenço do Oeste;2;2;4;672
4106506;Coronel Vivida;4216909;São Lourenço do Oeste;2;2;4;53
4113700;Londrina;4216909;São Lourenço do Oeste;2;2;4;381
4205407;Florianópolis;4216909;São Lourenço do Oeste;2;2;4;458
4211652;Novo Horizonte;4216909;São Lourenço do Oeste;2;2;4;9
4203600;Campos Novos;4216800;São José do Cerrito;2;2;4;68
4205001;Dionísio Cerqueira;4216701;São José do Cedro;2;2;4;22
1302603;Manaus;4216602;São José;2;2;4;2905
3205200;Vila Velha;4216602;São José;2;2;4;1132
3304904;São Gonçalo;4216602;São José;2;2;4;760
3503208;Araraquara;4216602;São José;2;2;4;644
3520509;Indaiatuba;4216602;São José;2;2;4;516
4101804;Araucária;4216602;São José;2;2;4;232
4105805;Colombo;4216602;São José;2;2;4;264
4201208;Antônio Carlos;4216602;São José;2;2;4;14
4201406;Araranguá;4216602;São José;2;2;4;171
4207304;Imbituba;4216602;São José;2;2;4;67
4207502;Indaial;4216602;São José;2;2;4;93
4209003;Joaçaba;4216602;São José;2;2;4;286
4210407;Maracajá;4216602;São José;2;2;4;160
4213203;Pomerode;4216602;São José;2;2;4;105
3550308;São Paulo;4216503;São Joaquim;2;2;4;603
4202503;Bom Jardim da Serra;4216503;São Joaquim;2;2;4;35
4213807;Praia Grande;4216404;São João do Sul;2;2;4;14
4202107;Barra Velha;4216354;São João do Itaperiú;2;2;4;9
4202404;Blumenau;4216305;São João Batista;2;2;4;43
4210209;Major Gercino;4216305;São João Batista;2;2;4;19
3518800;Guarulhos;4216206;São Francisco do Sul;2;2;4;376
3529401;Mauá;4216206;São Francisco do Sul;2;2;4;361
3545209;Salto;4216206;São Francisco do Sul;2;2;4;367
3550704;São Sebastião;4216206;São Francisco do Sul;2;2;4;422
4104808;Cascavel;4216206;São Francisco do Sul;2;2;4;503
4119905;Ponta Grossa;4216206;São Francisco do Sul;2;2;4;202
4202404;Blumenau;4216206;São Francisco do Sul;2;2;4;86
3550308;São Paulo;4216107;São Domingos;2;2;4;663
4104303;Campo Mourão;4216107;São Domingos;2;2;4;279
4115309;Mariópolis;4216107;São Domingos;2;2;4;23
4109401;Guarapuava;4216057;São Cristovão do Sul;2;2;4;230
4213302;Ponte Alta;4216057;São Cristovão do Sul;2;2;4;25
4204806;Curitibanos;4216008;São Carlos;2;2;4;241
4205407;Florianópolis;4216008;São Carlos;2;2;4;452
4208401;Itapiranga;4216008;São Carlos;2;2;4;69
4205407;Florianópolis;4215901;São Bonifácio;2;2;4;53
2602902;Cabo de Santo Agostinho;4215802;São Bento do Sul;2;2;4;2411
4101804;Araucária;4215802;São Bento do Sul;2;2;4;74
4203006;Caçador;4215802;São Bento do Sul;2;2;4;182
4204202;Chapecó;4215802;São Bento do Sul;2;2;4;339
4204608;Criciúma;4215802;São Bento do Sul;2;2;4;266
4208450;Itapoá;4215802;São Bento do Sul;2;2;4;73
4212908;Pinhalzinho;4215802;São Bento do Sul;2;2;4;368
4114203;Mandaguari;4215703;Santo Amaro da Imperatriz;2;2;4;538
4200606;Águas Mornas;4215703;Santo Amaro da Imperatriz;2;2;4;7
4214201;Quilombo;4215695;Santiago do Sul;2;2;4;10
4204707;Cunha Porã;4215687;Santa Terezinha do Progresso;2;2;4;31
4214805;Rio do Sul;4215679;Santa Terezinha;2;2;4;64
4201406;Araranguá;4215653;Santa Rosa do Sul;2;2;4;30
4205407;Florianópolis;4215604;Santa Rosa de Lima;2;2;4;78
4204905;Descanso;4215554;Santa Helena;2;2;4;17
4210100;Mafra;4215505;Santa Cecília;2;2;4;111
4211751;Otacílio Costa;4215505;Santa Cecília;2;2;4;66
4210050;Macieira;4215406;Salto Veloso;2;2;4;6
4203501;Campo Erê;4215356;Saltinho;2;2;4;24
4213708;Pouso Redondo;4215307;Salete;2;2;4;31
4206900;Ibirama;4215109;Rodeio;2;2;4;21
3550308;São Paulo;4215000;Rio Negrinho;2;2;4;404
4119905;Ponta Grossa;4215000;Rio Negrinho;2;2;4;143
4203303;Campo Alegre;4215000;Rio Negrinho;2;2;4;26
4203808;Canoinhas;4215000;Rio Negrinho;2;2;4;90
4208302;Itapema;4215000;Rio Negrinho;2;2;4;128
4202800;Braço do Norte;4214904;Rio Fortuna;2;2;4;17
3304557;Rio de Janeiro;4214805;Rio do Sul;2;2;4;784
4201802;Atalanta;4214805;Rio do Sul;2;2;4;26
4204608;Criciúma;4214805;Rio do Sul;2;2;4;160
4210100;Mafra;4214805;Rio do Sul;2;2;4;123
4211306;Navegantes;4214805;Rio do Sul;2;2;4;100
4201109;Anitápolis;4214300;Rancho Queimado;2;2;4;27
4204400;Coronel Freitas;4214201;Quilombo;2;2;4;20
4202404;Blumenau;4214102;Presidente Nereu;2;2;4;48
4201703;Ascurra;4214003;Presidente Getúlio;2;2;4;24
4202404;Blumenau;4214003;Presidente Getúlio;2;2;4;55
4204806;Curitibanos;4214003;Presidente Getúlio;2;2;4;100
4205100;Dona Emma;4214003;Presidente Getúlio;2;2;4;13
4207502;Indaial;4214003;Presidente Getúlio;2;2;4;42
4200200;Agrolândia;4213708;Pouso Redondo;2;2;4;20
4204806;Curitibanos;4213708;Pouso Redondo;2;2;4;66
4205407;Florianópolis;4213708;Pouso Redondo;2;2;4;145
4205902;Gaspar;4213708;Pouso Redondo;2;2;4;103
4208906;Jaraguá do Sul;4213708;Pouso Redondo;2;2;4;120
4209102;Joinville;4213609;Porto União;2;2;4;218
4202404;Blumenau;4213500;Porto Belo;2;2;4;54
4203204;Camboriú;4213500;Porto Belo;2;2;4;18
4209300;Lages;4213500;Porto Belo;2;2;4;188
4204202;Chapecó;4213401;Ponte Serrada;2;2;4;66
4204301;Concórdia;4213401;Ponte Serrada;2;2;4;38
4204806;Curitibanos;4213302;Ponte Alta;2;2;4;32
3106200;Belo Horizonte;4213203;Pomerode;2;2;4;910
3170206;Uberlândia;4213203;Pomerode;2;2;4;873
3518800;Guarulhos;4213203;Pomerode;2;2;4;447
4104204;Campo Largo;4213203;Pomerode;2;2;4;146
4119905;Ponta Grossa;4213203;Pomerode;2;2;4;206
4205407;Florianópolis;4213203;Pomerode;2;2;4;115
4205902;Gaspar;4213203;Pomerode;2;2;4;30
4206504;Guaramirim;4213203;Pomerode;2;2;4;34
4203600;Campos Novos;4213104;Piratuba;2;2;4;55
4204806;Curitibanos;4213104;Piratuba;2;2;4;117
4204707;Cunha Porã;4212908;Pinhalzinho;2;2;4;18
4205407;Florianópolis;4212908;Pinhalzinho;2;2;4;454
2602902;Cabo de Santo Agostinho;4212809;Piçarras;2;2;4;2418
4106902;Curitiba;4212809;Piçarras;2;2;4;157
4202008;Balneário Camboriú;4212809;Piçarras;2;2;4;26
4202909;Brusque;4212809;Piçarras;2;2;4;42
4210001;Luiz Alves;4212809;Piçarras;2;2;4;21
4205001;Dionísio Cerqueira;4212700;Petrolândia;2;2;4;411
4204301;Concórdia;4212601;Peritiba;2;2;4;20
4205407;Florianópolis;4212502;Penha;2;2;4;89
4207106;Ilhota;4212502;Penha;2;2;4;20
4117602;Palmas;4212270;Passos Maia;2;2;4;32
4204202;Chapecó;4212270;Passos Maia;2;2;4;67
4201406;Araranguá;4212254;Passo de Torres;2;2;4;42
4208104;Itaiópolis;4212205;Papanduva;2;2;4;24
4210308;Major Vieira;4212205;Papanduva;2;2;4;18
4204707;Cunha Porã;4212106;Palmitos;2;2;4;19
4205407;Florianópolis;4212106;Palmitos;2;2;4;464
4210506;Maravilha;4212106;Palmitos;2;2;4;34
4107850;Flor da Serra do Sul;4212007;Palma Sola;2;2;4;15
4205001;Dionísio Cerqueira;4212007;Palma Sola;2;2;4;36
2507507;João Pessoa;4211900;Palhoça;2;2;4;2607
2611606;Recife;4211900;Palhoça;2;2;4;2515
3548807;São Caetano do Sul;4211900;Palhoça;2;2;4;495
4118204;Paranaguá;4211900;Palhoça;2;2;4;230
4202909;Brusque;4211900;Palhoça;2;2;4;64
4207205;Imaruí;4211900;Palhoça;2;2;4;75
4203600;Campos Novos;4211801;Ouro;2;2;4;44
4209201;Lacerdópolis;4211801;Ouro;2;2;4;9
3534401;Osasco;4211751;Otacílio Costa;2;2;4;544
3550308;São Paulo;4211751;Otacílio Costa;2;2;4;542
4106902;Curitiba;4211751;Otacílio Costa;2;2;4;241
4117602;Palmas;4211751;Otacílio Costa;2;2;4;212
4208203;Itajaí;4211751;Otacílio Costa;2;2;4;148
4209102;Joinville;4211751;Otacílio Costa;2;2;4;182
4209151;José Boiteux;4211751;Otacílio Costa;2;2;4;76
4209409;Laguna;4211702;Orleans;2;2;4;50
4202404;Blumenau;4211504;Nova Trento;2;2;4;40
4200556;Águas Frias;4211405;Nova Erechim;2;2;4;5
4202578;Bom Jesus do Oeste;4211405;Nova Erechim;2;2;4;30
3106200;Belo Horizonte;4211306;Navegantes;2;2;4;896
3505708;Barueri;4211306;Navegantes;2;2;4;413
3513009;Cotia;4211306;Navegantes;2;2;4;402
3552205;Sorocaba;4211306;Navegantes;2;2;4;393
4208906;Jaraguá do Sul;4211306;Navegantes;2;2;4;59
4210001;Luiz Alves;4211306;Navegantes;2;2;4;31
4210803;Meleiro;4211256;Morro Grande;2;2;4;9
2906501;Candeias;4211207;Morro da Fumaça;2;2;4;2026
3543907;Rio Claro;4211207;Morro da Fumaça;2;2;4;709
4105805;Colombo;4211207;Morro da Fumaça;2;2;4;376
4106902;Curitiba;4211207;Morro da Fumaça;2;2;4;356
4106902;Curitiba;4211058;Monte Carlo;2;2;4;258
4207650;Iporã do Oeste;4211009;Mondaí;2;2;4;14
4207007;Içara;4210803;Meleiro;2;2;4;35
4128203;União da Vitória;4210704;Matos Costa;2;2;4;21
4202107;Barra Velha;4210605;Massaranduba;2;2;4;28
4206504;Guaramirim;4210605;Massaranduba;2;2;4;15
4210001;Luiz Alves;4210605;Massaranduba;2;2;4;14
4205357;Flor do Sertão;4210506;Maravilha;2;2;4;17
4205407;Florianópolis;4210506;Maravilha;2;2;4;474
4207759;Iraceminha;4210506;Maravilha;2;2;4;16
4209003;Joaçaba;4210506;Maravilha;2;2;4;168
3509254;Cajati;4210407;Maracajá;2;2;4;475
4207502;Indaial;4210407;Maracajá;2;2;4;217
4210100;Mafra;4210308;Major Vieira;2;2;4;55
3304557;Rio de Janeiro;4210100;Mafra;2;2;4;743
4104105;Campo do Tenente;4210100;Mafra;2;2;4;24
4119905;Ponta Grossa;4210100;Mafra;2;2;4;119
4125506;São José dos Pinhais;4210100;Mafra;2;2;4;94
4127106;Telêmaco Borba;4210100;Mafra;2;2;4;214
4203006;Caçador;4210100;Mafra;2;2;4;145
4204806;Curitibanos;4210100;Mafra;2;2;4;147
4207908;Irineópolis;4210100;Mafra;2;2;4;97
4206801;Ibicaré;4210035;Luzerna;2;2;4;13
4205902;Gaspar;4210001;Luiz Alves;2;2;4;23
4202404;Blumenau;4209904;Lontras;2;2;4;52
4207502;Indaial;4209904;Lontras;2;2;4;43
4207809;Irani;4209854;Lindóia do Sul;2;2;4;17
4200705;Alfredo Wagner;4209805;Leoberto Leal;2;2;4;22
4204806;Curitibanos;4209706;Lebon Régis;2;2;4;39
4200309;Agronômica;4209508;Laurentino;2;2;4;6
4204608;Criciúma;4209508;Laurentino;2;2;4;164
4207205;Imaruí;4209409;Laguna;2;2;4;17
3171006;Vazante;4209300;Lages;2;2;4;1131
3505708;Barueri;4209300;Lages;2;2;4;581
3526902;Limeira;4209300;Lages;2;2;4;646
3541406;Presidente Prudente;4209300;Lages;2;2;4;636
3543907;Rio Claro;4209300;Lages;2;2;4;655
4202602;Bom Retiro;4209300;Lages;2;2;4;83
4203253;Capão Alto;4209300;Lages;2;2;4;23
4203808;Canoinhas;4209300;Lages;2;2;4;178
4203907;Capinzal;4209300;Lages;2;2;4;135
4205506;Fraiburgo;4209300;Lages;2;2;4;104
4206702;Herval d'Oeste;4209300;Lages;2;2;4;132
4207007;Içara;4209300;Lages;2;2;4;145
4208500;Ituporanga;4209300;Lages;2;2;4;84
4203907;Capinzal;4209201;Lacerdópolis;2;2;4;10
2111300;São Luís;4209102;Joinville;2;2;4;2663
2605202;Escada;4209102;Joinville;2;2;4;2368
2800308;Aracaju;4209102;Joinville;2;2;4;2040
3106705;Betim;4209102;Joinville;2;2;4;835
3170107;Uberaba;4209102;Joinville;2;2;4;730
3515004;Embu;4209102;Joinville;2;2;4;353
3529401;Mauá;4209102;Joinville;2;2;4;374
4104204;Campo Largo;4209102;Joinville;2;2;4;113
4108304;Foz do Iguaçu;4209102;Joinville;2;2;4;568
4109401;Guarapuava;4209102;Joinville;2;2;4;276
4122305;Rio Negro;4209102;Joinville;2;2;4;95
4207304;Imbituba;4209102;Joinville;2;2;4;211
4208500;Ituporanga;4209102;Joinville;2;2;4;146
4209003;Joaçaba;4209102;Joinville;2;2;4;286
3106200;Belo Horizonte;4209003;Joaçaba;2;2;4;1085
3534401;Osasco;4209003;Joaçaba;2;2;4;613
4108403;Francisco Beltrão;4209003;Joaçaba;2;2;4;190
4113700;Londrina;4209003;Joaçaba;2;2;4;428
4203808;Canoinhas;4209003;Joaçaba;2;2;4;153
4207809;Irani;4209003;Joaçaba;2;2;4;38
3505708;Barueri;4208906;Jaraguá do Sul;2;2;4;394
3543402;Ribeirão Preto;4208906;Jaraguá do Sul;2;2;4;603
3548807;São Caetano do Sul;4208906;Jaraguá do Sul;2;2;4;403
4101804;Araucária;4208906;Jaraguá do Sul;2;2;4;104
4201307;Araquari;4208906;Jaraguá do Sul;2;2;4;32
4202057;Balneário Barra do Sul;4208906;Jaraguá do Sul;2;2;4;40
4202206;Benedito Novo;4208906;Jaraguá do Sul;2;2;4;45
4202305;Biguaçu;4208906;Jaraguá do Sul;2;2;4;119
4204806;Curitibanos;4208906;Jaraguá do Sul;2;2;4;176
4207007;Içara;4208906;Jaraguá do Sul;2;2;4;249
4207809;Irani;4208906;Jaraguá do Sul;2;2;4;288
4201901;Aurora;4208500;Ituporanga;2;2;4;11
4204194;Chapadão do Lageado;4208500;Ituporanga;2;2;4;21
4204608;Criciúma;4208500;Ituporanga;2;2;4;140
4206900;Ibirama;4208500;Ituporanga;2;2;4;40
4207502;Indaial;4208500;Ituporanga;2;2;4;68
4208302;Itapema;4208500;Ituporanga;2;2;4;102
4205407;Florianópolis;4208450;Itapoá;2;2;4;164
4204202;Chapecó;4208401;Itapiranga;2;2;4;108
3550308;São Paulo;4208302;Itapema;2;2;4;428
4207502;Indaial;4208302;Itapema;2;2;4;62
1501402;Belém;4208203;Itajaí;2;2;4;2828
2607901;Jaboatão dos Guararapes;4208203;Itajaí;2;2;4;2451
3170206;Uberlândia;4208203;Itajaí;2;2;4;892
3170701;Varginha;4208203;Itajaí;2;2;4;684
3300407;Barra Mansa;4208203;Itajaí;2;2;4;660
3302254;Itatiaia;4208203;Itajaí;2;2;4;639
3303302;Niterói;4208203;Itajaí;2;2;4;712
3303906;Petrópolis;4208203;Itajaí;2;2;4;728
3513009;Cotia;4208203;Itajaí;2;2;4;411
3516200;Franca;4208203;Itajaí;2;2;4;721
3523107;Itaquaquecetuba;4208203;Itajaí;2;2;4;450
3523206;Itararé;4208203;Itajaí;2;2;4;320
3527306;Louveira;4208203;Itajaí;2;2;4;463
3534708;Ourinhos;4208203;Itajaí;2;2;4;453
3545209;Salto;4208203;Itajaí;2;2;4;438
3552502;Suzano;4208203;Itajaí;2;2;4;446
3554102;Taubaté;4208203;Itajaí;2;2;4;535
3556206;Valinhos;4208203;Itajaí;2;2;4;472
4103701;Cambé;4208203;Itajaí;2;2;4;473
4107652;Fazenda Rio Grande;4208203;Itajaí;2;2;4;152
4109401;Guarapuava;4208203;Itajaí;2;2;4;317
4127700;Toledo;4208203;Itajaí;2;2;4;551
4201406;Araranguá;4208203;Itajaí;2;2;4;234
4202305;Biguaçu;4208203;Itajaí;2;2;4;62
4202800;Braço do Norte;4208203;Itajaí;2;2;4;154
4205902;Gaspar;4208203;Itajaí;2;2;4;21
4206504;Guaramirim;4208203;Itajaí;2;2;4;58
3550308;São Paulo;4208104;Itaiópolis;2;2;4;438
4203006;Caçador;4207908;Irineópolis;2;2;4;69
4204301;Concórdia;4207809;Irani;2;2;4;24
3526100;Juquiá;4207502;Indaial;2;2;4;325
4104808;Cascavel;4207502;Indaial;2;2;4;469
4128104;Umuarama;4207502;Indaial;2;2;4;532
4204202;Chapecó;4207502;Indaial;2;2;4;338
4205100;Dona Emma;4207502;Indaial;2;2;4;50
4207106;Ilhota;4207502;Indaial;2;2;4;40
4118204;Paranaguá;4207304;Imbituba;2;2;4;289
3550308;São Paulo;4207106;Ilhota;2;2;4;418
3512407;Cordeirópolis;4207007;Içara;2;2;4;713
3543907;Rio Claro;4207007;Içara;2;2;4;719
4202800;Braço do Norte;4207007;Içara;2;2;4;51
4204251;Cocal do Sul;4207007;Içara;2;2;4;14
4106902;Curitiba;4206900;Ibirama;2;2;4;181
4202008;Balneário Camboriú;4206900;Ibirama;2;2;4;83
4204806;Curitibanos;4206900;Ibirama;2;2;4;110
4205506;Fraiburgo;4206702;Herval d'Oeste;2;2;4;60
2905602;Camacan;4206504;Guaramirim;2;2;4;1525
3509502;Campinas;4206504;Guaramirim;2;2;4;440
4204202;Chapecó;4206504;Guaramirim;2;2;4;369
4204509;Corupá;4206504;Guaramirim;2;2;4;25
4204608;Criciúma;4206504;Guaramirim;2;2;4;246
4200804;Anchieta;4206405;Guaraciaba;2;2;4;20
4204905;Descanso;4206405;Guaraciaba;2;2;4;25
4202008;Balneário Camboriú;4206306;Guabiruba;2;2;4;33
3512407;Cordeirópolis;4206207;Gravatal;2;2;4;665
3534401;Osasco;4205902;Gaspar;2;2;4;432
4201406;Araranguá;4205902;Gaspar;2;2;4;230
4205407;Florianópolis;4205902;Gaspar;2;2;4;86
3550308;São Paulo;4205803;Garuva;2;2;4;342
4114609;Marechal Cândido Rondon;4205803;Garuva;2;2;4;543
4119152;Pinhais;4205803;Garuva;2;2;4;73
4125506;São José dos Pinhais;4205803;Garuva;2;2;4;63
4205407;Florianópolis;4205803;Garuva;2;2;4;177
4204608;Criciúma;4205704;Garopaba;2;2;4;101
3118601;Contagem;4205506;Fraiburgo;2;2;4;1027
4113205;Lapa;4205506;Fraiburgo;2;2;4;183
4128203;União da Vitória;4205506;Fraiburgo;2;2;4;86
4202909;Brusque;4205506;Fraiburgo;2;2;4;200
4204202;Chapecó;4205506;Fraiburgo;2;2;4;169
4205407;Florianópolis;4205456;Forquilhinha;2;2;4;158
1500602;Altamira;4205407;Florianópolis;2;2;4;2724
1501402;Belém;4205407;Florianópolis;2;2;4;2900
1716208;Paranã;4205407;Florianópolis;2;2;4;1658
2207702;Parnaíba;4205407;Florianópolis;2;2;4;2805
2607901;Jaboatão dos Guararapes;4205407;Florianópolis;2;2;4;2496
2800308;Aracaju;4205407;Florianópolis;2;2;4;2136
3113404;Caratinga;4205407;Florianópolis;2;2;4;1053
3303500;Nova Iguaçu;4205407;Florianópolis;2;2;4;725
3503208;Araraquara;4205407;Florianópolis;2;2;4;644
3549904;São José dos Campos;4205407;Florianópolis;2;2;4;550
3552809;Taboão da Serra;4205407;Florianópolis;2;2;4;474
4109401;Guarapuava;4205407;Florianópolis;2;2;4;377
4119152;Pinhais;4205407;Florianópolis;2;2;4;247
4200309;Agronômica;4205407;Florianópolis;2;2;4;126
4200507;Águas de Chapecó;4205407;Florianópolis;2;2;4;444
4200606;Águas Mornas;4205407;Florianópolis;2;2;4;35
4200903;Angelina;4205407;Florianópolis;2;2;4;46
4201000;Anita Garibaldi;4205407;Florianópolis;2;2;4;258
4201307;Araquari;4205407;Florianópolis;2;2;4;138
4202453;Bombinhas;4205407;Florianópolis;2;2;4;50
4202701;Botuverá;4205407;Florianópolis;2;2;4;70
4202800;Braço do Norte;4205407;Florianópolis;2;2;4;99
4203204;Camboriú;4205407;Florianópolis;2;2;4;65
4203402;Campo Belo do Sul;4205407;Florianópolis;2;2;4;224
4204509;Corupá;4205407;Florianópolis;2;2;4;148
4203600;Campos Novos;4205209;Erval Velho;2;2;4;28
4202008;Balneário Camboriú;4205001;Dionísio Cerqueira;2;2;4;502
4203006;Caçador;4205001;Dionísio Cerqueira;2;2;4;261
3518800;Guarulhos;4204806;Curitibanos;2;2;4;579
3550308;São Paulo;4204806;Curitibanos;2;2;4;556
4101804;Araucária;4204806;Curitibanos;2;2;4;221
4204301;Concórdia;4204806;Curitibanos;2;2;4;140
2507507;João Pessoa;4204608;Criciúma;2;2;4;2726
2611606;Recife;4204608;Criciúma;2;2;4;2634
3118601;Contagem;4204608;Criciúma;2;2;4;1090
3203205;Linhares;4204608;Criciúma;2;2;4;1356
3501608;Americana;4204608;Criciúma;2;2;4;685
3505708;Barueri;4204608;Criciúma;2;2;4;619
3547304;Santana de Parnaíba;4204608;Criciúma;2;2;4;624
3552809;Taboão da Serra;4204608;Criciúma;2;2;4;615
4105508;Cianorte;4204608;Criciúma;2;2;4;633
4202800;Braço do Norte;4204608;Criciúma;2;2;4;48
4203006;Caçador;4204608;Criciúma;2;2;4;264
3518800;Guarulhos;4204558;Correia Pinto;2;2;4;589
4106902;Curitiba;4204558;Correia Pinto;2;2;4;260
4204301;Concórdia;4204400;Coronel Freitas;2;2;4;76
3550308;São Paulo;4204350;Cordilheira Alta;2;2;4;693
4117602;Palmas;4204350;Cordilheira Alta;2;2;4;84
1702109;Araguaína;4204301;Concórdia;2;2;4;2244
2307650;Maracanaú;4204301;Concórdia;2;2;4;2871
2906907;Caravelas;4204301;Concórdia;2;2;4;1610
2922003;Mucuri;4204301;Concórdia;2;2;4;1570
2927408;Salvador;4204301;Concórdia;2;2;4;2030
3513801;Diadema;4204301;Concórdia;2;2;4;657
3518701;Guarujá;4204301;Concórdia;2;2;4;668
3524006;Itupeva;4204301;Concórdia;2;2;4;661
3534401;Osasco;4204301;Concórdia;2;2;4;653
4104808;Cascavel;4204301;Concórdia;2;2;4;289
4127106;Telêmaco Borba;4204301;Concórdia;2;2;4;342
4201273;Arabutã;4204301;Concórdia;2;2;4;14
1100205;Porto Velho;4204202;Chapecó;2;2;4;2288
2211001;Teresina;4204202;Chapecó;2;2;4;2604
3205200;Vila Velha;4204202;Chapecó;2;2;4;1402
3524006;Itupeva;4204202;Chapecó;2;2;4;698
3548500;Santos;4204202;Chapecó;2;2;4;710
3548708;São Bernardo do Campo;4204202;Chapecó;2;2;4;700
3549805;São José do Rio Preto;4204202;Chapecó;2;2;4;763
4104204;Campo Largo;4204202;Chapecó;2;2;4;355
4108304;Foz do Iguaçu;4204202;Chapecó;2;2;4;256
4128203;União da Vitória;4204202;Chapecó;2;2;4;172
4128708;Vitorino;4204202;Chapecó;2;2;4;94
4200804;Anchieta;4204202;Chapecó;2;2;4;95
4201000;Anita Garibaldi;4204178;Cerro Negro;2;2;4;24
3304557;Rio de Janeiro;4203956;Capivari de Baixo;2;2;4;823
3543907;Rio Claro;4203956;Capivari de Baixo;2;2;4;682
3550308;São Paulo;4203907;Capinzal;2;2;4;633
4119905;Ponta Grossa;4203808;Canoinhas;2;2;4;124
4203006;Caçador;4203808;Canoinhas;2;2;4;95
4202008;Balneário Camboriú;4203709;Canelinha;2;2;4;32
4200051;Abdon Batista;4203600;Campos Novos;2;2;4;28
4202875;Brunópolis;4203600;Campos Novos;2;2;4;37
4203006;Caçador;4203600;Campos Novos;2;2;4;70
4118501;Pato Branco;4203501;Campo Erê;2;2;4;45
4202453;Bombinhas;4203204;Camboriú;2;2;4;20
4203006;Caçador;4203154;Calmon;2;2;4;22
3518800;Guarulhos;4203006;Caçador;2;2;4;580
4101804;Araucária;4203006;Caçador;2;2;4;214
4109401;Guarapuava;4203006;Caçador;2;2;4;160
4112009;Jaguariaíva;4203006;Caçador;2;2;4;312
4113700;Londrina;4203006;Caçador;2;2;4;388
4122305;Rio Negro;4203006;Caçador;2;2;4;150
4202008;Balneário Camboriú;4203006;Caçador;2;2;4;241
2304400;Fortaleza;4202909;Brusque;2;2;4;2757
3106200;Belo Horizonte;4202909;Brusque;2;2;4;928
3304557;Rio de Janeiro;4202909;Brusque;2;2;4;722
3548906;São Carlos;4202909;Brusque;2;2;4;570
3549805;São José do Rio Preto;4202909;Brusque;2;2;4;696
3549904;São José dos Campos;4202909;Brusque;2;2;4;523
4116901;Nova Esperança;4202909;Brusque;2;2;4;539
4119905;Ponta Grossa;4202909;Brusque;2;2;4;252
4128104;Umuarama;4202909;Brusque;2;2;4;569
4201307;Araquari;4202909;Brusque;2;2;4;80
2917706;Jaguarari;4202602;Bom Retiro;2;2;4;2126
1100205;Porto Velho;4202404;Blumenau;2;2;4;2447
2609600;Olinda;4202404;Blumenau;2;2;4;2485
2910800;Feira de Santana;4202404;Blumenau;2;2;4;1884
3306305;Volta Redonda;4202404;Blumenau;2;2;4;692
3515004;Embu;4202404;Blumenau;2;2;4;426
3524006;Itupeva;4202404;Blumenau;2;2;4;465
3525003;Jandira;4202404;Blumenau;2;2;4;435
3548708;São Bernardo do Campo;4202404;Blumenau;2;2;4;433
3552403;Sumaré;4202404;Blumenau;2;2;4;490
3556701;Vinhedo;4202404;Blumenau;2;2;4;480
4101408;Apucarana;4202404;Blumenau;2;2;4;442
4200903;Angelina;4202404;Blumenau;2;2;4;69
4201307;Araquari;4202404;Blumenau;2;2;4;70
4201802;Atalanta;4202404;Blumenau;2;2;4;87
2927408;Salvador;4202305;Biguaçu;2;2;4;1872
3518800;Guarulhos;4202305;Biguaçu;2;2;4;495
4101804;Araucária;4202305;Biguaçu;2;2;4;222
4125506;São José dos Pinhais;4202305;Biguaçu;2;2;4;222
3534401;Osasco;4202107;Barra Velha;2;2;4;392
4101804;Araucária;4202107;Barra Velha;2;2;4;134
4119905;Ponta Grossa;4202107;Barra Velha;2;2;4;221
4201307;Araquari;4202057;Balneário Barra do Sul;2;2;4;15
1302603;Manaus;4202008;Balneário Camboriú;2;2;4;2847
1721000;Palmas;4202008;Balneário Camboriú;2;2;4;1841
3205309;Vitória;4202008;Balneário Camboriú;2;2;4;1101
3306008;Três Rios;4202008;Balneário Camboriú;2;2;4;760
3518800;Guarulhos;4202008;Balneário Camboriú;2;2;4;445
3548500;Santos;4202008;Balneário Camboriú;2;2;4;412
3548807;São Caetano do Sul;4202008;Balneário Camboriú;2;2;4;428
4104808;Cascavel;4202008;Balneário Camboriú;2;2;4;522
4108304;Foz do Iguaçu;4202008;Balneário Camboriú;2;2;4;596
4109609;Guaratuba;4202008;Balneário Camboriú;2;2;4;116
4122701;Sabáudia;4202008;Balneário Camboriú;2;2;4;494
3550308;São Paulo;4201653;Arvoredo;2;2;4;683
3511300;Cedral;4201406;Araranguá;2;2;4;891
3202603;Iconha;4201307;Araquari;2;2;4;994
3304557;Rio de Janeiro;4201307;Araquari;2;2;4;667
4101804;Araucária;4201307;Araquari;2;2;4;106
4106902;Curitiba;4201307;Araquari;2;2;4;116
4115200;Maringá;4201307;Araquari;2;2;4;450
4119905;Ponta Grossa;4201307;Araquari;2;2;4;196
3543402;Ribeirão Preto;4200556;Águas Frias;2;2;4;803
4108403;Francisco Beltrão;4200101;Abelardo Luz;2;2;4;90
4117602;Palmas;4200101;Abelardo Luz;2;2;4;36
4106902;Curitiba;4128708;Vitorino;2;2;4;360
4115309;Mariópolis;4128708;Vitorino;2;2;4;24
4104451;Cantagalo;4128658;Virmond;2;2;4;7
4113304;Laranjeiras do Sul;4128658;Virmond;2;2;4;29
4105201;Cerro Azul;4128633;Doutor Ulysses;2;2;4;33
4105300;Céu Azul;4128559;Vera Cruz do Oeste;2;2;4;10
4127700;Toledo;4128559;Vera Cruz do Oeste;2;2;4;39
4101606;Arapoti;4128534;Ventania;2;2;4;43
4104907;Castro;4128534;Ventania;2;2;4;62
4107009;Curiúva;4128534;Ventania;2;2;4;32
4119905;Ponta Grossa;4128534;Ventania;2;2;4;96
4124103;Santo Antônio da Platina;4128534;Ventania;2;2;4;106
4127502;Tibagi;4128534;Ventania;2;2;4;34
4106902;Curitiba;4128500;Wenceslau Braz;2;2;4;181
4109708;Ibaiti;4128500;Wenceslau Braz;2;2;4;37
4119905;Ponta Grossa;4128500;Wenceslau Braz;2;2;4;141
4122909;Salto do Itararé;4128500;Wenceslau Braz;2;2;4;35
4124004;Santana do Itararé;4128500;Wenceslau Braz;2;2;4;24
4115200;Maringá;4128302;Uniflor;2;2;4;45
4117602;Palmas;4128203;União da Vitória;2;2;4;87
4120606;Prudentópolis;4128203;União da Vitória;2;2;4;118
4125506;São José dos Pinhais;4128203;União da Vitória;2;2;4;212
1302603;Manaus;4128104;Umuarama;2;2;4;2374
2105302;Imperatriz;4128104;Umuarama;2;2;4;2097
2903201;Barreiras;4128104;Umuarama;2;2;4;1517
3106200;Belo Horizonte;4128104;Umuarama;2;2;4;1031
3509502;Campinas;4128104;Umuarama;2;2;4;643
3518800;Guarulhos;4128104;Umuarama;2;2;4;689
3541406;Presidente Prudente;4128104;Umuarama;2;2;4;264
4100707;Alto Piquiri;4128104;Umuarama;2;2;4;34
4102000;Assis Chateaubriand;4128104;Umuarama;2;2;4;80
4103701;Cambé;4128104;Umuarama;2;2;4;214
4105607;Cidade Gaúcha;4128104;Umuarama;2;2;4;55
4109302;Guaraniaçu;4128104;Umuarama;2;2;4;159
4109401;Guarapuava;4128104;Umuarama;2;2;4;264
4113502;Loanda;4128104;Umuarama;2;2;4;92
4114609;Marechal Cândido Rondon;4128104;Umuarama;2;2;4;118
4114807;Marialva;4128104;Umuarama;2;2;4;158
4115804;Medianeira;4128104;Umuarama;2;2;4;189
4118501;Pato Branco;4128104;Umuarama;2;2;4;284
4123501;Santa Helena;4128104;Umuarama;2;2;4;163
4126801;Tapejara;4128104;Umuarama;2;2;4;45
4104303;Campo Mourão;4128005;Ubiratã;2;2;4;82
4106308;Corbélia;4128005;Ubiratã;2;2;4;41
4115200;Maringá;4128005;Ubiratã;2;2;4;163
4119905;Ponta Grossa;4128005;Ubiratã;2;2;4;293
4127700;Toledo;4128005;Ubiratã;2;2;4;81
4106902;Curitiba;4127965;Turvo;2;2;4;230
4119905;Ponta Grossa;4127965;Turvo;2;2;4;138
4103453;Cafelândia;4127957;Tupãssi;2;2;4;20
4104808;Cascavel;4127957;Tupãssi;2;2;4;40
4104303;Campo Mourão;4127908;Tuneiras do Oeste;2;2;4;53
4126801;Tapejara;4127908;Tuneiras do Oeste;2;2;4;15
4105805;Colombo;4127882;Tunas do Paraná;2;2;4;35
4120903;Quedas do Iguaçu;4127858;Três Barras do Paraná;2;2;4;28
4124103;Santo Antônio da Platina;4127809;Tomazina;2;2;4;55
3304557;Rio de Janeiro;4127700;Toledo;2;2;4;1075
3509502;Campinas;4127700;Toledo;2;2;4;703
3522604;Itapira;4127700;Toledo;2;2;4;741
3524006;Itupeva;4127700;Toledo;2;2;4;696
3525904;Jundiaí;4127700;Toledo;2;2;4;711
4103354;Braganey;4127700;Toledo;2;2;4;65
4105508;Cianorte;4127700;Toledo;2;2;4;166
4108403;Francisco Beltrão;4127700;Toledo;2;2;4;167
4109302;Guaraniaçu;4127700;Toledo;2;2;4;100
4115606;Matelândia;4127700;Toledo;2;2;4;63
4116703;Nova Aurora;4127700;Toledo;2;2;4;55
4117222;Nova Santa Rosa;4127700;Toledo;2;2;4;35
4120853;Quatro Pontes;4127700;Toledo;2;2;4;27
4122404;Rolândia;4127700;Toledo;2;2;4;287
4101804;Araucária;4127601;Tijucas do Sul;2;2;4;43
4106902;Curitiba;4127601;Tijucas do Sul;2;2;4;55
4104907;Castro;4127502;Tibagi;2;2;4;47
4106902;Curitiba;4127403;Terra Roxa;2;2;4;511
4108320;Francisco Alves;4127403;Terra Roxa;2;2;4;27
4108908;Guairaçá;4127304;Terra Rica;2;2;4;26
4118105;Paranacity;4127304;Terra Rica;2;2;4;54
3550308;São Paulo;4127205;Terra Boa;2;2;4;590
4113007;Jussara;4127205;Terra Boa;2;2;4;16
4113700;Londrina;4127205;Terra Boa;2;2;4;141
3505708;Barueri;4127106;Telêmaco Borba;2;2;4;396
3509502;Campinas;4127106;Telêmaco Borba;2;2;4;399
3518800;Guarulhos;4127106;Telêmaco Borba;2;2;4;428
3534401;Osasco;4127106;Telêmaco Borba;2;2;4;403
4104907;Castro;4127106;Telêmaco Borba;2;2;4;78
4106407;Cornélio Procópio;4127106;Telêmaco Borba;2;2;4;131
4109401;Guarapuava;4127106;Telêmaco Borba;2;2;4;139
4110078;Imbaú;4127106;Telêmaco Borba;2;2;4;12
4117305;Ortigueira;4127106;Telêmaco Borba;2;2;4;33
4121703;Reserva;4127106;Telêmaco Borba;2;2;4;36
4124103;Santo Antônio da Platina;4127106;Telêmaco Borba;2;2;4;131
3525904;Jundiaí;4127007;Teixeira Soares;2;2;4;430
4115200;Maringá;4126900;Tapira;2;2;4;117
4123709;Santa Isabel do Ivaí;4126900;Tapira;2;2;4;39
4118808;Peabiru;4126801;Tapejara;2;2;4;58
4118402;Paranavaí;4126702;Tamboara;2;2;4;12
4115754;Mauá da Serra;4126678;Tamarana;2;2;4;24
4109708;Ibaiti;4126603;Siqueira Campos;2;2;4;41
4112009;Jaguariaíva;4126603;Siqueira Campos;2;2;4;66
4120705;Quatiguá;4126603;Siqueira Campos;2;2;4;16
4122909;Salto do Itararé;4126603;Siqueira Campos;2;2;4;21
3550308;São Paulo;4126504;Sertanópolis;2;2;4;455
4101507;Arapongas;4126504;Sertanópolis;2;2;4;57
4119905;Ponta Grossa;4126306;Sengés;2;2;4;131
4124806;São João;4126272;Saudade do Iguaçu;2;2;4;18
4110003;Iguaraçu;4126256;Sarandi;2;2;4;28
4117503;Paiçandu;4126256;Sarandi;2;2;4;18
4117909;Palotina;4126256;Sarandi;2;2;4;220
4112405;Japurá;4126108;São Tomé;2;2;4;8
4113700;Londrina;4126009;São Sebastião da Amoreira;2;2;4;44
4123204;Santa Cecília do Pavão;4126009;São Sebastião da Amoreira;2;2;4;6
4124707;São Jerônimo da Serra;4126009;São Sebastião da Amoreira;2;2;4;29
4112108;Jandaia do Sul;4125803;São Pedro do Ivaí;2;2;4;36
3534401;Osasco;4125704;São Miguel do Iguaçu;2;2;4;771
4106902;Curitiba;4125704;São Miguel do Iguaçu;2;2;4;498
4114609;Marechal Cândido Rondon;4125704;São Miguel do Iguaçu;2;2;4;90
4119905;Ponta Grossa;4125704;São Miguel do Iguaçu;2;2;4;411
3304557;Rio de Janeiro;4125605;São Mateus do Sul;2;2;4;778
4101309;Antônio Olinto;4125605;São Mateus do Sul;2;2;4;25
4109401;Guarapuava;4125605;São Mateus do Sul;2;2;4;118
4109708;Ibaiti;4125605;São Mateus do Sul;2;2;4;220
4118204;Paranaguá;4125605;São Mateus do Sul;2;2;4;185
4122305;Rio Negro;4125605;São Mateus do Sul;2;2;4;66
2927408;Salvador;4125506;São José dos Pinhais;2;2;4;1732
3136702;Juiz de Fora;4125506;São José dos Pinhais;2;2;4;715
3205309;Vitória;4125506;São José dos Pinhais;2;2;4;1053
3301702;Duque de Caxias;4125506;São José dos Pinhais;2;2;4;659
3504107;Atibaia;4125506;São José dos Pinhais;2;2;4;375
3508504;Caçapava;4125506;São José dos Pinhais;2;2;4;439
3509205;Cajamar;4125506;São José dos Pinhais;2;2;4;334
3509254;Cajati;4125506;São José dos Pinhais;2;2;4;139
3515004;Embu;4125506;São José dos Pinhais;2;2;4;313
3522208;Itapecerica da Serra;4125506;São José dos Pinhais;2;2;4;308
3523404;Itatiba;4125506;São José dos Pinhais;2;2;4;365
3529005;Marília;4125506;São José dos Pinhais;2;2;4;375
3538709;Piracicaba;4125506;São José dos Pinhais;2;2;4;344
3547809;Santo André;4125506;São José dos Pinhais;2;2;4;337
3554508;Tietê;4125506;São José dos Pinhais;2;2;4;307
4103107;Bocaiúva do Sul;4125506;São José dos Pinhais;2;2;4;38
4103701;Cambé;4125506;São José dos Pinhais;2;2;4;324
4105508;Cianorte;4125506;São José dos Pinhais;2;2;4;399
4109401;Guarapuava;4125506;São José dos Pinhais;2;2;4;229
4109609;Guaratuba;4125506;São José dos Pinhais;2;2;4;69
4114609;Marechal Cândido Rondon;4125456;São José das Palmeiras;2;2;4;29
4105508;Cianorte;4125357;São Jorge do Patrocínio;2;2;4;136
4107520;Esperança Nova;4125357;São Jorge do Patrocínio;2;2;4;12
4107306;Doutor Camargo;4125308;São Jorge do Ivaí;2;2;4;17
4120903;Quedas do Iguaçu;4125209;São Jorge d'Oeste;2;2;4;28
4113205;Lapa;4125100;São João do Triunfo;2;2;4;59
4117701;Palmeira;4125100;São João do Triunfo;2;2;4;41
4101408;Apucarana;4125001;São João do Ivaí;2;2;4;60
4102505;Barbosa Ferraz;4125001;São João do Ivaí;2;2;4;20
4111506;Ivaiporã;4125001;São João do Ivaí;2;2;4;31
4112108;Jandaia do Sul;4125001;São João do Ivaí;2;2;4;45
4103222;Bom Sucesso do Sul;4124806;São João;2;2;4;30
4106506;Coronel Vivida;4124806;São João;2;2;4;25
4107405;Enéas Marques;4124806;São João;2;2;4;46
4115408;Marmeleiro;4124806;São João;2;2;4;47
4117255;Nova Prata do Iguaçu;4124806;São João;2;2;4;66
4121604;Renascença;4124806;São João;2;2;4;44
4123006;Salto do Lontra;4124806;São João;2;2;4;59
4106407;Cornélio Procópio;4124707;São Jerônimo da Serra;2;2;4;61
3550308;São Paulo;4124608;São Carlos do Ivaí;2;2;4;598
4105508;Cianorte;4124608;São Carlos do Ivaí;2;2;4;41
4107801;Floraí;4124608;São Carlos do Ivaí;2;2;4;18
4115200;Maringá;4124608;São Carlos do Ivaí;2;2;4;57
3550308;São Paulo;4124509;Santo Inácio;2;2;4;541
4103404;Cafeara;4124509;Santo Inácio;2;2;4;13
4102604;Barracão;4124400;Santo Antônio do Sudoeste;2;2;4;21
4104600;Capitão Leônidas Marques;4124400;Santo Antônio do Sudoeste;2;2;4;66
4106902;Curitiba;4124400;Santo Antônio do Sudoeste;2;2;4;448
4108403;Francisco Beltrão;4124400;Santo Antônio do Sudoeste;2;2;4;67
4119806;Planalto;4124400;Santo Antônio do Sudoeste;2;2;4;39
3534401;Osasco;4124103;Santo Antônio da Platina;2;2;4;341
4101606;Arapoti;4124103;Santo Antônio da Platina;2;2;4;99
4107751;Figueira;4124103;Santo Antônio da Platina;2;2;4;68
4111704;Jaboti;4124103;Santo Antônio da Platina;2;2;4;49
4112306;Japira;4124103;Santo Antônio da Platina;2;2;4;57
4115200;Maringá;4124103;Santo Antônio da Platina;2;2;4;187
4117008;Nova Fátima;4124103;Santo Antônio da Platina;2;2;4;49
4119202;Pinhalão;4124103;Santo Antônio da Platina;2;2;4;55
4119905;Ponta Grossa;4124103;Santo Antônio da Platina;2;2;4;200
4124004;Santana do Itararé;4124103;Santo Antônio da Platina;2;2;4;71
4106902;Curitiba;4124053;Santa Terezinha de Itaipu;2;2;4;518
4116059;Missal;4124053;Santa Terezinha de Itaipu;2;2;4;43
4119905;Ponta Grossa;4124053;Santa Terezinha de Itaipu;2;2;4;432
4115804;Medianeira;4124020;Santa Tereza do Oeste;2;2;4;54
3550308;São Paulo;4123907;Santa Mariana;2;2;4;401
4102406;Bandeirantes;4123907;Santa Mariana;2;2;4;16
4109807;Ibiporã;4123907;Santa Mariana;2;2;4;56
4119905;Ponta Grossa;4123857;Santa Maria do Oeste;2;2;4;173
4101002;Ampére;4123808;Santa Izabel do Oeste;2;2;4;10
4104501;Capanema;4123808;Santa Izabel do Oeste;2;2;4;36
4104808;Cascavel;4123808;Santa Izabel do Oeste;2;2;4;97
4123006;Salto do Lontra;4123808;Santa Izabel do Oeste;2;2;4;18
3550308;São Paulo;4123709;Santa Isabel do Ivaí;2;2;4;679
4113502;Loanda;4123709;Santa Isabel do Ivaí;2;2;4;12
4118402;Paranavaí;4123709;Santa Isabel do Ivaí;2;2;4;80
4105508;Cianorte;4123501;Santa Helena;2;2;4;219
4115200;Maringá;4123501;Santa Helena;2;2;4;289
2704302;Maceió;4123402;Santa Fé;2;2;4;2172
4102109;Astorga;4123402;Santa Fé;2;2;4;26
4113601;Lobato;4123402;Santa Fé;2;2;4;15
4113700;Londrina;4123402;Santa Fé;2;2;4;73
4115200;Maringá;4123402;Santa Fé;2;2;4;45
4116406;Nossa Senhora das Graças;4123402;Santa Fé;2;2;4;14
4116901;Nova Esperança;4123402;Santa Fé;2;2;4;44
4122404;Rolândia;4123402;Santa Fé;2;2;4;54
4113700;Londrina;4123204;Santa Cecília do Pavão;2;2;4;45
4100103;Abatiá;4123105;Santa Amélia;2;2;4;12
4107207;Dois Vizinhos;4123006;Salto do Lontra;2;2;4;26
4117255;Nova Prata do Iguaçu;4123006;Salto do Lontra;2;2;4;17
4121406;Realeza;4123006;Salto do Lontra;2;2;4;23
3550308;São Paulo;4122909;Salto do Itararé;2;2;4;306
4104501;Capanema;4122800;Salgado Filho;2;2;4;70
3550308;São Paulo;4122701;Sabáudia;2;2;4;503
4101408;Apucarana;4122701;Sabáudia;2;2;4;29
4106902;Curitiba;4122701;Sabáudia;2;2;4;331
4112405;Japurá;4122602;Rondon;2;2;4;22
4118402;Paranavaí;4122602;Rondon;2;2;4;47
4116802;Nova Cantu;4122503;Roncador;2;2;4;31
3511102;Catanduva;4122404;Rolândia;2;2;4;340
3529005;Marília;4122404;Rolândia;2;2;4;188
3534401;Osasco;4122404;Rolândia;2;2;4;469
3543402;Ribeirão Preto;4122404;Rolândia;2;2;4;434
4101101;Andirá;4122404;Rolândia;2;2;4;120
4101804;Araucária;4122404;Rolândia;2;2;4;324
4103602;Cambará;4122404;Rolândia;2;2;4;136
4114203;Mandaguari;4122404;Rolândia;2;2;4;44
4117214;Nova Santa Bárbara;4122404;Rolândia;2;2;4;73
4118402;Paranavaí;4122404;Rolândia;2;2;4;112
4101804;Araucária;4122305;Rio Negro;2;2;4;70
4113205;Lapa;4122305;Rio Negro;2;2;4;38
4105201;Cerro Azul;4122206;Rio Branco do Sul;2;2;4;41
4119905;Ponta Grossa;4122206;Rio Branco do Sul;2;2;4;86
4101408;Apucarana;4122107;Rio Bom;2;2;4;23
4114203;Mandaguari;4122107;Rio Bom;2;2;4;37
4114906;Marilândia do Sul;4122107;Rio Bom;2;2;4;11
4110706;Irati;4122008;Rio Azul;2;2;4;32
4117008;Nova Fátima;4121901;Ribeirão do Pinhal;2;2;4;21
3550308;São Paulo;4121802;Ribeirão Claro;2;2;4;323
4103602;Cambará;4121802;Ribeirão Claro;2;2;4;36
4101606;Arapoti;4121703;Reserva;2;2;4;117
4120606;Prudentópolis;4121505;Rebouças;2;2;4;56
4102604;Barracão;4121406;Realeza;2;2;4;52
4106902;Curitiba;4121406;Realeza;2;2;4;427
3550308;São Paulo;4121307;Rancho Alegre;2;2;4;442
4104006;Campina Grande do Sul;4121208;Quitandinha;2;2;4;77
4114302;Mandirituba;4121208;Quitandinha;2;2;4;20
4107504;Engenheiro Beltrão;4121109;Quinta do Sol;2;2;4;15
4113502;Loanda;4121000;Querência do Norte;2;2;4;39
4115200;Maringá;4121000;Querência do Norte;2;2;4;164
4118402;Paranavaí;4121000;Querência do Norte;2;2;4;106
4106902;Curitiba;4120903;Quedas do Iguaçu;2;2;4;364
4117057;Nova Laranjeiras;4120903;Quedas do Iguaçu;2;2;4;40
3550308;São Paulo;4120705;Quatiguá;2;2;4;333
4101507;Arapongas;4120606;Prudentópolis;2;2;4;204
4113908;Mallet;4120606;Prudentópolis;2;2;4;76
4118204;Paranaguá;4120606;Prudentópolis;2;2;4;253
4102802;Bela Vista do Paraíso;4120507;Primeiro de Maio;2;2;4;22
4113700;Londrina;4120408;Presidente Castelo Branco;2;2;4;102
4104808;Cascavel;4120358;Pranchita;2;2;4;122
4115200;Maringá;4120200;Porto Rico;2;2;4;156
4105102;Centenário do Sul;4120002;Porecatu;2;2;4;23
4109807;Ibiporã;4120002;Porecatu;2;2;4;66
3550308;São Paulo;4119954;Pontal do Paraná;2;2;4;291
2905701;Camaçari;4119905;Ponta Grossa;2;2;4;1791
3104007;Araxá;4119905;Ponta Grossa;2;2;4;689
3169307;Três Corações;4119905;Ponta Grossa;2;2;4;622
3201308;Cariacica;4119905;Ponta Grossa;2;2;4;1103
3205101;Viana;4119905;Ponta Grossa;2;2;4;1084
3507506;Botucatu;4119905;Ponta Grossa;2;2;4;301
3513504;Cubatão;4119905;Ponta Grossa;2;2;4;399
3522307;Itapetininga;4119905;Ponta Grossa;2;2;4;271
3524006;Itupeva;4119905;Ponta Grossa;2;2;4;379
3525904;Jundiaí;4119905;Ponta Grossa;2;2;4;390
3534302;Orlândia;4119905;Ponta Grossa;2;2;4;536
3538709;Piracicaba;4119905;Ponta Grossa;2;2;4;362
3548708;São Bernardo do Campo;4119905;Ponta Grossa;2;2;4;391
3549805;São José do Rio Preto;4119905;Ponta Grossa;2;2;4;480
3557006;Votorantim;4119905;Ponta Grossa;2;2;4;328
4102000;Assis Chateaubriand;4119905;Ponta Grossa;2;2;4;345
4103602;Cambará;4119905;Ponta Grossa;2;2;4;228
4104006;Campina Grande do Sul;4119905;Ponta Grossa;2;2;4;114
4105508;Cianorte;4119905;Ponta Grossa;2;2;4;292
4106407;Cornélio Procópio;4119905;Ponta Grossa;2;2;4;219
4107009;Curiúva;4119905;Ponta Grossa;2;2;4;122
4107207;Dois Vizinhos;4119905;Ponta Grossa;2;2;4;301
4109302;Guaraniaçu;4119905;Ponta Grossa;2;2;4;273
4110201;Inácio Martins;4119905;Ponta Grossa;2;2;4;106
4113304;Laranjeiras do Sul;4119905;Ponta Grossa;2;2;4;237
4114609;Marechal Cândido Rondon;4119905;Ponta Grossa;2;2;4;396
4115804;Medianeira;4119905;Ponta Grossa;2;2;4;398
4117305;Ortigueira;4119905;Ponta Grossa;2;2;4;127
4117909;Palotina;4119905;Ponta Grossa;2;2;4;377
4117107;Nova Londrina;4119707;Planaltina do Paraná;2;2;4;28
3550308;São Paulo;4119608;Pitanga;2;2;4;529
4102901;Bituruna;4119608;Pitanga;2;2;4;156
4110706;Irati;4119608;Pitanga;2;2;4;138
4113304;Laranjeiras do Sul;4119608;Pitanga;2;2;4;105
2211001;Teresina;4119509;Piraquara;2;2;4;2330
3552205;Sorocaba;4119509;Piraquara;2;2;4;267
3550308;São Paulo;4119400;Piraí do Sul;2;2;4;347
4102901;Bituruna;4119301;Pinhão;2;2;4;53
4106902;Curitiba;4119301;Pinhão;2;2;4;239
4109708;Ibaiti;4119202;Pinhalão;2;2;4;15
4111704;Jaboti;4119202;Pinhalão;2;2;4;6
2304285;Eusébio;4119152;Pinhais;2;2;4;2596
2611606;Recife;4119152;Pinhais;2;2;4;2354
2905701;Camaçari;4119152;Pinhais;2;2;4;1759
2927408;Salvador;4119152;Pinhais;2;2;4;1725
3106200;Belo Horizonte;4119152;Pinhais;2;2;4;801
3522505;Itapevi;4119152;Pinhais;2;2;4;308
3545209;Salto;4119152;Pinhais;2;2;4;313
3547809;Santo André;4119152;Pinhais;2;2;4;332
3548708;São Bernardo do Campo;4119152;Pinhais;2;2;4;323
3548807;São Caetano do Sul;4119152;Pinhais;2;2;4;332
4103107;Bocaiúva do Sul;4119152;Pinhais;2;2;4;28
4107652;Fazenda Rio Grande;4119152;Pinhais;2;2;4;26
4108304;Foz do Iguaçu;4119152;Pinhais;2;2;4;534
4118204;Paranaguá;4119152;Pinhais;2;2;4;66
4100301;Agudos do Sul;4119103;Piên;2;2;4;15
4104105;Campo do Tenente;4119103;Piên;2;2;4;29
4114302;Mandirituba;4119103;Piên;2;2;4;37
4102752;Bela Vista da Caroba;4119004;Pérola d'Oeste;2;2;4;10
4103479;Cafezal do Sul;4118857;Perobal;2;2;4;15
4107504;Engenheiro Beltrão;4118808;Peabiru;2;2;4;15
4115200;Maringá;4118808;Peabiru;2;2;4;68
3304557;Rio de Janeiro;4118600;Paula Freitas;2;2;4;842
4117602;Palmas;4118600;Paula Freitas;2;2;4;109
3538709;Piracicaba;4118501;Pato Branco;2;2;4;627
3552403;Sumaré;4118501;Pato Branco;2;2;4;652
4101002;Ampére;4118501;Pato Branco;2;2;4;88
4104303;Campo Mourão;4118501;Pato Branco;2;2;4;244
4115804;Medianeira;4118501;Pato Branco;2;2;4;177
4107538;Entre Rios do Oeste;4118451;Pato Bragado;2;2;4;9
4108403;Francisco Beltrão;4118451;Pato Bragado;2;2;4;201
4101507;Arapongas;4118402;Paranavaí;2;2;4;109
4102109;Astorga;4118402;Paranavaí;2;2;4;81
4104808;Cascavel;4118402;Paranavaí;2;2;4;230
4107108;Diamante do Norte;4118402;Paranavaí;2;2;4;65
4111506;Ivaiporã;4118402;Paranavaí;2;2;4;147
4117107;Nova Londrina;4118402;Paranavaí;2;2;4;66
3550308;São Paulo;4118303;Paranapoema;2;2;4;573
1501402;Belém;4118204;Paranaguá;2;2;4;2677
3170107;Uberaba;4118204;Paranaguá;2;2;4;650
3205101;Viana;4118204;Paranaguá;2;2;4;974
3513504;Cubatão;4118204;Paranaguá;2;2;4;283
3518701;Guarujá;4118204;Paranaguá;2;2;4;291
3543402;Ribeirão Preto;4118204;Paranaguá;2;2;4;496
3548807;São Caetano do Sul;4118204;Paranaguá;2;2;4;295
3550704;São Sebastião;4118204;Paranaguá;2;2;4;371
4104105;Campo do Tenente;4118204;Paranaguá;2;2;4;121
4108809;Guaíra;4118204;Paranaguá;2;2;4;590
4110706;Irati;4118204;Paranaguá;2;2;4;209
4105508;Cianorte;4118006;Paraíso do Norte;2;2;4;42
4102109;Astorga;4117909;Palotina;2;2;4;247
4103370;Brasilândia do Sul;4117909;Palotina;2;2;4;31
4103909;Campina da Lagoa;4117909;Palotina;2;2;4;108
4108601;Goioerê;4117909;Palotina;2;2;4;81
4116802;Nova Cantu;4117909;Palotina;2;2;4;133
4109401;Guarapuava;4117800;Palmital;2;2;4;94
4104204;Campo Largo;4117701;Palmeira;2;2;4;48
4113205;Lapa;4117701;Palmeira;2;2;4;48
4115309;Mariópolis;4117602;Palmas;2;2;4;60
4115200;Maringá;4117404;Ourizona;2;2;4;28
4101408;Apucarana;4117305;Ortigueira;2;2;4;88
4104907;Castro;4117305;Ortigueira;2;2;4;111
4114203;Mandaguari;4117305;Ortigueira;2;2;4;105
4101002;Ampére;4117255;Nova Prata do Iguaçu;2;2;4;34
4104303;Campo Mourão;4117222;Nova Santa Rosa;2;2;4;165
3550308;São Paulo;4117206;Nova Olímpia;2;2;4;659
4107256;Douradina;4117206;Nova Olímpia;2;2;4;23
4106902;Curitiba;4117107;Nova Londrina;2;2;4;484
4108908;Guairaçá;4117107;Nova Londrina;2;2;4;36
4104808;Cascavel;4117057;Nova Laranjeiras;2;2;4;100
4113700;Londrina;4117008;Nova Fátima;2;2;4;62
4115408;Marmeleiro;4116950;Nova Esperança do Sudoeste;2;2;4;36
4102109;Astorga;4116901;Nova Esperança;2;2;4;55
4105904;Colorado;4116901;Nova Esperança;2;2;4;45
4106902;Curitiba;4116901;Nova Esperança;2;2;4;391
4114203;Mandaguari;4116901;Nova Esperança;2;2;4;66
4103909;Campina da Lagoa;4116802;Nova Cantu;2;2;4;25
4104303;Campo Mourão;4116802;Nova Cantu;2;2;4;72
4104808;Cascavel;4116703;Nova Aurora;2;2;4;51
3550308;São Paulo;4116109;Moreira Sales;2;2;4;647
4108601;Goioerê;4116109;Moreira Sales;2;2;4;15
4115101;Mariluz;4116109;Moreira Sales;2;2;4;16
4115200;Maringá;4116109;Moreira Sales;2;2;4;130
4115606;Matelândia;4116059;Missal;2;2;4;31
4104501;Capanema;4115804;Medianeira;2;2;4;53
4114203;Mandaguari;4115754;Mauá da Serra;2;2;4;62
4101200;Antonina;4115705;Matinhos;2;2;4;51
4106902;Curitiba;4115606;Matelândia;2;2;4;474
4108403;Francisco Beltrão;4115358;Maripá;2;2;4;201
4106506;Coronel Vivida;4115309;Mariópolis;2;2;4;40
1100304;Vilhena;4115200;Maringá;2;2;4;1431
1501402;Belém;4115200;Maringá;2;2;4;2463
1721000;Palmas;4115200;Maringá;2;2;4;1488
2111300;São Luís;4115200;Maringá;2;2;4;2431
2507507;João Pessoa;4115200;Maringá;2;2;4;2456
2704302;Maceió;4115200;Maringá;2;2;4;2206
2919207;Lauro de Freitas;4115200;Maringá;2;2;4;1783
3118601;Contagem;4115200;Maringá;2;2;4;882
3131307;Ipatinga;4115200;Maringá;2;2;4;1043
3136702;Juiz de Fora;4115200;Maringá;2;2;4;893
3148004;Patos de Minas;4115200;Maringá;2;2;4;765
3205002;Serra;4115200;Maringá;2;2;4;1230
3305505;Saquarema;4115200;Maringá;2;2;4;968
3506508;Birigui;4115200;Maringá;2;2;4;285
3510005;Cândido Mota;4115200;Maringá;2;2;4;175
3551702;Sertãozinho;4115200;Maringá;2;2;4;473
4101705;Araruna;4115200;Maringá;2;2;4;80
4101804;Araucária;4115200;Maringá;2;2;4;353
4102208;Atalaia;4115200;Maringá;2;2;4;34
4104204;Campo Largo;4115200;Maringá;2;2;4;334
4104709;Carlópolis;4115200;Maringá;2;2;4;226
4104907;Castro;4115200;Maringá;2;2;4;244
4105607;Cidade Gaúcha;4115200;Maringá;2;2;4;104
4107256;Douradina;4115200;Maringá;2;2;4;139
4107652;Fazenda Rio Grande;4115200;Maringá;2;2;4;366
4108403;Francisco Beltrão;4115200;Maringá;2;2;4;316
4113007;Jussara;4115200;Maringá;2;2;4;59
4113205;Lapa;4115200;Maringá;2;2;4;345
4113601;Lobato;4115200;Maringá;2;2;4;47
4115002;Marilena;4115200;Maringá;2;2;4;137
4113700;Londrina;4115101;Mariluz;2;2;4;217
4114203;Mandaguari;4114906;Marilândia do Sul;2;2;4;45
4101507;Arapongas;4114807;Marialva;2;2;4;37
4101804;Araucária;4114807;Marialva;2;2;4;339
4114104;Mandaguaçu;4114807;Marialva;2;2;4;38
4107256;Douradina;4114708;Maria Helena;2;2;4;27
2933307;Vitória da Conquista;4114609;Marechal Cândido Rondon;2;2;4;1684
3504008;Assis;4114609;Marechal Cândido Rondon;2;2;4;419
4109401;Guarapuava;4114500;Manoel Ribas;2;2;4;99
3518800;Guarulhos;4114302;Mandirituba;2;2;4;378
4104006;Campina Grande do Sul;4114302;Mandirituba;2;2;4;59
2607901;Jaboatão dos Guararapes;4114203;Mandaguari;2;2;4;2364
4103800;Cambira;4114203;Mandaguari;2;2;4;11
4105508;Cianorte;4114203;Mandaguari;2;2;4;92
4111100;Itambé;4114203;Mandaguari;2;2;4;31
4113106;Kaloré;4114203;Mandaguari;2;2;4;29
4113700;Londrina;4114203;Mandaguari;2;2;4;63
4106902;Curitiba;4114104;Mandaguaçu;2;2;4;373
4113700;Londrina;4114104;Mandaguaçu;2;2;4;100
4103008;Boa Esperança;4114005;Mamborê;2;2;4;28
4106803;Cruz Machado;4113908;Mallet;2;2;4;55
4105102;Centenário do Sul;4113809;Lupionópolis;2;2;4;10
4113700;Londrina;4113809;Lupionópolis;2;2;4;79
4105508;Cianorte;4113759;Lunardelli;2;2;4;99
4112108;Jandaia do Sul;4113759;Lunardelli;2;2;4;54
4112504;Jardim Alegre;4113759;Lunardelli;2;2;4;12
3550308;São Paulo;4113734;Luiziana;2;2;4;574
2403251;Parnamirim;4113700;Londrina;2;2;4;2475
2910800;Feira de Santana;4113700;Londrina;2;2;4;1715
2919553;Luís Eduardo magalhães;4113700;Londrina;2;2;4;1347
3106705;Betim;4113700;Londrina;2;2;4;795
3122306;Divinópolis;4113700;Londrina;2;2;4;723
3143302;Montes Claros;4113700;Londrina;2;2;4;1029
3147907;Passos;4113700;Londrina;2;2;4;541
3152501;Pouso Alegre;4113700;Londrina;2;2;4;544
3203205;Linhares;4113700;Londrina;2;2;4;1204
3300704;Cabo Frio;4113700;Londrina;2;2;4;929
3301702;Duque de Caxias;4113700;Londrina;2;2;4;803
3305802;Teresópolis;4113700;Londrina;2;2;4;836
3501608;Americana;4113700;Londrina;2;2;4;395
3503307;Araras;4113700;Londrina;2;2;4;399
3505500;Barretos;4113700;Londrina;2;2;4;400
3507506;Botucatu;4113700;Londrina;2;2;4;281
3515509;Fernandópolis;4113700;Londrina;2;2;4;347
3524402;Jacareí;4113700;Londrina;2;2;4;533
3525003;Jandira;4113700;Londrina;2;2;4;436
3526902;Limeira;4113700;Londrina;2;2;4;392
3542404;Regente Feijó;4113700;Londrina;2;2;4;120
3545803;Santa Bárbara d'Oeste;4113700;Londrina;2;2;4;386
3548906;São Carlos;4113700;Londrina;2;2;4;361
3552502;Suzano;4113700;Londrina;2;2;4;497
3553609;Tapiratiba;4113700;Londrina;2;2;4;491
4104204;Campo Largo;4113700;Londrina;2;2;4;292
4107009;Curiúva;4113700;Londrina;2;2;4;108
4107306;Doutor Camargo;4113700;Londrina;2;2;4;113
4108601;Goioerê;4113700;Londrina;2;2;4;216
4108908;Guairaçá;4113700;Londrina;2;2;4;162
4109401;Guarapuava;4113700;Londrina;2;2;4;234
4110003;Iguaraçu;4113700;Londrina;2;2;4;70
4110904;Itaguajé;4113700;Londrina;2;2;4;112
4111902;Jaguapitã;4113700;Londrina;2;2;4;44
4112504;Jardim Alegre;4113700;Londrina;2;2;4;112
3541406;Presidente Prudente;4113601;Lobato;2;2;4;112
4108106;Flórida;4113601;Lobato;2;2;4;9
4106902;Curitiba;4113502;Loanda;2;2;4;485
4104808;Cascavel;4113452;Lindoeste;2;2;4;37
4105409;Chopinzinho;4113304;Laranjeiras do Sul;2;2;4;46
4106902;Curitiba;4113304;Laranjeiras do Sul;2;2;4;321
4108403;Francisco Beltrão;4113304;Laranjeiras do Sul;2;2;4;92
3304557;Rio de Janeiro;4113205;Lapa;2;2;4;716
4104907;Castro;4113205;Lapa;2;2;4;115
4109401;Guarapuava;4113205;Lapa;2;2;4;179
4109609;Guaratuba;4113205;Lapa;2;2;4;108
3550308;São Paulo;4112801;Joaquim Távora;2;2;4;333
4104709;Carlópolis;4112801;Joaquim Távora;2;2;4;20
4104303;Campo Mourão;4112504;Jardim Alegre;2;2;4;72
4111704;Jaboti;4112306;Japira;2;2;4;10
1703701;Brejinho de Nazaré;4112009;Jaguariaíva;2;2;4;1471
3107505;Bom Jardim de Minas;4112009;Jaguariaíva;2;2;4;611
4101804;Araucária;4112009;Jaguariaíva;2;2;4;149
4105102;Centenário do Sul;4111902;Jaguapitã;2;2;4;33
4106407;Cornélio Procópio;4111803;Jacarezinho;2;2;4;66
4107256;Douradina;4111555;Ivaté;2;2;4;8
4109906;Icaraíma;4111555;Ivaté;2;2;4;38
3550308;São Paulo;4111506;Ivaiporã;2;2;4;518
4105201;Cerro Azul;4111258;Itaperuçu;2;2;4;45
4108403;Francisco Beltrão;4111209;Itapejara d'Oeste;2;2;4;27
4108304;Foz do Iguaçu;4110953;Itaipulândia;2;2;4;46
4107736;Fernandes Pinheiro;4110706;Irati;2;2;4;12
4101804;Araucária;4110102;Imbituva;2;2;4;128
4104659;Carambeí;4110102;Imbituva;2;2;4;62
4108957;Guamiranga;4110102;Imbituva;2;2;4;21
4109401;Guarapuava;4110102;Imbituva;2;2;4;88
3534401;Osasco;4109906;Icaraíma;2;2;4;712
3506003;Bauru;4109807;Ibiporã;2;2;4;225
3524402;Jacareí;4109807;Ibiporã;2;2;4;522
4100806;Alvorada do Sul;4109807;Ibiporã;2;2;4;57
4101408;Apucarana;4109807;Ibiporã;2;2;4;52
4108007;Florestópolis;4109807;Ibiporã;2;2;4;57
3534401;Osasco;4109708;Ibaiti;2;2;4;347
4100202;Adrianópolis;4109708;Ibaiti;2;2;4;153
4102406;Bandeirantes;4109708;Ibaiti;2;2;4;85
4103602;Cambará;4109708;Ibaiti;2;2;4;91
4104659;Carambeí;4109708;Ibaiti;2;2;4;118
4104907;Castro;4109708;Ibaiti;2;2;4;103
4106001;Congonhinhas;4109708;Ibaiti;2;2;4;50
4107009;Curiúva;4109708;Ibaiti;2;2;4;34
4106506;Coronel Vivida;4109658;Honório Serpa;2;2;4;23
2408102;Natal;4109401;Guarapuava;2;2;4;2664
3104007;Araxá;4109401;Guarapuava;2;2;4;781
3505708;Barueri;4109401;Guarapuava;2;2;4;503
3516200;Franca;4109401;Guarapuava;2;2;4;670
3523800;Itobi;4109401;Guarapuava;2;2;4;601
3534302;Orlândia;4109401;Guarapuava;2;2;4;626
4103040;Boa Ventura de São Roque;4109401;Guarapuava;2;2;4;60
4104204;Campo Largo;4109401;Guarapuava;2;2;4;194
4105805;Colombo;4109401;Guarapuava;2;2;4;223
4106506;Coronel Vivida;4109401;Guarapuava;2;2;4;129
4107207;Dois Vizinhos;4109401;Guarapuava;2;2;4;166
4104808;Cascavel;4109302;Guaraniaçu;2;2;4;62
4106902;Curitiba;4108809;Guaíra;2;2;4;526
4103305;Borrazópolis;4108700;Grandes Rios;2;2;4;24
4104451;Cantagalo;4108650;Goioxim;2;2;4;24
4100509;Altônia;4108601;Goioerê;2;2;4;95
4105508;Cianorte;4108601;Goioerê;2;2;4;73
4106605;Cruzeiro do Oeste;4108601;Goioerê;2;2;4;46
4102901;Bituruna;4108502;General Carneiro;2;2;4;38
4106902;Curitiba;4108502;General Carneiro;2;2;4;229
2919553;Luís Eduardo magalhães;4108304;Foz do Iguaçu;2;2;4;1704
3504107;Atibaia;4108304;Foz do Iguaçu;2;2;4;835
3509502;Campinas;4108304;Foz do Iguaçu;2;2;4;795
3523909;Itu;4108304;Foz do Iguaçu;2;2;4;759
3525904;Jundiaí;4108304;Foz do Iguaçu;2;2;4;799
3543402;Ribeirão Preto;4108304;Foz do Iguaçu;2;2;4;820
3548500;Santos;4108304;Foz do Iguaçu;2;2;4;833
3554003;Tatuí;4108304;Foz do Iguaçu;2;2;4;705
4101507;Arapongas;4108304;Foz do Iguaçu;2;2;4;383
4104303;Campo Mourão;4108304;Foz do Iguaçu;2;2;4;266
3550308;São Paulo;4107900;Floresta;2;2;4;554
3550308;São Paulo;4107801;Floraí;2;2;4;580
4103305;Borrazópolis;4107603;Faxinal;2;2;4;29
4106852;Cruzmaltina;4107603;Faxinal;2;2;4;14
4106902;Curitiba;4107603;Faxinal;2;2;4;260
4101705;Araruna;4107504;Engenheiro Beltrão;2;2;4;28
4102505;Barbosa Ferraz;4107504;Engenheiro Beltrão;2;2;4;37
4105508;Cianorte;4107504;Engenheiro Beltrão;2;2;4;37
3550308;São Paulo;4107306;Doutor Camargo;2;2;4;569
3550308;São Paulo;4107207;Dois Vizinhos;2;2;4;678
4103024;Boa Esperança do Iguaçu;4107207;Dois Vizinhos;2;2;4;19
4105409;Chopinzinho;4107207;Dois Vizinhos;2;2;4;55
4106902;Curitiba;4107207;Dois Vizinhos;2;2;4;379
3509502;Campinas;4107009;Curiúva;2;2;4;367
4101903;Assaí;4107009;Curiúva;2;2;4;83
4104907;Castro;4107009;Curiúva;2;2;4;93
1200401;Rio Branco;4106902;Curitiba;2;2;4;2470
1500503;Almeirim;4106902;Curitiba;2;2;4;2666
1500602;Altamira;4106902;Curitiba;2;2;4;2479
1503606;Itaituba;4106902;Curitiba;2;2;4;2432
1504422;Marituba;4106902;Curitiba;2;2;4;2665
1600303;Macapá;4106902;Curitiba;2;2;4;2827
1722107;Xambioá;4106902;Curitiba;2;2;4;2105
2105302;Imperatriz;4106902;Curitiba;2;2;4;2211
2307304;Juazeiro do Norte;4106902;Curitiba;2;2;4;2230
2504009;Campina Grande;4106902;Curitiba;2;2;4;2390
2910727;Eunápolis;4106902;Curitiba;2;2;4;1379
2925303;Porto Seguro;4106902;Curitiba;2;2;4;1406
2933307;Vitória da Conquista;4106902;Curitiba;2;2;4;1429
3127107;Frutal;4106902;Curitiba;2;2;4;590
3127701;Governador Valadares;4106902;Curitiba;2;2;4;1026
3131307;Ipatinga;4106902;Curitiba;2;2;4;937
3143302;Montes Claros;4106902;Curitiba;2;2;4;1099
3149309;Pedro Leopoldo;4106902;Curitiba;2;2;4;825
3152501;Pouso Alegre;4106902;Curitiba;2;2;4;487
3170701;Varginha;4106902;Curitiba;2;2;4;582
3171204;Vespasiano;4106902;Curitiba;2;2;4;826
3301009;Campos dos Goytacazes;4106902;Curitiba;2;2;4;888
3302254;Itatiaia;4106902;Curitiba;2;2;4;571
3303401;Nova Friburgo;4106902;Curitiba;2;2;4;753
3303708;Paraíba do Sul;4106902;Curitiba;2;2;4;698
3304524;Rio das Ostras;4106902;Curitiba;2;2;4;801
3305505;Saquarema;4106902;Curitiba;2;2;4;738
3305802;Teresópolis;4106902;Curitiba;2;2;4;708
3306008;Três Rios;4106902;Curitiba;2;2;4;708
3502101;Andradina;4106902;Curitiba;2;2;4;541
3505500;Barretos;4106902;Curitiba;2;2;4;545
3507001;Boituva;4106902;Curitiba;2;2;4;288
3507100;Bom Jesus dos Perdões;4106902;Curitiba;2;2;4;380
3508504;Caçapava;4106902;Curitiba;2;2;4;441
3509007;Caieiras;4106902;Curitiba;2;2;4;343
3509254;Cajati;4106902;Curitiba;2;2;4;141
3509700;Campos do Jordão;4106902;Curitiba;2;2;4;477
3510500;Caraguatatuba;4106902;Curitiba;2;2;4;433
3511102;Catanduva;4106902;Curitiba;2;2;4;476
3513405;Cruzeiro;4106902;Curitiba;2;2;4;535
3518404;Guaratinguetá;4106902;Curitiba;2;2;4;503
3520509;Indaiatuba;4106902;Curitiba;2;2;4;330
3522307;Itapetininga;4106902;Curitiba;2;2;4;240
3522604;Itapira;4106902;Curitiba;2;2;4;413
3524402;Jacareí;4106902;Curitiba;2;2;4;408
3524709;Jaguariúna;4106902;Curitiba;2;2;4;380
3524808;Jales;4106902;Curitiba;2;2;4;585
3527306;Louveira;4106902;Curitiba;2;2;4;350
3528106;Macaubal;4106902;Curitiba;2;2;4;517
3531803;Monte Mor;4106902;Curitiba;2;2;4;339
3534609;Osvaldo Cruz;4106902;Curitiba;2;2;4;432
3536208;Pariquera-Açu;4106902;Curitiba;2;2;4;163
3541000;Praia Grande;4106902;Curitiba;2;2;4;330
3541505;Presidente Venceslau;4106902;Curitiba;2;2;4;473
3546801;Santa Isabel;4106902;Curitiba;2;2;4;386
3551504;Serrana;4106902;Curitiba;2;2;4;497
3553609;Tapiratiba;4106902;Curitiba;2;2;4;506
3553708;Taquaritinga;4106902;Curitiba;2;2;4;448
3556503;Várzea Paulista;4106902;Curitiba;2;2;4;348
3557006;Votorantim;4106902;Curitiba;2;2;4;284
4100103;Abatiá;4106902;Curitiba;2;2;4;257
4101101;Andirá;4106902;Curitiba;2;2;4;280
4102802;Bela Vista do Paraíso;4106902;Curitiba;2;2;4;330
4103040;Boa Ventura de São Roque;4106902;Curitiba;2;2;4;243
4103602;Cambará;4106902;Curitiba;2;2;4;276
4103909;Campina da Lagoa;4106902;Curitiba;2;2;4;364
4104055;Campo Bonito;4106902;Curitiba;2;2;4;374
4104105;Campo do Tenente;4106902;Curitiba;2;2;4;72
4105300;Céu Azul;4106902;Curitiba;2;2;4;459
4105706;Clevelândia;4106902;Curitiba;2;2;4;338
4105904;Colorado;4106902;Curitiba;2;2;4;392
4106308;Corbélia;4106902;Curitiba;2;2;4;408
3139003;Machado;4106407;Cornélio Procópio;2;2;4;511
3516200;Franca;4106407;Cornélio Procópio;2;2;4;441
3542206;Rancharia;4106407;Cornélio Procópio;2;2;4;108
3548500;Santos;4106407;Cornélio Procópio;2;2;4;449
4101101;Andirá;4106407;Cornélio Procópio;2;2;4;46
4101408;Apucarana;4106407;Cornélio Procópio;2;2;4;91
4101507;Arapongas;4106407;Cornélio Procópio;2;2;4;84
3104007;Araxá;4106209;Contenda;2;2;4;720
3541406;Presidente Prudente;4105904;Colorado;2;2;4;98
3304557;Rio de Janeiro;4105805;Colombo;2;2;4;653
3518800;Guarulhos;4105805;Colombo;2;2;4;336
3548807;São Caetano do Sul;4105805;Colombo;2;2;4;324
3548906;São Carlos;4105805;Colombo;2;2;4;382
4101507;Arapongas;4105805;Colombo;2;2;4;300
4104808;Cascavel;4105805;Colombo;2;2;4;425
4105508;Cianorte;4105607;Cidade Gaúcha;2;2;4;47
3106200;Belo Horizonte;4105508;Cianorte;2;2;4;963
3557006;Votorantim;4105508;Cianorte;2;2;4;531
4101507;Arapongas;4105508;Cianorte;2;2;4;121
4102000;Assis Chateaubriand;4105508;Cianorte;2;2;4;127
4103479;Cafezal do Sul;4105508;Cianorte;2;2;4;101
4104808;Cascavel;4105409;Chopinzinho;2;2;4;137
3550308;São Paulo;4105300;Céu Azul;2;2;4;740
3522406;Itapeva;4104907;Castro;2;2;4;147
2304400;Fortaleza;4104808;Cascavel;2;2;4;2746
2611606;Recife;4104808;Cascavel;2;2;4;2581
3118601;Contagem;4104808;Cascavel;2;2;4;1084
3170107;Uberaba;4104808;Cascavel;2;2;4;796
3548807;São Caetano do Sul;4104808;Cascavel;2;2;4;708
3549805;São José do Rio Preto;4104808;Cascavel;2;2;4;609
4103909;Campina da Lagoa;4104808;Cascavel;2;2;4;77
3538808;Piraju;4104709;Carlópolis;2;2;4;43
4101002;Ampére;4104600;Capitão Leônidas Marques;2;2;4;50
4102604;Barracão;4104501;Capanema;2;2;4;63
4104303;Campo Mourão;4104428;Candói;2;2;4;180
3550308;São Paulo;4104402;Cândido de Abreu;2;2;4;483
3304557;Rio de Janeiro;4104303;Campo Mourão;2;2;4;933
4102000;Assis Chateaubriand;4104303;Campo Mourão;2;2;4;123
4102505;Barbosa Ferraz;4104303;Campo Mourão;2;2;4;39
4103453;Cafelândia;4104303;Campo Mourão;2;2;4;114
4103909;Campina da Lagoa;4104303;Campo Mourão;2;2;4;74
3118601;Contagem;4104204;Campo Largo;2;2;4;815
3509254;Cajati;4104204;Campo Largo;2;2;4;163
3534401;Osasco;4104204;Campo Largo;2;2;4;346
4101507;Arapongas;4104204;Campo Largo;2;2;4;296
4101804;Araucária;4104006;Campina Grande do Sul;2;2;4;47
4103107;Bocaiúva do Sul;4104006;Campina Grande do Sul;2;2;4;13
3550308;São Paulo;4103800;Cambira;2;2;4;506
2304400;Fortaleza;4103701;Cambé;2;2;4;2494
3170206;Uberlândia;4103701;Cambé;2;2;4;573
3506003;Bauru;4103701;Cambé;2;2;4;247
3534401;Osasco;4103453;Cafelândia;2;2;4;669
4102000;Assis Chateaubriand;4103370;Brasilândia do Sul;2;2;4;27
4102406;Bandeirantes;4102802;Bela Vista do Paraíso;2;2;4;85
3550308;São Paulo;4102307;Balsa Nova;2;2;4;366
4100707;Alto Piquiri;4102000;Assis Chateaubriand;2;2;4;46
4101507;Arapongas;4102000;Assis Chateaubriand;2;2;4;239
2304400;Fortaleza;4101804;Araucária;2;2;4;2626
2408102;Natal;4101804;Araucária;2;2;4;2571
2905701;Camaçari;4101804;Araucária;2;2;4;1783
2906501;Candeias;4101804;Araucária;2;2;4;1772
2919926;Madre de Deus;4101804;Araucária;2;2;4;1762
3106200;Belo Horizonte;4101804;Araucária;2;2;4;825
3205200;Vila Velha;4101804;Araucária;2;2;4;1063
3302007;Itaguaí;4101804;Araucária;2;2;4;635
3506003;Bauru;4101804;Araucária;2;2;4;361
3522208;Itapecerica da Serra;4101804;Araucária;2;2;4;328
3526902;Limeira;4101804;Araucária;2;2;4;390
3530607;Moji das Cruzes;4101804;Araucária;2;2;4;391
3538709;Piracicaba;4101804;Araucária;2;2;4;359
3549904;São José dos Campos;4101804;Araucária;2;2;4;439
3552403;Sumaré;4101804;Araucária;2;2;4;373
3510203;Capão Bonito;4101606;Arapoti;2;2;4;151
3522406;Itapeva;4101606;Arapoti;2;2;4;97
3523206;Itararé;4101606;Arapoti;2;2;4;50
3170107;Uberaba;4101507;Arapongas;2;2;4;540
3304557;Rio de Janeiro;4101507;Arapongas;2;2;4;837
3506003;Bauru;4101507;Arapongas;2;2;4;268
3513009;Cotia;4101507;Arapongas;2;2;4;463
3527108;Lins;4101507;Arapongas;2;2;4;255
2304400;Fortaleza;4101408;Apucarana;2;2;4;2526
3106200;Belo Horizonte;4101408;Apucarana;2;2;4;855
3303302;Niterói;4101408;Apucarana;2;2;4;854
3518800;Guarulhos;4101408;Apucarana;2;2;4;499
3304557;Rio de Janeiro;4101200;Antonina;2;2;4;610
3534708;Ourinhos;4101101;Andirá;2;2;4;35
3550308;São Paulo;4100905;Amaporã;2;2;4;633
3550308;São Paulo;4100806;Alvorada do Sul;2;2;4;482
3550308;São Paulo;4100509;Altônia;2;2;4;737
3550308;São Paulo;3557303;Estiva Gerbi;2;2;4;160
3520905;Ipaussu;3557204;Chavantes;2;2;4;9
3538709;Piracicaba;3557204;Chavantes;2;2;4;214
3538808;Piraju;3557204;Chavantes;2;2;4;37
3134400;Iturama;3557105;Votuporanga;2;2;4;81
3530300;Mirassol;3557105;Votuporanga;2;2;4;64
3533908;Olímpia;3557105;Votuporanga;2;2;4;117
3536604;Paulo de Faria;3557105;Votuporanga;2;2;4;77
3546603;Santa Fé do Sul;3557105;Votuporanga;2;2;4;107
3507001;Boituva;3557006;Votorantim;2;2;4;39
3518800;Guarulhos;3557006;Votorantim;2;2;4;86
3529401;Mauá;3557006;Votorantim;2;2;4;97
3545209;Salto;3557006;Votorantim;2;2;4;38
3554003;Tatuí;3557006;Votorantim;2;2;4;50
3556701;Vinhedo;3557006;Votorantim;2;2;4;70
3118601;Contagem;3556909;Vista Alegre do Alto;2;2;4;490
3503703;Ariranha;3556909;Vista Alegre do Alto;2;2;4;17
3506102;Bebedouro;3556909;Vista Alegre do Alto;2;2;4;27
3553203;Taiúva;3556909;Vista Alegre do Alto;2;2;4;19
3543402;Ribeirão Preto;3556800;Viradouro;2;2;4;61
3551702;Sertãozinho;3556800;Viradouro;2;2;4;43
3554409;Terra Roxa;3556800;Viradouro;2;2;4;10
1501402;Belém;3556701;Vinhedo;2;2;4;2399
2607901;Jaboatão dos Guararapes;3556701;Vinhedo;2;2;4;2027
2905701;Camaçari;3556701;Vinhedo;2;2;4;1431
3106200;Belo Horizonte;3556701;Vinhedo;2;2;4;461
3106705;Betim;3556701;Vinhedo;2;2;4;442
3118601;Contagem;3556701;Vinhedo;2;2;4;452
3143302;Montes Claros;3556701;Vinhedo;2;2;4;764
3513801;Diadema;3556701;Vinhedo;2;2;4;81
3516200;Franca;3556701;Vinhedo;2;2;4;279
3518800;Guarulhos;3556701;Vinhedo;2;2;4;62
3523909;Itu;3556701;Vinhedo;2;2;4;43
3529401;Mauá;3556701;Vinhedo;2;2;4;88
3530706;Mogi Guaçu;3556701;Vinhedo;2;2;4;78
3543402;Ribeirão Preto;3556701;Vinhedo;2;2;4;224
3545209;Salto;3556701;Vinhedo;2;2;4;37
3547809;Santo André;3556701;Vinhedo;2;2;4;82
3556503;Várzea Paulista;3556701;Vinhedo;2;2;4;25
3516705;Garça;3556602;Vera Cruz;2;2;4;17
3550308;São Paulo;3556602;Vera Cruz;2;2;4;365
2304400;Fortaleza;3556503;Várzea Paulista;2;2;4;2299
2905701;Camaçari;3556503;Várzea Paulista;2;2;4;1437
3522703;Itápolis;3556503;Várzea Paulista;2;2;4;270
3525201;Jarinu;3556503;Várzea Paulista;2;2;4;16
3534401;Osasco;3556503;Várzea Paulista;2;2;4;36
3545209;Salto;3556503;Várzea Paulista;2;2;4;47
3548708;São Bernardo do Campo;3556453;Vargem Grande Paulista;2;2;4;47
3110301;Caldas;3556404;Vargem Grande do Sul;2;2;4;54
3534401;Osasco;3556404;Vargem Grande do Sul;2;2;4;189
3540705;Porto Ferreira;3556404;Vargem Grande do Sul;2;2;4;61
3502101;Andradina;3556305;Valparaíso;2;2;4;65
3506508;Birigui;3556305;Valparaíso;2;2;4;55
3538709;Piracicaba;3556305;Valparaíso;2;2;4;376
3513801;Diadema;3556206;Valinhos;2;2;4;88
3529302;Matão;3556206;Valinhos;2;2;4;209
3532009;Morungaba;3556206;Valinhos;2;2;4;23
3536505;Paulínia;3556206;Valinhos;2;2;4;28
3538006;Pindamonhangaba;3556206;Valinhos;2;2;4;157
3538709;Piracicaba;3556206;Valinhos;2;2;4;71
3545209;Salto;3556206;Valinhos;2;2;4;39
3551702;Sertãozinho;3556206;Valinhos;2;2;4;227
3554508;Tietê;3556206;Valinhos;2;2;4;75
3550308;São Paulo;3556107;Valentim Gentil;2;2;4;512
3525706;José Bonifácio;3556008;Urupês;2;2;4;44
3544806;Sales;3556008;Urupês;2;2;4;25
3550308;São Paulo;3555901;Uru;2;2;4;345
3519402;Ibirá;3555604;Uchoa;2;2;4;16
3303807;Parati;3555406;Ubatuba;2;2;4;46
3304557;Rio de Janeiro;3555406;Ubatuba;2;2;4;199
3518404;Guaratinguetá;3555406;Ubatuba;2;2;4;65
3539806;Poá;3555406;Ubatuba;2;2;4;126
3525706;José Bonifácio;3555356;Ubarana;2;2;4;13
3550308;São Paulo;3555356;Ubarana;2;2;4;423
3534906;Pacaembu;3555109;Tupi Paulista;2;2;4;38
3502101;Andradina;3555000;Tupã;2;2;4;142
3506003;Bauru;3555000;Tupã;2;2;4;158
3506508;Birigui;3555000;Tupã;2;2;4;73
3509502;Campinas;3555000;Tupã;2;2;4;377
3536000;Parapuã;3555000;Tupã;2;2;4;31
3537305;Penápolis;3555000;Tupã;2;2;4;75
3541604;Promissão;3555000;Tupã;2;2;4;84
3548807;São Caetano do Sul;3555000;Tupã;2;2;4;453
3551702;Sertãozinho;3555000;Tupã;2;2;4;278
3513405;Cruzeiro;3554805;Tremembé;2;2;4;73
3548708;São Bernardo do Campo;3554805;Tremembé;2;2;4;136
3514106;Dois Córregos;3554706;Torrinha;2;2;4;23
3501608;Americana;3554508;Tietê;2;2;4;56
3505302;Barra Bonita;3554508;Tietê;2;2;4;109
3507506;Botucatu;3554508;Tietê;2;2;4;78
3511607;Cesário Lange;3554508;Tietê;2;2;4;28
3523206;Itararé;3554508;Tietê;2;2;4;201
3525854;Jumirim;3554508;Tietê;2;2;4;7
3543907;Rio Claro;3554508;Tietê;2;2;4;79
3545209;Salto;3554508;Tietê;2;2;4;45
3545803;Santa Bárbara d'Oeste;3554508;Tietê;2;2;4;49
3551702;Sertãozinho;3554409;Terra Roxa;2;2;4;52
3535507;Paraguaçu Paulista;3554300;Teodoro Sampaio;2;2;4;163
3544251;Rosana;3554300;Teodoro Sampaio;2;2;4;90
3538808;Piraju;3554201;Tejupá;2;2;4;17
2304400;Fortaleza;3554102;Taubaté;2;2;4;2237
3118601;Contagem;3554102;Taubaté;2;2;4;373
3306305;Volta Redonda;3554102;Taubaté;2;2;4;161
3502507;Aparecida;3554102;Taubaté;2;2;4;40
3525003;Jandira;3554102;Taubaté;2;2;4;148
3525904;Jundiaí;3554102;Taubaté;2;2;4;137
3529401;Mauá;3554102;Taubaté;2;2;4;117
3543907;Rio Claro;3554102;Taubaté;2;2;4;213
3547304;Santana de Parnaíba;3554102;Taubaté;2;2;4;146
3552205;Sorocaba;3554102;Taubaté;2;2;4;204
3552502;Suzano;3554102;Taubaté;2;2;4;96
3552809;Taboão da Serra;3554102;Taubaté;2;2;4;139
3101607;Alfenas;3554003;Tatuí;2;2;4;288
3106705;Betim;3554003;Tatuí;2;2;4;527
3170206;Uberlândia;3554003;Tatuí;2;2;4;494
3304557;Rio de Janeiro;3554003;Tatuí;2;2;4;471
3514106;Dois Córregos;3554003;Tatuí;2;2;4;121
3522406;Itapeva;3554003;Tatuí;2;2;4;128
3525904;Jundiaí;3554003;Tatuí;2;2;4;98
3538709;Piracicaba;3554003;Tatuí;2;2;4;69
3548708;São Bernardo do Campo;3554003;Tatuí;2;2;4;136
3548807;São Caetano do Sul;3554003;Tatuí;2;2;4;134
3548906;São Carlos;3554003;Tatuí;2;2;4;147
3528809;Maracaí;3553955;Tarumã;2;2;4;18
3550308;São Paulo;3553856;Taquarivaí;2;2;4;210
3522802;Itaporanga;3553807;Taquarituba;2;2;4;32
3534708;Ourinhos;3553807;Taquarituba;2;2;4;90
3538808;Piraju;3553807;Taquarituba;2;2;4;40
3516200;Franca;3553708;Taquaritinga;2;2;4;155
3518602;Guariba;3553708;Taquaritinga;2;2;4;34
3522703;Itápolis;3553708;Taquaritinga;2;2;4;32
3526902;Limeira;3553708;Taquaritinga;2;2;4;173
3548906;São Carlos;3553708;Taquaritinga;2;2;4;94
3551702;Sertãozinho;3553708;Taquaritinga;2;2;4;67
3524303;Jaboticabal;3553658;Taquaral;2;2;4;23
2304400;Fortaleza;3553609;Tapiratiba;2;2;4;2122
2927408;Salvador;3553609;Tapiratiba;2;2;4;1258
3106200;Belo Horizonte;3553609;Tapiratiba;2;2;4;334
3205200;Vila Velha;3553609;Tapiratiba;2;2;4;671
3304557;Rio de Janeiro;3553609;Tapiratiba;2;2;4;395
3508702;Caconde;3553609;Tapiratiba;2;2;4;13
3509502;Campinas;3553609;Tapiratiba;2;2;4;162
3534401;Osasco;3553609;Tapiratiba;2;2;4;229
3549706;São José do Rio Pardo;3553609;Tapiratiba;2;2;4;20
3512902;Cosmorama;3553401;Tanabi;2;2;4;21
3503307;Araras;3553302;Tambaú;2;2;4;73
3539301;Pirassununga;3553302;Tambaú;2;2;4;38
3540705;Porto Ferreira;3553302;Tambaú;2;2;4;27
3549706;São José do Rio Pardo;3553302;Tambaú;2;2;4;42
3524303;Jaboticabal;3553203;Taiúva;2;2;4;21
3522802;Itaporanga;3553005;Taguaí;2;2;4;30
3550308;São Paulo;3553005;Taguaí;2;2;4;283
3541406;Presidente Prudente;3552908;Taciba;2;2;4;31
2507507;João Pessoa;3552809;Taboão da Serra;2;2;4;2157
3136702;Juiz de Fora;3552809;Taboão da Serra;2;2;4;404
3205002;Serra;3552809;Taboão da Serra;2;2;4;757
3300407;Barra Mansa;3552809;Taboão da Serra;2;2;4;287
3502804;Araçatuba;3552809;Taboão da Serra;2;2;4;456
3520509;Indaiatuba;3552809;Taboão da Serra;2;2;4;73
3522307;Itapetininga;3552809;Taboão da Serra;2;2;4;130
3526209;Juquitiba;3552809;Taboão da Serra;2;2;4;48
3529005;Marília;3552809;Taboão da Serra;2;2;4;356
3529401;Mauá;3552809;Taboão da Serra;2;2;4;33
3530607;Moji das Cruzes;3552809;Taboão da Serra;2;2;4;60
3549805;São José do Rio Preto;3552809;Taboão da Serra;2;2;4;405
3529302;Matão;3552700;Tabatinga;2;2;4;33
3550308;São Paulo;3552700;Tabatinga;2;2;4;302
3550308;São Paulo;3552601;Tabapuã;2;2;4;389
2611606;Recife;3552502;Suzano;2;2;4;2038
3118601;Contagem;3552502;Suzano;2;2;4;460
3201209;Cachoeiro de Itapemirim;3552502;Suzano;2;2;4;608
3205002;Serra;3552502;Suzano;2;2;4;714
3527306;Louveira;3552502;Suzano;2;2;4;84
1500800;Ananindeua;3552403;Sumaré;2;2;4;2375
1721000;Palmas;3552403;Sumaré;2;2;4;1383
3106705;Betim;3552403;Sumaré;2;2;4;445
3170206;Uberlândia;3552403;Sumaré;2;2;4;446
3502804;Araçatuba;3552403;Sumaré;2;2;4;371
3512803;Cosmópolis;3552403;Sumaré;2;2;4;21
3516200;Franca;3552403;Sumaré;2;2;4;253
3520509;Indaiatuba;3552403;Sumaré;2;2;4;30
3522307;Itapetininga;3552403;Sumaré;2;2;4;117
3527306;Louveira;3552403;Sumaré;2;2;4;42
3528403;Mairinque;3552403;Sumaré;2;2;4;81
3529005;Marília;3552403;Sumaré;2;2;4;283
3531803;Monte Mor;3552403;Sumaré;2;2;4;15
3548500;Santos;3552403;Sumaré;2;2;4;152
3548807;São Caetano do Sul;3552403;Sumaré;2;2;4;113
3537404;Pereira Barreto;3552304;Sud Mennucci;2;2;4;19
3539004;Pirangi;3552304;Sud Mennucci;2;2;4;241
2307304;Juazeiro do Norte;3552205;Sorocaba;2;2;4;1970
2609600;Olinda;3552205;Sorocaba;2;2;4;2112
2930709;Simões Filho;3552205;Sorocaba;2;2;4;1487
3106705;Betim;3552205;Sorocaba;2;2;4;514
3131703;Itabira;3552205;Sorocaba;2;2;4;605
3143302;Montes Claros;3552205;Sorocaba;2;2;4;831
3152501;Pouso Alegre;3552205;Sorocaba;2;2;4;211
3170107;Uberaba;3552205;Sorocaba;2;2;4;416
3201308;Cariacica;3552205;Sorocaba;2;2;4;797
3205002;Serra;3552205;Sorocaba;2;2;4;816
3302403;Macaé;3552205;Sorocaba;2;2;4;583
3306206;Vassouras;3552205;Sorocaba;2;2;4;408
3502200;Angatuba;3552205;Sorocaba;2;2;4;93
3507506;Botucatu;3552205;Sorocaba;2;2;4;117
3509205;Cajamar;3552205;Sorocaba;2;2;4;65
3510203;Capão Bonito;3552205;Sorocaba;2;2;4;105
3517604;Guapiara;3552205;Sorocaba;2;2;4;131
3521002;Iperó;3552205;Sorocaba;2;2;4;24
3524709;Jaguariúna;3552205;Sorocaba;2;2;4;101
3526407;Laranjal Paulista;3552205;Sorocaba;2;2;4;59
3527108;Lins;3552205;Sorocaba;2;2;4;305
3530706;Mogi Guaçu;3552205;Sorocaba;2;2;4;140
3534708;Ourinhos;3552205;Sorocaba;2;2;4;251
3539806;Poá;3552205;Sorocaba;2;2;4;117
3541000;Praia Grande;3552205;Sorocaba;2;2;4;126
3541406;Presidente Prudente;3552205;Sorocaba;2;2;4;423
3543907;Rio Claro;3552205;Sorocaba;2;2;4;120
3548906;São Carlos;3552205;Sorocaba;2;2;4;167
3109105;Bueno Brandão;3552106;Socorro;2;2;4;25
3509502;Campinas;3552106;Socorro;2;2;4;64
3527009;Lindóia;3552106;Socorro;2;2;4;17
3537107;Pedreira;3552106;Socorro;2;2;4;42
3509304;Cajobi;3551900;Severínia;2;2;4;8
3531506;Monte Azul Paulista;3551900;Severínia;2;2;4;20
3551702;Sertãozinho;3551900;Severínia;2;2;4;92
3534401;Osasco;3551801;Sete Barras;2;2;4;149
3550308;São Paulo;3551801;Sete Barras;2;2;4;153
2704302;Maceió;3551702;Sertãozinho;2;2;4;1773
3106200;Belo Horizonte;3551702;Sertãozinho;2;2;4;437
3502804;Araçatuba;3551702;Sertãozinho;2;2;4;257
3505906;Batatais;3551702;Sertãozinho;2;2;4;47
3507803;Brodowski;3551702;Sertãozinho;2;2;4;38
3512001;Colina;3551702;Sertãozinho;2;2;4;74
3524105;Ituverava;3551702;Sertãozinho;2;2;4;90
3534302;Orlândia;3551702;Sertãozinho;2;2;4;47
3551504;Serrana;3551702;Sertãozinho;2;2;4;42
3509502;Campinas;3551603;Serra Negra;2;2;4;49
3522604;Itapira;3551603;Serra Negra;2;2;4;23
3527009;Lindóia;3551603;Serra Negra;2;2;4;12
3505906;Batatais;3551504;Serrana;2;2;4;36
3508207;Buritizal;3551504;Serrana;2;2;4;114
3549409;São Joaquim da Barra;3551504;Serrana;2;2;4;74
3551405;Serra Azul;3551504;Serrana;2;2;4;12
3531407;Monte Aprazível;3551306;Sebastianópolis do Sul;2;2;4;25
3550308;São Paulo;3551306;Sebastianópolis do Sul;2;2;4;478
3513801;Diadema;3551009;São Vicente;2;2;4;35
3534302;Orlândia;3551009;São Vicente;2;2;4;386
3513702;Descalvado;3550902;São Simão;2;2;4;48
3108404;Botelhos;3550803;São Sebastião da Grama;2;2;4;45
3549706;São José do Rio Pardo;3550803;São Sebastião da Grama;2;2;4;15
2607208;Ipojuca;3550704;São Sebastião;2;2;4;1979
2611606;Recife;3550704;São Sebastião;2;2;4;2011
3205309;Vitória;3550704;São Sebastião;2;2;4;646
3518701;Guarujá;3550704;São Sebastião;2;2;4;88
3304557;Rio de Janeiro;3550605;São Roque;2;2;4;401
3507001;Boituva;3550605;São Roque;2;2;4;61
3523206;Itararé;3550605;São Roque;2;2;4;234
3548807;São Caetano do Sul;3550605;São Roque;2;2;4;59
3546405;Santa Cruz do Rio Pardo;3550506;São Pedro do Turvo;2;2;4;20
3500600;Águas de São Pedro;3550407;São Pedro;2;2;4;6
1100114;Jaru;3550308;São Paulo;2;2;4;2141
1100155;Ouro Preto do Oeste;3550308;São Paulo;2;2;4;2101
1302504;Manacapuru;3550308;São Paulo;2;2;4;2634
1502202;Capanema;3550308;São Paulo;2;2;4;2475
1502772;Curionópolis;3550308;São Paulo;2;2;4;1966
1503044;Floresta do Araguaia;3550308;São Paulo;2;2;4;1806
1503705;Itupiranga;3550308;São Paulo;2;2;4;2066
1504059;Mãe do Rio;3550308;São Paulo;2;2;4;2393
1504703;Moju;3550308;São Paulo;2;2;4;2411
1504976;Nova Ipixuna;3550308;São Paulo;2;2;4;2086
1505064;Novo Repartimento;3550308;São Paulo;2;2;4;2170
1505304;Oriximiná;3550308;São Paulo;2;2;4;2583
1506583;Santa Maria das Barreiras;3550308;São Paulo;2;2;4;1665
1507201;São Domingos do Capim;3550308;São Paulo;2;2;4;2433
1508209;Vigia;3550308;São Paulo;2;2;4;2523
1600238;Ferreira Gomes;3550308;São Paulo;2;2;4;2744
1600600;Santana;3550308;São Paulo;2;2;4;2652
1701002;Ananás;3550308;São Paulo;2;2;4;1917
1708205;Formoso do Araguaia;3550308;São Paulo;2;2;4;1343
1716505;Pedro Afonso;3550308;São Paulo;2;2;4;1627
1717909;Ponte Alta do Tocantins;3550308;São Paulo;2;2;4;1427
2101202;Bacabal;3550308;São Paulo;2;2;4;2159
2105401;Itapecuru Mirim;3550308;São Paulo;2;2;4;2252
2112001;Tasso Fragoso;3550308;São Paulo;2;2;4;1680
2302206;Beberibe;3550308;São Paulo;2;2;4;2308
2310001;Palhano;3550308;São Paulo;2;2;4;2257
2311306;Quixadá;3550308;São Paulo;2;2;4;2197
2402006;Caicó;3550308;São Paulo;2;2;4;2118
2407104;Macaíba;3550308;São Paulo;2;2;4;2256
2504603;Conde;3550308;São Paulo;2;2;4;2147
2506301;Guarabira;3550308;São Paulo;2;2;4;2155
2513703;Santa Rita;3550308;São Paulo;2;2;4;2154
2600104;Afogados da Ingazeira;3550308;São Paulo;2;2;4;1966
2603454;Camaragibe;3550308;São Paulo;2;2;4;2071
2616407;Vitória de Santo Antão;3550308;São Paulo;2;2;4;2047
2706307;Palmeira dos Índios;3550308;São Paulo;2;2;4;1854
2708600;São Miguel dos Campos;3550308;São Paulo;2;2;4;1851
2803500;Lagarto;3550308;São Paulo;2;2;4;1666
2806701;São Cristóvão;3550308;São Paulo;2;2;4;1684
2902500;Baianópolis;3550308;São Paulo;2;2;4;1273
2906006;Campo Formoso;3550308;São Paulo;2;2;4;1582
2907202;Casa Nova;3550308;São Paulo;2;2;4;1704
2908002;Coaraci;3550308;São Paulo;2;2;4;1226
2908507;Conceição do Jacuípe;3550308;São Paulo;2;2;4;1474
2911204;Gandu;3550308;São Paulo;2;2;4;1305
2913200;Ibotirama;3550308;São Paulo;2;2;4;1314
2913903;Ipiaú;3550308;São Paulo;2;2;4;1263
2914406;Iraquara;3550308;São Paulo;2;2;4;1356
2914604;Irecê;3550308;São Paulo;2;2;4;1441
2914703;Itaberaba;3550308;São Paulo;2;2;4;1377
2916302;Itapebi;3550308;São Paulo;2;2;4;1109
2920502;Maracás;3550308;São Paulo;2;2;4;1287
2920601;Maragogipe;3550308;São Paulo;2;2;4;1423
2932507;Una;3550308;São Paulo;2;2;4;1192
2933208;Vera Cruz;3550308;São Paulo;2;2;4;1420
3100500;Açucena;3550308;São Paulo;2;2;4;653
3101003;Águas Vermelhas;3550308;São Paulo;2;2;4;1017
3101904;Alpinópolis;3550308;São Paulo;2;2;4;310
3103009;Antônio Dias;3550308;São Paulo;2;2;4;584
3105103;Bambuí;3550308;São Paulo;2;2;4;409
3105400;Barão de Cocais;3550308;São Paulo;2;2;4;519
3105905;Barroso;3550308;São Paulo;2;2;4;384
3106101;Belmiro Braga;3550308;São Paulo;2;2;4;379
3106309;Belo Oriente;3550308;São Paulo;2;2;4;645
3111101;Campina Verde;3550308;São Paulo;2;2;4;539
3112000;Candeias;3550308;São Paulo;2;2;4;348
3113404;Caratinga;3550308;São Paulo;2;2;4;618
3113503;Carbonita;3550308;São Paulo;2;2;4;769
3114303;Carmo do Paranaíba;3550308;São Paulo;2;2;4;515
3114402;Carmo do Rio Claro;3550308;São Paulo;2;2;4;301
3115102;Cássia;3550308;São Paulo;2;2;4;342
3116001;Chalé;3550308;São Paulo;2;2;4;640
3116100;Chapada do Norte;3550308;São Paulo;2;2;4;835
3116605;Cláudio;3550308;São Paulo;2;2;4;403
3117603;Conceição do Pará;3550308;São Paulo;2;2;4;466
3117900;Congonhal;3550308;São Paulo;2;2;4;177
3118007;Congonhas;3550308;São Paulo;2;2;4;447
3123106;Dores de Guanhães;3550308;São Paulo;2;2;4;631
3127503;Gonzaga;3550308;São Paulo;2;2;4;678
3127602;Gouveia;3550308;São Paulo;2;2;4;647
3128204;Guaraciaba;3550308;São Paulo;2;2;4;502
3128303;Guaranésia;3550308;São Paulo;2;2;4;261
3130101;Igarapé;3550308;São Paulo;2;2;4;461
3130507;Ilicínea;3550308;São Paulo;2;2;4;312
3130705;Indianópolis;3550308;São Paulo;2;2;4;526
3133006;Itamonte;3550308;São Paulo;2;2;4;236
3133105;Itanhandu;3550308;São Paulo;2;2;4;230
3133303;Itaobim;3550308;São Paulo;2;2;4;935
3136306;João Pinheiro;3550308;São Paulo;2;2;4;655
3137809;Lambari;3550308;São Paulo;2;2;4;229
3138708;Luminárias;3550308;São Paulo;2;2;4;296
3139102;Madre de Deus de Minas;3550308;São Paulo;2;2;4;336
3139607;Mantena;3550308;São Paulo;2;2;4;778
3144102;Muzambinho;3550308;São Paulo;2;2;4;252
3144300;Nanuque;3550308;São Paulo;2;2;4;897
3144607;Nepomuceno;3550308;São Paulo;2;2;4;303
3145604;Oliveira;3550308;São Paulo;2;2;4;374
3147204;Paraguaçu;3550308;São Paulo;2;2;4;251
3148301;Paula Cândido;3550308;São Paulo;2;2;4;482
3151107;Pirapetinga;3550308;São Paulo;2;2;4;489
3151602;Planura;3550308;São Paulo;2;2;4;441
3151701;Poço Fundo;3550308;São Paulo;2;2;4;219
3154705;Ribeirão Vermelho;3550308;São Paulo;2;2;4;318
3154804;Rio Acima;3550308;São Paulo;2;2;4;489
3156908;Sacramento;3550308;São Paulo;2;2;4;428
3157708;Santa Juliana;3550308;São Paulo;2;2;4;489
3158201;Santa Maria do Suaçuí;3550308;São Paulo;2;2;4;739
3158953;Santana do Paraíso;3550308;São Paulo;2;2;4;628
3159308;Santa Rita de Jacutinga;3550308;São Paulo;2;2;4;309
3159803;Santa Vitória;3550308;São Paulo;2;2;4;635
3160702;Santos Dumont;3550308;São Paulo;2;2;4;396
3161700;São Gonçalo do Abaeté;3550308;São Paulo;2;2;4;594
3162005;São Gonçalo do Sapucaí;3550308;São Paulo;2;2;4;222
3162203;São João Batista do Glória;3550308;São Paulo;2;2;4;334
3162955;São José da Lapa;3550308;São Paulo;2;2;4;515
3165800;Senador José Bento;3550308;São Paulo;2;2;4;172
3168101;Tapira;3550308;São Paulo;2;2;4;413
3169356;Três Marias;3550308;São Paulo;2;2;4;620
3169406;Três Pontas;3550308;São Paulo;2;2;4;278
3169604;Tupaciguara;3550308;São Paulo;2;2;4;597
3169703;Turmalina;3550308;São Paulo;2;2;4;806
3170800;Várzea da Palma;3550308;São Paulo;2;2;4;696
3171006;Vazante;3550308;São Paulo;2;2;4;627
3171303;Viçosa;3550308;São Paulo;2;2;4;495
3200805;Baixo Guandu;3550308;São Paulo;2;2;4;726
3202603;Iconha;3550308;São Paulo;2;2;4;669
3202801;Itapemirim;3550308;São Paulo;2;2;4;649
3203346;Marechal Floriano;3550308;São Paulo;2;2;4;701
3204609;Santa Teresa;3550308;São Paulo;2;2;4;735
3300225;Areal;3550308;São Paulo;2;2;4;391
3300506;Bom Jardim;3550308;São Paulo;2;2;4;460
3301504;Cordeiro;3550308;São Paulo;2;2;4;470
3301850;Guapimirim;3550308;São Paulo;2;2;4;393
3301876;Iguaba Grande;3550308;São Paulo;2;2;4;459
3302908;Miguel Pereira;3550308;São Paulo;2;2;4;349
3304102;Porciúncula;3550308;São Paulo;2;2;4;553
3304151;Quissamã;3550308;São Paulo;2;2;4;553
3304508;Rio das Flores;3550308;São Paulo;2;2;4;352
3305208;São Pedro da Aldeia;3550308;São Paulo;2;2;4;471
3305406;Sapucaia;3550308;São Paulo;2;2;4;421
3305604;Silva Jardim;3550308;São Paulo;2;2;4;447
3500600;Águas de São Pedro;3550308;São Paulo;2;2;4;172
3500758;Alambari;3550308;São Paulo;2;2;4;128
3500808;Alfredo Marcondes;3550308;São Paulo;2;2;4;518
3500907;Altair;3550308;São Paulo;2;2;4;423
3501707;Américo Brasiliense;3550308;São Paulo;2;2;4;259
3503109;Arandu;3550308;São Paulo;2;2;4;251
3503406;Arealva;3550308;São Paulo;2;2;4;291
3503604;Areiópolis;3550308;São Paulo;2;2;4;232
3503950;Aspásia;3550308;São Paulo;2;2;4;564
3504800;Bálsamo;3550308;São Paulo;2;2;4;438
3505005;Barão de Antonina;3550308;São Paulo;2;2;4;297
3505104;Barbosa;3550308;São Paulo;2;2;4;424
3508702;Caconde;3550308;São Paulo;2;2;4;235
3508801;Cafelândia;3550308;São Paulo;2;2;4;363
3510104;Cândido Rodrigues;3550308;São Paulo;2;2;4;326
3511201;Catiguá;3550308;São Paulo;2;2;4;377
3511706;Charqueada;3550308;São Paulo;2;2;4;171
3512605;Coronel Macedo;3550308;São Paulo;2;2;4;272
3513207;Cristais Paulista;3550308;São Paulo;2;2;4;369
3513850;Dirce Reis;3550308;São Paulo;2;2;4;535
3513900;Divinolândia;3550308;São Paulo;2;2;4;221
3514809;Eldorado;3550308;São Paulo;2;2;4;177
3515152;Engenheiro Coelho;3550308;São Paulo;2;2;4;141
3515301;Estrela do Norte;3550308;São Paulo;2;2;4;525
3515400;Fartura;3550308;São Paulo;2;2;4;293
3516853;Gavião Peixoto;3550308;São Paulo;2;2;4;274
3517109;Glicério;3550308;São Paulo;2;2;4;439
3517307;Guaimbê;3550308;São Paulo;2;2;4;381
3518859;Guatapará;3550308;São Paulo;2;2;4;277
3519402;Ibirá;3550308;São Paulo;2;2;4;387
3520004;Igaraçu do Tietê;3550308;São Paulo;2;2;4;231
3521408;Iracemápolis;3550308;São Paulo;2;2;4;148
3522000;Itaju;3550308;São Paulo;2;2;4;286
3522653;Itapirapuã Paulista;3550308;São Paulo;2;2;4;277
3522901;Itapuí;3550308;São Paulo;2;2;4;262
3525854;Jumirim;3550308;São Paulo;2;2;4;131
3527504;Lucianópolis;3550308;São Paulo;2;2;4;322
3527801;Lupércio;3550308;São Paulo;2;2;4;350
3527900;Lutécia;3550308;São Paulo;2;2;4;407
3528809;Maracaí;3550308;São Paulo;2;2;4;424
3529500;Mendonça;3550308;São Paulo;2;2;4;404
3530201;Mirante do Paranapanema;3550308;São Paulo;2;2;4;554
3531001;Monções;3550308;São Paulo;2;2;4;466
3531506;Monte Azul Paulista;3550308;São Paulo;2;2;4;364
3532603;Nhandeara;3550308;São Paulo;2;2;4;474
3532900;Nova Europa;3550308;São Paulo;2;2;4;284
3533809;Óleo;3550308;São Paulo;2;2;4;285
3534005;Onda Verde;3550308;São Paulo;2;2;4;431
3534500;Oscar Bressane;3550308;São Paulo;2;2;4;397
3534757;Ouroeste;3550308;São Paulo;2;2;4;555
3535705;Paraíso;3550308;São Paulo;2;2;4;362
3536109;Pardinho;3550308;São Paulo;2;2;4;186
3536604;Paulo de Faria;3550308;São Paulo;2;2;4;486
3536802;Pedra Bela;3550308;São Paulo;2;2;4;98
3538303;Piquerobi;3550308;São Paulo;2;2;4;551
3538501;Piquete;3550308;São Paulo;2;2;4;189
3539608;Planalto;3550308;São Paulo;2;2;4;440
3540259;Pontalinda;3550308;São Paulo;2;2;4;528
3541059;Pratânia;3550308;São Paulo;2;2;4;225
3541109;Presidente Alves;3550308;São Paulo;2;2;4;331
3542008;Quintana;3550308;São Paulo;2;2;4;410
3542107;Rafard;3550308;São Paulo;2;2;4;116
3542701;Restinga;3550308;São Paulo;2;2;4;348
3542909;Ribeirão Bonito;3550308;São Paulo;2;2;4;234
3543204;Ribeirão do Sul;3550308;São Paulo;2;2;4;347
3543253;Ribeirão Grande;3550308;São Paulo;2;2;4;182
3544509;Rubinéia;3550308;São Paulo;2;2;4;585
3545506;Sandovalina;3550308;São Paulo;2;2;4;536
3546207;Santa Cruz da Conceição;3550308;São Paulo;2;2;4;188
3546504;Santa Ernestina;3550308;São Paulo;2;2;4;300
3547106;Santa Mercedes;3550308;São Paulo;2;2;4;576
3547650;Santa Salete;3550308;São Paulo;2;2;4;558
3548104;Santo Antônio do Jardim;3550308;São Paulo;2;2;4;170
3548203;Santo Antônio do Pinhal;3550308;São Paulo;2;2;4;136
3549607;São José do Barreiro;3550308;São Paulo;2;2;4;238
3500709;Agudos;3550100;São Manuel;2;2;4;52
3503604;Areiópolis;3550100;São Manuel;2;2;4;12
3505302;Barra Bonita;3550100;São Manuel;2;2;4;26
3506102;Bebedouro;3550100;São Manuel;2;2;4;199
3522307;Itapetininga;3550100;São Manuel;2;2;4;108
3525300;Jaú;3550100;São Manuel;2;2;4;50
3538709;Piracicaba;3550100;São Manuel;2;2;4;95
3545209;Salto;3550100;São Manuel;2;2;4;142
3304557;Rio de Janeiro;3549953;São Lourenço da Serra;2;2;4;389
1100205;Porto Velho;3549904;São José dos Campos;2;2;4;2385
2906501;Candeias;3549904;São José dos Campos;2;2;4;1374
3118601;Contagem;3549904;São José dos Campos;2;2;4;406
3136652;Juatuba;3549904;São José dos Campos;2;2;4;392
3170701;Varginha;3549904;São José dos Campos;2;2;4;194
3201209;Cachoeiro de Itapemirim;3549904;São José dos Campos;2;2;4;553
3201308;Cariacica;3549904;São José dos Campos;2;2;4;640
3301009;Campos dos Goytacazes;3549904;São José dos Campos;2;2;4;490
3301702;Duque de Caxias;3549904;São José dos Campos;2;2;4;267
3302403;Macaé;3549904;São José dos Campos;2;2;4;417
3513009;Cotia;3549904;São José dos Campos;2;2;4;115
3516853;Gavião Peixoto;3549904;São José dos Campos;2;2;4;306
3518305;Guararema;3549904;São José dos Campos;2;2;4;29
3519071;Hortolândia;3549904;São José dos Campos;2;2;4;142
3523107;Itaquaquecetuba;3549904;São José dos Campos;2;2;4;57
3526902;Limeira;3549904;São José dos Campos;2;2;4;169
3529005;Marília;3549904;São José dos Campos;2;2;4;428
3533403;Nova Odessa;3549904;São José dos Campos;2;2;4;153
3539806;Poá;3549904;São José dos Campos;2;2;4;59
3541000;Praia Grande;3549904;São José dos Campos;2;2;4;104
3548609;São Bento do Sapucaí;3549904;São José dos Campos;2;2;4;58
3548906;São Carlos;3549904;São José dos Campos;2;2;4;243
1506807;Santarém;3549805;São José do Rio Preto;2;2;4;2099
2611606;Recife;3549805;São José do Rio Preto;2;2;4;2026
3152808;Prata;3549805;São José do Rio Preto;2;2;4;172
3205002;Serra;3549805;São José do Rio Preto;2;2;4;947
3205200;Vila Velha;3549805;São José do Rio Preto;2;2;4;940
3205309;Vitória;3549805;São José do Rio Preto;2;2;4;947
3500907;Altair;3549805;São José do Rio Preto;2;2;4;48
3504503;Avaré;3549805;São José do Rio Preto;2;2;4;256
3507605;Bragança Paulista;3549805;São José do Rio Preto;2;2;4;379
3516705;Garça;3549805;São José do Rio Preto;2;2;4;157
3517406;Guaíra;3549805;São José do Rio Preto;2;2;4;126
3517901;Guaraci;3549805;São José do Rio Preto;2;2;4;59
3526803;Lençóis Paulista;3549805;São José do Rio Preto;2;2;4;206
3528304;Magda;3549805;São José do Rio Preto;2;2;4;89
3529500;Mendonça;3549805;São José do Rio Preto;2;2;4;42
3531308;Monte Alto;3549805;São José do Rio Preto;2;2;4;108
3534203;Orindiúva;3549805;São José do Rio Preto;2;2;4;71
3539301;Pirassununga;3549805;São José do Rio Preto;2;2;4;243
3549706;São José do Rio Pardo;3549805;São José do Rio Preto;2;2;4;275
1302603;Manaus;3549706;São José do Rio Pardo;2;2;4;2427
3102605;Andradas;3549706;São José do Rio Pardo;2;2;4;62
3144102;Muzambinho;3549706;São José do Rio Pardo;2;2;4;45
3304557;Rio de Janeiro;3549706;São José do Rio Pardo;2;2;4;403
3500303;Aguaí;3549706;São José do Rio Pardo;2;2;4;52
3513702;Descalvado;3549706;São José do Rio Pardo;2;2;4;83
3515186;Espírito Santo do Pinhal;3549706;São José do Rio Pardo;2;2;4;68
3526902;Limeira;3549706;São José do Rio Pardo;2;2;4;119
3530706;Mogi Guaçu;3549706;São José do Rio Pardo;2;2;4;81
3545209;Salto;3549706;São José do Rio Pardo;2;2;4;182
3546306;Santa Cruz das Palmeiras;3549706;São José do Rio Pardo;2;2;4;45
3540200;Pontal;3549508;São José da Bela Vista;2;2;4;63
3533601;Nuporanga;3549409;São Joaquim da Barra;2;2;4;21
2604205;Catende;3549102;São João da Boa Vista;2;2;4;1841
3138203;Lavras;3549102;São João da Boa Vista;2;2;4;203
3501608;Americana;3549102;São João da Boa Vista;2;2;4;102
3508702;Caconde;3549102;São João da Boa Vista;2;2;4;51
3513900;Divinolândia;3549102;São João da Boa Vista;2;2;4;34
3520509;Indaiatuba;3549102;São João da Boa Vista;2;2;4;133
3523404;Itatiba;3549102;São João da Boa Vista;2;2;4;116
3523800;Itobi;3549102;São João da Boa Vista;2;2;4;30
3548104;Santo Antônio do Jardim;3549102;São João da Boa Vista;2;2;4;22
3548807;São Caetano do Sul;3549102;São João da Boa Vista;2;2;4;184
3548906;São Carlos;3549102;São João da Boa Vista;2;2;4;112
1302603;Manaus;3548906;São Carlos;2;2;4;2413
3152808;Prata;3548906;São Carlos;2;2;4;320
3170107;Uberaba;3548906;São Carlos;2;2;4;253
3170206;Uberlândia;3548906;São Carlos;2;2;4;348
3502804;Araçatuba;3548906;São Carlos;2;2;4;278
3506508;Birigui;3548906;São Carlos;2;2;4;264
3511102;Catanduva;3548906;São Carlos;2;2;4;148
3513801;Diadema;3548906;São Carlos;2;2;4;227
3515509;Fernandópolis;3548906;São Carlos;2;2;4;310
3523602;Itirapina;3548906;São Carlos;2;2;4;26
3525904;Jundiaí;3548906;São Carlos;2;2;4;164
3526803;Lençóis Paulista;3548906;São Carlos;2;2;4;115
3529609;Meridiano;3548906;São Carlos;2;2;4;298
3530300;Mirassol;3548906;São Carlos;2;2;4;214
3531308;Monte Alto;3548906;São Carlos;2;2;4;102
3538006;Pindamonhangaba;3548906;São Carlos;2;2;4;271
3542909;Ribeirão Bonito;3548906;São Carlos;2;2;4;29
3545209;Salto;3548906;São Carlos;2;2;4;145
3547304;Santana de Parnaíba;3548906;São Carlos;2;2;4;187
3547809;Santo André;3548906;São Carlos;2;2;4;229
3548500;Santos;3548906;São Carlos;2;2;4;262
1100205;Porto Velho;3548807;São Caetano do Sul;2;2;4;2361
1709500;Gurupi;3548807;São Caetano do Sul;2;2;4;1340
2800308;Aracaju;3548807;São Caetano do Sul;2;2;4;1689
2914802;Itabuna;3548807;São Caetano do Sul;2;2;4;1215
2919207;Lauro de Freitas;3548807;São Caetano do Sul;2;2;4;1440
3104007;Araxá;3548807;São Caetano do Sul;2;2;4;447
3113404;Caratinga;3548807;São Caetano do Sul;2;2;4;608
3115300;Cataguases;3548807;São Caetano do Sul;2;2;4;465
3143906;Muriaé;3548807;São Caetano do Sul;2;2;4;512
3149309;Pedro Leopoldo;3548807;São Caetano do Sul;2;2;4;509
3163706;São Lourenço;3548807;São Caetano do Sul;2;2;4;227
3169307;Três Corações;3548807;São Caetano do Sul;2;2;4;255
3201209;Cachoeiro de Itapemirim;3548807;São Caetano do Sul;2;2;4;634
3300100;Angra dos Reis;3548807;São Caetano do Sul;2;2;4;244
3301900;Itaboraí;3548807;São Caetano do Sul;2;2;4;389
3302205;Itaperuna;3548807;São Caetano do Sul;2;2;4;547
3305505;Saquarema;3548807;São Caetano do Sul;2;2;4;426
3305554;Seropédica;3548807;São Caetano do Sul;2;2;4;306
3305802;Teresópolis;3548807;São Caetano do Sul;2;2;4;384
3306107;Valença;3548807;São Caetano do Sul;2;2;4;325
3502101;Andradina;3548807;São Caetano do Sul;2;2;4;572
3504107;Atibaia;3548807;São Caetano do Sul;2;2;4;55
3504503;Avaré;3548807;São Caetano do Sul;2;2;4;247
3505500;Barretos;3548807;São Caetano do Sul;2;2;4;395
3506102;Bebedouro;3548807;São Caetano do Sul;2;2;4;357
3506359;Bertioga;3548807;São Caetano do Sul;2;2;4;48
3509007;Caieiras;3548807;São Caetano do Sul;2;2;4;33
3509700;Campos do Jordão;3548807;São Caetano do Sul;2;2;4;141
3513504;Cubatão;3548807;São Caetano do Sul;2;2;4;35
3514403;Dracena;3548807;São Caetano do Sul;2;2;4;555
3515004;Embu;3548807;São Caetano do Sul;2;2;4;29
3515707;Ferraz de Vasconcelos;3548807;São Caetano do Sul;2;2;4;22
3519071;Hortolândia;3548807;São Caetano do Sul;2;2;4;107
3519600;Ibitinga;3548807;São Caetano do Sul;2;2;4;309
3522109;Itanhaém;3548807;São Caetano do Sul;2;2;4;67
3522307;Itapetininga;3548807;São Caetano do Sul;2;2;4;152
3522406;Itapeva;3548807;São Caetano do Sul;2;2;4;241
3522505;Itapevi;3548807;São Caetano do Sul;2;2;4;39
3523404;Itatiba;3548807;São Caetano do Sul;2;2;4;73
3524303;Jaboticabal;3548807;São Caetano do Sul;2;2;4;314
3524808;Jales;3548807;São Caetano do Sul;2;2;4;546
3525300;Jaú;3548807;São Caetano do Sul;2;2;4;252
3526704;Leme;3548807;São Caetano do Sul;2;2;4;179
3526803;Lençóis Paulista;3548807;São Caetano do Sul;2;2;4;255
3528502;Mairiporã;3548807;São Caetano do Sul;2;2;4;32
3529302;Matão;3548807;São Caetano do Sul;2;2;4;290
3530300;Mirassol;3548807;São Caetano do Sul;2;2;4;430
3530805;Moji-Mirim;3548807;São Caetano do Sul;2;2;4;137
3536505;Paulínia;3548807;São Caetano do Sul;2;2;4;111
3537305;Penápolis;3548807;São Caetano do Sul;2;2;4;429
3537602;Peruíbe;3548807;São Caetano do Sul;2;2;4;88
3539301;Pirassununga;3548807;São Caetano do Sul;2;2;4;198
3541307;Presidente Epitácio;3548807;São Caetano do Sul;2;2;4;597
3546405;Santa Cruz do Rio Pardo;3548807;São Caetano do Sul;2;2;4;322
2408102;Natal;3548708;São Bernardo do Campo;2;2;4;2268
2503209;Cabedelo;3548708;São Bernardo do Campo;2;2;4;2171
2610707;Paulista;3548708;São Bernardo do Campo;2;2;4;2088
2800308;Aracaju;3548708;São Bernardo do Campo;2;2;4;1699
2906501;Candeias;3548708;São Bernardo do Campo;2;2;4;1457
2910800;Feira de Santana;3548708;São Bernardo do Campo;2;2;4;1471
3162005;São Gonçalo do Sapucaí;3548708;São Bernardo do Campo;2;2;4;226
3170107;Uberaba;3548708;São Bernardo do Campo;2;2;4;460
3205200;Vila Velha;3548708;São Bernardo do Campo;2;2;4;730
3306008;Três Rios;3548708;São Bernardo do Campo;2;2;4;385
3502804;Araçatuba;3548708;São Bernardo do Campo;2;2;4;479
3509007;Caieiras;3548708;São Bernardo do Campo;2;2;4;42
3509205;Cajamar;3548708;São Bernardo do Campo;2;2;4;50
3512407;Cordeirópolis;3548708;São Bernardo do Campo;2;2;4;163
3516408;Franco da Rocha;3548708;São Bernardo do Campo;2;2;4;46
3518305;Guararema;3548708;São Bernardo do Campo;2;2;4;64
3522505;Itapevi;3548708;São Bernardo do Campo;2;2;4;41
3522604;Itapira;3548708;São Bernardo do Campo;2;2;4;144
3524006;Itupeva;3548708;São Bernardo do Campo;2;2;4;79
3525300;Jaú;3548708;São Bernardo do Campo;2;2;4;257
3529005;Marília;3548708;São Bernardo do Campo;2;2;4;379
3530805;Moji-Mirim;3548708;São Bernardo do Campo;2;2;4;148
1301902;Itacoatiara;3548500;Santos;2;2;4;2584
2930709;Simões Filho;3548500;Santos;2;2;4;1458
3144102;Muzambinho;3548500;Santos;2;2;4;280
3144805;Nova Lima;3548500;Santos;2;2;4;497
3164704;São Sebastião do Paraíso;3548500;Santos;2;2;4;335
3170107;Uberaba;3548500;Santos;2;2;4;486
3170206;Uberlândia;3548500;Santos;2;2;4;585
3201506;Colatina;3548500;Santos;2;2;4;749
3205101;Viana;3548500;Santos;2;2;4;698
3302007;Itaguaí;3548500;Santos;2;2;4;284
3503901;Arujá;3548500;Santos;2;2;4;56
3509700;Campos do Jordão;3548500;Santos;2;2;4;152
3513801;Diadema;3548500;Santos;2;2;4;36
3515004;Embu;3548500;Santos;2;2;4;58
3525300;Jaú;3548500;Santos;2;2;4;288
3538006;Pindamonhangaba;3548500;Santos;2;2;4;140
3539806;Poá;3548500;Santos;2;2;4;42
3542602;Registro;3548500;Santos;2;2;4;170
3543907;Rio Claro;3548500;Santos;2;2;4;206
3541406;Presidente Prudente;3548302;Santo Expedito;2;2;4;31
3525904;Jundiaí;3548104;Santo Antônio do Jardim;2;2;4;120
3534401;Osasco;3548005;Santo Antônio de Posse;2;2;4;104
3537107;Pedreira;3548005;Santo Antônio de Posse;2;2;4;15
3132909;Itamogi;3547908;Santo Antônio da Alegria;2;2;4;11
3164704;São Sebastião do Paraíso;3547908;Santo Antônio da Alegria;2;2;4;25
3170206;Uberlândia;3547908;Santo Antônio da Alegria;2;2;4;268
3501004;Altinópolis;3547908;Santo Antônio da Alegria;2;2;4;24
3543402;Ribeirão Preto;3547908;Santo Antônio da Alegria;2;2;4;67
2910800;Feira de Santana;3547809;Santo André;2;2;4;1462
3118601;Contagem;3547809;Santo André;2;2;4;481
3128709;Guaxupé;3547809;Santo André;2;2;4;260
3129806;Ibirité;3547809;Santo André;2;2;4;472
3136702;Juiz de Fora;3547809;Santo André;2;2;4;386
3138203;Lavras;3547809;Santo André;2;2;4;309
3170206;Uberlândia;3547809;Santo André;2;2;4;554
3205200;Vila Velha;3547809;Santo André;2;2;4;721
3301702;Duque de Caxias;3547809;Santo André;2;2;4;341
3303906;Petrópolis;3547809;Santo André;2;2;4;359
3502804;Araçatuba;3547809;Santo André;2;2;4;479
3504107;Atibaia;3547809;Santo André;2;2;4;59
3512209;Conchal;3547809;Santo André;2;2;4;160
3520509;Indaiatuba;3547809;Santo André;2;2;4;95
3531100;Mongaguá;3547809;Santo André;2;2;4;50
3539806;Poá;3547809;Santo André;2;2;4;23
3545209;Salto;3547809;Santo André;2;2;4;92
3545803;Santa Bárbara d'Oeste;3547809;Santo André;2;2;4;134
3523909;Itu;3547502;Santa Rita do Passa Quatro;2;2;4;175
3525904;Jundiaí;3547502;Santa Rita do Passa Quatro;2;2;4;173
3526704;Leme;3547502;Santa Rita do Passa Quatro;2;2;4;54
1100122;Ji-Paraná;3547304;Santana de Parnaíba;2;2;4;2025
1500800;Ananindeua;3547304;Santana de Parnaíba;2;2;4;2446
1504208;Marabá;3547304;Santana de Parnaíba;2;2;4;2011
2507507;João Pessoa;3547304;Santana de Parnaíba;2;2;4;2152
2607208;Ipojuca;3547304;Santana de Parnaíba;2;2;4;2031
2607901;Jaboatão dos Guararapes;3547304;Santana de Parnaíba;2;2;4;2058
2609600;Olinda;3547304;Santana de Parnaíba;2;2;4;2076
2910800;Feira de Santana;3547304;Santana de Parnaíba;2;2;4;1464
2930709;Simões Filho;3547304;Santana de Parnaíba;2;2;4;1450
3118601;Contagem;3547304;Santana de Parnaíba;2;2;4;484
3151800;Poços de Caldas;3547304;Santana de Parnaíba;2;2;4;189
3170107;Uberaba;3547304;Santana de Parnaíba;2;2;4;422
3203205;Linhares;3547304;Santana de Parnaíba;2;2;4;828
3300704;Cabo Frio;3547304;Santana de Parnaíba;2;2;4;498
3301009;Campos dos Goytacazes;3547304;Santana de Parnaíba;2;2;4;597
3303906;Petrópolis;3547304;Santana de Parnaíba;2;2;4;390
3513801;Diadema;3547304;Santana de Parnaíba;2;2;4;40
3515004;Embu;3547304;Santana de Parnaíba;2;2;4;24
3519071;Hortolândia;3547304;Santana de Parnaíba;2;2;4;72
3520509;Indaiatuba;3547304;Santana de Parnaíba;2;2;4;51
3524709;Jaguariúna;3547304;Santana de Parnaíba;2;2;4;82
3525003;Jandira;3547304;Santana de Parnaíba;2;2;4;9
3527108;Lins;3547304;Santana de Parnaíba;2;2;4;350
3530607;Moji das Cruzes;3547304;Santana de Parnaíba;2;2;4;75
3532009;Morungaba;3547304;Santana de Parnaíba;2;2;4;64
3539103;Pirapora do Bom Jesus;3547304;Santana de Parnaíba;2;2;4;10
3518305;Guararema;3546801;Santa Isabel;2;2;4;21
3518800;Guarulhos;3546801;Santa Isabel;2;2;4;37
3523107;Itaquaquecetuba;3546801;Santa Isabel;2;2;4;22
3521408;Iracemápolis;3546702;Santa Gertrudes;2;2;4;14
3520442;Ilha Solteira;3546603;Santa Fé do Sul;2;2;4;46
3520905;Ipaussu;3546405;Santa Cruz do Rio Pardo;2;2;4;18
3535507;Paraguaçu Paulista;3546405;Santa Cruz do Rio Pardo;2;2;4;114
3510807;Casa Branca;3546306;Santa Cruz das Palmeiras;2;2;4;18
3516200;Franca;3546306;Santa Cruz das Palmeiras;2;2;4;143
3530508;Mococa;3546306;Santa Cruz das Palmeiras;2;2;4;45
3530706;Mogi Guaçu;3546306;Santa Cruz das Palmeiras;2;2;4;63
3503307;Araras;3546207;Santa Cruz da Conceição;2;2;4;27
3539301;Pirassununga;3546207;Santa Cruz da Conceição;2;2;4;14
3545704;Santa Albertina;3546108;Santa Clara d'Oeste;2;2;4;24
3134905;Jacutinga;3545803;Santa Bárbara d'Oeste;2;2;4;97
3503802;Artur Nogueira;3545803;Santa Bárbara d'Oeste;2;2;4;32
3504503;Avaré;3545803;Santa Bárbara d'Oeste;2;2;4;161
3506003;Bauru;3545803;Santa Bárbara d'Oeste;2;2;4;177
3507001;Boituva;3545803;Santa Bárbara d'Oeste;2;2;4;64
3516200;Franca;3545803;Santa Bárbara d'Oeste;2;2;4;245
3541406;Presidente Prudente;3545506;Sandovalina;2;2;4;52
3502903;Araçoiaba da Serra;3545308;Salto de Pirapora;2;2;4;16
3534401;Osasco;3545308;Salto de Pirapora;2;2;4;81
1505536;Parauapebas;3545209;Salto;2;2;4;1919
2111300;São Luís;3545209;Salto;2;2;4;2306
3170107;Uberaba;3545209;Salto;2;2;4;388
3301702;Duque de Caxias;3545209;Salto;2;2;4;409
3504503;Avaré;3545209;Salto;2;2;4;169
3507001;Boituva;3545209;Salto;2;2;4;40
3507605;Bragança Paulista;3545209;Salto;2;2;4;80
3508405;Cabreúva;3545209;Salto;2;2;4;20
3509205;Cajamar;3545209;Salto;2;2;4;45
3510807;Casa Branca;3545209;Salto;2;2;4;159
3513504;Cubatão;3545209;Salto;2;2;4;117
3514908;Elias Fausto;3545209;Salto;2;2;4;20
3515707;Ferraz de Vasconcelos;3545209;Salto;2;2;4;101
3516200;Franca;3545209;Salto;2;2;4;295
3518800;Guarulhos;3545209;Salto;2;2;4;79
3522208;Itapecerica da Serra;3545209;Salto;2;2;4;73
3522406;Itapeva;3545209;Salto;2;2;4;186
3522505;Itapevi;3545209;Salto;2;2;4;52
3524402;Jacareí;3545209;Salto;2;2;4;138
3525300;Jaú;3545209;Salto;2;2;4;166
3526803;Lençóis Paulista;3545209;Salto;2;2;4;170
3526902;Limeira;3545209;Salto;2;2;4;71
3527306;Louveira;3545209;Salto;2;2;4;36
3530706;Mogi Guaçu;3545209;Salto;2;2;4;103
3536505;Paulínia;3545209;Salto;2;2;4;51
3544004;Rio das Pedras;3545209;Salto;2;2;4;51
3527405;Lucélia;3545100;Salmourão;2;2;4;20
3530607;Moji das Cruzes;3545001;Salesópolis;2;2;4;35
3170206;Uberlândia;3544905;Sales Oliveira;2;2;4;212
3509502;Campinas;3544905;Sales Oliveira;2;2;4;249
3543402;Ribeirão Preto;3544905;Sales Oliveira;2;2;4;42
3511102;Catanduva;3544806;Sales;2;2;4;56
3527405;Lucélia;3544400;Rubiácea;2;2;4;55
3518404;Guaratinguetá;3544301;Roseira;2;2;4;16
3538006;Pindamonhangaba;3544301;Roseira;2;2;4;16
3541406;Presidente Prudente;3544251;Rosana;2;2;4;178
3517406;Guaíra;3544202;Riolândia;2;2;4;148
3529401;Mauá;3544103;Rio Grande da Serra;2;2;4;9
2932705;Uruçuca;3543907;Rio Claro;2;2;4;1201
3151800;Poços de Caldas;3543907;Rio Claro;2;2;4;126
3153400;Presidente Olegário;3543907;Rio Claro;2;2;4;457
3164704;São Sebastião do Paraíso;3543907;Rio Claro;2;2;4;174
3169307;Três Corações;3543907;Rio Claro;2;2;4;254
3504107;Atibaia;3543907;Rio Claro;2;2;4;131
3505906;Batatais;3543907;Rio Claro;2;2;4;168
3506003;Bauru;3543907;Rio Claro;2;2;4;156
3516200;Franca;3543907;Rio Claro;2;2;4;207
3518800;Guarulhos;3543907;Rio Claro;2;2;4;154
3521309;Ipuã;3543907;Rio Claro;2;2;4;223
3521408;Iracemápolis;3543907;Rio Claro;2;2;4;20
3523404;Itatiba;3543907;Rio Claro;2;2;4;100
3525300;Jaú;3543907;Rio Claro;2;2;4;105
3527108;Lins;3543907;Rio Claro;2;2;4;241
3529302;Matão;3543907;Rio Claro;2;2;4;124
3540705;Porto Ferreira;3543907;Rio Claro;2;2;4;62
3505807;Bastos;3543808;Rinópolis;2;2;4;22
3534609;Osvaldo Cruz;3543808;Rinópolis;2;2;4;18
3540903;Pradópolis;3543709;Rincão;2;2;4;25
1721000;Palmas;3543402;Ribeirão Preto;2;2;4;1196
2111300;São Luís;3543402;Ribeirão Preto;2;2;4;2090
2211001;Teresina;3543402;Ribeirão Preto;2;2;4;1846
2307304;Juazeiro do Norte;3543402;Ribeirão Preto;2;2;4;1761
2611101;Petrolina;3543402;Ribeirão Preto;2;2;4;1501
2919207;Lauro de Freitas;3543402;Ribeirão Preto;2;2;4;1327
2919553;Luís Eduardo magalhães;3543402;Ribeirão Preto;2;2;4;1022
3103504;Araguari;3543402;Ribeirão Preto;2;2;4;281
3117876;Confins;3543402;Ribeirão Preto;2;2;4;428
3128303;Guaranésia;3543402;Ribeirão Preto;2;2;4;104
3134400;Iturama;3543402;Ribeirão Preto;2;2;4;294
3138203;Lavras;3543402;Ribeirão Preto;2;2;4;290
3151503;Piumhi;3543402;Ribeirão Preto;2;2;4;205
3151800;Poços de Caldas;3543402;Ribeirão Preto;2;2;4;147
3205200;Vila Velha;3543402;Ribeirão Preto;2;2;4;775
3301702;Duque de Caxias;3543402;Ribeirão Preto;2;2;4;501
3501004;Altinópolis;3543402;Ribeirão Preto;2;2;4;46
3505302;Barra Bonita;3543402;Ribeirão Preto;2;2;4;169
3507506;Botucatu;3543402;Ribeirão Preto;2;2;4;203
3509205;Cajamar;3543402;Ribeirão Preto;2;2;4;262
3512001;Colina;3543402;Ribeirão Preto;2;2;4;91
3513801;Diadema;3543402;Ribeirão Preto;2;2;4;306
3518602;Guariba;3543402;Ribeirão Preto;2;2;4;50
3519600;Ibitinga;3543402;Ribeirão Preto;2;2;4;128
3520509;Indaiatuba;3543402;Ribeirão Preto;2;2;4;223
3522505;Itapevi;3543402;Ribeirão Preto;2;2;4;279
3524709;Jaguariúna;3543402;Ribeirão Preto;2;2;4;192
3537008;Pedregulho;3543402;Ribeirão Preto;2;2;4;105
3540903;Pradópolis;3543402;Ribeirão Preto;2;2;4;36
3513801;Diadema;3543303;Ribeirão Pires;2;2;4;19
3518800;Guarulhos;3543303;Ribeirão Pires;2;2;4;32
3534708;Ourinhos;3543204;Ribeirão do Sul;2;2;4;22
3501707;Américo Brasiliense;3542909;Ribeirão Bonito;2;2;4;39
3514304;Dourado;3542909;Ribeirão Bonito;2;2;4;15
3304557;Rio de Janeiro;3542602;Registro;2;2;4;499
3505708;Barueri;3542602;Registro;2;2;4;151
3509908;Cananéia;3542602;Registro;2;2;4;57
3537602;Peruíbe;3542602;Registro;2;2;4;91
3533502;Novo Horizonte;3542503;Reginópolis;2;2;4;47
3502408;Anhumas;3542404;Regente Feijó;2;2;4;12
3505807;Bastos;3542206;Rancharia;2;2;4;38
3529203;Martinópolis;3542206;Rancharia;2;2;4;30
3534401;Osasco;3542206;Rancharia;2;2;4;449
3534708;Ourinhos;3542206;Rancharia;2;2;4;132
3541505;Presidente Venceslau;3542206;Rancharia;2;2;4;111
3304557;Rio de Janeiro;3541901;Queluz;2;2;4;161
3535507;Paraguaçu Paulista;3541703;Quatá;2;2;4;20
3502804;Araçatuba;3541604;Promissão;2;2;4;71
3506003;Bauru;3541604;Promissão;2;2;4;120
3508801;Cafelândia;3541604;Promissão;2;2;4;39
3525706;José Bonifácio;3541604;Promissão;2;2;4;56
3514403;Dracena;3541505;Presidente Venceslau;2;2;4;50
1100205;Porto Velho;3541406;Presidente Prudente;2;2;4;1931
3504503;Avaré;3541406;Presidente Prudente;2;2;4;276
3506508;Birigui;3541406;Presidente Prudente;2;2;4;142
3507506;Botucatu;3541406;Presidente Prudente;2;2;4;316
3513009;Cotia;3541406;Presidente Prudente;2;2;4;492
3515806;Flora Rica;3541406;Presidente Prudente;2;2;4;51
3519907;Iepê;3541406;Presidente Prudente;2;2;4;67
3527108;Lins;3541406;Presidente Prudente;2;2;4;174
3532207;Narandiba;3541406;Presidente Prudente;2;2;4;33
3535507;Paraguaçu Paulista;3541406;Presidente Prudente;2;2;4;86
3537305;Penápolis;3541406;Presidente Prudente;2;2;4;157
3541208;Presidente Bernardes;3541406;Presidente Prudente;2;2;4;22
3534609;Osvaldo Cruz;3541307;Presidente Epitácio;2;2;4;127
3504305;Avaí;3541109;Presidente Alves;2;2;4;12
3501608;Americana;3541000;Praia Grande;2;2;4;169
3506003;Bauru;3541000;Praia Grande;2;2;4;328
3523305;Itariri;3541000;Praia Grande;2;2;4;85
3532058;Motuca;3540903;Pradópolis;2;2;4;19
3525706;José Bonifácio;3540804;Potirendaba;2;2;4;32
3152501;Pouso Alegre;3540705;Porto Ferreira;2;2;4;163
3503307;Araras;3540705;Porto Ferreira;2;2;4;57
3505500;Barretos;3540705;Porto Ferreira;2;2;4;183
3506102;Bebedouro;3540705;Porto Ferreira;2;2;4;149
3510807;Casa Branca;3540705;Porto Ferreira;2;2;4;42
3518602;Guariba;3540705;Porto Ferreira;2;2;4;95
3519303;Ibaté;3540705;Porto Ferreira;2;2;4;55
3526902;Limeira;3540705;Porto Ferreira;2;2;4;79
3538709;Piracicaba;3540705;Porto Ferreira;2;2;4;101
3509502;Campinas;3540606;Porto Feliz;2;2;4;59
3511607;Cesário Lange;3540507;Porangaba;2;2;4;18
3127107;Frutal;3540200;Pontal;2;2;4;140
3505609;Barrinha;3540200;Pontal;2;2;4;23
3505906;Batatais;3540200;Pontal;2;2;4;46
3517703;Guará;3540200;Pontal;2;2;4;69
3533601;Nuporanga;3540200;Pontal;2;2;4;45
3534302;Orlândia;3540200;Pontal;2;2;4;37
3505708;Barueri;3540002;Pompéia;2;2;4;375
3529302;Matão;3539905;Poloni;2;2;4;174
1501402;Belém;3539806;Poá;2;2;4;2457
2408102;Natal;3539806;Poá;2;2;4;2239
2704302;Maceió;3539806;Poá;2;2;4;1856
2800308;Aracaju;3539806;Poá;2;2;4;1669
3136702;Juiz de Fora;3539806;Poá;2;2;4;363
3509502;Campinas;3539806;Poá;2;2;4;99
3524006;Itupeva;3539806;Poá;2;2;4;83
3525904;Jundiaí;3539806;Poá;2;2;4;68
3527207;Lorena;3539806;Poá;2;2;4;155
3524303;Jaboticabal;3539509;Pitangueiras;2;2;4;29
3529302;Matão;3539509;Pitangueiras;2;2;4;68
3500303;Aguaí;3539301;Pirassununga;2;2;4;48
3503208;Araraquara;3539301;Pirassununga;2;2;4;79
3505708;Barueri;3539301;Pirassununga;2;2;4;176
3510807;Casa Branca;3539301;Pirassununga;2;2;4;45
3515186;Espírito Santo do Pinhal;3539301;Pirassununga;2;2;4;75
3530201;Mirante do Paranapanema;3539202;Pirapozinho;2;2;4;42
3503703;Ariranha;3539004;Pirangi;2;2;4;17
3503208;Araraquara;3538907;Pirajuí;2;2;4;135
3526407;Laranjal Paulista;3538907;Pirajuí;2;2;4;204
3522307;Itapetininga;3538808;Piraju;2;2;4;143
3522406;Itapeva;3538808;Piraju;2;2;4;100
3534401;Osasco;3538808;Piraju;2;2;4;268
3534708;Ourinhos;3538808;Piraju;2;2;4;58
1302603;Manaus;3538709;Piracicaba;2;2;4;2491
2919553;Luís Eduardo magalhães;3538709;Piracicaba;2;2;4;1193
3136702;Juiz de Fora;3538709;Piracicaba;2;2;4;455
3168705;Timóteo;3538709;Piracicaba;2;2;4;618
3170107;Uberaba;3538709;Piracicaba;2;2;4;334
3170206;Uberlândia;3538709;Piracicaba;2;2;4;431
3301702;Duque de Caxias;3538709;Piracicaba;2;2;4;445
3504107;Atibaia;3538709;Piracicaba;2;2;4;120
3507605;Bragança Paulista;3538709;Piracicaba;2;2;4;114
3509205;Cajamar;3538709;Piracicaba;2;2;4;104
3511409;Cerqueira César;3538709;Piracicaba;2;2;4;159
3513504;Cubatão;3538709;Piracicaba;2;2;4;178
3520103;Igarapava;3538709;Piracicaba;2;2;4;300
3524303;Jaboticabal;3538709;Piracicaba;2;2;4;179
3526704;Leme;3538709;Piracicaba;2;2;4;67
3530805;Moji-Mirim;3538709;Piracicaba;2;2;4;78
3531100;Mongaguá;3538709;Piracicaba;2;2;4;181
3507100;Bom Jesus dos Perdões;3538600;Piracaia;2;2;4;14
3507605;Bragança Paulista;3538600;Piracaia;2;2;4;24
2611606;Recife;3538006;Pindamonhangaba;2;2;4;1939
3118601;Contagem;3538006;Pindamonhangaba;2;2;4;361
3304201;Resende;3538006;Pindamonhangaba;2;2;4;113
3509502;Campinas;3538006;Pindamonhangaba;2;2;4;164
3510500;Caraguatatuba;3538006;Pindamonhangaba;2;2;4;76
3502200;Angatuba;3537909;Pilar do Sul;2;2;4;79
3522406;Itapeva;3537909;Pilar do Sul;2;2;4;121
3304557;Rio de Janeiro;3537602;Peruíbe;2;2;4;409
3518701;Guarujá;3537602;Peruíbe;2;2;4;83
3523305;Itariri;3537602;Peruíbe;2;2;4;17
3531100;Mongaguá;3537602;Peruíbe;2;2;4;45
3512308;Conchas;3537503;Pereiras;2;2;4;8
3524303;Jaboticabal;3537404;Pereira Barreto;2;2;4;299
3524808;Jales;3537404;Pereira Barreto;2;2;4;66
3534401;Osasco;3537404;Pereira Barreto;2;2;4;556
3503208;Araraquara;3537305;Penápolis;2;2;4;201
3506003;Bauru;3537305;Penápolis;2;2;4;144
3507704;Braúna;3537305;Penápolis;2;2;4;27
3509502;Campinas;3537305;Penápolis;2;2;4;353
3523305;Itariri;3537206;Pedro de Toledo;2;2;4;6
3508801;Cafelândia;3537156;Pedrinhas Paulista;2;2;4;165
3530706;Mogi Guaçu;3537107;Pedreira;2;2;4;46
3530805;Moji-Mirim;3537107;Pedreira;2;2;4;35
3304557;Rio de Janeiro;3537008;Pedregulho;2;2;4;531
3504503;Avaré;3536703;Pederneiras;2;2;4;84
3505302;Barra Bonita;3536703;Pederneiras;2;2;4;27
3505708;Barueri;3536703;Pederneiras;2;2;4;235
3526803;Lençóis Paulista;3536703;Pederneiras;2;2;4;29
3534203;Orindiúva;3536604;Paulo de Faria;2;2;4;17
1302603;Manaus;3536505;Paulínia;2;2;4;2515
2304400;Fortaleza;3536505;Paulínia;2;2;4;2265
2927408;Salvador;3536505;Paulínia;2;2;4;1386
3137106;Lagamar;3536505;Paulínia;2;2;4;509
3164704;São Sebastião do Paraíso;3536505;Paulínia;2;2;4;204
3502804;Araçatuba;3536505;Paulínia;2;2;4;378
3503208;Araraquara;3536505;Paulínia;2;2;4;150
3503802;Artur Nogueira;3536505;Paulínia;2;2;4;21
3507506;Botucatu;3536505;Paulínia;2;2;4;133
3513405;Cruzeiro;3536505;Paulínia;2;2;4;226
3513702;Descalvado;3536505;Paulínia;2;2;4;106
3531803;Monte Mor;3536505;Paulínia;2;2;4;26
3534708;Ourinhos;3536505;Paulínia;2;2;4;283
3535408;Panorama;3536406;Paulicéia;2;2;4;11
3127107;Frutal;3536307;Patrocínio Paulista;2;2;4;184
3505708;Barueri;3536307;Patrocínio Paulista;2;2;4;321
3509502;Campinas;3536208;Pariquera-Açu;2;2;4;217
3509908;Cananéia;3536208;Pariquera-Açu;2;2;4;36
3514809;Eldorado;3536208;Pariquera-Açu;2;2;4;32
3534401;Osasco;3536208;Pariquera-Açu;2;2;4;171
3507506;Botucatu;3536109;Pardinho;2;2;4;24
3534401;Osasco;3536109;Pardinho;2;2;4;170
3505807;Bastos;3536000;Parapuã;2;2;4;17
3527405;Lucélia;3536000;Parapuã;2;2;4;24
3522406;Itapeva;3535804;Paranapanema;2;2;4;66
3523503;Itatinga;3535804;Paranapanema;2;2;4;35
3534609;Osvaldo Cruz;3535507;Paraguaçu Paulista;2;2;4;73
3534708;Ourinhos;3535507;Paraguaçu Paulista;2;2;4;97
3535309;Palmital;3535507;Paraguaçu Paulista;2;2;4;58
3514403;Dracena;3534906;Pacaembu;2;2;4;30
3526001;Junqueirópolis;3534906;Pacaembu;2;2;4;19
3514403;Dracena;3534807;Ouro Verde;2;2;4;18
3134400;Iturama;3534757;Ouroeste;2;2;4;38
2408102;Natal;3534708;Ourinhos;2;2;4;2384
3509502;Campinas;3534708;Ourinhos;2;2;4;292
3510005;Cândido Mota;3534708;Ourinhos;2;2;4;56
3531407;Monte Aprazível;3534708;Ourinhos;2;2;4;245
3502804;Araçatuba;3534609;Osvaldo Cruz;2;2;4;77
3506003;Bauru;3534609;Osvaldo Cruz;2;2;4;196
3527405;Lucélia;3534609;Osvaldo Cruz;2;2;4;17
3529005;Marília;3534609;Osvaldo Cruz;2;2;4;107
3530102;Mirandópolis;3534609;Osvaldo Cruz;2;2;4;77
1100114;Jaru;3534401;Osasco;2;2;4;2124
1500602;Altamira;3534401;Osasco;2;2;4;2315
1504422;Marituba;3534401;Osasco;2;2;4;2458
2305233;Horizonte;3534401;Osasco;2;2;4;2297
2513703;Santa Rita;3534401;Osasco;2;2;4;2151
2601706;Belo Jardim;3534401;Osasco;2;2;4;1962
2608800;Lajedo;3534401;Osasco;2;2;4;1940
2612208;Salgueiro;3534401;Osasco;2;2;4;1862
2906501;Candeias;3534401;Osasco;2;2;4;1452
2907202;Casa Nova;3534401;Osasco;2;2;4;1697
2919553;Luís Eduardo magalhães;3534401;Osasco;2;2;4;1269
3102605;Andradas;3534401;Osasco;2;2;4;164
3105400;Barão de Cocais;3534401;Osasco;2;2;4;518
3105608;Barbacena;3534401;Osasco;2;2;4;398
3113206;Carandaí;3534401;Osasco;2;2;4;410
3118304;Conselheiro Lafaiete;3534401;Osasco;2;2;4;437
3129806;Ibirité;3534401;Osasco;2;2;4;477
3131703;Itabira;3534401;Osasco;2;2;4;561
3137205;Lagoa da Prata;3534401;Osasco;2;2;4;410
3138203;Lavras;3534401;Osasco;2;2;4;313
3143401;Monte Sião;3534401;Osasco;2;2;4;124
3145901;Ouro Branco;3534401;Osasco;2;2;4;458
3146107;Ouro Preto;3534401;Osasco;2;2;4;480
3159605;Santa Rita do Sapucaí;3534401;Osasco;2;2;4;180
3161908;São Gonçalo do Rio Abaixo;3534401;Osasco;2;2;4;537
3162500;São João del Rei;3534401;Osasco;2;2;4;367
3169000;Tocantins;3534401;Osasco;2;2;4;463
3171303;Viçosa;3534401;Osasco;2;2;4;498
3200607;Aracruz;3534401;Osasco;2;2;4;775
3302908;Miguel Pereira;3534401;Osasco;2;2;4;358
3305752;Tanguá;3534401;Osasco;2;2;4;422
3500709;Agudos;3534401;Osasco;2;2;4;253
3502507;Aparecida;3534401;Osasco;2;2;4;176
3506359;Bertioga;3534401;Osasco;2;2;4;72
3507001;Boituva;3534401;Osasco;2;2;4;94
3507308;Boracéia;3534401;Osasco;2;2;4;251
3509254;Cajati;3534401;Osasco;2;2;4;190
3509908;Cananéia;3534401;Osasco;2;2;4;205
3512209;Conchal;3534401;Osasco;2;2;4;139
3512407;Cordeirópolis;3534401;Osasco;2;2;4;135
3513405;Cruzeiro;3534401;Osasco;2;2;4;214
3513504;Cubatão;3534401;Osasco;2;2;4;55
3514403;Dracena;3534401;Osasco;2;2;4;531
3514809;Eldorado;3534401;Osasco;2;2;4;174
3514908;Elias Fausto;3534401;Osasco;2;2;4;81
3515103;Embu-Guaçu;3534401;Osasco;2;2;4;33
3515707;Ferraz de Vasconcelos;3534401;Osasco;2;2;4;43
3517703;Guará;3534401;Osasco;2;2;4;359
3518305;Guararema;3534401;Osasco;2;2;4;77
3521002;Iperó;3534401;Osasco;2;2;4;94
3521408;Iracemápolis;3534401;Osasco;2;2;4;129
3522406;Itapeva;3534401;Osasco;2;2;4;220
3523206;Itararé;3534401;Osasco;2;2;4;268
3523305;Itariri;3534401;Osasco;2;2;4;92
3524006;Itupeva;3534401;Osasco;2;2;4;50
3524600;Jacupiranga;3534401;Osasco;2;2;4;179
3525102;Jardinópolis;3534401;Osasco;2;2;4;295
3525201;Jarinu;3534401;Osasco;2;2;4;48
3526100;Juquiá;3534401;Osasco;2;2;4;125
3526407;Laranjal Paulista;3534401;Osasco;2;2;4;119
3526704;Leme;3534401;Osasco;2;2;4;161
3527207;Lorena;3534401;Osasco;2;2;4;195
3529906;Miracatu;3534401;Osasco;2;2;4;107
3533403;Nova Odessa;3534401;Osasco;2;2;4;100
3117306;Conceição das Alagoas;3534302;Orlândia;2;2;4;103
3127107;Frutal;3534302;Orlândia;2;2;4;132
3147907;Passos;3534302;Orlândia;2;2;4;131
3150703;Pirajuba;3534302;Orlândia;2;2;4;124
3157708;Santa Juliana;3534302;Orlândia;2;2;4;161
3505500;Barretos;3534302;Orlândia;2;2;4;75
3506102;Bebedouro;3534302;Orlândia;2;2;4;72
3521309;Ipuã;3534302;Orlândia;2;2;4;34
3525102;Jardinópolis;3534302;Orlândia;2;2;4;35
3509502;Campinas;3533908;Olímpia;2;2;4;307
3529005;Marília;3533700;Ocauçu;2;2;4;24
3529500;Mendonça;3533502;Novo Horizonte;2;2;4;50
3511102;Catanduva;3533403;Nova Odessa;2;2;4;248
3502101;Andradina;3533205;Nova Independência;2;2;4;21
3506706;Boa Esperança do Sul;3532900;Nova Europa;2;2;4;30
3519600;Ibitinga;3532900;Nova Europa;2;2;4;29
3507100;Bom Jesus dos Perdões;3532405;Nazaré Paulista;2;2;4;9
3519907;Iepê;3532157;Nantes;2;2;4;17
3502101;Andradina;3532108;Murutinga do Sul;2;2;4;15
3505708;Barueri;3532009;Morungaba;2;2;4;70
3514908;Elias Fausto;3531803;Monte Mor;2;2;4;12
3518800;Guarulhos;3531803;Monte Mor;2;2;4;95
3515509;Fernandópolis;3531407;Monte Aprazível;2;2;4;78
3525706;José Bonifácio;3531407;Monte Aprazível;2;2;4;31
3509502;Campinas;3531308;Monte Alto;2;2;4;232
3516200;Franca;3531308;Monte Alto;2;2;4;139
3526902;Limeira;3531308;Monte Alto;2;2;4;181
3530607;Moji das Cruzes;3531308;Monte Alto;2;2;4;347
3510401;Capivari;3530904;Mombuca;2;2;4;9
3128709;Guaxupé;3530805;Moji-Mirim;2;2;4;127
3152501;Pouso Alegre;3530805;Moji-Mirim;2;2;4;108
3170206;Uberlândia;3530805;Moji-Mirim;2;2;4;412
3503802;Artur Nogueira;3530805;Moji-Mirim;2;2;4;26
3516200;Franca;3530805;Moji-Mirim;2;2;4;214
3519071;Hortolândia;3530805;Moji-Mirim;2;2;4;54
3520509;Indaiatuba;3530805;Moji-Mirim;2;2;4;79
3525300;Jaú;3530805;Moji-Mirim;2;2;4;166
3530607;Moji das Cruzes;3530805;Moji-Mirim;2;2;4;149
3106200;Belo Horizonte;3530706;Mogi Guaçu;2;2;4;405
3128709;Guaxupé;3530706;Mogi Guaçu;2;2;4;116
3512803;Cosmópolis;3530706;Mogi Guaçu;2;2;4;44
3518800;Guarulhos;3530706;Mogi Guaçu;2;2;4;129
3518859;Guatapará;3530706;Mogi Guaçu;2;2;4;145
3519055;Holambra;3530706;Mogi Guaçu;2;2;4;36
3520509;Indaiatuba;3530706;Mogi Guaçu;2;2;4;90
2704302;Maceió;3530607;Moji das Cruzes;2;2;4;1850
3201308;Cariacica;3530607;Moji das Cruzes;2;2;4;686
3507605;Bragança Paulista;3530607;Moji das Cruzes;2;2;4;77
3513801;Diadema;3530607;Moji das Cruzes;2;2;4;46
3515004;Embu;3530607;Moji das Cruzes;2;2;4;68
3515707;Ferraz de Vasconcelos;3530607;Moji das Cruzes;2;2;4;18
3516200;Franca;3530607;Moji das Cruzes;2;2;4;356
3525904;Jundiaí;3530607;Moji das Cruzes;2;2;4;84
3147907;Passos;3530508;Mococa;2;2;4;95
3304557;Rio de Janeiro;3530508;Mococa;2;2;4;423
3516200;Franca;3530508;Mococa;2;2;4;110
3170206;Uberlândia;3530300;Mirassol;2;2;4;249
3304557;Rio de Janeiro;3530300;Mirassol;2;2;4;695
3502804;Araçatuba;3530300;Mirassol;2;2;4;108
3506003;Bauru;3530300;Mirassol;2;2;4;175
3506102;Bebedouro;3530300;Mirassol;2;2;4;103
3513009;Cotia;3530300;Mirassol;2;2;4;412
3515509;Fernandópolis;3530300;Mirassol;2;2;4;97
3521150;Ipiguá;3530300;Mirassol;2;2;4;22
3524501;Jaci;3530300;Mirassol;2;2;4;9
3529302;Matão;3530300;Mirassol;2;2;4;146
3520442;Ilha Solteira;3530102;Mirandópolis;2;2;4;82
3505302;Barra Bonita;3529807;Mineiros do Tietê;2;2;4;15
3170107;Uberaba;3529708;Miguelópolis;2;2;4;50
3170206;Uberlândia;3529708;Miguelópolis;2;2;4;144
3516200;Franca;3529708;Miguelópolis;2;2;4;77
2607901;Jaboatão dos Guararapes;3529401;Mauá;2;2;4;2052
3170107;Uberaba;3529401;Mauá;2;2;4;459
3201308;Cariacica;3529401;Mauá;2;2;4;714
3205002;Serra;3529401;Mauá;2;2;4;733
3513504;Cubatão;3529401;Mauá;2;2;4;25
3522109;Itanhaém;3529401;Mauá;2;2;4;66
3524402;Jacareí;3529401;Mauá;2;2;4;65
3526902;Limeira;3529401;Mauá;2;2;4;155
3114550;Carneirinho;3529302;Matão;2;2;4;316
3127107;Frutal;3529302;Matão;2;2;4;175
3304557;Rio de Janeiro;3529302;Matão;2;2;4;553
3503307;Araras;3529302;Matão;2;2;4;135
3506805;Bocaina;3529302;Matão;2;2;4;61
3507407;Borborema;3529302;Matão;2;2;4;70
3509304;Cajobi;3529302;Matão;2;2;4;90
3516200;Franca;3529302;Matão;2;2;4;155
3518602;Guariba;3529302;Matão;2;2;4;32
3518800;Guarulhos;3529302;Matão;2;2;4;279
3527405;Lucélia;3529203;Martinópolis;2;2;4;50
2607901;Jaboatão dos Guararapes;3529005;Marília;2;2;4;2153
2930709;Simões Filho;3529005;Marília;2;2;4;1560
3500105;Adamantina;3529005;Marília;2;2;4;132
3503208;Araraquara;3529005;Marília;2;2;4;189
3504503;Avaré;3529005;Marília;2;2;4;143
3514403;Dracena;3529005;Marília;2;2;4;182
3519006;Herculândia;3529005;Marília;2;2;4;51
3525904;Jundiaí;3529005;Marília;2;2;4;332
3504008;Assis;3528809;Maracaí;2;2;4;24
3510005;Cândido Mota;3528809;Maracaí;2;2;4;32
3304557;Rio de Janeiro;3527603;Luís Antônio;2;2;4;485
3503208;Araraquara;3527603;Luís Antônio;2;2;4;55
3513108;Cravinhos;3527603;Luís Antônio;2;2;4;24
3506201;Bento de Abreu;3527405;Lucélia;2;2;4;54
3516002;Flórida Paulista;3527405;Lucélia;2;2;4;20
3304557;Rio de Janeiro;3527306;Louveira;2;2;4;379
3509007;Caieiras;3527306;Louveira;2;2;4;39
3513801;Diadema;3527306;Louveira;2;2;4;76
3524006;Itupeva;3527306;Louveira;2;2;4;13
3524402;Jacareí;3527306;Louveira;2;2;4;107
3505708;Barueri;3527207;Lorena;2;2;4;204
3508504;Caçapava;3527207;Lorena;2;2;4;76
3504008;Assis;3527108;Lins;2;2;4;129
3505708;Barueri;3527108;Lins;2;2;4;364
3517000;Getulina;3527108;Lins;2;2;4;20
3517208;Guaiçara;3527108;Lins;2;2;4;7
3525300;Jaú;3527108;Lins;2;2;4;141
3500501;Águas de Lindóia;3527009;Lindóia;2;2;4;5
2905701;Camaçari;3526902;Limeira;2;2;4;1419
2927408;Salvador;3526902;Limeira;2;2;4;1385
3118601;Contagem;3526902;Limeira;2;2;4;447
3133808;Itaúna;3526902;Limeira;2;2;4;395
3138203;Lavras;3526902;Limeira;2;2;4;286
3170206;Uberlândia;3526902;Limeira;2;2;4;415
3202603;Iconha;3526902;Limeira;2;2;4;701
3511102;Catanduva;3526902;Limeira;2;2;4;226
3515152;Engenheiro Coelho;3526902;Limeira;2;2;4;20
3519055;Holambra;3526902;Limeira;2;2;4;36
3523909;Itu;3526902;Limeira;2;2;4;80
2304285;Eusébio;3526803;Lençóis Paulista;2;2;4;2309
3503604;Areiópolis;3526803;Lençóis Paulista;2;2;4;17
3501608;Americana;3526704;Leme;2;2;4;61
3513702;Descalvado;3526704;Leme;2;2;4;39
3525904;Jundiaí;3526704;Leme;2;2;4;121
3502804;Araçatuba;3526506;Lavínia;2;2;4;61
3507001;Boituva;3526407;Laranjal Paulista;2;2;4;31
3522307;Itapetininga;3526407;Laranjal Paulista;2;2;4;63
3515004;Embu;3526209;Juquitiba;2;2;4;38
3523909;Itu;3526209;Juquitiba;2;2;4;76
2800308;Aracaju;3525904;Jundiaí;2;2;4;1671
2905701;Camaçari;3525904;Jundiaí;2;2;4;1439
2927408;Salvador;3525904;Jundiaí;2;2;4;1404
3103504;Araguari;3525904;Jundiaí;2;2;4;519
3125101;Extrema;3525904;Jundiaí;2;2;4;70
3133600;Itapeva;3525904;Jundiaí;2;2;4;82
3138203;Lavras;3525904;Jundiaí;2;2;4;290
3140704;Mateus Leme;3525904;Jundiaí;2;2;4;433
3152501;Pouso Alegre;3525904;Jundiaí;2;2;4;145
3157807;Santa Luzia;3525904;Jundiaí;2;2;4;488
3301009;Campos dos Goytacazes;3525904;Jundiaí;2;2;4;589
3302403;Macaé;3525904;Jundiaí;2;2;4;519
3304904;São Gonçalo;3525904;Jundiaí;2;2;4;395
3506003;Bauru;3525904;Jundiaí;2;2;4;241
3507001;Boituva;3525904;Jundiaí;2;2;4;80
3510609;Carapicuíba;3525904;Jundiaí;2;2;4;39
3511409;Cerqueira César;3525904;Jundiaí;2;2;4;232
3513702;Descalvado;3525904;Jundiaí;2;2;4;159
3516309;Francisco Morato;3525904;Jundiaí;2;2;4;20
3519071;Hortolândia;3525904;Jundiaí;2;2;4;48
3522307;Itapetininga;3525904;Jundiaí;2;2;4;126
3524709;Jaguariúna;3525904;Jundiaí;2;2;4;53
3525201;Jarinu;3525904;Jundiaí;2;2;4;20
3504206;Auriflama;3525706;José Bonifácio;2;2;4;99
3525300;Jaú;3525706;José Bonifácio;2;2;4;179
3504107;Atibaia;3525508;Joanópolis;2;2;4;35
3170206;Uberlândia;3525300;Jaú;2;2;4;375
3304557;Rio de Janeiro;3525300;Jaú;2;2;4;553
3501608;Americana;3525300;Jaú;2;2;4;138
3506102;Bebedouro;3525300;Jaú;2;2;4;148
3513702;Descalvado;3525300;Jaú;2;2;4;106
3522703;Itápolis;3525300;Jaú;2;2;4;79
3304557;Rio de Janeiro;3525201;Jarinu;2;2;4;356
2909307;Correntina;3525102;Jardinópolis;2;2;4;907
3170107;Uberaba;3525102;Jardinópolis;2;2;4;142
3170206;Uberlândia;3525102;Jardinópolis;2;2;4;240
3516200;Franca;3525102;Jardinópolis;2;2;4;65
3524303;Jaboticabal;3525102;Jardinópolis;2;2;4;62
3502754;Araçariguama;3525003;Jandira;2;2;4;19
3522208;Itapecerica da Serra;3525003;Jandira;2;2;4;22
3507506;Botucatu;3524907;Jambeiro;2;2;4;284
3520442;Ilha Solteira;3524808;Jales;2;2;4;84
2301000;Aquiraz;3524709;Jaguariúna;2;2;4;2246
2611606;Recife;3524709;Jaguariúna;2;2;4;2006
2800308;Aracaju;3524709;Jaguariúna;2;2;4;1636
2905701;Camaçari;3524709;Jaguariúna;2;2;4;1405
3167202;Sete Lagoas;3524709;Jaguariúna;2;2;4;457
3302403;Macaé;3524709;Jaguariúna;2;2;4;524
3513801;Diadema;3524709;Jaguariúna;2;2;4;115
3520509;Indaiatuba;3524709;Jaguariúna;2;2;4;50
3523404;Itatiba;3524709;Jaguariúna;2;2;4;37
2930709;Simões Filho;3524402;Jacareí;2;2;4;1385
3301702;Duque de Caxias;3524402;Jacareí;2;2;4;275
3503208;Araraquara;3524402;Jacareí;2;2;4;283
3507605;Bragança Paulista;3524402;Jacareí;2;2;4;75
3513405;Cruzeiro;3524402;Jacareí;2;2;4;130
2304285;Eusébio;3524303;Jaboticabal;2;2;4;2159
3503208;Araraquara;3524303;Jaboticabal;2;2;4;60
3505500;Barretos;3524303;Jaboticabal;2;2;4;83
3506003;Bauru;3524303;Jaboticabal;2;2;4;145
3511102;Catanduva;3524303;Jaboticabal;2;2;4;72
3514007;Dobrada;3524303;Jaboticabal;2;2;4;30
3516200;Franca;3524303;Jaboticabal;2;2;4;122
3519600;Ibitinga;3524303;Jaboticabal;2;2;4;78
3170107;Uberaba;3524105;Ituverava;2;2;4;67
3521309;Ipuã;3524105;Ituverava;2;2;4;22
1302603;Manaus;3524006;Itupeva;2;2;4;2555
2930709;Simões Filho;3524006;Itupeva;2;2;4;1434
1302603;Manaus;3523909;Itu;2;2;4;2555
3106705;Betim;3523909;Itu;2;2;4;484
3510609;Carapicuíba;3523909;Itu;2;2;4;54
3515004;Embu;3523909;Itu;2;2;4;61
3522307;Itapetininga;3523909;Itu;2;2;4;84
3510807;Casa Branca;3523800;Itobi;2;2;4;12
3513801;Diadema;3523602;Itirapina;2;2;4;202
3502200;Angatuba;3523503;Itatinga;2;2;4;48
3145000;Nova Ponte;3523404;Itatiba;2;2;4;437
3145604;Oliveira;3523404;Itatiba;2;2;4;325
3516200;Franca;3523404;Itatiba;2;2;4;279
3518800;Guarulhos;3523404;Itatiba;2;2;4;56
3514809;Eldorado;3523305;Itariri;2;2;4;98
3152501;Pouso Alegre;3523206;Itararé;2;2;4;401
2611606;Recife;3523107;Itaquaquecetuba;2;2;4;2035
3205309;Vitória;3523107;Itaquaquecetuba;2;2;4;707
3500501;Águas de Lindóia;3522604;Itapira;2;2;4;20
3516200;Franca;3522604;Itapira;2;2;4;218
2304400;Fortaleza;3522505;Itapevi;2;2;4;2336
3152501;Pouso Alegre;3522505;Itapevi;2;2;4;179
3170206;Uberlândia;3522505;Itapevi;2;2;4;531
3205002;Serra;3522505;Itapevi;2;2;4;769
3506003;Bauru;3522505;Itapevi;2;2;4;255
3518800;Guarulhos;3522505;Itapevi;2;2;4;41
3520509;Indaiatuba;3522505;Itapevi;2;2;4;59
2601706;Belo Jardim;3522307;Itapetininga;2;2;4;2033
3106200;Belo Horizonte;3522307;Itapetininga;2;2;4;578
3503307;Araras;3522307;Itapetininga;2;2;4;152
3504503;Avaré;3522307;Itapetininga;2;2;4;104
3507001;Boituva;3522307;Itapetininga;2;2;4;51
3508009;Buri;3522307;Itapetininga;2;2;4;60
3513801;Diadema;3522307;Itapetininga;2;2;4;147
3518800;Guarulhos;3522307;Itapetininga;2;2;4;153
2611606;Recife;3522208;Itapecerica da Serra;2;2;4;2082
2927408;Salvador;3522208;Itapecerica da Serra;2;2;4;1447
3515103;Embu-Guaçu;3522208;Itapecerica da Serra;2;2;4;13
3505708;Barueri;3522109;Itanhaém;2;2;4;75
3516200;Franca;3521309;Ipuã;2;2;4;64
3505708;Barueri;3521002;Iperó;2;2;4;85
2910800;Feira de Santana;3520509;Indaiatuba;2;2;4;1451
3503307;Araras;3520509;Indaiatuba;2;2;4;82
3504107;Atibaia;3520509;Indaiatuba;2;2;4;71
3506003;Bauru;3520509;Indaiatuba;2;2;4;206
3507605;Bragança Paulista;3520509;Indaiatuba;2;2;4;72
3513801;Diadema;3520509;Indaiatuba;2;2;4;91
3504206;Auriflama;3520442;Ilha Solteira;2;2;4;87
3303807;Parati;3520400;Ilhabela;2;2;4;90
3508207;Buritizal;3520103;Igarapava;2;2;4;17
3127008;Fronteira;3519808;Icém;2;2;4;8
3515004;Embu;3519709;Ibiúna;2;2;4;38
3501608;Americana;3519600;Ibitinga;2;2;4;191
3507407;Borborema;3519600;Ibitinga;2;2;4;28
3509502;Campinas;3519600;Ibitinga;2;2;4;224
3519105;Iacanga;3519600;Ibitinga;2;2;4;24
3501707;Américo Brasiliense;3519303;Ibaté;2;2;4;28
2611606;Recife;3519071;Hortolândia;2;2;4;2032
2927408;Salvador;3519071;Hortolândia;2;2;4;1397
3106200;Belo Horizonte;3519071;Hortolândia;2;2;4;464
3106705;Betim;3519071;Hortolândia;2;2;4;445
3168705;Timóteo;3519071;Hortolândia;2;2;4;589
3510401;Capivari;3519071;Hortolândia;2;2;4;33
3500303;Aguaí;3519055;Holambra;2;2;4;64
1100189;Pimenta Bueno;3518800;Guarulhos;2;2;4;1947
1100304;Vilhena;3518800;Guarulhos;2;2;4;1789
1200401;Rio Branco;3518800;Guarulhos;2;2;4;2570
1400100;Boa Vista;3518800;Guarulhos;2;2;4;3219
1600303;Macapá;3518800;Guarulhos;2;2;4;2638
2304285;Eusébio;3518800;Guarulhos;2;2;4;2303
2510808;Patos;3518800;Guarulhos;2;2;4;2031
2601706;Belo Jardim;3518800;Guarulhos;2;2;4;1942
2609600;Olinda;3518800;Guarulhos;2;2;4;2056
2802908;Itabaiana;3518800;Guarulhos;2;2;4;1679
2904605;Brumado;3518800;Guarulhos;2;2;4;1132
2910727;Eunápolis;3518800;Guarulhos;2;2;4;1047
2933307;Vitória da Conquista;3518800;Guarulhos;2;2;4;1106
3104007;Araxá;3518800;Guarulhos;2;2;4;428
3115300;Cataguases;3518800;Guarulhos;2;2;4;455
3122306;Divinópolis;3518800;Guarulhos;2;2;4;400
3131307;Ipatinga;3518800;Guarulhos;2;2;4;597
3146107;Ouro Preto;3518800;Guarulhos;2;2;4;456
3152501;Pouso Alegre;3518800;Guarulhos;2;2;4;149
3157807;Santa Luzia;3518800;Guarulhos;2;2;4;489
3171204;Vespasiano;3518800;Guarulhos;2;2;4;491
3204906;São Mateus;3518800;Guarulhos;2;2;4;848
3300308;Barra do Piraí;3518800;Guarulhos;2;2;4;298
3302858;Mesquita;3518800;Guarulhos;2;2;4;326
3303401;Nova Friburgo;3518800;Guarulhos;2;2;4;425
3305109;São João de Meriti;3518800;Guarulhos;2;2;4;332
3503307;Araras;3518800;Guarulhos;2;2;4;145
3507506;Botucatu;3518800;Guarulhos;2;2;4;201
3518305;Guararema;3518800;Guarulhos;2;2;4;53
3106200;Belo Horizonte;3518701;Guarujá;2;2;4;504
3170206;Uberlândia;3518701;Guarujá;2;2;4;594
3514601;Dumont;3518602;Guariba;2;2;4;30
3300407;Barra Mansa;3518404;Guaratinguetá;2;2;4;105
3513009;Cotia;3518404;Guaratinguetá;2;2;4;200
3503901;Arujá;3518305;Guararema;2;2;4;29
3506359;Bertioga;3518305;Guararema;2;2;4;46
3507001;Boituva;3518305;Guararema;2;2;4;167
3508801;Cafelândia;3518107;Guarantã;2;2;4;10
3500907;Altair;3517901;Guaraci;2;2;4;12
3506102;Bebedouro;3517901;Guaraci;2;2;4;64
3517406;Guaíra;3517901;Guaraci;2;2;4;69
3505906;Batatais;3517703;Guará;2;2;4;56
3516200;Franca;3517703;Guará;2;2;4;45
3510203;Capão Bonito;3517604;Guapiara;2;2;4;27
3506508;Birigui;3516507;Gabriel Monteiro;2;2;4;33
3501608;Americana;3516309;Francisco Morato;2;2;4;85
2112209;Timon;3516200;Franca;2;2;4;1765
2207702;Parnaíba;3516200;Franca;2;2;4;2034
2900702;Alagoinhas;3516200;Franca;2;2;4;1306
2917508;Jacobina;3516200;Franca;2;2;4;1247
3101607;Alfenas;3516200;Franca;2;2;4;179
3104007;Araxá;3516200;Franca;2;2;4;116
3111200;Campo Belo;3516200;Franca;2;2;4;227
3112307;Capelinha;3516200;Franca;2;2;4;595
3128709;Guaxupé;3516200;Franca;2;2;4;111
3133758;Itaú de Minas;3516200;Franca;2;2;4;69
3148004;Patos de Minas;3516200;Franca;2;2;4;236
3151503;Piumhi;3516200;Franca;2;2;4;151
3156908;Sacramento;3516200;Franca;2;2;4;76
3169406;Três Pontas;3516200;Franca;2;2;4;218
3301702;Duque de Caxias;3516200;Franca;2;2;4;495
3501905;Amparo;3516200;Franca;2;2;4;249
3502804;Araçatuba;3516200;Franca;2;2;4;328
3504107;Atibaia;3516200;Franca;2;2;4;299
3505203;Bariri;3516200;Franca;2;2;4;220
3505302;Barra Bonita;3516200;Franca;2;2;4;248
3506102;Bebedouro;3516200;Franca;2;2;4;126
3507506;Botucatu;3516200;Franca;2;2;4;281
3509403;Cajuru;3516200;Franca;2;2;4;82
3513702;Descalvado;3516200;Franca;2;2;4;153
3513900;Divinolândia;3516200;Franca;2;2;4;142
3515186;Espírito Santo do Pinhal;3516200;Franca;2;2;4;196
3500105;Adamantina;3516002;Flórida Paulista;2;2;4;12
3503901;Arujá;3515707;Ferraz de Vasconcelos;2;2;4;18
3134400;Iturama;3515509;Fernandópolis;2;2;4;60
3304557;Rio de Janeiro;3515509;Fernandópolis;2;2;4;791
3506508;Birigui;3515509;Fernandópolis;2;2;4;114
3513009;Cotia;3515509;Fernandópolis;2;2;4;509
3515202;Estrela d'Oeste;3515509;Fernandópolis;2;2;4;16
3128709;Guaxupé;3515186;Espírito Santo do Pinhal;2;2;4;98
3170701;Varginha;3515186;Espírito Santo do Pinhal;2;2;4;157
3508405;Cabreúva;3515152;Engenheiro Coelho;2;2;4;91
3512803;Cosmópolis;3515152;Engenheiro Coelho;2;2;4;18
2908507;Conceição do Jacuípe;3515004;Embu;2;2;4;1484
3509254;Cajati;3514809;Eldorado;2;2;4;22
3503307;Araras;3514502;Duartina;2;2;4;209
3502101;Andradina;3514403;Dracena;2;2;4;67
3507506;Botucatu;3514106;Dois Córregos;2;2;4;57
3507902;Brotas;3514106;Dois Córregos;2;2;4;28
3128709;Guaxupé;3513900;Divinolândia;2;2;4;39
2304400;Fortaleza;3513801;Diadema;2;2;4;2339
2611606;Recife;3513801;Diadema;2;2;4;2067
2927408;Salvador;3513801;Diadema;2;2;4;1431
3503208;Araraquara;3513702;Descalvado;2;2;4;58
3509502;Campinas;3513603;Cunha;2;2;4;216
3118601;Contagem;3513504;Cubatão;2;2;4;499
3170701;Varginha;3513504;Cubatão;2;2;4;284
3504107;Atibaia;3513504;Cubatão;2;2;4;87
3506102;Bebedouro;3513504;Cubatão;2;2;4;391
3136702;Juiz de Fora;3513405;Cruzeiro;2;2;4;190
3306305;Volta Redonda;3513405;Cruzeiro;2;2;4;89
3509502;Campinas;3513405;Cruzeiro;2;2;4;219
3513009;Cotia;3513405;Cruzeiro;2;2;4;232
1302603;Manaus;3513009;Cotia;2;2;4;2602
2905701;Camaçari;3513009;Cotia;2;2;4;1476
2919207;Lauro de Freitas;3513009;Cotia;2;2;4;1459
3159605;Santa Rita do Sapucaí;3513009;Cotia;2;2;4;194
3170206;Uberlândia;3513009;Cotia;2;2;4;538
3203205;Linhares;3513009;Cotia;2;2;4;837
3205200;Vila Velha;3513009;Cotia;2;2;4;753
3205309;Vitória;3513009;Cotia;2;2;4;763
3302403;Macaé;3513009;Cotia;2;2;4;528
3304524;Rio das Ostras;3513009;Cotia;2;2;4;520
3501608;Americana;3512803;Cosmópolis;2;2;4;18
3512209;Conchal;3512803;Cosmópolis;2;2;4;35
3503307;Araras;3512704;Corumbataí;2;2;4;30
2111300;São Luís;3512407;Cordeirópolis;2;2;4;2229
3507506;Botucatu;3512308;Conchas;2;2;4;47
3510807;Casa Branca;3512209;Conchal;2;2;4;62
2312908;Sobral;3511508;Cerquilho;2;2;4;2275
3145208;Nova Serrana;3511508;Cerquilho;2;2;4;459
2927408;Salvador;3511409;Cerqueira César;2;2;4;1539
3106200;Belo Horizonte;3511409;Cerqueira César;2;2;4;630
3170206;Uberlândia;3511409;Cerqueira César;2;2;4;467
3127107;Frutal;3511102;Catanduva;2;2;4;114
3133402;Itapagipe;3511102;Catanduva;2;2;4;143
3148103;Patrocínio;3511102;Catanduva;2;2;4;319
3505708;Barueri;3511102;Catanduva;2;2;4;343
3506508;Birigui;3511102;Catanduva;2;2;4;142
3502804;Araçatuba;3511003;Castilho;2;2;4;114
3503208;Araraquara;3510807;Casa Branca;2;2;4;112
3503307;Araras;3510807;Casa Branca;2;2;4;71
3106200;Belo Horizonte;3510609;Carapicuíba;2;2;4;494
3505708;Barueri;3510500;Caraguatatuba;2;2;4;145
3502804;Araçatuba;3510401;Capivari;2;2;4;359
3510203;Capão Bonito;3510401;Capivari;2;2;4;142
3502705;Apiaí;3510203;Capão Bonito;2;2;4;75
3508009;Buri;3510203;Capão Bonito;2;2;4;34
3504107;Atibaia;3509601;Campo Limpo Paulista;2;2;4;26
1302405;Lábrea;3509502;Campinas;2;2;4;2454
1500602;Altamira;3509502;Campinas;2;2;4;2241
1500800;Ananindeua;3509502;Campinas;2;2;4;2385
1506807;Santarém;3509502;Campinas;2;2;4;2381
2305233;Horizonte;3509502;Campinas;2;2;4;2243
2307650;Maracanaú;3509502;Campinas;2;2;4;2262
2403251;Parnamirim;3509502;Campinas;2;2;4;2209
2408102;Natal;3509502;Campinas;2;2;4;2219
2501807;Bayeux;3509502;Campinas;2;2;4;2115
2507507;João Pessoa;3509502;Campinas;2;2;4;2114
2607208;Ipojuca;3509502;Campinas;2;2;4;1994
2611101;Petrolina;3509502;Campinas;2;2;4;1637
2707701;Rio Largo;3509502;Campinas;2;2;4;1853
2930709;Simões Filho;3509502;Campinas;2;2;4;1413
2933307;Vitória da Conquista;3509502;Campinas;2;2;4;1085
3101607;Alfenas;3509502;Campinas;2;2;4;200
3104007;Araxá;3509502;Campinas;2;2;4;367
3104106;Arceburgo;3509502;Campinas;2;2;4;170
3110509;Camanducaia;3509502;Campinas;2;2;4;95
3117876;Confins;3509502;Campinas;2;2;4;477
3122306;Divinópolis;3509502;Campinas;2;2;4;375
3127701;Governador Valadares;3509502;Campinas;2;2;4;685
3131307;Ipatinga;3509502;Campinas;2;2;4;595
3131703;Itabira;3509502;Campinas;2;2;4;530
3132404;Itajubá;3509502;Campinas;2;2;4;171
3134202;Ituiutaba;3509502;Campinas;2;2;4;498
3146008;Ouro Fino;3509502;Campinas;2;2;4;98
3162500;São João del Rei;3509502;Campinas;2;2;4;343
3301009;Campos dos Goytacazes;3509502;Campinas;2;2;4;599
3303302;Niterói;3509502;Campinas;2;2;4;406
3303500;Nova Iguaçu;3509502;Campinas;2;2;4;368
3303906;Petrópolis;3509502;Campinas;2;2;4;395
3304201;Resende;3509502;Campinas;2;2;4;270
3304904;São Gonçalo;3509502;Campinas;2;2;4;409
3305109;São João de Meriti;3509502;Campinas;2;2;4;378
3306305;Volta Redonda;3509502;Campinas;2;2;4;306
3500709;Agudos;3509502;Campinas;2;2;4;204
3502903;Araçoiaba da Serra;3509502;Campinas;2;2;4;88
3504503;Avaré;3509502;Campinas;2;2;4;194
3505302;Barra Bonita;3509502;Campinas;2;2;4;160
3506508;Birigui;3509502;Campinas;2;2;4;379
3507902;Brotas;3509502;Campinas;2;2;4;129
3508405;Cabreúva;3509502;Campinas;2;2;4;46
3508009;Buri;3509452;Campina do Monte Alegre;2;2;4;26
3505906;Batatais;3509403;Cajuru;2;2;4;53
3503208;Araraquara;3509304;Cajobi;2;2;4;120
1302603;Manaus;3509205;Cajamar;2;2;4;2582
2611606;Recife;3509205;Cajamar;2;2;4;2054
3205002;Serra;3509205;Cajamar;2;2;4;754
3205309;Vitória;3509205;Cajamar;2;2;4;748
1302603;Manaus;3509007;Caieiras;2;2;4;2589
3128709;Guaxupé;3508702;Caconde;2;2;4;26
3205002;Serra;3508504;Caçapava;2;2;4;639
3505708;Barueri;3508504;Caçapava;2;2;4;128
3503000;Aramina;3508207;Buritizal;2;2;4;18
3502200;Angatuba;3508009;Buri;2;2;4;39
3170206;Uberlândia;3507803;Brodowski;2;2;4;240
3505906;Batatais;3507803;Brodowski;2;2;4;12
3502804;Araçatuba;3507753;Brejo Alegre;2;2;4;26
3506508;Birigui;3507704;Braúna;2;2;4;22
3113602;Careaçu;3507605;Bragança Paulista;2;2;4;133
3135050;Jaíba;3507605;Bragança Paulista;2;2;4;891
3162005;São Gonçalo do Sapucaí;3507605;Bragança Paulista;2;2;4;152
3500501;Águas de Lindóia;3507605;Bragança Paulista;2;2;4;52
3501608;Americana;3507605;Bragança Paulista;2;2;4;83
3505708;Barueri;3507605;Bragança Paulista;2;2;4;71
3507100;Bom Jesus dos Perdões;3507605;Bragança Paulista;2;2;4;23
3106200;Belo Horizonte;3507506;Botucatu;2;2;4;560
3502804;Araçatuba;3507506;Botucatu;2;2;4;275
3504008;Assis;3507506;Botucatu;2;2;4;207
3506904;Bofete;3507506;Botucatu;2;2;4;31
3506003;Bauru;3507407;Borborema;2;2;4;80
3304557;Rio de Janeiro;3507100;Bom Jesus dos Perdões;2;2;4;329
3106200;Belo Horizonte;3507001;Boituva;2;2;4;529
3503208;Araraquara;3506805;Bocaina;2;2;4;53
3505203;Bariri;3506805;Bocaina;2;2;4;24
3506706;Boa Esperança do Sul;3506805;Bocaina;2;2;4;21
3501707;Américo Brasiliense;3506706;Boa Esperança do Sul;2;2;4;42
3106200;Belo Horizonte;3506508;Birigui;2;2;4;676
3304557;Rio de Janeiro;3506508;Birigui;2;2;4;759
3502101;Andradina;3506508;Birigui;2;2;4;117
3506003;Bauru;3506508;Birigui;2;2;4;174
3304557;Rio de Janeiro;3506359;Bertioga;2;2;4;312
3103504;Araguari;3506102;Bebedouro;2;2;4;257
3106200;Belo Horizonte;3506102;Bebedouro;2;2;4;487
3304557;Rio de Janeiro;3506102;Bebedouro;2;2;4;593
3502804;Araçatuba;3506102;Bebedouro;2;2;4;202
3506003;Bauru;3506102;Bebedouro;2;2;4;165
1100205;Porto Velho;3506003;Bauru;2;2;4;2101
3106705;Betim;3506003;Bauru;2;2;4;565
3127701;Governador Valadares;3506003;Bauru;2;2;4;822
3136702;Juiz de Fora;3506003;Bauru;2;2;4;594
3301702;Duque de Caxias;3506003;Bauru;2;2;4;597
3505500;Barretos;3506003;Bauru;2;2;4;204
3500105;Adamantina;3505807;Bastos;2;2;4;45
1501303;Barcarena;3505708;Barueri;2;2;4;2440
1505536;Parauapebas;3505708;Barueri;2;2;4;1958
1506807;Santarém;3505708;Barueri;2;2;4;2450
2105302;Imperatriz;3505708;Barueri;2;2;4;1992
2303709;Caucaia;3505708;Barueri;2;2;4;2330
2403251;Parnamirim;3505708;Barueri;2;2;4;2253
2408003;Mossoró;3505708;Barueri;2;2;4;2231
2503209;Cabedelo;3505708;Barueri;2;2;4;2168
2504603;Conde;3505708;Barueri;2;2;4;2146
2600054;Abreu e Lima;3505708;Barueri;2;2;4;2088
2602902;Cabo de Santo Agostinho;3505708;Barueri;2;2;4;2047
2800605;Barra dos Coqueiros;3505708;Barueri;2;2;4;1703
2804805;Nossa Senhora do Socorro;3505708;Barueri;2;2;4;1698
2910727;Eunápolis;3505708;Barueri;2;2;4;1074
2913903;Ipiaú;3505708;Barueri;2;2;4;1263
2919926;Madre de Deus;3505708;Barueri;2;2;4;1445
3147006;Paracatu;3505708;Barueri;2;2;4;695
3169307;Três Corações;3505708;Barueri;2;2;4;264
3171204;Vespasiano;3505708;Barueri;2;2;4;516
3201506;Colatina;3505708;Barueri;2;2;4;768
3300209;Araruama;3505708;Barueri;2;2;4;467
3301900;Itaboraí;3505708;Barueri;2;2;4;418
3302254;Itatiaia;3505708;Barueri;2;2;4;259
3304110;Porto Real;3505708;Barueri;2;2;4;287
3305208;São Pedro da Aldeia;3505708;Barueri;2;2;4;491
3504107;Atibaia;3505708;Barueri;2;2;4;55
3170206;Uberlândia;3505500;Barretos;2;2;4;186
3501608;Americana;3505302;Barra Bonita;2;2;4;129
2304400;Fortaleza;3505203;Bariri;2;2;4;2263
2609600;Olinda;3505203;Bariri;2;2;4;2080
3304557;Rio de Janeiro;3505203;Bariri;2;2;4;574
1500800;Ananindeua;3504602;Bady Bassitt;2;2;4;2165
3500709;Agudos;3504503;Avaré;2;2;4;68
3503208;Araraquara;3504503;Avaré;2;2;4;165
3300407;Barra Mansa;3504305;Avaí;2;2;4;532
2800308;Aracaju;3504107;Atibaia;2;2;4;1645
2905701;Camaçari;3504107;Atibaia;2;2;4;1413
3130101;Igarapé;3504107;Atibaia;2;2;4;406
3131307;Ipatinga;3504107;Atibaia;2;2;4;572
3133808;Itaúna;3504107;Atibaia;2;2;4;389
3138203;Lavras;3504107;Atibaia;2;2;4;262
3167202;Sete Lagoas;3504107;Atibaia;2;2;4;470
3302403;Macaé;3504107;Atibaia;2;2;4;483
3501608;Americana;3504107;Atibaia;2;2;4;91
1721000;Palmas;3504008;Assis;2;2;4;1377
3500105;Adamantina;3504008;Assis;2;2;4;127
3502804;Araçatuba;3504008;Assis;2;2;4;159
3118601;Contagem;3503901;Arujá;2;2;4;446
3205309;Vitória;3503901;Arujá;2;2;4;701
3134202;Ituiutaba;3503307;Araras;2;2;4;431
3304557;Rio de Janeiro;3503307;Araras;2;2;4;428
3502804;Araçatuba;3503307;Araras;2;2;4;340
3503208;Araraquara;3503307;Araras;2;2;4;103
2304400;Fortaleza;3503208;Araraquara;2;2;4;2211
3302403;Macaé;3503208;Araraquara;2;2;4;653
3300407;Barra Mansa;3503158;Arapeí;2;2;4;30
2704302;Maceió;3502804;Araçatuba;2;2;4;1960
3304557;Rio de Janeiro;3502754;Araçariguama;2;2;4;392
3304557;Rio de Janeiro;3502101;Andradina;2;2;4;880
3304557;Rio de Janeiro;3501905;Amparo;2;2;4;361
2602902;Cabo de Santo Agostinho;3501608;Americana;2;2;4;2010
2607901;Jaboatão dos Guararapes;3501608;Americana;2;2;4;2024
2611606;Recife;3501608;Americana;2;2;4;2030
2704302;Maceió;3501608;Americana;2;2;4;1850
3133808;Itaúna;3501608;Americana;2;2;4;404
3151800;Poços de Caldas;3501608;Americana;2;2;4;135
3205002;Serra;3501608;Americana;2;2;4;772
3205200;Vila Velha;3501608;Americana;2;2;4;758
3134905;Jacutinga;3500501;Águas de Lindóia;2;2;4;21
2304400;Fortaleza;3306305;Volta Redonda;2;2;4;2143
3145901;Ouro Branco;3306305;Volta Redonda;2;2;4;223
3201209;Cachoeiro de Itapemirim;3306305;Volta Redonda;2;2;4;360
3302254;Itatiaia;3306305;Volta Redonda;2;2;4;50
3303500;Nova Iguaçu;3306305;Volta Redonda;2;2;4;71
3304110;Porto Real;3306305;Volta Redonda;2;2;4;26
3305505;Saquarema;3306305;Volta Redonda;2;2;4;173
3305802;Teresópolis;3306305;Volta Redonda;2;2;4;112
3303609;Paracambi;3306206;Vassouras;2;2;4;21
3302205;Itaperuna;3306156;Varre-Sai;2;2;4;23
3136702;Juiz de Fora;3306107;Valença;2;2;4;66
3300100;Angra dos Reis;3306107;Valença;2;2;4;96
3304003;Piraí;3306107;Valença;2;2;4;48
3304201;Resende;3306107;Valença;2;2;4;80
3118601;Contagem;3306008;Três Rios;2;2;4;254
3138203;Lavras;3306008;Três Rios;2;2;4;204
3138401;Leopoldina;3306008;Três Rios;2;2;4;82
3303500;Nova Iguaçu;3306008;Três Rios;2;2;4;80
3304201;Resende;3306008;Três Rios;2;2;4;135
3305505;Saquarema;3306008;Três Rios;2;2;4;118
3301108;Cantagalo;3305901;Trajano de Morais;2;2;4;35
3304607;Santa Maria Madalena;3305901;Trajano de Morais;2;2;4;13
3205002;Serra;3305802;Teresópolis;2;2;4;375
3303500;Nova Iguaçu;3305802;Teresópolis;2;2;4;60
3303856;Paty do Alferes;3305802;Teresópolis;2;2;4;42
3205002;Serra;3305752;Tanguá;2;2;4;380
3304904;São Gonçalo;3305752;Tanguá;2;2;4;35
3305406;Sapucaia;3305703;Sumidouro;2;2;4;25
3300209;Araruama;3305604;Silva Jardim;2;2;4;26
3301306;Casimiro de Abreu;3305604;Silva Jardim;2;2;4;27
3304524;Rio das Ostras;3305604;Silva Jardim;2;2;4;50
3106200;Belo Horizonte;3305554;Seropédica;2;2;4;316
3205200;Vila Velha;3305505;Saquarema;2;2;4;351
3300456;Belford Roxo;3305505;Saquarema;2;2;4;96
3301405;Conceição de Macabu;3305505;Saquarema;2;2;4;104
3302205;Itaperuna;3305505;Saquarema;2;2;4;198
3304524;Rio das Ostras;3305505;Saquarema;2;2;4;68
3305158;São José do Vale do Rio Preto;3305406;Sapucaia;2;2;4;17
3301009;Campos dos Goytacazes;3305208;São Pedro da Aldeia;2;2;4;140
3301306;Casimiro de Abreu;3305208;São Pedro da Aldeia;2;2;4;39
3301702;Duque de Caxias;3305208;São Pedro da Aldeia;2;2;4;124
3301900;Itaboraí;3305208;São Pedro da Aldeia;2;2;4;77
3302205;Itaperuna;3305208;São Pedro da Aldeia;2;2;4;188
3302403;Macaé;3305208;São Pedro da Aldeia;2;2;4;56
3302502;Magé;3305208;São Pedro da Aldeia;2;2;4;100
3302700;Maricá;3305208;São Pedro da Aldeia;2;2;4;73
3303302;Niterói;3305208;São Pedro da Aldeia;2;2;4;102
3303401;Nova Friburgo;3305208;São Pedro da Aldeia;2;2;4;76
3304300;Rio Bonito;3305208;São Pedro da Aldeia;2;2;4;54
3304524;Rio das Ostras;3305208;São Pedro da Aldeia;2;2;4;43
3305109;São João de Meriti;3305208;São Pedro da Aldeia;2;2;4;130
3300159;Aperibé;3305133;São José de Ubá;2;2;4;36
3201308;Cariacica;3305109;São João de Meriti;2;2;4;410
3303955;Pinheiral;3305109;São João de Meriti;2;2;4;71
3302403;Macaé;3305000;São João da Barra;2;2;4;115
2611606;Recife;3304904;São Gonçalo;2;2;4;1811
3300233;Armação dos Búzios;3304904;São Gonçalo;2;2;4;118
3300456;Belford Roxo;3304904;São Gonçalo;2;2;4;34
3300803;Cachoeiras de Macacu;3304904;São Gonçalo;2;2;4;56
3301009;Campos dos Goytacazes;3304904;São Gonçalo;2;2;4;210
3302205;Itaperuna;3304904;São Gonçalo;2;2;4;218
3302858;Mesquita;3304904;São Gonçalo;2;2;4;39
3205002;Serra;3304805;São Fidélis;2;2;4;227
3300902;Cambuci;3304805;São Fidélis;2;2;4;24
3302106;Itaocara;3304805;São Fidélis;2;2;4;34
3304557;Rio de Janeiro;3304805;São Fidélis;2;2;4;206
3304706;Santo Antônio de Pádua;3304755;São Francisco de Itabapoana;2;2;4;120
3143906;Muriaé;3304706;Santo Antônio de Pádua;2;2;4;54
3172103;Volta Grande;3304706;Santo Antônio de Pádua;2;2;4;45
3300159;Aperibé;3304706;Santo Antônio de Pádua;2;2;4;9
3300902;Cambuci;3304706;Santo Antônio de Pádua;2;2;4;26
3301405;Conceição de Macabu;3304607;Santa Maria Madalena;2;2;4;21
1304062;Tabatinga;3304557;Rio de Janeiro;2;2;4;3334
1304203;Tefé;3304557;Rio de Janeiro;2;2;4;3012
1500503;Almeirim;3304557;Rio de Janeiro;2;2;4;2536
1502772;Curionópolis;3304557;Rio de Janeiro;2;2;4;1963
1505502;Paragominas;3304557;Rio de Janeiro;2;2;4;2233
1508100;Tucuruí;3304557;Rio de Janeiro;2;2;4;2209
1600154;Pedra Branca do Amaparí;3304557;Rio de Janeiro;2;2;4;2751
1702406;Arraias;3304557;Rio de Janeiro;2;2;4;1158
1713205;Miracema do Tocantins;3304557;Rio de Janeiro;2;2;4;1560
2101251;Bacabeira;3304557;Rio de Janeiro;2;2;4;2204
2103000;Caxias;3304557;Rio de Janeiro;2;2;4;1994
2109106;Presidente Dutra;3304557;Rio de Janeiro;2;2;4;1948
2200400;Altos;3304557;Rio de Janeiro;2;2;4;1974
2202208;Campo Maior;3304557;Rio de Janeiro;2;2;4;1998
2203909;Floriano;3304557;Rio de Janeiro;2;2;4;1778
2207801;Paulistana;3304557;Rio de Janeiro;2;2;4;1638
2300200;Acaraú;3304557;Rio de Janeiro;2;2;4;2231
2311801;Russas;3304557;Rio de Janeiro;2;2;4;2053
2401107;Areia Branca;3304557;Rio de Janeiro;2;2;4;2072
2407104;Macaíba;3304557;Rio de Janeiro;2;2;4;2038
2503704;Cajazeiras;3304557;Rio de Janeiro;2;2;4;1828
2600054;Abreu e Lima;3304557;Rio de Janeiro;2;2;4;1851
2604007;Carpina;3304557;Rio de Janeiro;2;2;4;1843
2606408;Gravatá;3304557;Rio de Janeiro;2;2;4;1793
2615300;Timbaúba;3304557;Rio de Janeiro;2;2;4;1873
2616407;Vitória de Santo Antão;3304557;Rio de Janeiro;2;2;4;1813
2802908;Itabaiana;3304557;Rio de Janeiro;2;2;4;1474
2903201;Barreiras;3304557;Rio de Janeiro;2;2;4;1193
2905800;Camamu;3304557;Rio de Janeiro;2;2;4;1072
2909802;Cruz das Almas;3304557;Rio de Janeiro;2;2;4;1200
2910602;Esplanada;3304557;Rio de Janeiro;2;2;4;1333
2915403;Itaju do Colônia;3304557;Rio de Janeiro;2;2;4;927
2916302;Itapebi;3304557;Rio de Janeiro;2;2;4;854
2927705;Santa Cruz Cabrália;3304557;Rio de Janeiro;2;2;4;842
2928604;Santo Amaro;3304557;Rio de Janeiro;2;2;4;1230
2930501;Serrinha;3304557;Rio de Janeiro;2;2;4;1313
2933208;Vera Cruz;3304557;Rio de Janeiro;2;2;4;1187
3101607;Alfenas;3304557;Rio de Janeiro;2;2;4;320
3103751;Araporã;3304557;Rio de Janeiro;2;2;4;775
3106309;Belo Oriente;3304557;Rio de Janeiro;2;2;4;413
3110905;Campanha;3304557;Rio de Janeiro;2;2;4;247
3111200;Campo Belo;3304557;Rio de Janeiro;2;2;4;300
3112802;Capitólio;3304557;Rio de Janeiro;2;2;4;379
3113206;Carandaí;3304557;Rio de Janeiro;2;2;4;221
3114204;Carmo do Cajuru;3304557;Rio de Janeiro;2;2;4;336
3115508;Caxambu;3304557;Rio de Janeiro;2;2;4;204
3119401;Coronel Fabriciano;3304557;Rio de Janeiro;2;2;4;378
3121605;Diamantina;3304557;Rio de Janeiro;2;2;4;518
3129806;Ibirité;3304557;Rio de Janeiro;2;2;4;327
3131901;Itabirito;3304557;Rio de Janeiro;2;2;4;293
3132404;Itajubá;3304557;Rio de Janeiro;2;2;4;232
3134400;Iturama;3304557;Rio de Janeiro;2;2;4;785
3135100;Janaúba;3304557;Rio de Janeiro;2;2;4;784
3135605;Jequitaí;3304557;Rio de Janeiro;2;2;4;641
3136405;Joaquim Felício;3304557;Rio de Janeiro;2;2;4;574
3137205;Lagoa da Prata;3304557;Rio de Janeiro;2;2;4;392
3145000;Nova Ponte;3304557;Rio de Janeiro;2;2;4;610
3145208;Nova Serrana;3304557;Rio de Janeiro;2;2;4;376
3154606;Ribeirão das Neves;3304557;Rio de Janeiro;2;2;4;355
3155405;Rio Novo;3304557;Rio de Janeiro;2;2;4;158
3155702;Rio Piracicaba;3304557;Rio de Janeiro;2;2;4;328
3157203;Santa Bárbara;3304557;Rio de Janeiro;2;2;4;324
3159605;Santa Rita do Sapucaí;3304557;Rio de Janeiro;2;2;4;259
3160900;São Brás do Suaçuí;3304557;Rio de Janeiro;2;2;4;260
3162906;São João Nepomuceno;3304557;Rio de Janeiro;2;2;4;151
3164704;São Sebastião do Paraíso;3304557;Rio de Janeiro;2;2;4;437
3171303;Viçosa;3304557;Rio de Janeiro;2;2;4;237
3200300;Alfredo Chaves;3304557;Rio de Janeiro;2;2;4;357
3200409;Anchieta;3304557;Rio de Janeiro;2;2;4;346
3201407;Castelo;3304557;Rio de Janeiro;2;2;4;324
3301876;Iguaba Grande;3304557;Rio de Janeiro;2;2;4;105
3302809;Mendes;3304557;Rio de Janeiro;2;2;4;64
3304128;Quatis;3304557;Rio de Janeiro;2;2;4;115
3304151;Quissamã;3304557;Rio de Janeiro;2;2;4;202
3106200;Belo Horizonte;3304524;Rio das Ostras;2;2;4;351
3205309;Vitória;3304524;Rio das Ostras;2;2;4;297
3300506;Bom Jardim;3304524;Rio das Ostras;2;2;4;59
3303500;Nova Iguaçu;3304524;Rio das Ostras;2;2;4;160
3303906;Petrópolis;3304524;Rio das Ostras;2;2;4;131
3136702;Juiz de Fora;3304508;Rio das Flores;2;2;4;53
3106200;Belo Horizonte;3304300;Rio Bonito;2;2;4;340
3301306;Casimiro de Abreu;3304300;Rio Bonito;2;2;4;50
3302502;Magé;3304300;Rio Bonito;2;2;4;46
3302700;Maricá;3304300;Rio Bonito;2;2;4;31
3303906;Petrópolis;3304300;Rio Bonito;2;2;4;64
3106200;Belo Horizonte;3304201;Resende;2;2;4;293
3118601;Contagem;3304201;Resende;2;2;4;290
3147600;Passa Quatro;3304201;Resende;2;2;4;55
3170206;Uberlândia;3304201;Resende;2;2;4;557
3300407;Barra Mansa;3304144;Queimados;2;2;4;66
3302270;Japeri;3304144;Queimados;2;2;4;10
3303203;Nilópolis;3304144;Queimados;2;2;4;19
3303302;Niterói;3304144;Queimados;2;2;4;53
3300407;Barra Mansa;3304128;Quatis;2;2;4;15
3300407;Barra Mansa;3304110;Porto Real;2;2;4;20
3113305;Carangola;3304102;Porciúncula;2;2;4;25
3124005;Ervália;3304102;Porciúncula;2;2;4;65
3124203;Espera Feliz;3304102;Porciúncula;2;2;4;37
3302809;Mendes;3304003;Piraí;2;2;4;19
3303955;Pinheiral;3304003;Piraí;2;2;4;17
3300308;Barra do Piraí;3303955;Pinheiral;2;2;4;19
2704302;Maceió;3303906;Petrópolis;2;2;4;1608
3135506;Jequeri;3303906;Petrópolis;2;2;4;236
3205200;Vila Velha;3303906;Petrópolis;2;2;4;379
3300100;Angra dos Reis;3303906;Petrópolis;2;2;4;118
3300233;Armação dos Búzios;3303906;Petrópolis;2;2;4;136
3301900;Itaboraí;3303906;Petrópolis;2;2;4;44
3302908;Miguel Pereira;3303906;Petrópolis;2;2;4;27
1506161;Rio Maria;3303708;Paraíba do Sul;2;2;4;1774
3300407;Barra Mansa;3303708;Paraíba do Sul;2;2;4;102
2927408;Salvador;3303500;Nova Iguaçu;2;2;4;1190
3118601;Contagem;3303500;Nova Iguaçu;2;2;4;320
3201308;Cariacica;3303500;Nova Iguaçu;2;2;4;414
3300704;Cabo Frio;3303500;Nova Iguaçu;2;2;4;145
3303401;Nova Friburgo;3303500;Nova Iguaçu;2;2;4;105
2304400;Fortaleza;3303401;Nova Friburgo;2;2;4;2088
3136702;Juiz de Fora;3303401;Nova Friburgo;2;2;4;98
3205200;Vila Velha;3303401;Nova Friburgo;2;2;4;313
3205309;Vitória;3303401;Nova Friburgo;2;2;4;324
3301306;Casimiro de Abreu;3303401;Nova Friburgo;2;2;4;44
3301900;Itaboraí;3303401;Nova Friburgo;2;2;4;58
3302700;Maricá;3303401;Nova Friburgo;2;2;4;74
1100205;Porto Velho;3303302;Niterói;2;2;4;2580
1302603;Manaus;3303302;Niterói;2;2;4;2747
2408102;Natal;3303302;Niterói;2;2;4;2040
2607901;Jaboatão dos Guararapes;3303302;Niterói;2;2;4;1817
3157807;Santa Luzia;3303302;Niterói;2;2;4;352
3170206;Uberlândia;3303302;Niterói;2;2;4;684
3205002;Serra;3303302;Niterói;2;2;4;416
3300258;Arraial do Cabo;3303302;Niterói;2;2;4;111
3302007;Itaguaí;3303302;Niterói;2;2;4;73
3302601;Mangaratiba;3303302;Niterói;2;2;4;96
3106200;Belo Horizonte;3303203;Nilópolis;2;2;4;327
3302007;Itaguaí;3303203;Nilópolis;2;2;4;39
3300605;Bom Jesus do Itabapoana;3303104;Natividade;2;2;4;32
3302205;Itaperuna;3303104;Natividade;2;2;4;14
3146701;Palma;3303005;Miracema;2;2;4;11
3118601;Contagem;3302858;Mesquita;2;2;4;324
3136702;Juiz de Fora;3302858;Mesquita;2;2;4;115
3300456;Belford Roxo;3302858;Mesquita;2;2;4;5
3300704;Cabo Frio;3302700;Maricá;2;2;4;77
3301702;Duque de Caxias;3302700;Maricá;2;2;4;54
3301900;Itaboraí;3302700;Maricá;2;2;4;20
3302502;Magé;3302700;Maricá;2;2;4;41
3106200;Belo Horizonte;3302601;Mangaratiba;2;2;4;331
3302007;Itaguaí;3302601;Mangaratiba;2;2;4;24
2304400;Fortaleza;3302502;Magé;2;2;4;2134
3205002;Serra;3302502;Magé;2;2;4;395
3300233;Armação dos Búzios;3302502;Magé;2;2;4;119
3301108;Cantagalo;3302452;Macuco;2;2;4;13
3301504;Cordeiro;3302452;Macuco;2;2;4;13
1302603;Manaus;3302403;Macaé;2;2;4;2782
3136702;Juiz de Fora;3302403;Macaé;2;2;4;162
3143906;Muriaé;3302403;Macaé;2;2;4;150
3201209;Cachoeiro de Itapemirim;3302403;Macaé;2;2;4;189
3204906;São Mateus;3302403;Macaé;2;2;4;449
3300803;Cachoeiras de Macacu;3302403;Macaé;2;2;4;79
3301900;Itaboraí;3302403;Macaé;2;2;4;108
3143906;Muriaé;3302304;Laje do Muriaé;2;2;4;27
3106200;Belo Horizonte;3302270;Japeri;2;2;4;306
2910727;Eunápolis;3302205;Itaperuna;2;2;4;578
2927408;Salvador;3302205;Itaperuna;2;2;4;966
3101508;Além Paraíba;3302205;Itaperuna;2;2;4;114
3118601;Contagem;3302205;Itaperuna;2;2;4;265
3136702;Juiz de Fora;3302205;Itaperuna;2;2;4;165
3201100;Bom Jesus do Norte;3302205;Itaperuna;2;2;4;23
3202306;Guaçuí;3302205;Itaperuna;2;2;4;46
3202405;Guarapari;3302205;Itaperuna;2;2;4;148
3203403;Mimoso do Sul;3302205;Itaperuna;2;2;4;55
3205200;Vila Velha;3302205;Itaperuna;2;2;4;181
3205309;Vitória;3302205;Itaperuna;2;2;4;191
3301504;Cordeiro;3302106;Itaocara;2;2;4;49
3143906;Muriaé;3302056;Italva;2;2;4;78
3106200;Belo Horizonte;3302007;Itaguaí;2;2;4;322
3205002;Serra;3302007;Itaguaí;2;2;4;464
3205309;Vitória;3302007;Itaguaí;2;2;4;455
2927408;Salvador;3301900;Itaboraí;2;2;4;1165
3300407;Barra Mansa;3301900;Itaboraí;2;2;4;140
3300704;Cabo Frio;3301900;Itaboraí;2;2;4;82
1100205;Porto Velho;3301702;Duque de Caxias;2;2;4;2557
1302603;Manaus;3301702;Duque de Caxias;2;2;4;2725
1500800;Ananindeua;3301702;Duque de Caxias;2;2;4;2418
2800308;Aracaju;3301702;Duque de Caxias;2;2;4;1452
2906501;Candeias;3301702;Duque de Caxias;2;2;4;1214
2931350;Teixeira de Freitas;3301702;Duque de Caxias;2;2;4;682
3140803;Matias Barbosa;3301702;Duque de Caxias;2;2;4;99
3143302;Montes Claros;3301702;Duque de Caxias;2;2;4;670
3169901;Ubá;3301702;Duque de Caxias;2;2;4;188
3205309;Vitória;3301702;Duque de Caxias;2;2;4;414
3300225;Areal;3301702;Duque de Caxias;2;2;4;63
3300233;Armação dos Búzios;3301702;Duque de Caxias;2;2;4;144
3300159;Aperibé;3301504;Cordeiro;2;2;4;51
3301009;Campos dos Goytacazes;3301306;Casimiro de Abreu;2;2;4;118
2609600;Olinda;3301009;Campos dos Goytacazes;2;2;4;1655
2927408;Salvador;3301009;Campos dos Goytacazes;2;2;4;1015
3118601;Contagem;3301009;Campos dos Goytacazes;2;2;4;352
3143906;Muriaé;3301009;Campos dos Goytacazes;2;2;4;132
3203205;Linhares;3301009;Campos dos Goytacazes;2;2;4;300
3139805;Mar de Espanha;3300902;Cambuci;2;2;4;118
3300506;Bom Jardim;3300803;Cachoeiras de Macacu;2;2;4;42
3300605;Bom Jesus do Itabapoana;3300704;Cabo Frio;2;2;4;196
3201209;Cachoeiro de Itapemirim;3300605;Bom Jesus do Itabapoana;2;2;4;70
3202306;Guaçuí;3300605;Bom Jesus do Itabapoana;2;2;4;40
3203403;Mimoso do Sul;3300605;Bom Jesus do Itabapoana;2;2;4;34
3107505;Bom Jardim de Minas;3300407;Barra Mansa;2;2;4;65
3169356;Três Marias;3300407;Barra Mansa;2;2;4;491
3202603;Iconha;3300407;Barra Mansa;2;2;4;396
3141108;Matozinhos;3300308;Barra do Piraí;2;2;4;323
3300209;Araruama;3300233;Armação dos Búzios;2;2;4;48
3106200;Belo Horizonte;3300100;Angra dos Reis;2;2;4;336
3205309;Vitória;3300100;Angra dos Reis;2;2;4;501
1500503;Almeirim;3205309;Vitória;2;2;4;2415
2607208;Ipojuca;3205309;Vitória;2;2;4;1415
2800605;Barra dos Coqueiros;3205309;Vitória;2;2;4;1092
2913606;Ilhéus;3205309;Vitória;2;2;4;616
2922003;Mucuri;3205309;Vitória;2;2;4;262
2925303;Porto Seguro;3205309;Vitória;2;2;4;440
3101102;Aimorés;3205309;Vitória;2;2;4;116
3103504;Araguari;3205309;Vitória;2;2;4;841
3119401;Coronel Fabriciano;3205309;Vitória;2;2;4;255
3140001;Mariana;3205309;Vitória;2;2;4;325
3144003;Mutum;3205309;Vitória;2;2;4;128
3144300;Nanuque;3205309;Vitória;2;2;4;263
3170701;Varginha;3205309;Vitória;2;2;4;552
3200136;Águia Branca;3205309;Vitória;2;2;4;147
3200169;Água Doce do Norte;3205309;Vitória;2;2;4;201
3200359;Alto Rio Novo;3205309;Vitória;2;2;4;151
3200508;Apiacá;3205309;Vitória;2;2;4;166
3200706;Atilio Vivacqua;3205309;Vitória;2;2;4;119
3201803;Divino de São Lourenço;3205309;Vitória;2;2;4;150
3202603;Iconha;3205309;Vitória;2;2;4;80
3202652;Irupi;3205309;Vitória;2;2;4;140
3203106;Jerônimo Monteiro;3205309;Vitória;2;2;4;129
3203353;Marilândia;3205309;Vitória;2;2;4;96
3204005;Pancas;3205309;Vitória;2;2;4;127
3204302;Presidente Kennedy;3205309;Vitória;2;2;4;122
3204401;Rio Novo do Sul;3205309;Vitória;2;2;4;95
3204658;São Domingos do Norte;3205309;Vitória;2;2;4;127
3204807;São José do Calçado;3205309;Vitória;2;2;4;165
3204955;São Roque do Canaã;3205309;Vitória;2;2;4;67
3205176;Vila Valério;3205309;Vitória;2;2;4;139
1302603;Manaus;3205200;Vila Velha;2;2;4;2750
1721000;Palmas;3205200;Vila Velha;2;2;4;1372
2408102;Natal;3205200;Vila Velha;2;2;4;1688
2704302;Maceió;3205200;Vila Velha;2;2;4;1274
2905701;Camaçari;3205200;Vila Velha;2;2;4;871
2906501;Candeias;3205200;Vila Velha;2;2;4;869
2910800;Feira de Santana;3205200;Vila Velha;2;2;4;902
2915601;Itamaraju;3205200;Vila Velha;2;2;4;377
2927408;Salvador;3205200;Vila Velha;2;2;4;836
3118304;Conselheiro Lafaiete;3205200;Vila Velha;2;2;4;363
3139409;Manhuaçu;3205200;Vila Velha;2;2;4;177
3143906;Muriaé;3205200;Vila Velha;2;2;4;222
3168705;Timóteo;3205200;Vila Velha;2;2;4;251
3200904;Barra de São Francisco;3205200;Vila Velha;2;2;4;184
3203130;João Neiva;3205200;Vila Velha;2;2;4;65
3203320;Marataízes;3205200;Vila Velha;2;2;4;95
3203908;Nova Venécia;3205200;Vila Velha;2;2;4;180
3204609;Santa Teresa;3205200;Vila Velha;2;2;4;51
3205101;Viana;3205200;Vila Velha;2;2;4;22
2806107;Rosário do Catete;3205101;Viana;2;2;4;1133
2905701;Camaçari;3205101;Viana;2;2;4;884
2915601;Itamaraju;3205101;Viana;2;2;4;390
3106705;Betim;3205101;Viana;2;2;4;381
3127701;Governador Valadares;3205101;Viana;2;2;4;230
3170107;Uberaba;3205101;Viana;2;2;4;769
3170206;Uberlândia;3205101;Viana;2;2;4;817
3204906;São Mateus;3205101;Viana;2;2;4;196
2611606;Recife;3205069;Venda Nova do Imigrante;2;2;4;1491
3201159;Brejetuba;3205069;Venda Nova do Imigrante;2;2;4;27
3201902;Domingos Martins;3205069;Venda Nova do Imigrante;2;2;4;50
3203700;Muniz Freire;3205069;Venda Nova do Imigrante;2;2;4;32
3205036;Vargem Alta;3205069;Venda Nova do Imigrante;2;2;4;39
3200102;Afonso Cláudio;3205036;Vargem Alta;2;2;4;67
3204401;Rio Novo do Sul;3205036;Vargem Alta;2;2;4;23
3205002;Serra;3205036;Vargem Alta;2;2;4;94
1502400;Castanhal;3205002;Serra;2;2;4;2220
1504208;Marabá;3205002;Serra;2;2;4;1860
1505536;Parauapebas;3205002;Serra;2;2;4;1837
2904506;Brotas de Macaúbas;3205002;Serra;2;2;4;930
2933307;Vitória da Conquista;3205002;Serra;2;2;4;585
3144805;Nova Lima;3205002;Serra;2;2;4;371
3168705;Timóteo;3205002;Serra;2;2;4;251
3170206;Uberlândia;3205002;Serra;2;2;4;840
3200102;Afonso Cláudio;3205002;Serra;2;2;4;86
3200136;Águia Branca;3205002;Serra;2;2;4;135
3200805;Baixo Guandu;3205002;Serra;2;2;4;97
3204559;Santa Maria de Jetibá;3205002;Serra;2;2;4;47
3204609;Santa Teresa;3205002;Serra;2;2;4;37
3204559;Santa Maria de Jetibá;3204955;São Roque do Canaã;2;2;4;35
2304400;Fortaleza;3204906;São Mateus;2;2;4;1663
2923001;Nova Viçosa;3204906;São Mateus;2;2;4;107
3106200;Belo Horizonte;3204906;São Mateus;2;2;4;452
3127701;Governador Valadares;3204906;São Mateus;2;2;4;222
3200607;Aracruz;3204906;São Mateus;2;2;4;124
3202504;Ibiraçu;3204906;São Mateus;2;2;4;130
3203502;Montanha;3204906;São Mateus;2;2;4;88
3202306;Guaçuí;3204807;São José do Calçado;2;2;4;28
3203056;Jaguaré;3204708;São Gabriel da Palha;2;2;4;53
3203205;Linhares;3204708;São Gabriel da Palha;2;2;4;70
3201308;Cariacica;3204609;Santa Teresa;2;2;4;39
3201506;Colatina;3204609;Santa Teresa;2;2;4;42
2910727;Eunápolis;3204559;Santa Maria de Jetibá;2;2;4;424
3200805;Baixo Guandu;3204559;Santa Maria de Jetibá;2;2;4;61
3202900;Itarana;3204559;Santa Maria de Jetibá;2;2;4;23
3202603;Iconha;3204401;Rio Novo do Sul;2;2;4;15
2910727;Eunápolis;3204351;Rio Bananal;2;2;4;330
3201308;Cariacica;3204203;Piúma;2;2;4;70
3202603;Iconha;3204203;Piúma;2;2;4;8
3202801;Itapemirim;3204203;Piúma;2;2;4;28
2922003;Mucuri;3204104;Pinheiros;2;2;4;84
2923001;Nova Viçosa;3204104;Pinheiros;2;2;4;98
3144300;Nanuque;3204104;Pinheiros;2;2;4;61
3168606;Teófilo Otoni;3204104;Pinheiros;2;2;4;148
3201001;Boa Esperança;3204104;Pinheiros;2;2;4;16
3203908;Nova Venécia;3204104;Pinheiros;2;2;4;38
3200169;Água Doce do Norte;3203908;Nova Venécia;2;2;4;65
3203502;Montanha;3203908;Nova Venécia;2;2;4;68
3200201;Alegre;3203700;Muniz Freire;2;2;4;38
3201407;Castelo;3203700;Muniz Freire;2;2;4;22
3200169;Água Doce do Norte;3203403;Mimoso do Sul;2;2;4;281
3200409;Anchieta;3203320;Marataízes;2;2;4;33
3202405;Guarapari;3203320;Marataízes;2;2;4;57
2304400;Fortaleza;3203205;Linhares;2;2;4;1731
3167202;Sete Lagoas;3203205;Linhares;2;2;4;441
3202405;Guarapari;3203205;Linhares;2;2;4;152
3203130;João Neiva;3203205;Linhares;2;2;4;58
3202504;Ibiraçu;3203130;João Neiva;2;2;4;10
3202702;Itaguaçu;3202900;Itarana;2;2;4;8
2304400;Fortaleza;3202603;Iconha;2;2;4;1897
2611606;Recife;3202603;Iconha;2;2;4;1522
2905701;Camaçari;3202603;Iconha;2;2;4;931
2931350;Teixeira de Freitas;3202603;Iconha;2;2;4;376
3200409;Anchieta;3202603;Iconha;2;2;4;8
3202306;Guaçuí;3202553;Ibitirama;2;2;4;26
3139409;Manhuaçu;3202454;Ibatiba;2;2;4;58
3201209;Cachoeiro de Itapemirim;3202454;Ibatiba;2;2;4;79
3127701;Governador Valadares;3202405;Guarapari;2;2;4;250
3140001;Mariana;3202405;Guarapari;2;2;4;298
3124203;Espera Feliz;3202306;Guaçuí;2;2;4;28
3201100;Bom Jesus do Norte;3202306;Guaçuí;2;2;4;37
3201803;Divino de São Lourenço;3202306;Guaçuí;2;2;4;17
3200904;Barra de São Francisco;3202256;Governador Lindenberg;2;2;4;72
3200102;Afonso Cláudio;3201704;Conceição do Castelo;2;2;4;34
3201407;Castelo;3201704;Conceição do Castelo;2;2;4;26
2304400;Fortaleza;3201506;Colatina;2;2;4;1759
2910727;Eunápolis;3201506;Colatina;2;2;4;368
2914653;Itabela;3201506;Colatina;2;2;4;348
3101102;Aimorés;3201506;Colatina;2;2;4;49
3139607;Mantena;3201506;Colatina;2;2;4;95
3144300;Nanuque;3201506;Colatina;2;2;4;188
3200102;Afonso Cláudio;3201506;Colatina;2;2;4;79
3200136;Águia Branca;3201506;Colatina;2;2;4;64
2913606;Ilhéus;3201308;Cariacica;2;2;4;620
3106705;Betim;3201308;Cariacica;2;2;4;393
3136702;Juiz de Fora;3201308;Cariacica;2;2;4;346
3170206;Uberlândia;3201308;Cariacica;2;2;4;828
3200805;Baixo Guandu;3201308;Cariacica;2;2;4;98
3200904;Barra de São Francisco;3201308;Cariacica;2;2;4;173
1500800;Ananindeua;3201209;Cachoeiro de Itapemirim;2;2;4;2273
1501402;Belém;3201209;Cachoeiro de Itapemirim;2;2;4;2273
2111300;São Luís;3201209;Cachoeiro de Itapemirim;2;2;4;2048
2606200;Goiana;3201209;Cachoeiro de Itapemirim;2;2;4;1591
2612208;Salgueiro;3201209;Cachoeiro de Itapemirim;2;2;4;1419
2916302;Itapebi;3201209;Cachoeiro de Itapemirim;2;2;4;564
3126752;Franciscópolis;3201209;Cachoeiro de Itapemirim;2;2;4;331
3127701;Governador Valadares;3201209;Cachoeiro de Itapemirim;2;2;4;242
3200169;Água Doce do Norte;3201209;Cachoeiro de Itapemirim;2;2;4;253
3201100;Bom Jesus do Norte;3201209;Cachoeiro de Itapemirim;2;2;4;69
3149309;Pedro Leopoldo;3200904;Barra de São Francisco;2;2;4;346
3154309;Resplendor;3200805;Baixo Guandu;2;2;4;35
1100205;Porto Velho;3200607;Aracruz;2;2;4;2701
2105302;Imperatriz;3200607;Aracruz;2;2;4;1741
2111300;São Luís;3200607;Aracruz;2;2;4;1953
2923001;Nova Viçosa;3200607;Aracruz;2;2;4;231
3101102;Aimorés;3200607;Aracruz;2;2;4;91
3118601;Contagem;3200607;Aracruz;2;2;4;399
3106200;Belo Horizonte;3200409;Anchieta;2;2;4;352
3115300;Cataguases;3172004;Visconde do Rio Branco;2;2;4;43
3129004;Guiricema;3172004;Visconde do Rio Branco;2;2;4;13
3152105;Ponte Nova;3172004;Visconde do Rio Branco;2;2;4;67
3133006;Itamonte;3171709;Virgínia;2;2;4;24
3163706;São Lourenço;3171709;Virgínia;2;2;4;24
3127701;Governador Valadares;3171501;Mathias Lobato;2;2;4;25
3115300;Cataguases;3171303;Viçosa;2;2;4;70
3139409;Manhuaçu;3171303;Viçosa;2;2;4;105
3140001;Mariana;3171303;Viçosa;2;2;4;69
3148301;Paula Cândido;3171303;Viçosa;2;2;4;14
3150802;Piranga;3171303;Viçosa;2;2;4;42
3168507;Teixeiras;3171303;Viçosa;2;2;4;14
2304400;Fortaleza;3171204;Vespasiano;2;2;4;1845
2927408;Salvador;3171204;Vespasiano;2;2;4;931
3117876;Confins;3171204;Vespasiano;2;2;4;10
3149309;Pedro Leopoldo;3171204;Vespasiano;2;2;4;17
3156700;Sabará;3171204;Vespasiano;2;2;4;23
3154002;Raul Soares;3171154;Vermelho Novo;2;2;4;19
3170909;Varzelândia;3171030;Verdelândia;2;2;4;47
3128600;Guarda-Mor;3171006;Vazante;2;2;4;29
3137106;Lagamar;3171006;Vazante;2;2;4;26
3104809;Augusto de Lima;3170800;Várzea da Palma;2;2;4;78
3109204;Buenópolis;3170800;Várzea da Palma;2;2;4;69
3118601;Contagem;3170800;Várzea da Palma;2;2;4;267
3143302;Montes Claros;3170800;Várzea da Palma;2;2;4;135
3147402;Paraopeba;3170800;Várzea da Palma;2;2;4;189
3165701;Senador Firmino;3170800;Várzea da Palma;2;2;4;408
3167202;Sete Lagoas;3170800;Várzea da Palma;2;2;4;211
2304285;Eusébio;3170701;Varginha;2;2;4;2068
3103504;Araguari;3170701;Varginha;2;2;4;428
3107109;Boa Esperança;3170701;Varginha;2;2;4;49
3117702;Conceição do Rio Verde;3170701;Varginha;2;2;4;53
3127701;Governador Valadares;3170701;Varginha;2;2;4;461
3142601;Monsenhor Paulo;3170701;Varginha;2;2;4;32
3145604;Oliveira;3170701;Varginha;2;2;4;105
3147907;Passos;3170701;Varginha;2;2;4;155
3148004;Patos de Minas;3170701;Varginha;2;2;4;343
3149903;Perdões;3170701;Varginha;2;2;4;56
3159902;Santo Antônio do Amparo;3170701;Varginha;2;2;4;79
3162005;São Gonçalo do Sapucaí;3170701;Varginha;2;2;4;47
3164308;São Roque de Minas;3170602;Vargem Bonita;2;2;4;14
3123858;Entre Folhas;3170578;Vargem Alegre;2;2;4;7
3154457;Riachinho;3170529;Urucuia;2;2;4;29
3152105;Ponte Nova;3170503;Urucânia;2;2;4;19
3164001;São Pedro dos Ferros;3170503;Urucânia;2;2;4;30
3170404;Unaí;3170479;Uruana de Minas;2;2;4;81
3161304;São Francisco de Sales;3170438;União de Minas;2;2;4;70
3170206;Uberlândia;3170438;União de Minas;2;2;4;228
2903201;Barreiras;3170404;Unaí;2;2;4;507
3104007;Araxá;3170404;Unaí;2;2;4;353
3108206;Bonfinópolis de Minas;3170404;Unaí;2;2;4;101
3148103;Patrocínio;3170404;Unaí;2;2;4;282
3151206;Pirapora;3170404;Unaí;2;2;4;238
1100189;Pimenta Bueno;3170206;Uberlândia;2;2;4;1561
1400100;Boa Vista;3170206;Uberlândia;2;2;4;2719
1500800;Ananindeua;3170206;Uberlândia;2;2;4;1939
1502707;Conceição do Araguaia;3170206;Uberlândia;2;2;4;1183
1600303;Macapá;3170206;Uberlândia;2;2;4;2119
1702109;Araguaína;3170206;Uberlândia;2;2;4;1295
1709500;Gurupi;3170206;Uberlândia;2;2;4;800
2109007;Porto Franco;3170206;Uberlândia;2;2;4;1391
2304285;Eusébio;3170206;Uberlândia;2;2;4;1940
2504009;Campina Grande;3170206;Uberlândia;2;2;4;1812
2609600;Olinda;3170206;Uberlândia;2;2;4;1828
2700300;Arapiraca;3170206;Uberlândia;2;2;4;1564
2804805;Nossa Senhora do Socorro;3170206;Uberlândia;2;2;4;1454
2910727;Eunápolis;3170206;Uberlândia;2;2;4;949
2930709;Simões Filho;3170206;Uberlândia;2;2;4;1227
3103751;Araporã;3170206;Uberlândia;2;2;4;110
3103900;Araújos;3170206;Uberlândia;2;2;4;345
3111408;Campo Florido;3170206;Uberlândia;2;2;4;100
3111507;Campos Altos;3170206;Uberlândia;2;2;4;238
3115805;Centralina;3170206;Uberlândia;2;2;4;107
3116902;Comendador Gomes;3170206;Uberlândia;2;2;4;123
3117306;Conceição das Alagoas;3170206;Uberlândia;2;2;4;113
3119807;Córrego Danta;3170206;Uberlândia;2;2;4;270
3121258;Delta;3170206;Uberlândia;2;2;4;125
3127701;Governador Valadares;3170206;Uberlândia;2;2;4;662
3129707;Ibiraci;3170206;Uberlândia;2;2;4;211
3131307;Ipatinga;3170206;Uberlândia;2;2;4;607
3131406;Ipiaçu;3170206;Uberlândia;2;2;4;178
3133402;Itapagipe;3170206;Uberlândia;2;2;4;162
3138203;Lavras;3170206;Uberlândia;2;2;4;432
3138807;Luz;3170206;Uberlândia;2;2;4;289
3139003;Machado;3170206;Uberlândia;2;2;4;396
3139706;Maravilhas;3170206;Uberlândia;2;2;4;385
3142403;Moema;3170206;Uberlândia;2;2;4;319
3145208;Nova Serrana;3170206;Uberlândia;2;2;4;363
3146909;Papagaios;3170206;Uberlândia;2;2;4;376
3149200;Pedrinópolis;3170206;Uberlândia;2;2;4;92
3149705;Perdigão;3170206;Uberlândia;2;2;4;356
3150703;Pirajuba;3170206;Uberlândia;2;2;4;120
3151602;Planura;3170206;Uberlândia;2;2;4;144
3155504;Rio Paranaíba;3170206;Uberlândia;2;2;4;215
3161304;São Francisco de Sales;3170206;Uberlândia;2;2;4;192
3169307;Três Corações;3170206;Uberlândia;2;2;4;445
2111300;São Luís;3170107;Uberaba;2;2;4;1940
2611606;Recife;3170107;Uberaba;2;2;4;1846
2927408;Salvador;3170107;Uberaba;2;2;4;1226
3104205;Arcos;3170107;Uberaba;2;2;4;257
3106705;Betim;3170107;Uberaba;2;2;4;392
3133402;Itapagipe;3170107;Uberaba;2;2;4;155
3134400;Iturama;3170107;Uberaba;2;2;4;239
3157708;Santa Juliana;3170107;Uberaba;2;2;4;63
3159803;Santa Vitória;3170107;Uberaba;2;2;4;251
3168705;Timóteo;3170107;Uberaba;2;2;4;553
3101508;Além Paraíba;3169901;Ubá;2;2;4;85
3101607;Alfenas;3169901;Ubá;2;2;4;311
3151305;Piraúba;3169901;Ubá;2;2;4;21
3109402;Buritizeiro;3169703;Turmalina;2;2;4;239
3112604;Capinópolis;3169604;Tupaciguara;2;2;4;92
3101607;Alfenas;3169406;Três Pontas;2;2;4;46
3139003;Machado;3169406;Três Pontas;2;2;4;54
3152501;Pouso Alegre;3169406;Três Pontas;2;2;4;104
3169307;Três Corações;3169406;Três Pontas;2;2;4;45
3119104;Corinto;3169356;Três Marias;2;2;4;86
3147006;Paracatu;3169356;Três Marias;2;2;4;207
3148004;Patos de Minas;3169356;Três Marias;2;2;4;140
3151206;Pirapora;3169356;Três Marias;2;2;4;103
3161700;São Gonçalo do Abaeté;3169356;Três Marias;2;2;4;64
3113909;Carmo da Cachoeira;3169307;Três Corações;2;2;4;23
3118601;Contagem;3169307;Três Corações;2;2;4;226
3123601;Elói Mendes;3169307;Três Corações;2;2;4;36
3126109;Formiga;3169307;Três Corações;2;2;4;134
3139003;Machado;3169307;Três Corações;2;2;4;72
3141900;Minduri;3169307;Três Corações;2;2;4;62
3151800;Poços de Caldas;3169307;Três Corações;2;2;4;137
3160801;São Bento Abade;3169307;Três Corações;2;2;4;18
3108305;Borda da Mata;3169059;Tocos do Moji;2;2;4;13
3151305;Piraúba;3169000;Tocantins;2;2;4;11
3139409;Manhuaçu;3168705;Timóteo;2;2;4;95
3140308;Marliéria;3168705;Timóteo;2;2;4;17
2304400;Fortaleza;3168606;Teófilo Otoni;2;2;4;1588
3112307;Capelinha;3168606;Teófilo Otoni;2;2;4;109
3131703;Itabira;3168606;Teófilo Otoni;2;2;4;269
3136009;Joaíma;3168606;Teófilo Otoni;2;2;4;140
3137007;Ladainha;3168606;Teófilo Otoni;2;2;4;35
3139409;Manhuaçu;3168606;Teófilo Otoni;2;2;4;270
3143302;Montes Claros;3168606;Teófilo Otoni;2;2;4;279
3145356;Novo Oriente de Minas;3168606;Teófilo Otoni;2;2;4;58
3152170;Ponto dos Volantes;3168606;Teófilo Otoni;2;2;4;122
3160306;Santo Antônio do Jacinto;3168606;Teófilo Otoni;2;2;4;203
3106200;Belo Horizonte;3168101;Tapira;2;2;4;298
3155801;Rio Pomba;3167905;Tabuleiro;2;2;4;12
3123700;Engenheiro Caldas;3167707;Sobrália;2;2;4;8
3152501;Pouso Alegre;3167400;Silvianópolis;2;2;4;24
3100203;Abaeté;3167202;Sete Lagoas;2;2;4;132
3121605;Diamantina;3167202;Sete Lagoas;2;2;4;150
3126406;Fortuna de Minas;3167202;Sete Lagoas;2;2;4;28
3130101;Igarapé;3167202;Sete Lagoas;2;2;4;71
3135704;Jequitibá;3167202;Sete Lagoas;2;2;4;31
3136959;Juvenília;3167202;Sete Lagoas;2;2;4;573
3147006;Paracatu;3167202;Sete Lagoas;2;2;4;372
3147105;Pará de Minas;3167202;Sete Lagoas;2;2;4;61
3152006;Pompéu;3167202;Sete Lagoas;2;2;4;77
3153608;Prudente de Morais;3167202;Sete Lagoas;2;2;4;10
3128006;Guanhães;3167103;Serro;2;2;4;49
3166402;Seritinga;3167004;Serranos;2;2;4;5
3139003;Machado;3166907;Serrania;2;2;4;19
3104007;Araxá;3166808;Serra do Salitre;2;2;4;59
3148004;Patos de Minas;3166808;Serra do Salitre;2;2;4;62
3102803;Andrelândia;3166402;Seritinga;2;2;4;28
3151800;Poços de Caldas;3165578;Senador Amaral;2;2;4;98
3145307;Novo Cruzeiro;3165552;Setubinha;2;2;4;51
3139102;Madre de Deus de Minas;3165305;São Vicente de Minas;2;2;4;28
3141900;Minduri;3165305;São Vicente de Minas;2;2;4;17
3120805;Cruzília;3165206;São Thomé das Letras;2;2;4;22
3152709;Prados;3165008;São Tiago;2;2;4;47
3156106;Ritápolis;3165008;São Tiago;2;2;4;23
2304400;Fortaleza;3164704;São Sebastião do Paraíso;2;2;4;2078
3104007;Araxá;3164704;São Sebastião do Paraíso;2;2;4;148
3114402;Carmo do Rio Claro;3164704;São Sebastião do Paraíso;2;2;4;90
3126109;Formiga;3164704;São Sebastião do Paraíso;2;2;4;170
3151503;Piumhi;3164704;São Sebastião do Paraíso;2;2;4;118
3152907;Pratápolis;3164704;São Sebastião do Paraíso;2;2;4;24
3133501;Itapecerica;3164605;São Sebastião do Oeste;2;2;4;25
3158003;Santa Maria de Itabira;3164506;São Sebastião do Maranhão;2;2;4;162
3121209;Delfinópolis;3164308;São Roque de Minas;2;2;4;52
3141306;Medeiros;3164308;São Roque de Minas;2;2;4;31
3151503;Piumhi;3164308;São Roque de Minas;2;2;4;49
3153004;Pratinha;3164308;São Roque de Minas;2;2;4;55
3106200;Belo Horizonte;3164209;São Romão;2;2;4;410
3101607;Alfenas;3163706;São Lourenço;2;2;4;125
3106200;Belo Horizonte;3163508;São José do Jacuri;2;2;4;227
3116803;Coluna;3163508;São José do Jacuri;2;2;4;19
3139904;Maria da Fé;3163201;São José do Alegre;2;2;4;16
3118601;Contagem;3162955;São José da Lapa;2;2;4;28
3115300;Cataguases;3162906;São João Nepomuceno;2;2;4;39
3121308;Descoberto;3162906;São João Nepomuceno;2;2;4;10
3106200;Belo Horizonte;3162807;São João Evangelista;2;2;4;198
3101607;Alfenas;3162500;São João del Rei;2;2;4;176
3119708;Coronel Xavier Chaves;3162500;São João del Rei;2;2;4;14
3122306;Divinópolis;3162500;São João del Rei;2;2;4;123
3139102;Madre de Deus de Minas;3162500;São João del Rei;2;2;4;39
3145604;Oliveira;3162500;São João del Rei;2;2;4;76
3154200;Resende Costa;3162500;São João del Rei;2;2;4;24
3132107;Itacarambi;3162450;São João das Missões;2;2;4;25
3139300;Manga;3162450;São João das Missões;2;2;4;25
3106200;Belo Horizonte;3162401;São João da Ponte;2;2;4;439
3135100;Janaúba;3162401;São João da Ponte;2;2;4;74
3138658;Lontra;3162401;São João da Ponte;2;2;4;31
3143302;Montes Claros;3162401;São João da Ponte;2;2;4;89
3114303;Carmo do Paranaíba;3162104;São Gotardo;2;2;4;46
3157708;Santa Juliana;3162104;São Gotardo;2;2;4;155
3110509;Camanducaia;3162005;São Gonçalo do Sapucaí;2;2;4;111
3115508;Caxambu;3162005;São Gonçalo do Sapucaí;2;2;4;64
3119005;Cordislândia;3162005;São Gonçalo do Sapucaí;2;2;4;15
3123601;Elói Mendes;3162005;São Gonçalo do Sapucaí;2;2;4;31
3137809;Lambari;3162005;São Gonçalo do Sapucaí;2;2;4;23
3144409;Natércia;3162005;São Gonçalo do Sapucaí;2;2;4;27
3105400;Barão de Cocais;3161908;São Gonçalo do Rio Abaixo;2;2;4;20
3144805;Nova Lima;3161908;São Gonçalo do Rio Abaixo;2;2;4;56
3133808;Itaúna;3161809;São Gonçalo do Pará;2;2;4;31
3145208;Nova Serrana;3161809;São Gonçalo do Pará;2;2;4;18
3106200;Belo Horizonte;3161700;São Gonçalo do Abaeté;2;2;4;262
3118601;Contagem;3161700;São Gonçalo do Abaeté;2;2;4;255
3127305;Galiléia;3161650;São Geraldo do Baixio;2;2;4;22
3143906;Muriaé;3161403;São Francisco do Glória;2;2;4;32
3111101;Campina Verde;3161304;São Francisco de Sales;2;2;4;48
3138625;Limeira do Oeste;3161304;São Francisco de Sales;2;2;4;91
3112000;Candeias;3161205;São Francisco de Paula;2;2;4;31
3106200;Belo Horizonte;3161106;São Francisco;2;2;4;444
3138682;Luislândia;3161106;São Francisco;2;2;4;30
3113404;Caratinga;3160959;São Domingos das Dores;2;2;4;36
3123908;Entre Rios de Minas;3160900;São Brás do Suaçuí;2;2;4;11
3104205;Arcos;3160405;Santo Antônio do Monte;2;2;4;35
3107406;Bom Despacho;3160405;Santo Antônio do Monte;2;2;4;40
3101706;Almenara;3160306;Santo Antônio do Jacinto;2;2;4;72
3106200;Belo Horizonte;3159803;Santa Vitória;2;2;4;660
3111101;Campina Verde;3159803;Santa Vitória;2;2;4;100
3106200;Belo Horizonte;3159704;Santa Rosa da Serra;2;2;4;213
1302603;Manaus;3159605;Santa Rita do Sapucaí;2;2;4;2547
2611606;Recife;3159605;Santa Rita do Sapucaí;2;2;4;1895
3106309;Belo Oriente;3158953;Santana do Paraíso;2;2;4;18
3143906;Muriaé;3158409;Santana de Cataguases;2;2;4;33
3127701;Governador Valadares;3157807;Santa Luzia;2;2;4;222
3129806;Ibirité;3157807;Santa Luzia;2;2;4;35
3139409;Manhuaçu;3157807;Santa Luzia;2;2;4;194
3144805;Nova Lima;3157807;Santa Luzia;2;2;4;28
3110004;Caeté;3157203;Santa Bárbara;2;2;4;28
3135506;Jequeri;3157203;Santa Bárbara;2;2;4;96
3101706;Almenara;3157005;Salinas;2;2;4;168
3130655;Indaiabira;3157005;Salinas;2;2;4;77
3133303;Itaobim;3157005;Salinas;2;2;4;88
3135100;Janaúba;3157005;Salinas;2;2;4;120
3141801;Minas Novas;3157005;Salinas;2;2;4;119
3145000;Nova Ponte;3156908;Sacramento;2;2;4;84
3148004;Patos de Minas;3156908;Sacramento;2;2;4;172
3106705;Betim;3156700;Sabará;2;2;4;40
3136702;Juiz de Fora;3156205;Rochedo de Minas;2;2;4;35
3106200;Belo Horizonte;3155801;Rio Pomba;2;2;4;173
3128402;Guarani;3155801;Rio Pomba;2;2;4;16
3106200;Belo Horizonte;3155603;Rio Pardo de Minas;2;2;4;500
3142908;Monte Azul;3155603;Rio Pardo de Minas;2;2;4;62
3119609;Coronel Pacheco;3155405;Rio Novo;2;2;4;21
3106200;Belo Horizonte;3155306;Rio Manso;2;2;4;53
3112208;Capela Nova;3155207;Rio Espera;2;2;4;17
3127701;Governador Valadares;3155108;Rio do Prado;2;2;4;287
2933307;Vitória da Conquista;3154606;Ribeirão das Neves;2;2;4;638
3118304;Conselheiro Lafaiete;3154606;Ribeirão das Neves;2;2;4;103
3136702;Juiz de Fora;3154606;Ribeirão das Neves;2;2;4;234
3106200;Belo Horizonte;3154507;Riacho dos Machados;2;2;4;443
3107307;Bocaiúva;3154507;Riacho dos Machados;2;2;4;150
3105608;Barbacena;3154408;Ressaquinha;2;2;4;16
3106200;Belo Horizonte;3154408;Ressaquinha;2;2;4;131
3106200;Belo Horizonte;3154200;Resende Costa;2;2;4;116
3151107;Pirapetinga;3154101;Recreio;2;2;4;19
3113404;Caratinga;3154002;Raul Soares;2;2;4;40
3135506;Jequeri;3154002;Raul Soares;2;2;4;47
3141108;Matozinhos;3153608;Prudente de Morais;2;2;4;11
3147402;Paraopeba;3153608;Prudente de Morais;2;2;4;35
3137502;Lagoa Formosa;3153400;Presidente Olegário;2;2;4;40
3137536;Lagoa Grande;3153400;Presidente Olegário;2;2;4;65
3119708;Coronel Xavier Chaves;3152709;Prados;2;2;4;15
3133006;Itamonte;3152600;Pouso Alto;2;2;4;15
3147600;Passa Quatro;3152600;Pouso Alto;2;2;4;22
3108008;Bom Sucesso;3152501;Pouso Alegre;2;2;4;179
3126109;Formiga;3152501;Pouso Alegre;2;2;4;201
3127701;Governador Valadares;3152501;Pouso Alegre;2;2;4;553
3128709;Guaxupé;3152501;Pouso Alegre;2;2;4;128
3130606;Inconfidentes;3152501;Pouso Alegre;2;2;4;41
3131505;Ipuiúna;3152501;Pouso Alegre;2;2;4;28
3143401;Monte Sião;3152501;Pouso Alegre;2;2;4;69
3147105;Pará de Minas;3152501;Pouso Alegre;2;2;4;295
3147303;Paraisópolis;3152501;Pouso Alegre;2;2;4;41
3135050;Jaíba;3152204;Porteirinha;2;2;4;88
3142908;Monte Azul;3152204;Porteirinha;2;2;4;67
3146552;Pai Pedro;3152204;Porteirinha;2;2;4;25
3106200;Belo Horizonte;3152170;Ponto dos Volantes;2;2;4;438
2933307;Vitória da Conquista;3152105;Ponte Nova;2;2;4;649
3100302;Abre Campo;3152105;Ponte Nova;2;2;4;46
3113404;Caratinga;3152105;Ponte Nova;2;2;4;99
3146107;Ouro Preto;3152105;Ponte Nova;2;2;4;66
3123205;Dores do Indaiá;3152006;Pompéu;2;2;4;75
2111300;São Luís;3151800;Poços de Caldas;2;2;4;2140
2602902;Cabo de Santo Agostinho;3151800;Poços de Caldas;2;2;4;1885
3138203;Lavras;3151800;Poços de Caldas;2;2;4;170
3146008;Ouro Fino;3151800;Poços de Caldas;2;2;4;60
3119955;Córrego Fundo;3151503;Piumhi;2;2;4;42
3137205;Lagoa da Prata;3151503;Piumhi;2;2;4;67
3120904;Curvelo;3151404;Pitangui;2;2;4;107
3138302;Leandro Ferreira;3151404;Pitangui;2;2;4;17
3145208;Nova Serrana;3151404;Pitangui;2;2;4;27
3104601;Astolfo Dutra;3151305;Piraúba;2;2;4;16
3119104;Corinto;3151206;Pirapora;2;2;4;126
3128006;Guanhães;3151206;Pirapora;2;2;4;263
3101508;Além Paraíba;3151107;Pirapetinga;2;2;4;42
3106200;Belo Horizonte;3151107;Pirapetinga;2;2;4;257
3106200;Belo Horizonte;3150802;Piranga;2;2;4;112
2702306;Coruripe;3150703;Pirajuba;2;2;4;1676
3132206;Itaguara;3150604;Piracema;2;2;4;13
3108107;Bonfim;3150406;Piedade dos Gerais;2;2;4;16
3102803;Andrelândia;3150307;Piedade do Rio Grande;2;2;4;32
3139102;Madre de Deus de Minas;3150307;Piedade do Rio Grande;2;2;4;14
3127701;Governador Valadares;3150000;Pescador;2;2;4;65
3106200;Belo Horizonte;3149903;Perdões;2;2;4;175
3107109;Boa Esperança;3149903;Perdões;2;2;4;48
3144607;Nepomuceno;3149903;Perdões;2;2;4;22
3148004;Patos de Minas;3149804;Perdizes;2;2;4;119
3103900;Araújos;3149705;Perdigão;2;2;4;11
3122306;Divinópolis;3149705;Perdigão;2;2;4;31
3139805;Mar de Espanha;3149507;Pequeri;2;2;4;12
3136702;Juiz de Fora;3149408;Pedro Teixeira;2;2;4;43
2607307;Ipubi;3149309;Pedro Leopoldo;2;2;4;1382
3130408;Ijaci;3149309;Pedro Leopoldo;2;2;4;195
3134608;Jaboticatubas;3149309;Pedro Leopoldo;2;2;4;35
3101706;Almenara;3148707;Pedra Azul;2;2;4;62
3117009;Comercinho;3148707;Pedra Azul;2;2;4;60
3122355;Divisa Alegre;3148707;Pedra Azul;2;2;4;36
3141405;Medina;3148707;Pedra Azul;2;2;4;30
3112059;Cantagalo;3148608;Peçanha;2;2;4;10
3143906;Muriaé;3148202;Patrocínio do Muriaé;2;2;4;16
3129509;Ibiá;3148103;Patrocínio;2;2;4;72
3139409;Manhuaçu;3148103;Patrocínio;2;2;4;539
3147006;Paracatu;3148103;Patrocínio;2;2;4;190
2900702;Alagoinhas;3148004;Patos de Minas;2;2;4;1101
2910727;Eunápolis;3148004;Patos de Minas;2;2;4;765
3133808;Itaúna;3148004;Patos de Minas;2;2;4;264
3104007;Araxá;3147907;Passos;2;2;4;128
3111200;Campo Belo;3147907;Passos;2;2;4;143
3114402;Carmo do Rio Claro;3147907;Passos;2;2;4;61
3129707;Ibiraci;3147907;Passos;2;2;4;58
3125705;Felixlândia;3147402;Paraopeba;2;2;4;77
3138302;Leandro Ferreira;3147402;Paraopeba;2;2;4;83
3127404;Gonçalves;3147303;Paraisópolis;2;2;4;14
3104007;Araxá;3147105;Pará de Minas;2;2;4;246
3111507;Campos Altos;3147105;Pará de Minas;2;2;4;164
3137205;Lagoa da Prata;3147105;Pará de Minas;2;2;4;98
3139706;Maravilhas;3147105;Pará de Minas;2;2;4;38
3145802;Onça de Pitangui;3147105;Pará de Minas;2;2;4;24
3100203;Abaeté;3147006;Paracatu;2;2;4;264
3120904;Curvelo;3147006;Paracatu;2;2;4;311
3128600;Guarda-Mor;3147006;Paracatu;2;2;4;63
3120904;Curvelo;3146909;Papagaios;2;2;4;81
3106200;Belo Horizonte;3146701;Palma;2;2;4;237
3138401;Leopoldina;3146701;Palma;2;2;4;43
3145703;Oliveira Fortes;3146602;Paiva;2;2;4;7
3104700;Ataléia;3146206;Ouro Verde de Minas;2;2;4;17
2906501;Candeias;3146107;Ouro Preto;2;2;4;994
3105400;Barão de Cocais;3146107;Ouro Preto;2;2;4;49
3118007;Congonhas;3146107;Ouro Preto;2;2;4;38
3131703;Itabira;3146107;Ouro Preto;2;2;4;88
3106200;Belo Horizonte;3146008;Ouro Fino;2;2;4;360
3125101;Extrema;3146008;Ouro Fino;2;2;4;64
3130606;Inconfidentes;3146008;Ouro Fino;2;2;4;6
3118601;Contagem;3145901;Ouro Branco;2;2;4;78
3140001;Mariana;3145901;Ouro Branco;2;2;4;33
3122009;Divino;3145877;Orizânia;2;2;4;14
3107406;Bom Despacho;3145604;Oliveira;2;2;4;115
3108008;Bom Sucesso;3145604;Oliveira;2;2;4;39
3133501;Itapecerica;3145604;Oliveira;2;2;4;37
3137205;Lagoa da Prata;3145604;Oliveira;2;2;4;103
3145208;Nova Serrana;3145604;Oliveira;2;2;4;92
3137809;Lambari;3145505;Olímpio Noronha;2;2;4;16
3143302;Montes Claros;3145455;Olhos-d'Água;2;2;4;80
3106200;Belo Horizonte;3145372;Novorizonte;2;2;4;462
3103405;Araçuaí;3145307;Novo Cruzeiro;2;2;4;66
3130200;Igaratinga;3145208;Nova Serrana;2;2;4;30
3136900;Juruaia;3145109;Nova Resende;2;2;4;22
3144102;Muzambinho;3145109;Nova Resende;2;2;4;30
3106200;Belo Horizonte;3145059;Nova Porteirinha;2;2;4;459
3103504;Araguari;3145000;Nova Ponte;2;2;4;78
3104007;Araxá;3145000;Nova Ponte;2;2;4;92
3130705;Indianópolis;3145000;Nova Ponte;2;2;4;27
3131604;Iraí de Minas;3145000;Nova Ponte;2;2;4;29
3127701;Governador Valadares;3144904;Nova Módica;2;2;4;66
1501402;Belém;3144805;Nova Lima;2;2;4;2113
2304400;Fortaleza;3144805;Nova Lima;2;2;4;1876
2930709;Simões Filho;3144805;Nova Lima;2;2;4;977
3118007;Congonhas;3144805;Nova Lima;2;2;4;53
3106002;Bela Vista de Minas;3144706;Nova Era;2;2;4;9
3106705;Betim;3144706;Nova Era;2;2;4;122
3106200;Belo Horizonte;3144656;Ninheira;2;2;4;562
3108008;Bom Sucesso;3144607;Nepomuceno;2;2;4;55
2923001;Nova Viçosa;3144300;Nanuque;2;2;4;91
3100906;Águas Formosas;3144300;Nanuque;2;2;4;107
3143005;Monte Belo;3144102;Muzambinho;2;2;4;17
3101102;Aimorés;3144003;Mutum;2;2;4;49
3122009;Divino;3143906;Muriaé;2;2;4;54
3124203;Espera Feliz;3143906;Muriaé;2;2;4;65
3127701;Governador Valadares;3143906;Muriaé;2;2;4;253
3136207;João Monlevade;3143906;Muriaé;2;2;4;164
3100203;Abaeté;3143500;Morada Nova de Minas;2;2;4;64
3109402;Buritizeiro;3143500;Morada Nova de Minas;2;2;4;141
3112703;Capitão Enéas;3143302;Montes Claros;2;2;4;50
3126604;Francisco Dumont;3143302;Montes Claros;2;2;4;75
3130051;Icaraí de Minas;3143302;Montes Claros;2;2;4;124
3132008;Itacambira;3143302;Montes Claros;2;2;4;71
3133808;Itaúna;3143302;Montes Claros;2;2;4;381
3136306;João Pinheiro;3143302;Montes Claros;2;2;4;274
3136801;Juramento;3143302;Montes Claros;2;2;4;33
3142908;Monte Azul;3143302;Montes Claros;2;2;4;205
3107406;Bom Despacho;3143104;Monte Carmelo;2;2;4;262
3124807;Estrela do Sul;3143104;Monte Carmelo;2;2;4;20
3130705;Indianópolis;3143104;Monte Carmelo;2;2;4;56
3134400;Iturama;3143104;Monte Carmelo;2;2;4;306
3136306;João Pinheiro;3143104;Monte Carmelo;2;2;4;174
3136900;Juruaia;3143005;Monte Belo;2;2;4;23
3135100;Janaúba;3142908;Monte Azul;2;2;4;87
3139300;Manga;3142700;Montalvânia;2;2;4;60
3131307;Ipatinga;3141702;Mesquita;2;2;4;28
3136108;Joanésia;3141702;Mesquita;2;2;4;9
3131802;Itabirinha de Mantena;3141504;Mendes Pimentel;2;2;4;21
2901205;Anagé;3141405;Medina;2;2;4;176
3102704;Cachoeira de Pajeú;3141405;Medina;2;2;4;28
3103405;Araçuaí;3141405;Medina;2;2;4;92
3117009;Comercinho;3141405;Medina;2;2;4;31
3105103;Bambuí;3141306;Medeiros;2;2;4;25
3106200;Belo Horizonte;3140902;Matipó;2;2;4;176
3112901;Caputira;3140902;Matipó;2;2;4;14
3105608;Barbacena;3140803;Matias Barbosa;2;2;4;89
3118304;Conselheiro Lafaiete;3140803;Matias Barbosa;2;2;4;144
3118601;Contagem;3140704;Mateus Leme;2;2;4;37
3126000;Florestal;3140704;Mateus Leme;2;2;4;11
3137700;Lajinha;3140530;Martins Soares;2;2;4;28
3139409;Manhuaçu;3140530;Martins Soares;2;2;4;20
3100203;Abaeté;3140506;Martinho Campos;2;2;4;31
3120904;Curvelo;3140506;Martinho Campos;2;2;4;102
3106200;Belo Horizonte;3140159;Mário Campos;2;2;4;28
3129806;Ibirité;3140159;Mário Campos;2;2;4;14
3127701;Governador Valadares;3140100;Marilac;2;2;4;35
3102308;Alvinópolis;3140001;Mariana;2;2;4;48
3131703;Itabira;3140001;Mariana;2;2;4;84
3135506;Jequeri;3140001;Mariana;2;2;4;78
3106200;Belo Horizonte;3139904;Maria da Fé;2;2;4;302
3106200;Belo Horizonte;3139607;Mantena;2;2;4;334
2304285;Eusébio;3139409;Manhuaçu;2;2;4;1844
3101102;Aimorés;3139409;Manhuaçu;2;2;4;130
3131307;Ipatinga;3139409;Manhuaçu;2;2;4;99
3136702;Juiz de Fora;3139409;Manhuaçu;2;2;4;215
3135050;Jaíba;3139300;Manga;2;2;4;66
3135100;Janaúba;3139300;Manga;2;2;4;132
3106200;Belo Horizonte;3139201;Malacacheta;2;2;4;305
3105608;Barbacena;3139102;Madre de Deus de Minas;2;2;4;63
3106705;Betim;3139003;Machado;2;2;4;260
3123205;Dores do Indaiá;3138807;Luz;2;2;4;38
3104908;Baependi;3138708;Luminárias;2;2;4;49
3106804;Bias Fortes;3138609;Lima Duarte;2;2;4;27
3107208;Bocaina de Minas;3138500;Liberdade;2;2;4;17
3136702;Juiz de Fora;3138500;Liberdade;2;2;4;106
3138005;Laranjal;3138401;Leopoldina;2;2;4;28
3113909;Carmo da Cachoeira;3138203;Lavras;2;2;4;34
3114600;Carrancas;3138203;Lavras;2;2;4;47
3123601;Elói Mendes;3138203;Lavras;2;2;4;72
3106200;Belo Horizonte;3138104;Lassance;2;2;4;233
3106200;Belo Horizonte;3137809;Lambari;2;2;4;268
3107406;Bom Despacho;3137809;Lambari;2;2;4;246
3129202;Heliodora;3137809;Lambari;2;2;4;22
1505536;Parauapebas;3137601;Lagoa Santa;2;2;4;1624
3106200;Belo Horizonte;3137304;Lagoa dos Patos;2;2;4;329
3111200;Campo Belo;3137205;Lagoa da Prata;2;2;4;101
3126109;Formiga;3137205;Lagoa da Prata;2;2;4;51
3106200;Belo Horizonte;3137007;Ladainha;2;2;4;347
3100302;Abre Campo;3136702;Juiz de Fora;2;2;4;184
3102803;Andrelândia;3136702;Juiz de Fora;2;2;4;104
3105905;Barroso;3136702;Juiz de Fora;2;2;4;91
3115904;Chácara;3136702;Juiz de Fora;2;2;4;15
3119609;Coronel Pacheco;3136702;Juiz de Fora;2;2;4;20
3125002;Ewbank da Câmara;3136702;Juiz de Fora;2;2;4;31
3131703;Itabira;3136702;Juiz de Fora;2;2;4;235
3135506;Jequeri;3136702;Juiz de Fora;2;2;4;159
3136207;João Monlevade;3136702;Juiz de Fora;2;2;4;216
3122306;Divinópolis;3136652;Juatuba;2;2;4;61
3130101;Igarapé;3136652;Juatuba;2;2;4;13
3106200;Belo Horizonte;3136603;Nova União;2;2;4;48
3110004;Caeté;3136603;Nova União;2;2;4;23
3101706;Almenara;3136504;Jordânia;2;2;4;64
3106200;Belo Horizonte;3136405;Joaquim Felício;2;2;4;238
3110004;Caeté;3136207;João Monlevade;2;2;4;53
3118304;Conselheiro Lafaiete;3136207;João Monlevade;2;2;4;116
3127701;Governador Valadares;3136207;João Monlevade;2;2;4;167
3106309;Belo Oriente;3136108;Joanésia;2;2;4;21
3133303;Itaobim;3135803;Jequitinhonha;2;2;4;61
3124104;Esmeraldas;3135605;Jequitaí;2;2;4;285
3100302;Abre Campo;3135506;Jequeri;2;2;4;26
3118007;Congonhas;3135407;Jeceaba;2;2;4;11
3118601;Contagem;3135407;Jeceaba;2;2;4;69
3108602;Brasília de Minas;3135209;Januária;2;2;4;82
3109402;Buritizeiro;3135209;Januária;2;2;4;220
3135050;Jaíba;3135209;Januária;2;2;4;74
1700301;Aguiarnópolis;3135100;Janaúba;2;2;4;1110
3102605;Andradas;3134905;Jacutinga;2;2;4;25
3101706;Almenara;3134707;Jacinto;2;2;4;46
3118601;Contagem;3134608;Jaboticatubas;2;2;4;57
3134301;Itumirim;3134509;Itutinga;2;2;4;22
3106200;Belo Horizonte;3134400;Iturama;2;2;4;652
3111408;Campo Florido;3134400;Iturama;2;2;4;170
3104007;Araxá;3134202;Ituiutaba;2;2;4;274
3131406;Ipiaçu;3134202;Ituiutaba;2;2;4;59
3103405;Araçuaí;3134004;Itinga;2;2;4;42
3118007;Congonhas;3133808;Itaúna;2;2;4;85
3114402;Carmo do Rio Claro;3133758;Itaú de Minas;2;2;4;74
3130101;Igarapé;3133709;Itatiaiuçu;2;2;4;17
3132206;Itaguara;3133709;Itatiaiuçu;2;2;4;23
3104205;Arcos;3133501;Itapecerica;2;2;4;48
3106200;Belo Horizonte;3133501;Itapecerica;2;2;4;135
3111101;Campina Verde;3133402;Itapagipe;2;2;4;45
3106200;Belo Horizonte;3133303;Itaobim;2;2;4;452
3110905;Campanha;3133105;Itanhandu;2;2;4;70
3115508;Caxambu;3133105;Itanhandu;2;2;4;39
3121100;Delfim Moreira;3133105;Itanhandu;2;2;4;43
3132404;Itajubá;3133105;Itanhandu;2;2;4;57
3101300;Alagoa;3133006;Itamonte;2;2;4;27
3131703;Itabira;3132800;Itambé do Mato Dentro;2;2;4;25
3113503;Carbonita;3132503;Itamarandiba;2;2;4;40
3120508;Cristina;3132404;Itajubá;2;2;4;31
3125101;Extrema;3132404;Itajubá;2;2;4;100
3106200;Belo Horizonte;3132206;Itaguara;2;2;4;76
3106200;Belo Horizonte;3132008;Itacambira;2;2;4;322
2304400;Fortaleza;3131901;Itabirito;2;2;4;1904
3118007;Congonhas;3131901;Itabirito;2;2;4;24
2611606;Recife;3131703;Itabira;2;2;4;1530
3115359;Catas Altas;3131703;Itabira;2;2;4;52
3118304;Conselheiro Lafaiete;3131703;Itabira;2;2;4;129
3118601;Contagem;3131703;Itabira;2;2;4;94
3127701;Governador Valadares;3131703;Itabira;2;2;4;160
3112604;Capinópolis;3131406;Ipiaçu;2;2;4;39
2304400;Fortaleza;3131307;Ipatinga;2;2;4;1784
3129301;Iapu;3131307;Ipatinga;2;2;4;34
3113404;Caratinga;3131208;Ipanema;2;2;4;52
3113404;Caratinga;3131158;Ipaba;2;2;4;49
3106200;Belo Horizonte;3131000;Inhaúma;2;2;4;63
3106200;Belo Horizonte;3130903;Inhapim;2;2;4;198
3106200;Belo Horizonte;3130200;Igaratinga;2;2;4;77
3104007;Araxá;3130101;Igarapé;2;2;4;279
3115102;Cássia;3129707;Ibiraci;2;2;4;24
3118601;Contagem;3129509;Ibiá;2;2;4;263
3102605;Andradas;3128709;Guaxupé;2;2;4;86
3106903;Bicas;3128501;Guarará;2;2;4;3
3104106;Arceburgo;3128303;Guaranésia;2;2;4;16
3123601;Elói Mendes;3128105;Guapé;2;2;4;101
3113404;Caratinga;3128006;Guanhães;2;2;4;141
3121605;Diamantina;3128006;Guanhães;2;2;4;93
3122603;Dom Joaquim;3128006;Guanhães;2;2;4;43
1505536;Parauapebas;3127701;Governador Valadares;2;2;4;1630
2304400;Fortaleza;3127701;Governador Valadares;2;2;4;1701
2611606;Recife;3127701;Governador Valadares;2;2;4;1387
3101102;Aimorés;3127701;Governador Valadares;2;2;4;122
3101508;Além Paraíba;3127701;Governador Valadares;2;2;4;342
3101805;Alpercata;3127701;Governador Valadares;2;2;4;18
3112653;Capitão Andrade;3127701;Governador Valadares;2;2;4;31
3113701;Carlos Chagas;3127701;Governador Valadares;2;2;4;175
3119203;Coroaci;3127701;Governador Valadares;2;2;4;38
3122504;Dom Cavati;3127701;Governador Valadares;2;2;4;64
3125804;Fernandes Tourinho;3127701;Governador Valadares;2;2;4;39
3127305;Galiléia;3127701;Governador Valadares;2;2;4;51
3118106;Congonhas do Norte;3127602;Gouveia;2;2;4;42
3122207;Divinolândia de Minas;3127503;Gonzaga;2;2;4;11
3119609;Coronel Pacheco;3127388;Goianá;2;2;4;9
3118403;Conselheiro Pena;3127370;Goiabeira;2;2;4;36
3116902;Comendador Gomes;3127107;Frutal;2;2;4;47
3106200;Belo Horizonte;3126208;Formoso;2;2;4;601
3118601;Contagem;3126109;Formiga;2;2;4;152
3106200;Belo Horizonte;3126000;Florestal;2;2;4;48
3113305;Carangola;3125952;Fervedouro;2;2;4;27
3106200;Belo Horizonte;3125903;Ferros;2;2;4;125
3121605;Diamantina;3125507;São Gonçalo do Rio Preto;2;2;4;33
3110707;Cambuquira;3125101;Extrema;2;2;4;153
3124500;Estiva;3125101;Extrema;2;2;4;53
3109402;Buritizeiro;3124807;Estrela do Sul;2;2;4;324
3106200;Belo Horizonte;3124708;Estrela do Indaiá;2;2;4;195
3107901;Bom Repouso;3124500;Estiva;2;2;4;13
3110608;Cambuí;3124500;Estiva;2;2;4;18
3102050;Alto Caparaó;3124203;Espera Feliz;2;2;4;24
3122009;Divino;3124203;Espera Feliz;2;2;4;26
3116704;Coimbra;3124005;Ervália;2;2;4;15
3118304;Conselheiro Lafaiete;3123908;Entre Rios de Minas;2;2;4;25
3107307;Bocaiúva;3123809;Engenheiro Navarro;2;2;4;21
3113404;Caratinga;3123700;Engenheiro Caldas;2;2;4;68
3102605;Andradas;3123601;Elói Mendes;2;2;4;116
3108404;Botelhos;3123601;Elói Mendes;2;2;4;86
3111002;Campestre;3123601;Elói Mendes;2;2;4;71
3114402;Carmo do Rio Claro;3123601;Elói Mendes;2;2;4;91
3117702;Conceição do Rio Verde;3123601;Elói Mendes;2;2;4;58
3119302;Coromandel;3123502;Douradoquara;2;2;4;43
3106200;Belo Horizonte;3122702;Dom Silvério;2;2;4;110
3106200;Belo Horizonte;3122504;Dom Cavati;2;2;4;206
3113404;Caratinga;3122504;Dom Cavati;2;2;4;49
3108552;Brasilândia de Minas;3122470;Dom Bosco;2;2;4;49
3104304;Areado;3122405;Divisa Nova;2;2;4;18
2927408;Salvador;3122306;Divinópolis;2;2;4;1030
3100203;Abaeté;3122306;Divinópolis;2;2;4;127
3106200;Belo Horizonte;3121803;Dionísio;2;2;4;126
3107307;Bocaiúva;3121605;Diamantina;2;2;4;122
3100203;Abaeté;3120904;Curvelo;2;2;4;111
3102308;Alvinópolis;3120904;Curvelo;2;2;4;212
3101003;Águas Vermelhas;3120870;Curral de Dentro;2;2;4;47
3118403;Conselheiro Pena;3120839;Cuparaque;2;2;4;47
3104908;Baependi;3120805;Cruzília;2;2;4;14
3106200;Belo Horizonte;3120409;Cristiano Otoni;2;2;4;105
3112000;Candeias;3120201;Cristais;2;2;4;28
3110608;Cambuí;3119906;Córrego do Bom Jesus;2;2;4;6
3104007;Araxá;3119807;Córrego Danta;2;2;4;112
3104007;Araxá;3119302;Coromandel;2;2;4;127
3106200;Belo Horizonte;3118908;Cordisburgo;2;2;4;94
1501303;Barcarena;3118601;Contagem;2;2;4;2087
2211001;Teresina;3118601;Contagem;2;2;4;1645
2604106;Caruaru;3118601;Contagem;2;2;4;1528
2607901;Jaboatão dos Guararapes;3118601;Contagem;2;2;4;1598
2704302;Maceió;3118601;Contagem;2;2;4;1420
2800308;Aracaju;3118601;Contagem;2;2;4;1229
2803609;Laranjeiras;3118601;Contagem;2;2;4;1232
2804805;Nossa Senhora do Socorro;3118601;Contagem;2;2;4;1229
2904605;Brumado;3118601;Contagem;2;2;4;680
2913606;Ilhéus;3118601;Contagem;2;2;4;764
2919207;Lauro de Freitas;3118601;Contagem;2;2;4;978
2931350;Teixeira de Freitas;3118601;Contagem;2;2;4;524
3101508;Além Paraíba;3118601;Contagem;2;2;4;255
3105004;Baldim;3118601;Contagem;2;2;4;71
3113404;Caratinga;3118601;Contagem;2;2;4;197
3111200;Campo Belo;3118304;Conselheiro Lafaiete;2;2;4;153
3105608;Barbacena;3118007;Congonhas;2;2;4;79
3106408;Belo Vale;3118007;Congonhas;2;2;4;17
3109709;Cachoeira de Minas;3117801;Conceição dos Ouros;2;2;4;7
3114105;Carmo de Minas;3117702;Conceição do Rio Verde;2;2;4;27
3106200;Belo Horizonte;3117306;Conceição das Alagoas;2;2;4;462
3104007;Araxá;3116605;Cláudio;2;2;4;246
3106200;Belo Horizonte;3115805;Centralina;2;2;4;575
3101201;Aiuruoca;3115508;Caxambu;2;2;4;38
3105608;Barbacena;3115508;Caxambu;2;2;4;147
3112406;Capetinga;3115102;Cássia;2;2;4;14
3107505;Bom Jardim de Minas;3114808;Carvalhos;2;2;4;29
3107406;Bom Despacho;3114501;Carmópolis de Minas;2;2;4;111
3101607;Alfenas;3114402;Carmo do Rio Claro;2;2;4;50
3102001;Alterosa;3114402;Carmo do Rio Claro;2;2;4;30
3104007;Araxá;3114303;Carmo do Paranaíba;2;2;4;89
3108008;Bom Sucesso;3114006;Carmo da Mata;2;2;4;54
3106200;Belo Horizonte;3113909;Carmo da Cachoeira;2;2;4;215
3100906;Águas Formosas;3113701;Carlos Chagas;2;2;4;73
3106309;Belo Oriente;3113404;Caratinga;2;2;4;72
3101631;Alfredo Vasconcelos;3113206;Carandaí;2;2;4;22
3107307;Bocaiúva;3112703;Capitão Enéas;2;2;4;93
3104007;Araxá;3112604;Capinópolis;2;2;4;295
3106200;Belo Horizonte;3112604;Capinópolis;2;2;4;607
3109808;Cachoeira Dourada;3112604;Capinópolis;2;2;4;21
3109402;Buritizeiro;3112505;Capim Branco;2;2;4;257
3102050;Alto Caparaó;3112109;Caparaó;2;2;4;10
3106200;Belo Horizonte;3112109;Caparaó;2;2;4;227
3106200;Belo Horizonte;3112000;Candeias;2;2;4;165
3111200;Campo Belo;3111903;Cana Verde;2;2;4;17
3101607;Alfenas;3111309;Campo do Meio;2;2;4;35
3100807;Aguanil;3111200;Campo Belo;2;2;4;14
3104007;Araxá;3111200;Campo Belo;2;2;4;226
3104205;Arcos;3111200;Campo Belo;2;2;4;72
3107406;Bom Despacho;3111200;Campo Belo;2;2;4;129
3108008;Bom Sucesso;3111200;Campo Belo;2;2;4;56
3104007;Araxá;3111101;Campina Verde;2;2;4;267
3101607;Alfenas;3111002;Campestre;2;2;4;45
3108404;Botelhos;3111002;Campestre;2;2;4;18
3107307;Bocaiúva;3109402;Buritizeiro;2;2;4;125
3106200;Belo Horizonte;3109105;Bueno Brandão;2;2;4;371
3108206;Bonfinópolis de Minas;3108552;Brasilândia de Minas;2;2;4;49
3106200;Belo Horizonte;3108107;Bonfim;2;2;4;54
3101904;Alpinópolis;3107604;Bom Jesus da Penha;2;2;4;22
3103603;Arantina;3107505;Bom Jardim de Minas;2;2;4;8
3104205;Arcos;3107406;Bom Despacho;2;2;4;69
2111300;São Luís;3106705;Betim;2;2;4;1927
2304400;Fortaleza;3106705;Betim;2;2;4;1880
2408102;Natal;3106705;Betim;2;2;4;1808
2601706;Belo Jardim;3106705;Betim;2;2;4;1507
2905701;Camaçari;3106705;Betim;2;2;4;1004
2929206;São Francisco do Conde;3106705;Betim;2;2;4;989
3106200;Belo Horizonte;3106408;Belo Vale;2;2;4;56
3100500;Açucena;3106309;Belo Oriente;2;2;4;18
1501303;Barcarena;3106200;Belo Horizonte;2;2;4;2088
1503606;Itaituba;3106200;Belo Horizonte;2;2;4;2118
1505304;Oriximiná;3106200;Belo Horizonte;2;2;4;2338
1508100;Tucuruí;3106200;Belo Horizonte;2;2;4;1879
2111201;São José de Ribamar;3106200;Belo Horizonte;2;2;4;1921
2312403;São Gonçalo do Amarante;3106200;Belo Horizonte;2;2;4;1872
2602902;Cabo de Santo Agostinho;3106200;Belo Horizonte;2;2;4;1576
2612208;Salgueiro;3106200;Belo Horizonte;2;2;4;1392
2708600;São Miguel dos Campos;3106200;Belo Horizonte;2;2;4;1378
2804805;Nossa Senhora do Socorro;3106200;Belo Horizonte;2;2;4;1222
2903201;Barreiras;3106200;Belo Horizonte;2;2;4;857
2907509;Catu;3106200;Belo Horizonte;2;2;4;1015
2911709;Guanambi;3106200;Belo Horizonte;2;2;4;633
2918001;Jequié;3106200;Belo Horizonte;2;2;4;785
2927705;Santa Cruz Cabrália;3106200;Belo Horizonte;2;2;4;646
3100609;Água Boa;3106200;Belo Horizonte;2;2;4;268
3102100;Alto Rio Doce;3106200;Belo Horizonte;2;2;4;138
3102407;Alvorada de Minas;3106200;Belo Horizonte;2;2;4;144
3103009;Antônio Dias;3106200;Belo Horizonte;2;2;4;119
3104502;Arinos;3106200;Belo Horizonte;2;2;4;493
3104908;Baependi;3106200;Belo Horizonte;2;2;4;246
3106002;Bela Vista de Minas;3106200;Belo Horizonte;2;2;4;93
3100203;Abaeté;3105103;Bambuí;2;2;4;111
1505536;Parauapebas;3105004;Baldim;2;2;4;1588
2606101;Glória do Goitá;3105004;Baldim;2;2;4;1532
3101607;Alfenas;3104908;Baependi;2;2;4;126
3104007;Araxá;3104205;Arcos;2;2;4;166
3100203;Abaeté;3104007;Araxá;2;2;4;164
3102803;Andrelândia;3103603;Arantina;2;2;4;22
1400100;Boa Vista;3100302;Abre Campo;2;2;4;3149
2902708;Barra;2933604;Xique-Xique;2;2;4;58
2903201;Barreiras;2933604;Xique-Xique;2;2;4;293
2927408;Salvador;2933604;Xique-Xique;2;2;4;524
2931608;Teolândia;2933505;Wenceslau Guimarães;2;2;4;12
2604007;Carpina;2933307;Vitória da Conquista;2;2;4;978
2804805;Nossa Senhora do Socorro;2933307;Vitória da Conquista;2;2;4;594
2807105;Simão Dias;2933307;Vitória da Conquista;2;2;4;565
2903508;Belo Campo;2933307;Vitória da Conquista;2;2;4;49
2904803;Caatiba;2933307;Vitória da Conquista;2;2;4;49
2905156;Caetanos;2933307;Vitória da Conquista;2;2;4;59
2905206;Caetité;2933307;Vitória da Conquista;2;2;4;198
2906709;Cândido Sales;2933307;Vitória da Conquista;2;2;4;81
2909802;Cruz das Almas;2933307;Vitória da Conquista;2;2;4;305
2928604;Santo Amaro;2933307;Vitória da Conquista;2;2;4;344
2928703;Santo Antônio de Jesus;2933307;Vitória da Conquista;2;2;4;268
2930501;Serrinha;2933307;Vitória da Conquista;2;2;4;406
2931004;Tanhaçu;2933307;Vitória da Conquista;2;2;4;102
2932200;Ubaitaba;2933307;Vitória da Conquista;2;2;4;175
2920106;Mairi;2933109;Várzea do Poço;2;2;4;27
2906873;Capim Grosso;2933059;Várzea da Roça;2;2;4;28
2910800;Feira de Santana;2933000;Valente;2;2;4;111
2304400;Fortaleza;2932903;Valença;2;2;4;1061
2901007;Amargosa;2932903;Valença;2;2;4;63
2910800;Feira de Santana;2932903;Valença;2;2;4;118
2914802;Itabuna;2932903;Valença;2;2;4;161
2917607;Jaguaquara;2932903;Valença;2;2;4;93
2918803;Laje;2932903;Valença;2;2;4;38
2922409;Mutuípe;2932903;Valença;2;2;4;44
2904050;Bonito;2932804;Utinga;2;2;4;27
2929909;Seabra;2932804;Utinga;2;2;4;84
2914901;Itacaré;2932705;Uruçuca;2;2;4;46
2918555;Jussari;2932507;Una;2;2;4;43
2927408;Salvador;2932507;Una;2;2;4;263
2914604;Irecê;2932408;Uibaí;2;2;4;29
2913903;Ipiaú;2932309;Ubatã;2;2;4;21
2927408;Salvador;2932309;Ubatã;2;2;4;174
2912103;Ibicaraí;2932200;Ubaitaba;2;2;4;69
2920700;Maraú;2932200;Ubaitaba;2;2;4;39
2927408;Salvador;2932200;Ubaitaba;2;2;4;169
2918001;Jequié;2932101;Ubaíra;2;2;4;75
2901353;Andorinha;2932002;Uauá;2;2;4;66
2906824;Canudos;2932002;Uauá;2;2;4;33
2907202;Casa Nova;2932002;Uauá;2;2;4;179
2921500;Monte Santo;2932002;Uauá;2;2;4;64
2925204;Pojuca;2932002;Uauá;2;2;4;310
2902104;Araci;2931905;Tucano;2;2;4;42
2925758;Presidente Tancredo Neves;2931608;Teolândia;2;2;4;16
2908507;Conceição do Jacuípe;2931400;Teodoro Sampaio;2;2;4;16
2903201;Barreiras;2931350;Teixeira de Freitas;2;2;4;808
2903904;Bom Jesus da Lapa;2931350;Teixeira de Freitas;2;2;4;609
2914604;Irecê;2931350;Teixeira de Freitas;2;2;4;722
2914653;Itabela;2931350;Teixeira de Freitas;2;2;4;109
2925501;Prado;2931350;Teixeira de Freitas;2;2;4;54
2930709;Simões Filho;2931350;Teixeira de Freitas;2;2;4;545
2921203;Miguel Calmon;2931301;Tapiramutá;2;2;4;52
2917300;Ituberá;2931202;Taperoá;2;2;4;22
2903904;Bom Jesus da Lapa;2931053;Tanque Novo;2;2;4;100
2913408;Igaporã;2931053;Tanque Novo;2;2;4;35
2923605;Paramirim;2931053;Tanque Novo;2;2;4;28
2901205;Anagé;2931004;Tanhaçu;2;2;4;72
1302603;Manaus;2930709;Simões Filho;2;2;4;2552
2403251;Parnamirim;2930709;Simões Filho;2;2;4;831
2504009;Campina Grande;2930709;Simões Filho;2;2;4;673
2602902;Cabo de Santo Agostinho;2930709;Simões Filho;2;2;4;617
2610707;Paulista;2930709;Simões Filho;2;2;4;656
2903201;Barreiras;2930709;Simões Filho;2;2;4;716
2903904;Bom Jesus da Lapa;2930709;Simões Filho;2;2;4;543
2910057;Dias d'Ávila;2930709;Simões Filho;2;2;4;22
2911709;Guanambi;2930709;Simões Filho;2;2;4;506
2914802;Itabuna;2930709;Simões Filho;2;2;4;242
2919553;Luís Eduardo magalhães;2930709;Simões Filho;2;2;4;807
2925931;Quixabeira;2930600;Serrolândia;2;2;4;19
2917508;Jacobina;2930501;Serrinha;2;2;4;166
2926301;Riachão do Jacuípe;2930501;Serrinha;2;2;4;40
2926608;Ribeira do Pombal;2930501;Serrinha;2;2;4;104
2914000;Ipirá;2930402;Serra Preta;2;2;4;47
2903201;Barreiras;2930303;Serra Dourada;2;2;4;123
2918407;Juazeiro;2930204;Sento Sé;2;2;4;162
2907103;Carinhanha;2930154;Serra do Ramalho;2;2;4;78
2927408;Salvador;2930154;Serra do Ramalho;2;2;4;558
2928208;Santana;2930154;Serra do Ramalho;2;2;4;83
2906808;Cansanção;2930105;Senhor do Bonfim;2;2;4;81
2914604;Irecê;2930105;Senhor do Bonfim;2;2;4;208
2917003;Itiúba;2930105;Senhor do Bonfim;2;2;4;50
2924603;Pindobaçu;2930105;Senhor do Bonfim;2;2;4;39
2925253;Ponto Novo;2930105;Senhor do Bonfim;2;2;4;47
2914406;Iraquara;2929909;Seabra;2;2;4;26
2918001;Jequié;2929909;Seabra;2;2;4;236
2928604;Santo Amaro;2929750;Saubara;2;2;4;22
2901908;Aporá;2929701;Sátiro Dias;2;2;4;57
2907301;Castro Alves;2929602;Sapeaçu;2;2;4;27
2907509;Catu;2929503;São Sebastião do Passé;2;2;4;23
2910057;Dias d'Ávila;2929503;São Sebastião do Passé;2;2;4;24
2304285;Eusébio;2929305;São Gonçalo dos Campos;2;2;4;946
2900702;Alagoinhas;2929305;São Gonçalo dos Campos;2;2;4;68
2607208;Ipojuca;2929206;São Francisco do Conde;2;2;4;609
2922300;Muritiba;2929008;São Félix;2;2;4;5
2927408;Salvador;2929008;São Félix;2;2;4;67
2926202;Riachão das Neves;2928901;São Desidério;2;2;4;69
2927408;Salvador;2928901;São Desidério;2;2;4;711
2913804;Ipecaetá;2928802;Santo Estêvão;2;2;4;16
2611606;Recife;2928703;Santo Antônio de Jesus;2;2;4;712
2908309;Conceição do Almeida;2928703;Santo Antônio de Jesus;2;2;4;22
2911204;Gandu;2928703;Santo Antônio de Jesus;2;2;4;89
2913903;Ipiaú;2928703;Santo Antônio de Jesus;2;2;4;132
2914802;Itabuna;2928703;Santo Antônio de Jesus;2;2;4;202
2918001;Jequié;2928703;Santo Antônio de Jesus;2;2;4;126
2918803;Laje;2928703;Santo Antônio de Jesus;2;2;4;28
2922409;Mutuípe;2928703;Santo Antônio de Jesus;2;2;4;37
2922508;Nazaré;2928703;Santo Antônio de Jesus;2;2;4;29
2928604;Santo Amaro;2928703;Santo Antônio de Jesus;2;2;4;79
2900702;Alagoinhas;2928604;Santo Amaro;2;2;4;55
2905701;Camaçari;2928604;Santo Amaro;2;2;4;45
2910800;Feira de Santana;2928604;Santo Amaro;2;2;4;40
2916856;Itatim;2928505;Santa Teresinha;2;2;4;20
2911709;Guanambi;2928109;Santa Maria da Vitória;2;2;4;187
2917607;Jaguaquara;2927903;Santa Inês;2;2;4;29
2924009;Paulo Afonso;2927606;Santa Brígida;2;2;4;43
2927408;Salvador;2927507;Santa Bárbara;2;2;4;127
1502400;Castanhal;2927408;Salvador;2;2;4;1640
1505536;Parauapebas;2927408;Salvador;2;2;4;1445
1506807;Santarém;2927408;Salvador;2;2;4;2091
1600303;Macapá;2927408;Salvador;2;2;4;1975
2307700;Maranguape;2927408;Salvador;2;2;4;1007
2404507;Guamaré;2927408;Salvador;2;2;4;902
2503209;Cabedelo;2927408;Salvador;2;2;4;763
2509305;Mataraca;2927408;Salvador;2;2;4;797
2607208;Ipojuca;2927408;Salvador;2;2;4;627
2609402;Moreno;2927408;Salvador;2;2;4;650
2706307;Palmeira dos Índios;2927408;Salvador;2;2;4;440
2707701;Rio Largo;2927408;Salvador;2;2;4;480
2800605;Barra dos Coqueiros;2927408;Salvador;2;2;4;283
2801504;Carmópolis;2927408;Salvador;2;2;4;305
2900801;Alcobaça;2927408;Salvador;2;2;4;504
2901957;Apuarema;2927408;Salvador;2;2;4;168
2902609;Baixa Grande;2927408;Salvador;2;2;4;216
2902708;Barra;2927408;Salvador;2;2;4;559
2903409;Belmonte;2927408;Salvador;2;2;4;326
2904605;Brumado;2927408;Salvador;2;2;4;371
2905404;Cairu;2927408;Salvador;2;2;4;79
2905800;Camamu;2927408;Salvador;2;2;4;128
2906006;Campo Formoso;2927408;Salvador;2;2;4;339
2906873;Capim Grosso;2927408;Salvador;2;2;4;244
2907301;Castro Alves;2927408;Salvador;2;2;4;107
2908002;Coaraci;2927408;Salvador;2;2;4;212
2908309;Conceição do Almeida;2927408;Salvador;2;2;4;78
2909901;Curaçá;2927408;Salvador;2;2;4;467
2910305;Elísio Medrado;2927408;Salvador;2;2;4;114
2912202;Ibicoara;2927408;Salvador;2;2;4;309
2912905;Ibirataia;2927408;Salvador;2;2;4;174
2914307;Iramaia;2927408;Salvador;2;2;4;271
2914505;Irará;2927408;Salvador;2;2;4;109
2914901;Itacaré;2927408;Salvador;2;2;4;154
2915700;Itamari;2927408;Salvador;2;2;4;158
2915809;Itambé;2927408;Salvador;2;2;4;343
2916807;Itarantim;2927408;Salvador;2;2;4;343
2916906;Itiruçu;2927408;Salvador;2;2;4;192
2917706;Jaguarari;2927408;Salvador;2;2;4;355
2917904;Jandaíra;2927408;Salvador;2;2;4;175
2919504;Livramento de Nossa Senhora;2927408;Salvador;2;2;4;372
2919603;Macajuba;2927408;Salvador;2;2;4;225
2921302;Milagres;2927408;Salvador;2;2;4;151
2921708;Morro do Chapéu;2927408;Salvador;2;2;4;330
2921906;Mucugê;2927408;Salvador;2;2;4;314
2922508;Nazaré;2927408;Salvador;2;2;4;61
2923035;Novo Horizonte;2927408;Salvador;2;2;4;401
2923209;Oliveira dos Brejinhos;2927408;Salvador;2;2;4;486
2923407;Palmas de Monte Alto;2927408;Salvador;2;2;4;529
2924603;Pindobaçu;2927408;Salvador;2;2;4;322
2926004;Remanso;2927408;Salvador;2;2;4;544
2926301;Riachão do Jacuípe;2927408;Salvador;2;2;4;162
2926400;Riacho de Santana;2927408;Salvador;2;2;4;494
2927002;Rio Real;2927408;Salvador;2;2;4;179
2903201;Barreiras;2927200;Ruy Barbosa;2;2;4;488
2904050;Bonito;2927200;Ruy Barbosa;2;2;4;92
2914604;Irecê;2927200;Ruy Barbosa;2;2;4;183
2804805;Nossa Senhora do Socorro;2927002;Rio Real;2;2;4;108
2917904;Jandaíra;2927002;Rio Real;2;2;4;17
2905008;Caculé;2926806;Rio do Antônio;2;2;4;22
2912004;Ibiassucê;2926806;Rio do Antônio;2;2;4;26
2903904;Bom Jesus da Lapa;2926400;Riacho de Santana;2;2;4;57
2908408;Conceição do Coité;2926103;Retirolândia;2;2;4;22
2924405;Pilão Arcado;2926004;Remanso;2;2;4;61
2906873;Capim Grosso;2925931;Quixabeira;2;2;4;13
2911204;Gandu;2925758;Presidente Tancredo Neves;2;2;4;34
2925303;Porto Seguro;2925501;Prado;2;2;4;99
2507507;João Pessoa;2925303;Porto Seguro;2;2;4;1116
2903201;Barreiras;2925303;Porto Seguro;2;2;4;774
2905503;Caldeirão Grande;2925253;Ponto Novo;2;2;4;25
2304400;Fortaleza;2925204;Pojuca;2;2;4;958
2804805;Nossa Senhora do Socorro;2925204;Pojuca;2;2;4;217
2901353;Andorinha;2925204;Pojuca;2;2;4;283
2910701;Euclides da Cunha;2925204;Pojuca;2;2;4;226
2921005;Mata de São João;2925204;Pojuca;2;2;4;11
2921450;Mirante;2925105;Poções;2;2;4;54
2903953;Bom Jesus da Serra;2925006;Planalto;2;2;4;31
2906857;Capela do Alto Alegre;2924652;Pintadas;2;2;4;18
2911709;Guanambi;2924504;Pindaí;2;2;4;25
2304400;Fortaleza;2924009;Paulo Afonso;2;2;4;624
2608057;Jatobá;2924009;Paulo Afonso;2;2;4;26
2910701;Euclides da Cunha;2924009;Paulo Afonso;2;2;4;144
2900355;Adustina;2923803;Paripiranga;2;2;4;28
2904605;Brumado;2923605;Paramirim;2;2;4;106
2919801;Macaúbas;2923605;Paramirim;2;2;4;69
2910800;Feira de Santana;2923357;Ourolândia;2;2;4;274
2917508;Jacobina;2923357;Ourolândia;2;2;4;72
2910727;Eunápolis;2923001;Nova Viçosa;2;2;4;165
2907905;Cipó;2922904;Nova Soure;2;2;4;14
2916500;Itapicuru;2922904;Nova Soure;2;2;4;30
2904308;Brejões;2922805;Nova Itarana;2;2;4;31
2918001;Jequié;2922409;Mutuípe;2;2;4;89
2902609;Baixa Grande;2922102;Mundo Novo;2;2;4;35
2912202;Ibicoara;2921906;Mucugê;2;2;4;46
2908705;Condeúba;2921807;Mortugaba;2;2;4;45
2917508;Jacobina;2921401;Mirangaba;2;2;4;34
2908507;Conceição do Jacuípe;2921302;Milagres;2;2;4;132
2910800;Feira de Santana;2921302;Milagres;2;2;4;116
2900702;Alagoinhas;2921005;Mata de São João;2;2;4;46
2910503;Entre Rios;2921005;Mata de São João;2;2;4;72
2914307;Iramaia;2920502;Maracás;2;2;4;60
2905206;Caetité;2920304;Malhada de Pedras;2;2;4;75
2903904;Bom Jesus da Lapa;2919801;Macaúbas;2;2;4;76
2904100;Boquira;2919801;Macaúbas;2;2;4;23
1702109;Araguaína;2919553;Luís Eduardo magalhães;2;2;4;601
2101400;Balsas;2919553;Luís Eduardo magalhães;2;2;4;509
2401453;Baraúna;2919553;Luís Eduardo magalhães;2;2;4;1176
2905701;Camaçari;2919553;Luís Eduardo magalhães;2;2;4;819
2914604;Irecê;2919553;Luís Eduardo magalhães;2;2;4;438
2911709;Guanambi;2919405;Licínio de Almeida;2;2;4;53
2911600;Governador Mangabeira;2919306;Lençóis;2;2;4;255
2403251;Parnamirim;2919207;Lauro de Freitas;2;2;4;838
2408102;Natal;2919207;Lauro de Freitas;2;2;4;848
2611101;Petrolina;2919207;Lauro de Freitas;2;2;4;462
2917607;Jaguaquara;2919058;Lajedo do Tabocal;2;2;4;29
2904605;Brumado;2918753;Lagoa Real;2;2;4;56
2911709;Guanambi;2918753;Lagoa Real;2;2;4;76
2915601;Itamaraju;2918456;Jucuruçu;2;2;4;71
2408003;Mossoró;2918407;Juazeiro;2;2;4;587
2504009;Campina Grande;2918407;Juazeiro;2;2;4;564
2507507;João Pessoa;2918407;Juazeiro;2;2;4;669
2603009;Cabrobó;2918407;Juazeiro;2;2;4;176
2613909;Serra Talhada;2918407;Juazeiro;2;2;4;296
2800308;Aracaju;2918407;Juazeiro;2;2;4;408
2906006;Campo Formoso;2918407;Juazeiro;2;2;4;117
2910800;Feira de Santana;2918357;João Dourado;2;2;4;313
2408102;Natal;2918001;Jequié;2;2;4;1023
2905800;Camamu;2918001;Jequié;2;2;4;102
2906873;Capim Grosso;2918001;Jequié;2;2;4;269
2910727;Eunápolis;2918001;Jequié;2;2;4;287
2911204;Gandu;2918001;Jequié;2;2;4;64
2916401;Itapetinga;2918001;Jequié;2;2;4;164
2917508;Jacobina;2918001;Jequié;2;2;4;287
2905107;Caém;2917508;Jacobina;2;2;4;18
2906006;Campo Formoso;2917508;Jacobina;2;2;4;84
2908408;Conceição do Coité;2917508;Jacobina;2;2;4;141
2611606;Recife;2917359;Jaborandi;2;2;4;1188
2909109;Coribe;2917359;Jaborandi;2;2;4;24
2911709;Guanambi;2917334;Iuiú;2;2;4;83
2905800;Camamu;2917300;Ituberá;2;2;4;23
2902807;Barra da Estiva;2917201;Ituaçu;2;2;4;22
2906873;Capim Grosso;2917003;Itiúba;2;2;4;81
2912202;Ibicoara;2916807;Itarantim;2;2;4;281
2906501;Candeias;2916708;Itaquara;2;2;4;174
2902807;Barra da Estiva;2916401;Itapetinga;2;2;4;218
2903904;Bom Jesus da Lapa;2916401;Itapetinga;2;2;4;401
2910727;Eunápolis;2916401;Itapetinga;2;2;4;139
2910727;Eunápolis;2916302;Itapebi;2;2;4;47
2914307;Iramaia;2915007;Itaeté;2;2;4;33
2611606;Recife;2914802;Itabuna;2;2;4;870
2804805;Nossa Senhora do Socorro;2914802;Itabuna;2;2;4;492
2902401;Aurelino Leal;2914802;Itabuna;2;2;4;53
2903300;Governador Lomanto Júnior;2914802;Itabuna;2;2;4;21
2911204;Gandu;2914802;Itabuna;2;2;4;117
2903805;Boa Vista do Tupim;2914703;Itaberaba;2;2;4;35
2906873;Capim Grosso;2914703;Itaberaba;2;2;4;135
2914604;Irecê;2914703;Itaberaba;2;2;4;217
2910107;Dom Basílio;2914653;Itabela;2;2;4;390
2911808;Guaratinga;2914653;Itabela;2;2;4;23
2507507;João Pessoa;2914604;Irecê;2;2;4;888
2914000;Ipirá;2914604;Irecê;2;2;4;249
2914406;Iraquara;2914604;Irecê;2;2;4;104
2908507;Conceição do Jacuípe;2914505;Irará;2;2;4;32
2908903;Coração de Maria;2914505;Irará;2;2;4;20
2910800;Feira de Santana;2914505;Irará;2;2;4;34
2906873;Capim Grosso;2914000;Ipirá;2;2;4;96
2910800;Feira de Santana;2913903;Ipiaú;2;2;4;214
2911204;Gandu;2913903;Ipiaú;2;2;4;44
2912905;Ibirataia;2913903;Ipiaú;2;2;4;7
2913606;Ilhéus;2913903;Ipiaú;2;2;4;100
2910602;Esplanada;2913705;Inhambupe;2;2;4;37
2611606;Recife;2913606;Ilhéus;2;2;4;861
2704302;Maceió;2913606;Ilhéus;2;2;4;674
2906303;Canavieiras;2913606;Ilhéus;2;2;4;96
2905800;Camamu;2913457;Igrapiúna;2;2;4;12
2903904;Bom Jesus da Lapa;2913200;Ibotirama;2;2;4;123
2912707;Ibirapitanga;2912905;Ibirataia;2;2;4;31
2904605;Brumado;2912004;Ibiassucê;2;2;4;65
2908507;Conceição do Jacuípe;2911907;Iaçu;2;2;4;160
2905008;Caculé;2911709;Guanambi;2;2;4;64
2907103;Carinhanha;2911709;Guanambi;2;2;4;111
2910776;Feira da Mata;2911709;Guanambi;2;2;4;161
2202901;Corrente;2911105;Formosa do Rio Preto;2;2;4;66
1302603;Manaus;2910800;Feira de Santana;2;2;4;2480
1721000;Palmas;2910800;Feira de Santana;2;2;4;1042
2211001;Teresina;2910800;Feira de Santana;2;2;4;896
2604106;Caruaru;2910800;Feira de Santana;2;2;4;547
2606804;Igarassu;2910800;Feira de Santana;2;2;4;656
2902104;Araci;2910800;Feira de Santana;2;2;4;107
2903805;Boa Vista do Tupim;2910800;Feira de Santana;2;2;4;184
2904308;Brejões;2910800;Feira de Santana;2;2;4;128
2906006;Campo Formoso;2910800;Feira de Santana;2;2;4;245
2907301;Castro Alves;2910800;Feira de Santana;2;2;4;73
2910057;Dias d'Ávila;2910800;Feira de Santana;2;2;4;81
2805505;Poço Verde;2910750;Fátima;2;2;4;18
2902658;Banzaê;2910750;Fátima;2;2;4;44
2903409;Belmonte;2910727;Eunápolis;2;2;4;86
2905701;Camaçari;2910727;Eunápolis;2;2;4;428
2906501;Candeias;2910701;Euclides da Cunha;2;2;4;245
2906808;Cansanção;2910701;Euclides da Cunha;2;2;4;54
2906824;Canudos;2910701;Euclides da Cunha;2;2;4;65
2908606;Conde;2910602;Esplanada;2;2;4;44
2907004;Cardeal da Silva;2910503;Entre Rios;2;2;4;18
2907509;Catu;2910503;Entre Rios;2;2;4;57
2901007;Amargosa;2910305;Elísio Medrado;2;2;4;13
2904605;Brumado;2910107;Dom Basílio;2;2;4;50
2607901;Jaboatão dos Guararapes;2910057;Dias d'Ávila;2;2;4;609
2704302;Maceió;2910057;Dias d'Ávila;2;2;4;429
2704708;Marechal Deodoro;2910057;Dias d'Ávila;2;2;4;413
2800308;Aracaju;2910057;Dias d'Ávila;2;2;4;231
2907509;Catu;2910057;Dias d'Ávila;2;2;4;29
2611606;Recife;2909901;Curaçá;2;2;4;553
2700300;Arapiraca;2909802;Cruz das Almas;2;2;4;415
2904852;Cabaceiras do Paraguaçu;2909802;Cruz das Almas;2;2;4;24
2904902;Cachoeira;2909802;Cruz das Almas;2;2;4;16
2903201;Barreiras;2909406;Cotegipe;2;2;4;81
2908705;Condeúba;2909000;Cordeiros;2;2;4;15
2804003;Maruim;2907509;Catu;2;2;4;227
2408102;Natal;2907202;Casa Nova;2;2;4;719
2901205;Anagé;2906899;Caraíbas;2;2;4;21
2307650;Maracanaú;2906501;Candeias;2;2;4;974
2704302;Maceió;2906501;Candeias;2;2;4;451
2905602;Camacan;2906303;Canavieiras;2;2;4;59
2903235;Barro Alto;2906204;Canarana;2;2;4;20
2607208;Ipojuca;2905701;Camaçari;2;2;4;591
2801504;Carmópolis;2905701;Camaçari;2;2;4;269
2903201;Barreiras;2905701;Camaçari;2;2;4;724
2904605;Brumado;2905206;Caetité;2;2;4;92
2903904;Bom Jesus da Lapa;2904605;Brumado;2;2;4;211
1721000;Palmas;2903201;Barreiras;2;2;4;421
2901007;Amargosa;2903201;Barreiras;2;2;4;593
2805505;Poço Verde;2900355;Adustina;2;2;4;25
2612208;Salgueiro;2900207;Abaré;2;2;4;66
2807501;Tomar do Geru;2807600;Umbaúba;2;2;4;20
2801702;Cristinápolis;2807501;Tomar do Geru;2;2;4;15
2807105;Simão Dias;2807402;Tobias Barreto;2;2;4;54
2800308;Aracaju;2807204;Siriri;2;2;4;31
2304400;Fortaleza;2807105;Simão Dias;2;2;4;769
2803203;Itaporanga d'Ajuda;2806701;São Cristóvão;2;2;4;12
2800308;Aracaju;2806602;Santo Amaro das Brotas;2;2;4;14
2804409;Neópolis;2806404;Santana do São Francisco;2;2;4;6
2802304;Frei Paulo;2806008;Ribeirópolis;2;2;4;13
2800308;Aracaju;2805802;Riachão do Dantas;2;2;4;71
2803500;Lagarto;2805802;Riachão do Dantas;2;2;4;23
2804508;Nossa Senhora da Glória;2805703;Propriá;2;2;4;60
2800308;Aracaju;2805604;Porto da Folha;2;2;4;111
2800308;Aracaju;2805406;Poço Redondo;2;2;4;135
2802304;Frei Paulo;2805208;Pinhão;2;2;4;22
2800308;Aracaju;2805000;Pedra Mole;2;2;4;71
2803401;Japoatã;2804904;Pacatuba;2;2;4;20
2801306;Capela;2804805;Nossa Senhora do Socorro;2;2;4;38
2800308;Aracaju;2804706;Nossa Senhora de Lourdes;2;2;4;92
2800308;Aracaju;2804607;Nossa Senhora das Dores;2;2;4;45
2804508;Nossa Senhora da Glória;2804607;Nossa Senhora das Dores;2;2;4;40
2304400;Fortaleza;2804508;Nossa Senhora da Glória;2;2;4;723
2800209;Aquidabã;2804508;Nossa Senhora da Glória;2;2;4;43
2802106;Estância;2804508;Nossa Senhora da Glória;2;2;4;114
2804201;Monte Alegre de Sergipe;2804508;Nossa Senhora da Glória;2;2;4;26
2804458;Nossa Senhora Aparecida;2804508;Nossa Senhora da Glória;2;2;4;25
2800308;Aracaju;2804458;Nossa Senhora Aparecida;2;2;4;68
2804003;Maruim;2804409;Neópolis;2;2;4;67
2801207;Canindé de São Francisco;2804201;Monte Alegre de Sergipe;2;2;4;52
2800308;Aracaju;2803906;Malhador;2;2;4;34
2304400;Fortaleza;2803609;Laranjeiras;2;2;4;792
2800308;Aracaju;2803401;Japoatã;2;2;4;68
2800308;Aracaju;2803302;Japaratuba;2;2;4;37
2801504;Carmópolis;2803302;Japaratuba;2;2;4;8
2611606;Recife;2803203;Itaporanga d'Ajuda;2;2;4;410
2802106;Estância;2803203;Itaporanga d'Ajuda;2;2;4;33
2800308;Aracaju;2803104;Itabi;2;2;4;86
2304400;Fortaleza;2802908;Itabaiana;2;2;4;768
2704302;Maceió;2802908;Itabaiana;2;2;4;215
2800506;Areia Branca;2802908;Itabaiana;2;2;4;20
2801009;Campo do Brito;2802908;Itabaiana;2;2;4;13
2800308;Aracaju;2802809;Indiaroba;2;2;4;81
2304400;Fortaleza;2802106;Estância;2;2;4;835
2801702;Cristinápolis;2802106;Estância;2;2;4;40
2800308;Aracaju;2802007;Divina Pastora;2;2;4;24
2800308;Aracaju;2801702;Cristinápolis;2;2;4;97
2304400;Fortaleza;2801504;Carmópolis;2;2;4;779
2800209;Aquidabã;2801504;Carmópolis;2;2;4;43
2801306;Capela;2801504;Carmópolis;2;2;4;18
2800308;Aracaju;2801108;Canhoba;2;2;4;83
2111300;São Luís;2800308;Aracaju;2;2;4;1204
2404507;Guamaré;2800308;Aracaju;2;2;4;644
2603454;Camaragibe;2800308;Aracaju;2;2;4;390
2709301;União dos Palmares;2800308;Aracaju;2;2;4;217
2700409;Atalaia;2709301;União dos Palmares;2;2;4;36
2705507;Murici;2709301;União dos Palmares;2;2;4;21
2706703;Penedo;2709301;União dos Palmares;2;2;4;129
2707305;Porto Calvo;2709301;União dos Palmares;2;2;4;78
2702306;Coruripe;2709152;Teotônio Vilela;2;2;4;31
2706703;Penedo;2709152;Teotônio Vilela;2;2;4;45
2700300;Arapiraca;2709103;Taquarana;2;2;4;25
2704005;Junqueiro;2708808;São Sebastião;2;2;4;9
2701001;Boca da Mata;2708600;São Miguel dos Campos;2;2;4;21
2701407;Campo Alegre;2708600;São Miguel dos Campos;2;2;4;27
2706307;Palmeira dos Índios;2708600;São Miguel dos Campos;2;2;4;72
2704302;Maceió;2708501;São Luís do Quitunde;2;2;4;41
2704302;Maceió;2708303;São José da Laje;2;2;4;77
2611606;Recife;2708006;Santana do Ipanema;2;2;4;287
2611606;Recife;2707701;Rio Largo;2;2;4;181
2706901;Pilar;2707701;Rio Largo;2;2;4;17
2702405;Delmiro Gouveia;2707107;Piranhas;2;2;4;40
2408102;Natal;2706901;Pilar;2;2;4;425
2700409;Atalaia;2706901;Pilar;2;2;4;13
2703809;Joaquim Gomes;2706901;Pilar;2;2;4;56
2706703;Penedo;2706802;Piaçabuçu;2;2;4;20
2705705;Olho d'Água das Flores;2706406;Pão de Açúcar;2;2;4;28
2304400;Fortaleza;2706307;Palmeira dos Índios;2;2;4;659
2700706;Batalha;2706307;Palmeira dos Índios;2;2;4;59
2702553;Estrela de Alagoas;2706307;Palmeira dos Índios;2;2;4;13
2700300;Arapiraca;2705705;Olho d'Água das Flores;2;2;4;70
2702405;Delmiro Gouveia;2705002;Mata Grande;2;2;4;39
2700201;Anadia;2704807;Maribondo;2;2;4;12
2700300;Arapiraca;2704708;Marechal Deodoro;2;2;4;88
2613404;São José da Coroa Grande;2704500;Maragogi;2;2;4;18
1721000;Palmas;2704302;Maceió;2;2;4;1389
2307650;Maracanaú;2704302;Maceió;2;2;4;712
2501807;Bayeux;2704302;Maceió;2;2;4;292
2503209;Cabedelo;2704302;Maceió;2;2;4;302
2600054;Abreu e Lima;2704302;Maceió;2;2;4;213
2603454;Camaragibe;2704302;Maceió;2;2;4;196
2610004;Palmares;2704302;Maceió;2;2;4;106
2700201;Anadia;2704302;Maceió;2;2;4;61
2701001;Boca da Mata;2704302;Maceió;2;2;4;51
2701407;Campo Alegre;2704302;Maceió;2;2;4;68
2700300;Arapiraca;2704203;Limoeiro de Anadia;2;2;4;21
2702603;Feira Grande;2704104;Lagoa da Canoa;2;2;4;10
2700300;Arapiraca;2704005;Junqueiro;2;2;4;29
2702108;Colônia Leopoldina;2703809;Joaquim Gomes;2;2;4;25
2702405;Delmiro Gouveia;2703304;Inhapi;2;2;4;31
2700300;Arapiraca;2702355;Craíbas;2;2;4;18
2700300;Arapiraca;2702306;Coruripe;2;2;4;69
2700409;Atalaia;2701704;Capela;2;2;4;12
2700300;Arapiraca;2700706;Batalha;2;2;4;48
2607901;Jaboatão dos Guararapes;2700300;Arapiraca;2;2;4;257
2700201;Anadia;2700300;Arapiraca;2;2;4;44
2610004;Palmares;2616506;Xexéu;2;2;4;14
2304400;Fortaleza;2616407;Vitória de Santo Antão;2;2;4;599
2507507;João Pessoa;2616407;Vitória de Santo Antão;2;2;4;113
2605202;Escada;2616407;Vitória de Santo Antão;2;2;4;28
2606101;Glória do Goitá;2616407;Vitória de Santo Antão;2;2;4;13
2604007;Carpina;2616308;Vicência;2;2;4;22
2612505;Santa Cruz do Capibaribe;2616209;Vertentes;2;2;4;25
2615409;Toritama;2616209;Vertentes;2;2;4;12
2600609;Alagoinha;2616001;Venturosa;2;2;4;16
2600104;Afogados da Ingazeira;2615706;Triunfo;2;2;4;53
2611606;Recife;2615607;Trindade;2;2;4;592
2605004;Cupira;2615409;Toritama;2;2;4;70
2608107;João Alfredo;2615409;Toritama;2;2;4;53
2506905;Itabaiana;2615300;Timbaúba;2;2;4;17
2507507;João Pessoa;2615300;Timbaúba;2;2;4;61
2511202;Pedras de Fogo;2615300;Timbaúba;2;2;4;26
2603603;Camutanga;2615300;Timbaúba;2;2;4;10
2604601;Condado;2615300;Timbaúba;2;2;4;24
2608909;Limoeiro;2615300;Timbaúba;2;2;4;44
2614501;Surubim;2615300;Timbaúba;2;2;4;59
2612208;Salgueiro;2615201;Terra Nova;2;2;4;29
2607901;Jaboatão dos Guararapes;2615003;Taquaritinga do Norte;2;2;4;115
2607208;Ipojuca;2614857;Tamandaré;2;2;4;40
2611903;Rio Formoso;2614857;Tamandaré;2;2;4;9
2612802;Santa Terezinha;2614600;Tabira;2;2;4;22
2610509;Passira;2614501;Surubim;2;2;4;27
2605301;Exu;2614303;Moreilândia;2;2;4;21
2611804;Ribeirão;2614204;Sirinhaém;2;2;4;27
2613404;São José da Coroa Grande;2614204;Sirinhaém;2;2;4;31
2613602;São José do Egito;2614105;Sertânia;2;2;4;62
2612208;Salgueiro;2614006;Serrita;2;2;4;26
2604106;Caruaru;2613909;Serra Talhada;2;2;4;257
2611002;Petrolândia;2613909;Serra Talhada;2;2;4;124
2612471;Santa Cruz da Baixa Verde;2613909;Serra Talhada;2;2;4;22
2613602;São José do Egito;2613909;Serra Talhada;2;2;4;123
2606200;Goiana;2613800;São Vicente Ferrer;2;2;4;55
2604007;Carpina;2613701;São Lourenço da Mata;2;2;4;29
2607901;Jaboatão dos Guararapes;2613701;São Lourenço da Mata;2;2;4;13
2609600;Olinda;2613701;São Lourenço da Mata;2;2;4;15
2610707;Paulista;2613701;São Lourenço da Mata;2;2;4;18
2601201;Arcoverde;2613602;São José do Egito;2;2;4;110
2607703;Itapetim;2613602;São José do Egito;2;2;4;16
2611606;Recife;2613503;São José do Belmonte;2;2;4;425
2611606;Recife;2613404;São José da Coroa Grande;2;2;4;85
2604106;Caruaru;2613305;São Joaquim do Monte;2;2;4;27
2603702;Canhotinho;2613206;São João;2;2;4;19
2608305;Jupi;2613206;São João;2;2;4;19
2603108;Cachoeirinha;2613008;São Bento do Una;2;2;4;24
2610905;Pesqueira;2613008;São Bento do Una;2;2;4;41
2506707;Imaculada;2612802;Santa Terezinha;2;2;4;4
2509396;Maturéia;2612802;Santa Terezinha;2;2;4;21
2504009;Campina Grande;2612505;Santa Cruz do Capibaribe;2;2;4;89
2611101;Petrolina;2612505;Santa Cruz do Capibaribe;2;2;4;501
2611705;Riacho das Almas;2612505;Santa Cruz do Capibaribe;2;2;4;41
2601706;Belo Jardim;2612406;Sanharó;2;2;4;16
2304400;Fortaleza;2612208;Salgueiro;2;2;4;487
2310605;Penaforte;2612208;Salgueiro;2;2;4;34
2608750;Lagoa Grande;2612208;Salgueiro;2;2;4;156
2609303;Mirandiba;2612208;Salgueiro;2;2;4;47
2609600;Olinda;2612208;Salgueiro;2;2;4;469
2604106;Caruaru;2611705;Riacho das Almas;2;2;4;21
2604908;Cumaru;2611705;Riacho das Almas;2;2;4;24
1100205;Porto Velho;2611606;Recife;2;2;4;3194
1200401;Rio Branco;2611606;Recife;2;2;4;3642
1504422;Marituba;2611606;Recife;2;2;4;1649
2204303;Fronteiras;2611606;Recife;2;2;4;635
2208007;Picos;2611606;Recife;2;2;4;729
2208403;Piripiri;2611606;Recife;2;2;4;864
2300200;Acaraú;2611606;Recife;2;2;4;808
2301901;Barbalha;2611606;Recife;2;2;4;490
2304285;Eusébio;2611606;Recife;2;2;4;607
2306405;Itapipoca;2611606;Recife;2;2;4;722
2309607;Pacajus;2611606;Recife;2;2;4;584
2309706;Pacatuba;2611606;Recife;2;2;4;611
2412005;São Gonçalo do Amarante;2611606;Recife;2;2;4;261
2503001;Caaporã;2611606;Recife;2;2;4;67
2503704;Cajazeiras;2611606;Recife;2;2;4;424
2509305;Mataraca;2611606;Recife;2;2;4;169
2515302;Sapé;2611606;Recife;2;2;4;119
2600500;Águas Belas;2611606;Recife;2;2;4;266
2601607;Belém de São Francisco;2611606;Recife;2;2;4;447
2602100;Bom Conselho;2611606;Recife;2;2;4;228
2602308;Bonito;2611606;Recife;2;2;4;96
2602803;Buíque;2611606;Recife;2;2;4;249
2607604;Ilha de Itamaracá;2611606;Recife;2;2;4;42
2607653;Itambé;2611606;Recife;2;2;4;81
2607802;Itaquitinga;2611606;Recife;2;2;4;54
2608800;Lajedo;2611606;Recife;2;2;4;164
2609501;Nazaré da Mata;2611606;Recife;2;2;4;53
2610400;Parnamirim;2611606;Recife;2;2;4;512
2605004;Cupira;2611507;Quipapá;2;2;4;24
2605400;Feira Nova;2611309;Pombos;2;2;4;21
2210607;São Raimundo Nonato;2611101;Petrolina;2;2;4;244
2600104;Afogados da Ingazeira;2611101;Petrolina;2;2;4;361
2601607;Belém de São Francisco;2611101;Petrolina;2;2;4;187
2605152;Dormentes;2611101;Petrolina;2;2;4;98
2601201;Arcoverde;2611002;Petrolândia;2;2;4;152
2601607;Belém de São Francisco;2611002;Petrolândia;2;2;4;81
2605707;Floresta;2611002;Petrolândia;2;2;4;63
2600609;Alagoinha;2610905;Pesqueira;2;2;4;14
2307650;Maracanaú;2610707;Paulista;2;2;4;610
2603454;Camaragibe;2610707;Paulista;2;2;4;16
2609501;Nazaré da Mata;2610608;Paudalho;2;2;4;18
2608503;Lagoa do Itaenga;2610509;Passira;2;2;4;33
2609907;Ouricuri;2610400;Parnamirim;2;2;4;63
2605004;Cupira;2610202;Panelas;2;2;4;8
2606002;Garanhuns;2610004;Palmares;2;2;4;105
2602001;Bodocó;2609907;Ouricuri;2;2;4;22
2605301;Exu;2609907;Ouricuri;2;2;4;56
2608107;João Alfredo;2609709;Orobó;2;2;4;13
1302603;Manaus;2609600;Olinda;2;2;4;2810
2407104;Macaíba;2609600;Olinda;2;2;4;242
2504009;Campina Grande;2609600;Olinda;2;2;4;140
2605905;Gameleira;2609600;Olinda;2;2;4;84
2607208;Ipojuca;2609600;Olinda;2;2;4;48
2608909;Limoeiro;2609600;Olinda;2;2;4;62
2604205;Catende;2609204;Maraial;2;2;4;19
2507507;João Pessoa;2608909;Limoeiro;2;2;4;100
2601706;Belo Jardim;2608800;Lajedo;2;2;4;35
2603702;Canhotinho;2608800;Lajedo;2;2;4;28
2603801;Capoeiras;2608800;Lajedo;2;2;4;35
2602209;Bom Jardim;2608107;João Alfredo;2;2;4;7
2500601;Alhandra;2607901;Jaboatão dos Guararapes;2;2;4;76
2503209;Cabedelo;2607901;Jaboatão dos Guararapes;2;2;4;120
2601409;Barreiros;2607901;Jaboatão dos Guararapes;2;2;4;79
2606002;Garanhuns;2607901;Jaboatão dos Guararapes;2;2;4;184
2604601;Condado;2607802;Itaquitinga;2;2;4;9
2606804;Igarassu;2607802;Itaquitinga;2;2;4;27
2507507;João Pessoa;2607653;Itambé;2;2;4;37
2604007;Carpina;2607653;Itambé;2;2;4;50
2601201;Arcoverde;2607505;Itaíba;2;2;4;67
2601102;Araripina;2607307;Ipubi;2;2;4;38
2606002;Garanhuns;2607208;Ipojuca;2;2;4;169
2602902;Cabo de Santo Agostinho;2606804;Igarassu;2;2;4;49
2601706;Belo Jardim;2606408;Gravatá;2;2;4;96
2211001;Teresina;2606200;Goiana;2;2;4;901
2301901;Barbalha;2606200;Goiana;2;2;4;477
2408003;Mossoró;2606200;Goiana;2;2;4;369
2501807;Bayeux;2606200;Goiana;2;2;4;49
2600054;Abreu e Lima;2606200;Goiana;2;2;4;38
2304400;Fortaleza;2606002;Garanhuns;2;2;4;603
2507507;João Pessoa;2606002;Garanhuns;2;2;4;260
2602407;Brejão;2606002;Garanhuns;2;2;4;20
2602902;Cabo de Santo Agostinho;2606002;Garanhuns;2;2;4;177
2603702;Canhotinho;2606002;Garanhuns;2;2;4;38
2604007;Carpina;2606002;Garanhuns;2;2;4;180
2602001;Bodocó;2605301;Exu;2;2;4;34
2304400;Fortaleza;2605202;Escada;2;2;4;624
2601904;Bezerros;2605202;Escada;2;2;4;65
2601508;Belém de Maria;2605004;Cupira;2;2;4;16
2602308;Bonito;2605004;Cupira;2;2;4;29
2601300;Barra de Guabiraba;2604809;Cortês;2;2;4;14
2600708;Aliança;2604601;Condado;2;2;4;14
2600906;Amaraji;2604502;Chã Grande;2;2;4;16
2601904;Bezerros;2604502;Chã Grande;2;2;4;37
2604106;Caruaru;2604502;Chã Grande;2;2;4;59
2601508;Belém de Maria;2604205;Catende;2;2;4;12
2604106;Caruaru;2604205;Catende;2;2;4;53
2601300;Barra de Guabiraba;2604106;Caruaru;2;2;4;40
2601409;Barreiros;2604106;Caruaru;2;2;4;103
2600054;Abreu e Lima;2604007;Carpina;2;2;4;38
2603454;Camaragibe;2604007;Carpina;2;2;4;34
2600104;Afogados da Ingazeira;2603900;Carnaíba;2;2;4;19
2603207;Caetés;2603801;Capoeiras;2;2;4;4
2601003;Angelim;2603702;Canhotinho;2;2;4;10
2601904;Bezerros;2603504;Camocim de São Félix;2;2;4;14
2507507;João Pessoa;2602902;Cabo de Santo Agostinho;2;2;4;122
2600054;Abreu e Lima;2602902;Cabo de Santo Agostinho;2;2;4;45
2601201;Arcoverde;2602902;Cabo de Santo Agostinho;2;2;4;226
2601706;Belo Jardim;2602605;Brejo da Madre de Deus;2;2;4;25
2205953;Marcolândia;2601102;Araripina;2;2;4;28
2208007;Picos;2601102;Araripina;2;2;4;122
2304400;Fortaleza;2601102;Araripina;2;2;4;470
2304400;Fortaleza;2600054;Abreu e Lima;2;2;4;606
2516201;Sousa;2516904;Uiraúna;2;2;4;32
2512309;Princesa Isabel;2516607;Tavares;2;2;4;17
2505709;Dona Inês;2516409;Campo de Santana;2;2;4;12
2304400;Fortaleza;2516201;Sousa;2;2;4;333
2409407;Pau dos Ferros;2516201;Sousa;2;2;4;75
2501807;Bayeux;2516201;Sousa;2;2;4;372
2513208;Santa Cruz;2516201;Sousa;2;2;4;35
2513901;São Bento;2516201;Sousa;2;2;4;96
2514503;São José de Piranhas;2516201;Sousa;2;2;4;46
2502508;Boqueirão;2516102;Soledade;2;2;4;54
2504009;Campina Grande;2516003;Solânea;2;2;4;53
2507507;João Pessoa;2516003;Solânea;2;2;4;103
2508901;Mamanguape;2516003;Solânea;2;2;4;62
2511400;Picuí;2516003;Solânea;2;2;4;76
2504009;Campina Grande;2515302;Sapé;2;2;4;75
2504009;Campina Grande;2515104;São Sebastião de Lagoa de Roça;2;2;4;16
2507507;João Pessoa;2514503;São José de Piranhas;2;2;4;403
2402006;Caicó;2513901;São Bento;2;2;4;36
2502805;Brejo do Cruz;2513901;São Bento;2;2;4;16
2510808;Patos;2513901;São Bento;2;2;4;62
2304400;Fortaleza;2513703;Santa Rita;2;2;4;539
2503704;Cajazeiras;2513703;Santa Rita;2;2;4;397
2506004;Esperança;2512705;Remígio;2;2;4;12
2506004;Esperança;2512507;Queimadas;2;2;4;35
2503704;Cajazeiras;2512101;Pombal;2;2;4;90
2505501;Vista Serrana;2512101;Pombal;2;2;4;24
2510808;Patos;2512101;Pombal;2;2;4;60
2504009;Campina Grande;2512002;Pocinhos;2;2;4;23
2506301;Guarabira;2511608;Pilões;2;2;4;16
2506301;Guarabira;2511400;Picuí;2;2;4;101
2507507;João Pessoa;2511400;Picuí;2;2;4;179
2510105;Nova Floresta;2511400;Picuí;2;2;4;20
2503704;Cajazeiras;2511301;Piancó;2;2;4;82
2507903;Juripiranga;2511202;Pedras de Fogo;2;2;4;14
2408003;Mossoró;2510808;Patos;2;2;4;203
2504306;Catolé do Rocha;2510808;Patos;2;2;4;91
2505105;Cuité;2510105;Nova Floresta;2;2;4;6
2501302;Aroeiras;2509909;Natuba;2;2;4;18
2507507;João Pessoa;2509909;Natuba;2;2;4;92
2502409;Bonito de Santa Fé;2509602;Monte Horebe;2;2;4;13
2506301;Guarabira;2509107;Mari;2;2;4;29
2507507;João Pessoa;2509107;Mari;2;2;4;53
2500304;Alagoa Grande;2508901;Mamanguape;2;2;4;56
2503704;Cajazeiras;2508901;Mamanguape;2;2;4;380
2507507;João Pessoa;2508505;Livramento;2;2;4;231
2500304;Alagoa Grande;2507606;Juarez Távora;2;2;4;15
1501402;Belém;2507507;João Pessoa;2;2;4;1625
2303709;Caucaia;2507507;João Pessoa;2;2;4;569
2305407;Icó;2507507;João Pessoa;2;2;4;450
2306405;Itapipoca;2507507;João Pessoa;2;2;4;661
2307601;Limoeiro do Norte;2507507;João Pessoa;2;2;4;421
2403103;Currais Novos;2507507;João Pessoa;2;2;4;210
2501302;Aroeiras;2507507;João Pessoa;2;2;4;102
2501609;Barra de Santa Rosa;2507507;João Pessoa;2;2;4;143
2503605;Caiçara;2507507;João Pessoa;2;2;4;93
2504900;Cruz do Espírito Santo;2507507;João Pessoa;2;2;4;26
2501906;Belém;2507309;Jacaraú;2;2;4;29
2504009;Campina Grande;2507002;Itaporanga;2;2;4;249
2504405;Conceição;2507002;Itaporanga;2;2;4;46
2506806;Ingá;2506905;Itabaiana;2;2;4;35
2403251;Parnamirim;2506301;Guarabira;2;2;4;107
2500809;Araçagi;2506301;Guarabira;2;2;4;12
2501005;Araruna;2506301;Guarabira;2;2;4;44
2503209;Cabedelo;2506301;Guarabira;2;2;4;73
2506004;Esperança;2506301;Guarabira;2;2;4;43
2500304;Alagoa Grande;2506004;Esperança;2;2;4;25
2501104;Areia;2506004;Esperança;2;2;4;17
2501203;Areial;2506004;Esperança;2;2;4;10
2403103;Currais Novos;2505105;Cuité;2;2;4;47
2504009;Campina Grande;2504355;Caturité;2;2;4;27
2502904;Brejo dos Santos;2504306;Catolé do Rocha;2;2;4;9
2305704;Ipaumirim;2504009;Campina Grande;2;2;4;315
2307650;Maracanaú;2504009;Campina Grande;2;2;4;478
2409407;Pau dos Ferros;2504009;Campina Grande;2;2;4;286
2501104;Areia;2504009;Campina Grande;2;2;4;36
2305407;Icó;2503704;Cajazeiras;2;2;4;62
2305506;Iguatu;2503704;Cajazeiras;2;2;4;102
2305704;Ipaumirim;2503704;Cajazeiras;2;2;4;19
2307304;Juazeiro do Norte;2503704;Cajazeiras;2;2;4;88
2403251;Parnamirim;2503704;Cajazeiras;2;2;4;382
2501302;Aroeiras;2503704;Cajazeiras;2;2;4;326
2502409;Bonito de Santa Fé;2503704;Cajazeiras;2;2;4;47
2304285;Eusébio;2503209;Cabedelo;2;2;4;528
2304400;Fortaleza;2503001;Caaporã;2;2;4;576
2501906;Belém;2503001;Caaporã;2;2;4;109
2501302;Aroeiras;2502508;Boqueirão;2;2;4;47
2500304;Alagoa Grande;2501807;Bayeux;2;2;4;76
2500502;Alagoinha;2501104;Areia;2;2;4;16
2402204;Canguaretama;2415008;Vila Flor;2;2;4;9
2400505;Alexandria;2414506;Umarizal;2;2;4;52
2402303;Caraúbas;2414506;Umarizal;2;2;4;36
2402600;Ceará-Mirim;2414407;Touros;2;2;4;47
2403103;Currais Novos;2414001;Tangará;2;2;4;79
2412302;São José do Campestre;2414001;Tangará;2;2;4;16
2408102;Natal;2413904;Taipu;2;2;4;44
2411502;Santo Antônio;2413508;Serrinha;2;2;4;4
2402006;Caicó;2413409;Serra Negra do Norte;2;2;4;38
2408102;Natal;2413003;São Vicente;2;2;4;165
2409332;Santa Maria;2412906;São Tomé;2;2;4;45
2412005;São Gonçalo do Amarante;2412906;São Tomé;2;2;4;85
2412609;São Paulo do Potengi;2412906;São Tomé;2;2;4;36
2405801;João Câmara;2412609;São Paulo do Potengi;2;2;4;40
2406700;Lajes;2412609;São Paulo do Potengi;2;2;4;58
2411403;Santana do Matos;2412609;São Paulo do Potengi;2;2;4;99
2412203;São José de Mipibu;2412609;São Paulo do Potengi;2;2;4;60
2310803;Pereiro;2412500;São Miguel;2;2;4;19
2408102;Natal;2412500;São Miguel;2;2;4;360
2402006;Caicó;2412401;São José do Seridó;2;2;4;28
2401206;Arês;2412203;São José de Mipibu;2;2;4;16
2402006;Caicó;2411809;São Fernando;2;2;4;11
2411205;Santa Cruz;2411502;Santo Antônio;2;2;4;59
2405405;Japi;2411205;Santa Cruz;2;2;4;25
2408003;Mossoró;2411056;Tibau;2;2;4;37
2405108;Jandaíra;2410405;Pureza;2;2;4;65
2409407;Pau dos Ferros;2410207;Portalegre;2;2;4;30
2408102;Natal;2410108;Poço Branco;2;2;4;51
2400703;Alto do Rodrigues;2409902;Pendências;2;2;4;9
2403251;Parnamirim;2409902;Pendências;2;2;4;173
2407203;Macau;2409902;Pendências;2;2;4;18
2402006;Caicó;2409407;Pau dos Ferros;2;2;4;130
2402303;Caraúbas;2409407;Pau dos Ferros;2;2;4;83
2402006;Caicó;2408904;Parelhas;2;2;4;58
2408102;Natal;2408300;Nova Cruz;2;2;4;76
2100055;Açailândia;2408102;Natal;2;2;4;1356
2307304;Juazeiro do Norte;2408102;Natal;2;2;4;477
2309607;Pacajus;2408102;Natal;2;2;4;399
2401206;Arês;2408102;Natal;2;2;4;43
2402402;Carnaúba dos Dantas;2408102;Natal;2;2;4;170
2402501;Carnaubais;2408102;Natal;2;2;4;183
2402808;Coronel Ezequiel;2408102;Natal;2;2;4;124
2403756;Fernando Pedroza;2408102;Natal;2;2;4;143
2405108;Jandaíra;2408102;Natal;2;2;4;110
2405603;Jardim de Piranhas;2408102;Natal;2;2;4;241
2406106;Jucurutu;2408102;Natal;2;2;4;193
2111300;São Luís;2408003;Mossoró;2;2;4;817
2208403;Piripiri;2408003;Mossoró;2;2;4;502
2211001;Teresina;2408003;Mossoró;2;2;4;604
2301000;Aquiraz;2408003;Mossoró;2;2;4;183
2303709;Caucaia;2408003;Mossoró;2;2;4;219
2305357;Icapuí;2408003;Mossoró;2;2;4;50
2307007;Jaguaruana;2408003;Mossoró;2;2;4;62
2307650;Maracanaú;2408003;Mossoró;2;2;4;205
2313104;Tabuleiro do Norte;2408003;Mossoró;2;2;4;87
2400505;Alexandria;2408003;Mossoró;2;2;4;155
2403608;Extremoz;2408003;Mossoró;2;2;4;233
2404309;Governador Dix-Sept Rosado;2408003;Mossoró;2;2;4;35
2406106;Jucurutu;2408003;Mossoró;2;2;4;103
2406700;Lajes;2408003;Mossoró;2;2;4;135
2403608;Extremoz;2407500;Maxaranguape;2;2;4;25
2401859;Caiçara do Norte;2407203;Macau;2;2;4;62
2405801;João Câmara;2407203;Macau;2;2;4;101
2307650;Maracanaú;2407104;Macaíba;2;2;4;425
2402709;Cerro Corá;2406502;Lagoa Nova;2;2;4;15
2400208;Açu;2404853;Itajá;2;2;4;11
2400703;Alto do Rodrigues;2404507;Guamaré;2;2;4;53
2401107;Areia Branca;2404408;Grossos;2;2;4;3
2403707;Felipe Guerra;2404309;Governador Dix-Sept Rosado;2;2;4;26
2401404;Baía Formosa;2404200;Goianinha;2;2;4;17
2403251;Parnamirim;2404200;Goianinha;2;2;4;47
2403103;Currais Novos;2403806;Florânia;2;2;4;37
2401008;Apodi;2403707;Felipe Guerra;2;2;4;27
2402402;Carnaúba dos Dantas;2403400;Equador;2;2;4;45
2306256;Itaitinga;2403251;Parnamirim;2;2;4;420
2400208;Açu;2403103;Currais Novos;2;2;4;89
2402402;Carnaúba dos Dantas;2403103;Currais Novos;2;2;4;34
2401651;Bodó;2402709;Cerro Corá;2;2;4;10
2400208;Açu;2402501;Carnaubais;2;2;4;26
2400703;Alto do Rodrigues;2402501;Carnaubais;2;2;4;10
2301109;Aracati;2401453;Baraúna;2;2;4;58
2400208;Açu;2401453;Baraúna;2;2;4;94
2303709;Caucaia;2401008;Apodi;2;2;4;245
2311801;Russas;2401008;Apodi;2;2;4;95
2400307;Afonso Bezerra;2400802;Angicos;2;2;4;29
2400703;Alto do Rodrigues;2400802;Angicos;2;2;4;52
2313609;Ubajara;2314102;Viçosa do Ceará;2;2;4;37
2303808;Cedro;2314003;Várzea Alegre;2;2;4;33
2304400;Fortaleza;2314003;Várzea Alegre;2;2;4;344
2305001;Guaraciaba do Norte;2313955;Varjota;2;2;4;30
2306405;Itapipoca;2313807;Uruburetama;2;2;4;16
2207702;Parnaíba;2313609;Ubajara;2;2;4;145
2305506;Iguatu;2313609;Ubajara;2;2;4;328
2300903;Apuiarés;2313500;Trairi;2;2;4;80
2207702;Parnaíba;2313401;Tianguá;2;2;4;130
2211001;Teresina;2313401;Tianguá;2;2;4;251
2301000;Aquiraz;2313401;Tianguá;2;2;4;289
2305001;Guaraciaba do Norte;2313401;Tianguá;2;2;4;55
2305308;Ibiapina;2313401;Tianguá;2;2;4;24
2300408;Aiuaba;2313302;Tauá;2;2;4;67
2302701;Campos Sales;2313302;Tauá;2;2;4;119
2305605;Independência;2313302;Tauá;2;2;4;66
2308500;Mombaça;2313302;Tauá;2;2;4;84
2308609;Monsenhor Tabosa;2313203;Tamboril;2;2;4;27
2306900;Jaguaribe;2313104;Tabuleiro do Norte;2;2;4;91
2311306;Quixadá;2313104;Tabuleiro do Norte;2;2;4;107
2312502;São João do Jaguaribe;2313104;Tabuleiro do Norte;2;2;4;16
2308351;Milhã;2313005;Solonópole;2;2;4;22
2312700;Senador Pompeu;2313005;Solonópole;2;2;4;51
2109908;Santa Inês;2312908;Sobral;2;2;4;564
2112209;Timon;2312908;Sobral;2;2;4;321
2208007;Picos;2312908;Sobral;2;2;4;397
2208403;Piripiri;2312908;Sobral;2;2;4;171
2300200;Acaraú;2312908;Sobral;2;2;4;90
2305001;Guaraciaba do Norte;2312908;Sobral;2;2;4;70
2306306;Itapagé;2312908;Sobral;2;2;4;86
2308203;Meruoca;2312908;Sobral;2;2;4;17
2307809;Marco;2312809;Senador Sá;2;2;4;43
2308005;Massapê;2312809;Senador Sá;2;2;4;23
2312403;São Gonçalo do Amarante;2312601;São Luís do Curu;2;2;4;31
2310704;Pentecoste;2312403;São Gonçalo do Amarante;2;2;4;39
2207702;Parnaíba;2312304;São Benedito;2;2;4;166
2303402;Carnaubal;2312304;São Benedito;2;2;4;16
2304236;Croatá;2312304;São Benedito;2;2;4;40
2305308;Ibiapina;2312304;São Benedito;2;2;4;14
2302800;Canindé;2312205;Santa Quitéria;2;2;4;93
2304103;Crateús;2312205;Santa Quitéria;2;2;4;109
2309201;Nova Olinda;2312106;Santana do Cariri;2;2;4;12
2307254;Jijoca de Jericoacoara;2312007;Santana do Acaraú;2;2;4;83
2302701;Campos Sales;2311959;Salitre;2;2;4;25
2300309;Acopiara;2311900;Saboeiro;2;2;4;69
2300705;Alto Santo;2311801;Russas;2;2;4;73
2303501;Cascavel;2311801;Russas;2;2;4;93
2303709;Caucaia;2311801;Russas;2;2;4;154
2305407;Icó;2311801;Russas;2;2;4;191
2306702;Jaguaretama;2311801;Russas;2;2;4;117
2306900;Jaguaribe;2311801;Russas;2;2;4;130
2308302;Milagres;2311801;Russas;2;2;4;285
2309458;Ocara;2311801;Russas;2;2;4;84
2305001;Guaraciaba do Norte;2311702;Reriutaba;2;2;4;19
2301208;Aracoiaba;2311603;Redenção;2;2;4;21
2301950;Barreira;2311603;Redenção;2;2;4;14
2302909;Capistrano;2311603;Redenção;2;2;4;34
2304400;Fortaleza;2311603;Redenção;2;2;4;53
2307007;Jaguaruana;2311504;Quixeré;2;2;4;35
2307601;Limoeiro do Norte;2311504;Quixeré;2;2;4;13
2307601;Limoeiro do Norte;2311405;Quixeramobim;2;2;4;134
2307700;Maranguape;2311405;Quixeramobim;2;2;4;158
2308500;Mombaça;2311405;Quixeramobim;2;2;4;68
2308708;Morada Nova;2311405;Quixeramobim;2;2;4;101
2300309;Acopiara;2311306;Quixadá;2;2;4;133
2304103;Crateús;2311009;Poranga;2;2;4;56
2300309;Acopiara;2310902;Piquet Carneiro;2;2;4;32
2304400;Fortaleza;2310803;Pereiro;2;2;4;251
2302404;Boa Viagem;2310506;Pedra Branca;2;2;4;29
2304400;Fortaleza;2310506;Pedra Branca;2;2;4;228
2304400;Fortaleza;2310308;Parambu;2;2;4;359
2305506;Iguatu;2310308;Parambu;2;2;4;151
2300903;Apuiarés;2310258;Paraipaba;2;2;4;65
2306306;Itapagé;2310209;Paracuru;2;2;4;72
2307700;Maranguape;2310100;Palmácia;2;2;4;34
2309102;Mulungu;2310100;Palmácia;2;2;4;24
2304400;Fortaleza;2310001;Palhano;2;2;4;126
2302107;Baturité;2309805;Pacoti;2;2;4;12
2304954;Guaiúba;2309706;Pacatuba;2;2;4;6
2303956;Chorozinho;2309607;Pacajus;2;2;4;15
2304400;Fortaleza;2309508;Orós;2;2;4;280
2305506;Iguatu;2309508;Orós;2;2;4;48
2304400;Fortaleza;2309300;Nova Russas;2;2;4;246
2305332;Ibicuitinga;2308708;Morada Nova;2;2;4;34
2305506;Iguatu;2308708;Morada Nova;2;2;4;172
2304400;Fortaleza;2308500;Mombaça;2;2;4;246
2302503;Brejo Santo;2308401;Missão Velha;2;2;4;30
2304400;Fortaleza;2308401;Missão Velha;2;2;4;391
2301703;Aurora;2308302;Milagres;2;2;4;42
2302503;Brejo Santo;2308302;Milagres;2;2;4;20
2307304;Juazeiro do Norte;2308104;Mauriti;2;2;4;62
2304251;Cruz;2307809;Marco;2;2;4;23
2302107;Baturité;2307700;Maranguape;2;2;4;53
1501402;Belém;2307650;Maracanaú;2;2;4;1121
2207702;Parnaíba;2307650;Maracanaú;2;2;4;366
2211001;Teresina;2307650;Maracanaú;2;2;4;482
2300200;Acaraú;2307650;Maracanaú;2;2;4;193
2302404;Boa Viagem;2307650;Maracanaú;2;2;4;190
2305506;Iguatu;2307601;Limoeiro do Norte;2;2;4;192
2304400;Fortaleza;2307502;Lavras da Mangabeira;2;2;4;334
1501402;Belém;2307304;Juazeiro do Norte;2;2;4;1193
2301604;Assaré;2307304;Juazeiro do Norte;2;2;4;73
2304285;Eusébio;2307304;Juazeiro do Norte;2;2;4;381
2302602;Camocim;2307254;Jijoca de Jericoacoara;2;2;4;44
2304400;Fortaleza;2307254;Jijoca de Jericoacoara;2;2;4;243
2306553;Itarema;2307254;Jijoca de Jericoacoara;2;2;4;67
2301901;Barbalha;2307106;Jardim;2;2;4;29
2304400;Fortaleza;2306553;Itarema;2;2;4;180
2300200;Acaraú;2306405;Itapipoca;2;2;4;87
2304400;Fortaleza;2306207;Itaiçaba;2;2;4;128
2300705;Alto Santo;2306009;Iracema;2;2;4;32
2304103;Crateús;2305902;Ipueiras;2;2;4;75
2302800;Canindé;2305803;Ipu;2;2;4;154
2301109;Aracati;2305506;Iguatu;2;2;4;264
2302503;Brejo Santo;2305506;Iguatu;2;2;4;131
2302701;Campos Sales;2305506;Iguatu;2;2;4;139
2303303;Cariús;2305506;Iguatu;2;2;4;28
2303709;Caucaia;2305506;Iguatu;2;2;4;299
2305233;Horizonte;2305506;Iguatu;2;2;4;265
2301109;Aracati;2305357;Icapuí;2;2;4;46
2304400;Fortaleza;2305100;Guaramiranga;2;2;4;70
2207702;Parnaíba;2305001;Guaraciaba do Norte;2;2;4;184
2300903;Apuiarés;2304608;General Sampaio;2;2;4;10
2304400;Fortaleza;2304509;Frecheirinha;2;2;4;253
2301109;Aracati;2304459;Fortim;2;2;4;14
2302206;Beberibe;2304459;Fortim;2;2;4;48
1100122;Ji-Paraná;2304400;Fortaleza;2;2;4;2730
1304203;Tefé;2304400;Fortaleza;2;2;4;2905
1505502;Paragominas;2304400;Fortaleza;2;2;4;981
1505536;Parauapebas;2304400;Fortaleza;2;2;4;1282
1709500;Gurupi;2304400;Fortaleza;2;2;4;1469
2109106;Presidente Dutra;2304400;Fortaleza;2;2;4;684
2114007;Zé Doca;2304400;Fortaleza;2;2;4;811
2208403;Piripiri;2304400;Fortaleza;2;2;4;365
2210607;São Raimundo Nonato;2304400;Fortaleza;2;2;4;742
2300101;Abaiara;2304400;Fortaleza;2;2;4;401
2300309;Acopiara;2304400;Fortaleza;2;2;4;276
2301851;Banabuiú;2304400;Fortaleza;2;2;4;176
2301950;Barreira;2304400;Fortaleza;2;2;4;59
2302701;Campos Sales;2304400;Fortaleza;2;2;4;419
2303808;Cedro;2304400;Fortaleza;2;2;4;319
2301000;Aquiraz;2304350;Forquilha;2;2;4;208
1501402;Belém;2304285;Eusébio;2;2;4;1142
1504422;Marituba;2304285;Eusébio;2;2;4;1133
2112209;Timon;2304285;Eusébio;2;2;4;509
2301000;Aquiraz;2304285;Eusébio;2;2;4;7
2300309;Acopiara;2304269;Deputado Irapuan Pinheiro;2;2;4;29
2301604;Assaré;2304202;Crato;2;2;4;64
2302404;Boa Viagem;2304103;Crateús;2;2;4;105
2302602;Camocim;2304004;Coreaú;2;2;4;72
2301000;Aquiraz;2303709;Caucaia;2;2;4;37
2302800;Canindé;2303709;Caucaia;2;2;4;99
2300309;Acopiara;2303600;Catarina;2;2;4;45
2301109;Aracati;2303501;Cascavel;2;2;4;73
2301901;Barbalha;2303204;Caririaçu;2;2;4;31
2207702;Parnaíba;2302602;Camocim;2;2;4;101
2302057;Barroquinha;2302602;Camocim;2;2;4;30
2301109;Aracati;2302206;Beberibe;2;2;4;61
2200202;Água Branca;2211308;Valença do Piauí;2;2;4;108
2201200;Barras;2211308;Valença do Piauí;2;2;4;243
2203503;Elesbão Veloso;2211308;Valença do Piauí;2;2;4;43
2206902;Novo Oriente do Piauí;2211308;Valença do Piauí;2;2;4;16
2210607;São Raimundo Nonato;2211308;Valença do Piauí;2;2;4;303
2208007;Picos;2211209;Uruçuí;2;2;4;340
1500800;Ananindeua;2211001;Teresina;2;2;4;742
1502400;Castanhal;2211001;Teresina;2;2;4;705
2101400;Balsas;2211001;Teresina;2;2;4;451
2103208;Chapadinha;2211001;Teresina;2;2;4;164
2104008;Esperantinópolis;2211001;Teresina;2;2;4;215
2107704;Paraibano;2211001;Teresina;2;2;4;195
2107803;Parnarama;2211001;Teresina;2;2;4;77
2109106;Presidente Dutra;2211001;Teresina;2;2;4;190
2200509;Amarante;2211001;Teresina;2;2;4;131
2200905;Aroazes;2211001;Teresina;2;2;4;159
2201705;Bertolínia;2211001;Teresina;2;2;4;311
2202000;Buriti dos Lopes;2211001;Teresina;2;2;4;233
2203206;Curimatá;2211001;Teresina;2;2;4;572
2204501;Guadalupe;2211001;Teresina;2;2;4;205
2205201;Jaicós;2211001;Teresina;2;2;4;310
2205581;Lagoa do Piauí;2211001;Teresina;2;2;4;40
2206100;Matias Olímpio;2211001;Teresina;2;2;4;154
2207207;Padre Marcos;2211001;Teresina;2;2;4;327
2207504;Palmeirais;2211001;Teresina;2;2;4;102
2207603;Parnaguá;2211001;Teresina;2;2;4;602
2208304;Piracuruca;2211001;Teresina;2;2;4;174
2209005;Rio Grande do Piauí;2211001;Teresina;2;2;4;300
2210508;São Pedro do Piauí;2211001;Teresina;2;2;4;92
2210805;Simplício Mendes;2211001;Teresina;2;2;4;320
2208007;Picos;2210938;Sussuapara;2;2;4;11
2204907;Isaías Coelho;2210805;Simplício Mendes;2;2;4;31
2201929;Bonfim do Piauí;2210607;São Raimundo Nonato;2;2;4;27
2202505;Caracol;2210607;São Raimundo Nonato;2;2;4;75
2203453;Dom Inocêncio;2210607;São Raimundo Nonato;2;2;4;84
2203909;Floriano;2210607;São Raimundo Nonato;2;2;4;241
2210359;São Lourenço do Piauí;2210607;São Raimundo Nonato;2;2;4;30
2200202;Água Branca;2210508;São Pedro do Piauí;2;2;4;9
2208809;Regeneração;2210508;São Pedro do Piauí;2;2;4;39
2202208;Campo Maior;2210409;São Miguel do Tapuio;2;2;4;119
2208304;Piracuruca;2210052;São José do Divino;2;2;4;20
2207934;Pedro Laurentino;2210003;São João do Piauí;2;2;4;33
2208007;Picos;2209856;São João da Canabrava;2;2;4;33
2205102;Itaueira;2208874;Ribeira do Piauí;2;2;4;40
2200509;Amarante;2208809;Regeneração;2;2;4;17
2207801;Paulistana;2208650;Queimada Nova;2;2;4;53
2202000;Buriti dos Lopes;2208403;Piripiri;2;2;4;118
2206357;Milton Brandão;2208403;Piripiri;2;2;4;60
2208304;Piracuruca;2208403;Piripiri;2;2;4;37
2203701;Esperantina;2208304;Piracuruca;2;2;4;58
2112209;Timon;2208007;Picos;2;2;4;264
2203503;Elesbão Veloso;2208007;Picos;2;2;4;122
2202208;Campo Maior;2207900;Pedro II;2;2;4;95
2207702;Parnaíba;2207900;Pedro II;2;2;4;176
2205201;Jaicós;2207801;Paulistana;2;2;4;91
2103208;Chapadinha;2207702;Parnaíba;2;2;4;199
2105302;Imperatriz;2207702;Parnaíba;2;2;4;693
2112506;Tutóia;2207702;Parnaíba;2;2;4;58
2201507;Batalha;2207702;Parnaíba;2;2;4;131
2202083;Cajueiro da Praia;2207702;Parnaíba;2;2;4;49
2202208;Campo Maior;2207702;Parnaíba;2;2;4;223
2205409;Joaquim Pires;2207702;Parnaíba;2;2;4;83
2201903;Bom Jesus;2207009;Oeiras;2;2;4;338
2202901;Corrente;2206605;Monte Alegre do Piauí;2;2;4;76
2202174;Campo Largo do Piauí;2206100;Matias Olímpio;2;2;4;13
2201200;Barras;2205805;Luzilândia;2;2;4;83
2201507;Batalha;2205805;Luzilândia;2;2;4;66
2201919;Bom Princípio do Piauí;2205706;Luís Correia;2;2;4;33
2202000;Buriti dos Lopes;2205706;Luís Correia;2;2;4;40
2202208;Campo Maior;2205508;José de Freitas;2;2;4;43
2200202;Água Branca;2203909;Floriano;2;2;4;110
2202307;Canto do Buriti;2203909;Floriano;2;2;4;138
2201200;Barras;2203701;Esperantina;2;2;4;41
2201101;Avelino Lopes;2203206;Curimatá;2;2;4;39
2202307;Canto do Buriti;2203107;Cristino Castro;2;2;4;162
2202901;Corrente;2203008;Cristalândia do Piauí;2;2;4;22
2200459;Alvorada do Gurguéia;2202752;Colônia do Gurguéia;2;2;4;27
2110906;São Francisco do Maranhão;2200509;Amarante;2;2;4;7
2200301;Alto Longá;2200400;Altos;2;2;4;35
2103307;Codó;2114007;Zé Doca;2;2;4;251
2105708;Lago da Pedra;2114007;Zé Doca;2;2;4;163
2110039;Santa Luzia do Paruá;2114007;Zé Doca;2;2;4;68
2105708;Lago da Pedra;2113009;Vitorino Freire;2;2;4;60
2103000;Caxias;2112803;Viana;2;2;4;272
2103307;Codó;2112803;Viana;2;2;4;194
2109908;Santa Inês;2112803;Viana;2;2;4;83
2101202;Bacabal;2112704;Vargem Grande;2;2;4;120
2103208;Chapadinha;2112704;Vargem Grande;2;2;4;61
2103307;Codó;2112704;Vargem Grande;2;2;4;105
2111508;São Mateus do Maranhão;2112704;Vargem Grande;2;2;4;85
2110401;São Benedito do Rio Preto;2112605;Urbano Santos;2;2;4;20
2103208;Chapadinha;2112506;Tutóia;2;2;4;157
2103802;Dom Pedro;2112308;Tuntum;2;2;4;32
2109106;Presidente Dutra;2112308;Tuntum;2;2;4;18
2103307;Codó;2112209;Timon;2;2;4;139
2104800;Grajaú;2111805;Sítio Novo;2;2;4;70
2105302;Imperatriz;2111763;Senador La Rocque;2;2;4;18
2101400;Balsas;2111607;São Raimundo das Mangabeiras;2;2;4;89
2109106;Presidente Dutra;2111607;São Raimundo das Mangabeiras;2;2;4;214
2100055;Açailândia;2111532;São Pedro da Água Branca;2;2;4;102
2105302;Imperatriz;2111532;São Pedro da Água Branca;2;2;4;112
2102705;Cantanhede;2111508;São Mateus do Maranhão;2;2;4;46
2105401;Itapecuru Mirim;2111508;São Mateus do Maranhão;2;2;4;73
2106755;Miranda do Norte;2111508;São Mateus do Maranhão;2;2;4;54
1100205;Porto Velho;2111300;São Luís;2;2;4;2299
1502152;Canaã dos Carajás;2111300;São Luís;2;2;4;767
1503606;Itaituba;2111300;São Luís;2;2;4;1323
1503903;Juruti;2111300;São Luís;2;2;4;1315
1505437;Ourilândia do Norte;2111300;São Luís;2;2;4;896
2103406;Coelho Neto;2111300;São Luís;2;2;4;232
2103505;Colinas;2111300;São Luís;2;2;4;390
2103604;Coroatá;2111300;São Luís;2;2;4;181
2103802;Dom Pedro;2111300;São Luís;2;2;4;280
2104677;Governador Nunes Freire;2111300;São Luís;2;2;4;189
2107704;Paraibano;2111300;São Luís;2;2;4;429
2109809;Santa Helena;2111300;São Luís;2;2;4;117
2110039;Santa Luzia do Paruá;2111300;São Luís;2;2;4;171
2110104;Santa Quitéria do Maranhão;2111300;São Luís;2;2;4;213
2110708;São Domingos do Maranhão;2111300;São Luís;2;2;4;339
2108207;Pedreiras;2111102;São João dos Patos;2;2;4;234
2102556;Campestre do Maranhão;2111052;São João do Paraíso;2;2;4;47
2110104;Santa Quitéria do Maranhão;2110609;São Bernardo;2;2;4;24
2103802;Dom Pedro;2110302;Santo Antônio dos Lopes;2;2;4;22
2106755;Miranda do Norte;2110203;Santa Rita;2;2;4;65
2109601;Rosário;2110203;Santa Rita;2;2;4;16
2104677;Governador Nunes Freire;2110039;Santa Luzia do Paruá;2;2;4;57
2101202;Bacabal;2110005;Santa Luzia;2;2;4;110
1505536;Parauapebas;2109908;Santa Inês;2;2;4;546
2103307;Codó;2109908;Santa Inês;2;2;4;182
2105153;Igarapé do Meio;2109908;Santa Inês;2;2;4;30
2109106;Presidente Dutra;2109908;Santa Inês;2;2;4;194
2109106;Presidente Dutra;2109601;Rosário;2;2;4;266
2102556;Campestre do Maranhão;2109551;Ribamar Fiquene;2;2;4;27
2101400;Balsas;2109502;Riachão;2;2;4;62
2100436;Alto Alegre do Maranhão;2109106;Presidente Dutra;2;2;4;121
2103000;Caxias;2109106;Presidente Dutra;2;2;4;139
2103802;Dom Pedro;2109106;Presidente Dutra;2;2;4;29
2104602;Governador Eugênio Barros;2109106;Presidente Dutra;2;2;4;27
2105609;Joselândia;2109106;Presidente Dutra;2;2;4;44
2105708;Lago da Pedra;2109106;Presidente Dutra;2;2;4;111
2107704;Paraibano;2109106;Presidente Dutra;2;2;4;134
2107803;Parnarama;2109106;Presidente Dutra;2;2;4;156
2107902;Passagem Franca;2109106;Presidente Dutra;2;2;4;125
2108009;Pastos Bons;2109106;Presidente Dutra;2;2;4;153
2102556;Campestre do Maranhão;2109007;Porto Franco;2;2;4;20
2105708;Lago da Pedra;2108900;Poção de Pedras;2;2;4;34
2103604;Coroatá;2108801;Pirapemas;2;2;4;49
1501402;Belém;2108603;Pinheiro;2;2;4;389
2103208;Chapadinha;2108603;Pinheiro;2;2;4;237
2103307;Codó;2108603;Pinheiro;2;2;4;255
2105708;Lago da Pedra;2108207;Pedreiras;2;2;4;65
2101400;Balsas;2108009;Pastos Bons;2;2;4;240
2105302;Imperatriz;2107506;Paço do Lumiar;2;2;4;496
2105005;Humberto de Campos;2107100;Morros;2;2;4;71
2105104;Icatu;2107100;Morros;2;2;4;10
2103000;Caxias;2106607;Matões;2;2;4;75
2105708;Lago da Pedra;2105948;Lago dos Rodrigues;2;2;4;27
2104008;Esperantinópolis;2105708;Lago da Pedra;2;2;4;60
1502939;Dom Eliseu;2105427;Itinga do Maranhão;2;2;4;18
2100709;Anajatuba;2105401;Itapecuru Mirim;2;2;4;38
2101202;Bacabal;2105401;Itapecuru Mirim;2;2;4;102
1500859;Anapu;2105302;Imperatriz;2;2;4;473
1503804;Jacundá;2105302;Imperatriz;2;2;4;223
1507953;Tailândia;2105302;Imperatriz;2;2;4;326
1700301;Aguiarnópolis;2105302;Imperatriz;2;2;4;116
1705508;Colinas do Tocantins;2105302;Imperatriz;2;2;4;304
1716109;Paraíso do Tocantins;2105302;Imperatriz;2;2;4;540
1721208;Tocantinópolis;2105302;Imperatriz;2;2;4;90
2101608;Barra do Corda;2105302;Imperatriz;2;2;4;246
2102002;Bom Jardim;2105302;Imperatriz;2;2;4;300
2102804;Carolina;2105302;Imperatriz;2;2;4;205
2101400;Balsas;2104107;Fortaleza dos Nogueiras;2;2;4;61
1702109;Araguaína;2104057;Estreito;2;2;4;112
2101202;Bacabal;2103802;Dom Pedro;2;2;4;98
2101608;Barra do Corda;2103802;Dom Pedro;2;2;4;100
2103307;Codó;2103802;Dom Pedro;2;2;4;85
2102705;Cantanhede;2103604;Coroatá;2;2;4;64
2101608;Barra do Corda;2103307;Codó;2;2;4;183
2103208;Chapadinha;2103307;Codó;2;2;4;105
2100055;Açailândia;2103257;Cidelândia;2;2;4;42
2100808;Anapurus;2103208;Chapadinha;2;2;4;29
1501402;Belém;2103000;Caxias;2;2;4;685
2101202;Bacabal;2103000;Caxias;2;2;4;173
2101400;Balsas;2103000;Caxias;2;2;4;423
1709005;Goiatins;2102804;Carolina;2;2;4;40
1721000;Palmas;2102804;Carolina;2;2;4;348
2100055;Açailândia;2102325;Buriticupu;2;2;4;136
2100808;Anapurus;2102101;Brejo;2;2;4;41
2100055;Açailândia;2102036;Bom Jesus das Selvas;2;2;4;98
2100477;Alto Alegre do Pindaré;2102002;Bom Jardim;2;2;4;39
1716505;Pedro Afonso;2101400;Balsas;2;2;4;286
1504422;Marituba;2100055;Açailândia;2;2;4;410
1508126;Ulianópolis;2100055;Açailândia;2;2;4;134
1702554;Augustinópolis;1721208;Tocantinópolis;2;2;4;109
1706506;Darcinópolis;1721208;Tocantinópolis;2;2;4;55
1721000;Palmas;1721208;Tocantinópolis;2;2;4;458
1100205;Porto Velho;1721000;Palmas;2;2;4;1702
1700707;Alvorada;1721000;Palmas;2;2;4;249
1703701;Brejinho de Nazaré;1721000;Palmas;2;2;4;75
1703909;Caseara;1721000;Palmas;2;2;4;211
1706100;Cristalândia;1721000;Palmas;2;2;4;95
1707306;Dueré;1721000;Palmas;2;2;4;147
1711902;Lagoa da Confusão;1721000;Palmas;2;2;4;146
1711951;Lagoa do Tocantins;1721000;Palmas;2;2;4;90
1712405;Lizarda;1721000;Palmas;2;2;4;207
1713601;Monte do Carmo;1721000;Palmas;2;2;4;53
1716604;Peixe;1721000;Palmas;2;2;4;185
1716703;Colméia;1721000;Palmas;2;2;4;185
1717503;Pium;1721000;Palmas;2;2;4;89
1718758;Rio Sono;1721000;Palmas;2;2;4;124
1718865;Santa Fé do Araguaia;1721000;Palmas;2;2;4;359
1719004;Santa Tereza do Tocantins;1721000;Palmas;2;2;4;64
1702109;Araguaína;1718865;Santa Fé do Araguaia;2;2;4;56
1709302;Guaraí;1718402;Presidente Kennedy;2;2;4;38
1702109;Araguaína;1718204;Porto Nacional;2;2;4;389
1709500;Gurupi;1718204;Porto Nacional;2;2;4;135
1712504;Marianópolis do Tocantins;1717503;Pium;2;2;4;88
1716505;Pedro Afonso;1716703;Colméia;2;2;4;73
1716653;Pequizeiro;1716703;Colméia;2;2;4;24
1709302;Guaraí;1716653;Pequizeiro;2;2;4;56
1702109;Araguaína;1716505;Pedro Afonso;2;2;4;201
1716109;Paraíso do Tocantins;1716505;Pedro Afonso;2;2;4;152
1702307;Arapoema;1716307;Pau d'Arco;2;2;4;32
1707207;Dois Irmãos do Tocantins;1716109;Paraíso do Tocantins;2;2;4;102
1711902;Lagoa da Confusão;1716109;Paraíso do Tocantins;2;2;4;105
1712504;Marianópolis do Tocantins;1716109;Paraíso do Tocantins;2;2;4;91
1713304;Miranorte;1716109;Paraíso do Tocantins;2;2;4;80
1715002;Nova Rosalândia;1716109;Paraíso do Tocantins;2;2;4;45
1702109;Araguaína;1714880;Nova Olinda;2;2;4;54
1703867;Cariri do Tocantins;1714880;Nova Olinda;2;2;4;478
1707009;Dianópolis;1714203;Natividade;2;2;4;100
1709500;Gurupi;1714203;Natividade;2;2;4;139
1709302;Guaraí;1713205;Miracema do Tocantins;2;2;4;76
1700251;Abreulândia;1712504;Marianópolis do Tocantins;2;2;4;58
1703867;Cariri do Tocantins;1709500;Gurupi;2;2;4;23
1707652;Figueirópolis;1709500;Gurupi;2;2;4;49
1702000;Araguaçu;1708205;Formoso do Araguaia;2;2;4;130
1702109;Araguaína;1707702;Filadélfia;2;2;4;80
1702406;Arraias;1705557;Combinado;2;2;4;49
1702307;Arapoema;1705508;Colinas do Tocantins;2;2;4;79
1501303;Barcarena;1600808;Vitória do Jari;2;2;4;433
1600600;Santana;1600709;Tartarugalzinho;2;2;4;170
1500800;Ananindeua;1600600;Santana;2;2;4;346
1600279;Laranjal do Jari;1600600;Santana;2;2;4;153
1600535;Porto Grande;1600600;Santana;2;2;4;82
1501402;Belém;1600501;Oiapoque;2;2;4;683
1400100;Boa Vista;1600303;Macapá;2;2;4;1111
1600154;Pedra Branca do Amaparí;1600303;Macapá;2;2;4;123
1500800;Ananindeua;1508407;Xinguara;2;2;4;656
1500909;Augusto Corrêa;1508308;Viseu;2;2;4;56
1501709;Bragança;1508308;Viseu;2;2;4;69
1502400;Castanhal;1508209;Vigia;2;2;4;53
1506203;Salinópolis;1508209;Vigia;2;2;4;95
1505650;Placas;1508159;Uruará;2;2;4;56
1506195;Rurópolis;1508159;Uruará;2;2;4;137
1302603;Manaus;1508100;Tucuruí;2;2;4;1145
1503804;Jacundá;1508100;Tucuruí;2;2;4;100
1505502;Paragominas;1508100;Tucuruí;2;2;4;278
1502152;Canaã dos Carajás;1508084;Tucumã;2;2;4;145
1500107;Abaetetuba;1508001;Tomé-Açu;2;2;4;102
1507607;São Miguel do Guamá;1508001;Tomé-Açu;2;2;4;115
1501402;Belém;1507979;Terra Santa;2;2;4;899
1502400;Castanhal;1507961;Terra Alta;2;2;4;28
1504703;Moju;1507953;Tailândia;2;2;4;114
1505064;Novo Repartimento;1507953;Tailândia;2;2;4;187
1500602;Altamira;1507805;Senador José Porfírio;2;2;4;74
1502806;Curralinho;1507706;São Sebastião da Boa Vista;2;2;4;31
1501303;Barcarena;1507607;São Miguel do Guamá;2;2;4;129
1504059;Mãe do Rio;1507607;São Miguel do Guamá;2;2;4;48
1502202;Capanema;1507474;São João de Pirabas;2;2;4;57
1501402;Belém;1507458;São Geraldo do Araguaia;2;2;4;552
1504208;Marabá;1507458;São Geraldo do Araguaia;2;2;4;123
1500602;Altamira;1507300;São Félix do Xingu;2;2;4;390
1502608;Colares;1507003;Santo Antônio do Tauá;2;2;4;27
1502756;Concórdia do Pará;1507003;Santo Antônio do Tauá;2;2;4;95
1506500;Santa Isabel do Pará;1507003;Santo Antônio do Tauá;2;2;4;16
1500404;Alenquer;1506807;Santarém;2;2;4;60
1506005;Prainha;1506807;Santarém;2;2;4;158
1501402;Belém;1506609;Santa Maria do Pará;2;2;4;98
1501402;Belém;1506583;Santa Maria das Barreiras;2;2;4;839
1501402;Belém;1506559;Santa Luzia do Pará;2;2;4;167
1502202;Capanema;1506500;Santa Isabel do Pará;2;2;4;109
1504422;Marituba;1506500;Santa Isabel do Pará;2;2;4;21
1502004;Cachoeira do Arari;1506302;Salvaterra;2;2;4;52
1500800;Ananindeua;1506203;Salinópolis;2;2;4;140
1501402;Belém;1506195;Rurópolis;2;2;4;779
1505536;Parauapebas;1506187;Rondon do Pará;2;2;4;239
1501402;Belém;1506161;Rio Maria;2;2;4;680
1503044;Floresta do Araguaia;1506161;Rio Maria;2;2;4;45
1506138;Redenção;1506161;Rio Maria;2;2;4;77
1500602;Altamira;1506138;Redenção;2;2;4;589
1502152;Canaã dos Carajás;1506138;Redenção;2;2;4;168
1501402;Belém;1505601;Peixe-Boi;2;2;4;126
1500602;Altamira;1505536;Parauapebas;2;2;4;410
1502954;Eldorado dos Carajás;1505536;Parauapebas;2;2;4;56
1505437;Ourilândia do Norte;1505536;Parauapebas;2;2;4;161
1302603;Manaus;1505502;Paragominas;2;2;4;1410
1501303;Barcarena;1505502;Paragominas;2;2;4;220
1502202;Capanema;1505502;Paragominas;2;2;4;193
1500602;Altamira;1505486;Pacajá;2;2;4;196
1501402;Belém;1505486;Pacajá;2;2;4;369
1501402;Belém;1505437;Ourilândia do Norte;2;2;4;663
1502152;Canaã dos Carajás;1505437;Ourilândia do Norte;2;2;4;137
1504208;Marabá;1505437;Ourilândia do Norte;2;2;4;268
1501402;Belém;1505403;Ourém;2;2;4;148
1501402;Belém;1505205;Oeiras do Pará;2;2;4;176
1500602;Altamira;1505064;Novo Repartimento;2;2;4;278
1501402;Belém;1505031;Novo Progresso;2;2;4;997
1501402;Belém;1505007;Nova Timboteua;2;2;4;118
1501402;Belém;1504976;Nova Ipixuna;2;2;4;398
1503077;Garrafão do Norte;1504950;Nova Esperança do Piriá;2;2;4;38
1501402;Belém;1504901;Muaná;2;2;4;91
1502202;Capanema;1504703;Moju;2;2;4;188
1502400;Castanhal;1504703;Moju;2;2;4;116
1503309;Igarapé-Miri;1504703;Moju;2;2;4;24
1501204;Baião;1504604;Mocajuba;2;2;4;30
1502400;Castanhal;1504422;Marituba;2;2;4;48
1501501;Benevides;1504406;Marapanim;2;2;4;94
1501402;Belém;1504307;Maracanã;2;2;4;124
1501303;Barcarena;1504208;Marabá;2;2;4;430
1502707;Conceição do Araguaia;1504208;Marabá;2;2;4;319
1502772;Curionópolis;1504208;Marabá;2;2;4;102
1501402;Belém;1504109;Magalhães Barata;2;2;4;113
1500958;Aurora do Pará;1504059;Mãe do Rio;2;2;4;11
1502202;Capanema;1504059;Mãe do Rio;2;2;4;93
1501402;Belém;1504000;Limoeiro do Ajuru;2;2;4;120
1302603;Manaus;1503903;Juruti;2;2;4;454
1501006;Aveiro;1503606;Itaituba;2;2;4;104
1501402;Belém;1503457;Ipixuna do Pará;2;2;4;167
1501402;Belém;1503408;Inhangapi;2;2;4;58
1501402;Belém;1503200;Igarapé-Açu;2;2;4;96
1500602;Altamira;1503101;Gurupá;2;2;4;200
1501402;Belém;1502954;Eldorado dos Carajás;2;2;4;533
1501402;Belém;1502756;Concórdia do Pará;2;2;4;88
1302603;Manaus;1502202;Capanema;2;2;4;1445
1500800;Ananindeua;1502202;Capanema;2;2;4;133
1501303;Barcarena;1502202;Capanema;2;2;4;163
1502103;Cametá;1502202;Capanema;2;2;4;282
1500107;Abaetetuba;1502103;Cametá;2;2;4;95
1501402;Belém;1502004;Cachoeira do Arari;2;2;4;66
1500107;Abaetetuba;1501808;Breves;2;2;4;184
1501105;Bagre;1501808;Breves;2;2;4;46
1302603;Manaus;1501709;Bragança;2;2;4;1493
1302603;Manaus;1501501;Benevides;2;2;4;1326
1501402;Belém;1501451;Belterra;2;2;4;736
1100023;Ariquemes;1501402;Belém;2;2;4;1882
1100122;Ji-Paraná;1501402;Belém;2;2;4;1841
1100288;Rolim de Moura;1501402;Belém;2;2;4;1881
1100304;Vilhena;1501402;Belém;2;2;4;1825
1200203;Cruzeiro do Sul;1501402;Belém;2;2;4;2792
1200302;Feijó;1501402;Belém;2;2;4;2558
1500206;Acará;1501402;Belém;2;2;4;63
1501204;Baião;1501402;Belém;2;2;4;206
1500503;Almeirim;1501303;Barcarena;2;2;4;439
1400472;Rorainópolis;1400605;São Luiz;2;2;4;42
1400100;Boa Vista;1400506;São João da Baliza;2;2;4;230
1400209;Caracaraí;1400506;São João da Baliza;2;2;4;171
1400209;Caracaraí;1400308;Mucajaí;2;2;4;71
1400100;Boa Vista;1400159;Bonfim;2;2;4;108
1100049;Cacoal;1400100;Boa Vista;2;2;4;1583
1100122;Ji-Paraná;1400100;Boa Vista;2;2;4;1533
1200203;Cruzeiro do Sul;1400100;Boa Vista;2;2;4;1769
1303536;Presidente Figueiredo;1400100;Boa Vista;2;2;4;547
1302603;Manaus;1304302;Urucará;2;2;4;260
1301209;Coari;1304203;Tefé;2;2;4;191
1302306;Jutaí;1304203;Tefé;2;2;4;241
1303403;Parintins;1304203;Tefé;2;2;4;888
1304062;Tabatinga;1304203;Tefé;2;2;4;583
1300201;Atalaia do Norte;1304062;Tabatinga;2;2;4;41
1303908;São Paulo de Olivença;1304062;Tabatinga;2;2;4;130
1300144;Apuí;1303304;Novo Aripuanã;2;2;4;233
1302603;Manaus;1303205;Novo Airão;2;2;4;112
1302603;Manaus;1303007;Nhamundá;2;2;4;376
1300144;Apuí;1302702;Manicoré;2;2;4;214
1100189;Pimenta Bueno;1302603;Manaus;2;2;4;959
1100288;Rolim de Moura;1302603;Manaus;2;2;4;978
1300144;Apuí;1302603;Manaus;2;2;4;452
1300607;Benjamin Constant;1302603;Manaus;2;2;4;1123
1301001;Carauari;1302603;Manaus;2;2;4;787
1301407;Eirunepé;1302603;Manaus;2;2;4;1164
1302306;Jutaí;1302603;Manaus;2;2;4;749
1301852;Iranduba;1302504;Manacapuru;2;2;4;48
1200401;Rio Branco;1200708;Xapuri;2;2;4;103
1200302;Feijó;1200609;Tarauacá;2;2;4;50
1200401;Rio Branco;1200609;Tarauacá;2;2;4;384
1100205;Porto Velho;1200450;Senador Guiomard;2;2;4;449
1100049;Cacoal;1200401;Rio Branco;2;2;4;717
1200104;Brasiléia;1200252;Epitaciolândia;2;2;4;8
1100205;Porto Velho;1200203;Cruzeiro do Sul;2;2;4;980
1200054;Assis Brasil;1200104;Brasiléia;2;2;4;93
1100114;Jaru;1101757;Vale do Anari;2;2;4;78
1100130;Machadinho d'Oeste;1101757;Vale do Anari;2;2;4;50
1101559;Teixeirópolis;1101708;Urupá;2;2;4;24
1100114;Jaru;1101609;Theobroma;2;2;4;39
1100148;Nova Brasilândia d'Oeste;1101500;Seringueiras;2;2;4;79
1100189;Pimenta Bueno;1101484;São Felipe d'Oeste;2;2;4;37
1100452;Buritis;1101401;Monte Negro;2;2;4;57
1100155;Ouro Preto do Oeste;1101302;Mirante da Serra;2;2;4;50
1100205;Porto Velho;1101104;Itapuã do Oeste;2;2;4;89
1100023;Ariquemes;1101005;Governador Jorge Teixeira;2;2;4;78
1100114;Jaru;1101005;Governador Jorge Teixeira;2;2;4;12
1100130;Machadinho d'Oeste;1100940;Cujubim;2;2;4;62
1100288;Rolim de Moura;1100502;Novo Horizonte do Oeste;2;2;4;34
1100056;Cerejeiras;1100452;Buritis;2;2;4;466
1100130;Machadinho d'Oeste;1100452;Buritis;2;2;4;215
1100205;Porto Velho;1100452;Buritis;2;2;4;159
1100304;Vilhena;1100452;Buritis;2;2;4;495
1100205;Porto Velho;1100346;Alvorada d'Oeste;2;2;4;330
1100031;Cabixi;1100304;Vilhena;2;2;4;87
1100072;Corumbiara;1100304;Vilhena;2;2;4;81
1100205;Porto Velho;1100296;Santa Luzia d'Oeste;2;2;4;413
1100155;Ouro Preto do Oeste;1100288;Rolim de Moura;2;2;4;133
1100254;Presidente Médici;1100288;Rolim de Moura;2;2;4;71
1100023;Ariquemes;1100262;Rio Crespo;2;2;4;26
1100023;Ariquemes;1100254;Presidente Médici;2;2;4;187
1100049;Cacoal;1100254;Presidente Médici;2;2;4;54
1100205;Porto Velho;1100254;Presidente Médici;2;2;4;342
1100106;Guajará-Mirim;1100155;Ouro Preto do Oeste;2;2;4;328
1100098;Espigão d'Oeste;1100122;Ji-Paraná;2;2;4;117
1100049;Cacoal;1100114;Jaru;2;2;4;163
1100031;Cabixi;1100064;Colorado do Oeste;2;2;4;46
4309571;Herveiras;5300108;Brasília;1;3;4;1596
5202502;Aruanã;5221403;Trindade;1;3;4;257
5214051;Mundo Novo;5221403;Trindade;1;3;4;331
3134202;Ituiutaba;5218805;Rio Verde;1;3;4;204
5213004;Maurilândia;5218508;Quirinópolis;1;3;4;54
5201405;Aparecida de Goiânia;5214838;Nova Crixás;1;3;4;323
5205208;Caturaí;5214838;Nova Crixás;1;3;4;276
5103403;Cuiabá;5211909;Jataí;1;3;4;531
5103502;Diamantino;5211503;Itumbiara;1;3;4;871
4118907;Pérola;5208707;Goiânia;1;3;4;922
3170404;Unaí;5204003;Cabeceiras;1;3;4;66
3143104;Monte Carmelo;5201405;Aparecida de Goiânia;1;3;4;283
3157807;Santa Luzia;5201405;Aparecida de Goiânia;1;3;4;667
4208203;Itajaí;5201405;Aparecida de Goiânia;1;3;4;1123
3204906;São Mateus;5200134;Acreúna;1;3;4;1130
4109708;Ibaiti;5108402;Várzea Grande;1;3;4;1121
4205902;Gaspar;5108006;Tapurah;1;3;4;1786
1302603;Manaus;5107958;Tangará da Serra;1;3;4;1301
4101507;Arapongas;5107958;Tangará da Serra;1;3;4;1180
4107256;Douradina;5107958;Tangará da Serra;1;3;4;1074
5106224;Nova Mutum;5107941;Tabaporã;1;3;4;300
4117909;Palotina;5107925;Sorriso;1;3;4;1319
1302603;Manaus;5107909;Sinop;1;3;4;1084
4101507;Arapongas;5107909;Sinop;1;3;4;1357
4117909;Palotina;5106224;Nova Mutum;1;3;4;1185
4101507;Arapongas;5104807;Jaciara;1;3;4;913
3550308;São Paulo;5103858;Gaúcha do Norte;1;3;4;1356
4117909;Palotina;5103502;Diamantino;1;3;4;1133
3548906;São Carlos;5103106;Cocalinho;1;3;4;911
4203006;Caçador;5101407;Aripuanã;1;3;4;2067
4205308;Faxinal dos Guedes;5101407;Aripuanã;1;3;4;2015
3120102;Couto de Magalhães de Minas;5007109;Ribas do Rio Pardo;1;3;4;1099
3505708;Barueri;5007109;Ribas do Rio Pardo;1;3;4;803
4117909;Palotina;5005707;Naviraí;1;3;4;147
4115804;Medianeira;5005400;Maracaju;1;3;4;424
4101507;Arapongas;5003702;Dourados;1;3;4;372
4320404;Serafina Corrêa;5003256;Costa Rica;1;3;4;1140
4101507;Arapongas;5003207;Corumbá;1;3;4;820
3513009;Cotia;5002704;Campo Grande;1;3;4;889
4211603;Nova Veneza;5002704;Campo Grande;1;3;4;1065
4101507;Arapongas;5001904;Bataguassu;1;3;4;215
4204202;Chapecó;4322400;Uruguaiana;1;3;4;519
4305207;Cerro Largo;4322400;Uruguaiana;1;3;4;289
4309506;Guarani das Missões;4322103;Tucunduva;1;3;4;55
4306106;Cruz Alta;4321808;Três de Maio;1;3;4;118
4320230;Sede Nova;4321808;Três de Maio;1;3;4;33
4304606;Canoas;4321501;Torres;1;3;4;150
4304002;Campo Novo;4321477;Tiradentes do Sul;1;3;4;41
4316907;Santa Maria;4321451;Teutônia;1;3;4;197
4307054;Ernestina;4320800;Soledade;1;3;4;37
4320107;Sarandi;4320206;Seberi;1;3;4;70
2306306;Itapagé;4319901;Sapiranga;1;3;4;3052
4303806;Campinas do Sul;4319703;São Valentim;1;3;4;20
4304606;Canoas;4318309;São Gabriel;1;3;4;302
4305207;Cerro Largo;4318309;São Gabriel;1;3;4;245
4310207;Ijuí;4318101;São Francisco de Assis;1;3;4;174
4303103;Cachoeirinha;4317905;Santo Cristo;1;3;4;425
4314100;Passo Fundo;4317806;Santo Augusto;1;3;4;143
4312401;Montenegro;4317251;Santa Tereza;1;3;4;60
2918001;Jequié;4316808;Santa Cruz do Sul;1;3;4;2093
4202404;Blumenau;4316808;Santa Cruz do Sul;1;3;4;444
4314803;Portão;4316808;Santa Cruz do Sul;1;3;4;115
4303004;Cachoeira do Sul;4315602;Rio Grande;1;3;4;240
3152501;Pouso Alegre;4314902;Porto Alegre;1;3;4;997
3167202;Sete Lagoas;4314902;Porto Alegre;1;3;4;1340
3506508;Birigui;4314902;Porto Alegre;1;3;4;972
3515509;Fernandópolis;4314902;Porto Alegre;1;3;4;1086
3530706;Mogi Guaçu;4314902;Porto Alegre;1;3;4;943
3534708;Ourinhos;4314902;Porto Alegre;1;3;4;793
3550902;São Simão;4314902;Porto Alegre;1;3;4;1009
3551009;São Vicente;4314902;Porto Alegre;1;3;4;809
3551702;Sertãozinho;4314902;Porto Alegre;1;3;4;1032
4308508;Frederico Westphalen;4314498;Pinheirinho do Vale;1;3;4;27
4312401;Montenegro;4314407;Pelotas;1;3;4;243
4309209;Gravataí;4314100;Passo Fundo;1;3;4;233
4311809;Marau;4314001;Paraí;1;3;4;44
4304606;Canoas;4313953;Pantano Grande;1;3;4;118
4306809;Encantado;4313508;Osório;1;3;4;173
2611606;Recife;4313409;Novo Hamburgo;1;3;4;2803
4301651;Barão;4312401;Montenegro;1;3;4;32
3304557;Rio de Janeiro;4311809;Marau;1;3;4;1055
3550308;São Paulo;4310603;Itaqui;1;3;4;1120
4306601;Dom Pedrito;4310207;Ijuí;1;3;4;295
4304200;Candelária;4310009;Ibirubá;1;3;4;121
4304002;Campo Novo;4309704;Humaitá;1;3;4;21
4304408;Canela;4309308;Guaíba;1;3;4;100
2306306;Itapagé;4309209;Gravataí;1;3;4;3082
3523404;Itatiba;4309209;Gravataí;1;3;4;861
3534401;Osasco;4309209;Gravataí;1;3;4;812
4216602;São José;4307906;Farroupilha;1;3;4;314
4307500;Espumoso;4307815;Estrela Velha;1;3;4;58
4212106;Palmitos;4307302;Erval Seco;1;3;4;64
4302253;Boa Vista do Sul;4306809;Encantado;1;3;4;26
4305009;Catuípe;4306106;Cruz Alta;1;3;4;60
4304002;Campo Novo;4306007;Crissiumal;1;3;4;35
4301602;Bagé;4305207;Cerro Largo;1;3;4;358
4202909;Brusque;4304606;Canoas;1;3;4;380
4214805;Rio do Sul;4304606;Canoas;1;3;4;332
4300455;Alegria;4304002;Campo Novo;1;3;4;30
2306306;Itapagé;4303103;Cachoeirinha;1;3;4;3086
4106902;Curitiba;4301602;Bagé;1;3;4;791
4118907;Pérola;4217709;Sombrio;1;3;4;700
2933307;Vitória da Conquista;4217303;Saudades;1;3;4;1768
4200101;Abelardo Luz;4217204;São Miguel do Oeste;1;3;4;122
4209706;Lebon Régis;4216503;São Joaquim;1;3;4;164
4106902;Curitiba;4216008;São Carlos;1;3;4;409
4204707;Cunha Porã;4216008;São Carlos;1;3;4;25
4117602;Palmas;4213609;Porto União;1;3;4;97
4203006;Caçador;4213401;Ponte Serrada;1;3;4;92
1501402;Belém;4211603;Nova Veneza;1;3;4;3017
2927408;Salvador;4211603;Nova Veneza;1;3;4;2011
4204301;Concórdia;4210100;Mafra;1;3;4;249
4209003;Joaçaba;4210100;Mafra;1;3;4;204
3534401;Osasco;4209300;Lages;1;3;4;584
4202008;Balneário Camboriú;4208500;Ituporanga;1;3;4;102
4204202;Chapecó;4208104;Itaiópolis;1;3;4;285
4204202;Chapecó;4207908;Irineópolis;1;3;4;207
2607208;Ipojuca;4205902;Gaspar;1;3;4;2433
2911105;Formosa do Rio Preto;4205902;Gaspar;1;3;4;1795
2919553;Luís Eduardo magalhães;4205902;Gaspar;1;3;4;1668
2927408;Salvador;4205902;Gaspar;1;3;4;1836
3516200;Franca;4205407;Florianópolis;1;3;4;788
4204103;Caxambu do Sul;4204202;Chapecó;1;3;4;26
3516200;Franca;4202404;Blumenau;1;3;4;728
4118501;Pato Branco;4128609;Verê;1;3;4;46
4117602;Palmas;4128534;Ventania;1;3;4;307
4104303;Campo Mourão;4125753;São Pedro do Iguaçu;1;3;4;178
4110409;Indianópolis;4125308;São Jorge do Ivaí;1;3;4;39
3541406;Presidente Prudente;4124202;Santo Antônio do Caiuá;1;3;4;118
3502804;Araçatuba;4124103;Santo Antônio da Platina;1;3;4;232
4104303;Campo Mourão;4120655;Quarto Centenário;1;3;4;74
3509502;Campinas;4118402;Paranavaí;1;3;4;552
3549904;São José dos Campos;4118402;Paranavaí;1;3;4;673
3516200;Franca;4115200;Maringá;1;3;4;558
3303401;Nova Friburgo;4113700;Londrina;1;3;4;881
4104907;Castro;4113254;Laranjal;1;3;4;244
3550308;São Paulo;4113007;Jussara;1;3;4;594
1100122;Ji-Paraná;4109708;Ibaiti;1;3;4;1835
4101507;Arapongas;4109203;Guaraci;1;3;4;53
4105508;Cianorte;4108304;Foz do Iguaçu;1;3;4;279
1100023;Ariquemes;4107256;Douradina;1;3;4;1772
1100049;Cacoal;4107256;Douradina;1;3;4;1550
2910800;Feira de Santana;4107256;Douradina;1;3;4;1876
3532207;Narandiba;4105904;Colorado;1;3;4;66
3534401;Osasco;4105805;Colombo;1;3;4;311
3529005;Marília;4105508;Cianorte;1;3;4;313
3523602;Itirapina;4104808;Cascavel;1;3;4;637
1100023;Ariquemes;4101507;Arapongas;1;3;4;1879
1100304;Vilhena;4101507;Arapongas;1;3;4;1457
2602308;Bonito;4101507;Arapongas;1;3;4;2262
3547304;Santana de Parnaíba;4100608;Alto Paraná;1;3;4;555
3534401;Osasco;3557105;Votuporanga;1;3;4;480
3528858;Marapoama;3555604;Uchoa;1;3;4;34
3545605;Santa Adélia;3555307;Turmalina;1;3;4;221
3302403;Macaé;3554508;Tietê;1;3;4;600
3303955;Pinheiral;3554102;Taubaté;1;3;4;170
3545506;Sandovalina;3553906;Tarabai;1;3;4;23
2408102;Natal;3552809;Taboão da Serra;1;3;4;2266
3503703;Ariranha;3552601;Tabapuã;1;3;4;36
3534401;Osasco;3551702;Sertãozinho;1;3;4;294
3548500;Santos;3551405;Serra Azul;1;3;4;313
2927408;Salvador;3550902;São Simão;1;3;4;1314
3521150;Ipiguá;3549805;São José do Rio Preto;1;3;4;20
2910800;Feira de Santana;3548807;São Caetano do Sul;1;3;4;1460
3506102;Bebedouro;3548054;Santo Antônio do Aracanguá;1;3;4;203
3149309;Pedro Leopoldo;3547809;Santo André;1;3;4;511
3513009;Cotia;3547502;Santa Rita do Passa Quatro;1;3;4;218
3525904;Jundiaí;3547007;Santa Maria da Serra;1;3;4;146
3509502;Campinas;3546801;Santa Isabel;1;3;4;97
3534401;Osasco;3545803;Santa Bárbara d'Oeste;1;3;4;108
3503950;Aspásia;3545605;Santa Adélia;1;3;4;233
3524808;Jales;3545605;Santa Adélia;1;3;4;210
3149309;Pedro Leopoldo;3543402;Ribeirão Preto;1;3;4;422
2927408;Salvador;3543303;Ribeirão Pires;1;3;4;1421
3509502;Campinas;3543303;Ribeirão Pires;1;3;4;109
3516200;Franca;3543105;Ribeirão Corrente;1;3;4;21
3534401;Osasco;3538006;Pindamonhangaba;1;3;4;152
2927408;Salvador;3535606;Paraibuna;1;3;4;1353
3136702;Juiz de Fora;3534708;Ourinhos;1;3;4;684
1100122;Ji-Paraná;3534401;Osasco;1;3;4;2040
1502400;Castanhal;3534401;Osasco;1;3;4;2462
3300100;Angra dos Reis;3534401;Osasco;1;3;4;264
3300704;Cabo Frio;3534401;Osasco;1;3;4;486
3302502;Magé;3534401;Osasco;1;3;4;392
3305802;Teresópolis;3534401;Osasco;1;3;4;404
3504008;Assis;3534401;Osasco;1;3;4;384
3517505;Guapiaçu;3534005;Onda Verde;1;3;4;23
3525706;José Bonifácio;3532504;Neves Paulista;1;3;4;24
3506102;Bebedouro;3530706;Mogi Guaçu;1;3;4;224
3506508;Birigui;3529302;Matão;1;3;4;204
3509502;Campinas;3528502;Mairiporã;1;3;4;67
3510401;Capivari;3526902;Limeira;1;3;4;49
3513801;Diadema;3526902;Limeira;1;3;4;147
3521705;Itaberá;3526902;Limeira;1;3;4;230
2304400;Fortaleza;3525904;Jundiaí;1;3;4;2298
3516200;Franca;3525904;Jundiaí;1;3;4;296
3516408;Franco da Rocha;3525003;Jandira;1;3;4;29
2611606;Recife;3523909;Itu;1;3;4;2072
2307650;Maracanaú;3523404;Itatiba;1;3;4;2265
3503703;Ariranha;3521903;Itajobi;1;3;4;31
3516408;Franco da Rocha;3518800;Guarulhos;1;3;4;21
3513009;Cotia;3518701;Guarujá;1;3;4;76
2211001;Teresina;3516200;Franca;1;3;4;1771
2408003;Mossoró;3516200;Franca;1;3;4;1978
2501302;Aroeiras;3516200;Franca;1;3;4;1862
2503209;Cabedelo;3516200;Franca;1;3;4;1959
2800308;Aracaju;3516200;Franca;1;3;4;1497
2910800;Feira de Santana;3516200;Franca;1;3;4;1255
2914802;Itabuna;3516200;Franca;1;3;4;1049
2930709;Simões Filho;3516200;Franca;1;3;4;1258
3141801;Minas Novas;3516200;Franca;1;3;4;618
3151800;Poços de Caldas;3516200;Franca;1;3;4;163
3506003;Bauru;3513504;Cubatão;1;3;4;319
3509502;Campinas;3510203;Capão Bonito;1;3;4;180
3148103;Patrocínio;3509502;Campinas;1;3;4;437
3509254;Cajati;3509502;Campinas;1;3;4;230
3504503;Avaré;3506102;Bebedouro;1;3;4;243
3504701;Balbinos;3506102;Bebedouro;1;3;4;136
3116902;Comendador Gomes;3503208;Araraquara;1;3;4;249
2927408;Salvador;3502200;Angatuba;1;3;4;1523
2930709;Simões Filho;3501905;Amparo;1;3;4;1379
3302007;Itaguaí;3305505;Saquarema;1;3;4;138
3136306;João Pinheiro;3304557;Rio de Janeiro;1;3;4;640
3159407;Santa Rita de Ibitipoca;3304557;Rio de Janeiro;1;3;4;160
3205200;Vila Velha;3304524;Rio das Ostras;1;3;4;286
3106200;Belo Horizonte;3304508;Rio das Flores;1;3;4;254
3301009;Campos dos Goytacazes;3304102;Porciúncula;1;3;4;118
2306306;Itapagé;3303302;Niterói;1;3;4;2151
3300605;Bom Jesus do Itabapoana;3302502;Magé;1;3;4;218
3205200;Vila Velha;3300704;Cabo Frio;1;3;4;330
2909307;Correntina;3205309;Vitória;1;3;4;884
3151800;Poços de Caldas;3205200;Vila Velha;1;3;4;667
2921104;Medeiros Neto;3205002;Serra;1;3;4;307
2927200;Ruy Barbosa;3205002;Serra;1;3;4;866
3112000;Candeias;3205002;Serra;1;3;4;525
3200136;Águia Branca;3204658;São Domingos do Norte;1;3;4;22
3144300;Nanuque;3203601;Mucurici;1;3;4;29
2306553;Itarema;3203205;Linhares;1;3;4;1818
3137700;Lajinha;3202652;Irupi;1;3;4;21
3201001;Boa Esperança;3202108;Ecoporanga;1;3;4;62
3118403;Conselheiro Pena;3201209;Cachoeiro de Itapemirim;1;3;4;187
3134004;Itinga;3201209;Cachoeiro de Itapemirim;1;3;4;472
3113404;Caratinga;3171303;Viçosa;1;3;4;129
3104205;Arcos;3170404;Unaí;1;3;4;456
3108552;Brasilândia de Minas;3169604;Tupaciguara;1;3;4;333
3127800;Grão Mogol;3167202;Sete Lagoas;1;3;4;348
3108008;Bom Sucesso;3162500;São João del Rei;1;3;4;49
3157609;Santa Fé de Minas;3162401;São João da Ponte;1;3;4;172
3106705;Betim;3161700;São Gonçalo do Abaeté;1;3;4;250
3113701;Carlos Chagas;3161007;São Domingos do Prata;1;3;4;329
3146503;Pains;3160405;Santo Antônio do Monte;1;3;4;50
3114105;Carmo de Minas;3159605;Santa Rita do Sapucaí;1;3;4;61
3141108;Matozinhos;3157807;Santa Luzia;1;3;4;34
3118809;Coração de Jesus;3157609;Santa Fé de Minas;1;3;4;112
3144805;Nova Lima;3157203;Santa Bárbara;1;3;4;47
3129806;Ibirité;3154606;Ribeirão das Neves;1;3;4;28
3137601;Lagoa Santa;3154606;Ribeirão das Neves;1;3;4;26
3144805;Nova Lima;3154606;Ribeirão das Neves;1;3;4;37
3150000;Pescador;3152105;Ponte Nova;1;3;4;265
3147600;Passa Quatro;3151800;Poços de Caldas;1;3;4;177
1716109;Paraíso do Tocantins;3147105;Pará de Minas;1;3;4;1158
3120904;Curvelo;3145455;Olhos-d'Água;1;3;4;179
3103009;Antônio Dias;3144706;Nova Era;1;3;4;22
3105400;Barão de Cocais;3140001;Mariana;1;3;4;50
3103751;Araporã;3134202;Ituiutaba;1;3;4;66
3119302;Coromandel;3133808;Itaúna;1;3;4;327
3113305;Carangola;3127701;Governador Valadares;1;3;4;213
3107406;Bom Despacho;3124708;Estrela do Indaiá;1;3;4;60
2305506;Iguatu;3118601;Contagem;1;3;4;1577
3115102;Cássia;3117108;Conceição da Aparecida;1;3;4;95
3106200;Belo Horizonte;3113701;Carlos Chagas;1;3;4;418
3103009;Antônio Dias;3106309;Belo Oriente;1;3;4;63
2109007;Porto Franco;3106200;Belo Horizonte;1;3;4;1537
3101904;Alpinópolis;3106200;Belo Horizonte;1;3;4;275
1302603;Manaus;2933307;Vitória da Conquista;1;3;4;2407
2307650;Maracanaú;2933307;Vitória da Conquista;1;3;4;1239
2408003;Mossoró;2933307;Vitória da Conquista;1;3;4;1133
2604106;Caruaru;2933307;Vitória da Conquista;1;3;4;892
2905701;Camaçari;2932903;Valença;1;3;4;112
2906501;Candeias;2931350;Teixeira de Freitas;1;3;4;553
2903904;Bom Jesus da Lapa;2928208;Santana;1;3;4;82
2922003;Mucuri;2927408;Salvador;1;3;4;566
2906006;Campo Formoso;2925204;Pojuca;1;3;4;303
2908606;Conde;2925204;Pojuca;1;3;4;104
2910602;Esplanada;2925204;Pojuca;1;3;4;78
2913705;Inhambupe;2925204;Pojuca;1;3;4;72
2211001;Teresina;2919553;Luís Eduardo magalhães;1;3;4;841
2804805;Nossa Senhora do Socorro;2918407;Juazeiro;1;3;4;401
2914802;Itabuna;2917300;Ituberá;1;3;4;118
2507507;João Pessoa;2914802;Itabuna;1;3;4;963
2903201;Barreiras;2906501;Candeias;1;3;4;700
2804805;Nossa Senhora do Socorro;2905701;Camaçari;1;3;4;241
2801702;Cristinápolis;2807600;Umbaúba;1;3;4;15
2611606;Recife;2805703;Propriá;1;3;4;313
2611101;Petrolina;2804805;Nossa Senhora do Socorro;1;3;4;407
2610004;Palmares;2614501;Surubim;1;3;4;99
1600600;Santana;2612505;Santa Cruz do Capibaribe;1;3;4;1861
2602605;Brejo da Madre de Deus;2605004;Cupira;1;3;4;70
2306306;Itapagé;2602902;Cabo de Santo Agostinho;1;3;4;713
2412005;São Gonçalo do Amarante;2414407;Touros;1;3;4;65
2304202;Crato;2311801;Russas;1;3;4;299
2301109;Aracati;2311504;Quixeré;1;3;4;62
2302305;Bela Cruz;2308906;Morrinhos;1;3;4;21
2101608;Barra do Corda;2211001;Teresina;1;3;4;273
2200459;Alvorada do Gurguéia;2204501;Guadalupe;1;3;4;183
2100055;Açailândia;2104800;Grajaú;1;3;4;175
1501402;Belém;1506708;Santana do Araguaia;1;3;4;904
1501709;Bragança;1506203;Salinópolis;1;3;4;73
1505064;Novo Repartimento;1505536;Parauapebas;1;3;4;194
1302603;Manaus;1304401;Urucurituba;1;3;4;213
1300201;Atalaia do Norte;1302603;Manaus;1;3;4;1141
1302108;Japurá;1302603;Manaus;1;3;4;741
1100114;Jaru;1100130;Machadinho d'Oeste;1;3;4;128
1304401;Urucurituba;5300108;Brasília;1;2;3;1761
1400704;Uiramutã;5300108;Brasília;1;2;3;2595
1704105;Centenário;5300108;Brasília;1;2;3;761
1711803;Juarina;5300108;Brasília;1;2;3;859
2305266;Ibaretama;5300108;Brasília;1;2;3;1552
2306603;Itatira;5300108;Brasília;1;2;3;1519
3108503;Botumirim;5300108;Brasília;1;2;3;541
3120300;Cristália;5300108;Brasília;1;2;3;555
3126604;Francisco Dumont;5300108;Brasília;1;2;3;430
3153806;Queluzito;5300108;Brasília;1;2;3;700
3157500;Santa Efigênia de Minas;5300108;Brasília;1;2;3;679
3158953;Santana do Paraíso;5300108;Brasília;1;2;3;700
3159001;Santana do Riacho;5300108;Brasília;1;2;3;588
3302270;Japeri;5300108;Brasília;1;2;3;889
3548054;Santo Antônio do Aracanguá;5300108;Brasília;1;2;3;633
5204250;Cachoeira Dourada;5300108;Brasília;1;2;3;341
5221502;Turvânia;5300108;Brasília;1;2;3;253
5222302;Vila Propício;5300108;Brasília;1;2;3;110
5208004;Formosa;5221858;Valparaíso de Goiás;1;2;3;91
5218904;Rubiataba;5221700;Uruana;1;2;3;42
5218805;Rio Verde;5220504;Serranópolis;1;2;3;122
1400100;Boa Vista;5218805;Rio Verde;1;2;3;2495
4205902;Gaspar;5218805;Rio Verde;1;2;3;1034
5101803;Barra do Garças;5218805;Rio Verde;1;2;3;260
5213707;Montes Claros de Goiás;5218805;Rio Verde;1;2;3;203
5201454;Aparecida do Rio Doce;5218508;Quirinópolis;1;2;3;75
5211909;Jataí;5218003;Porangatu;1;2;3;566
5207402;Edéia;5217708;Pontalina;1;2;3;55
3304557;Rio de Janeiro;5217104;Piracanjuba;1;2;3;877
1721000;Palmas;5215702;Palmeiras de Goiás;1;2;3;732
3103504;Araguari;5215702;Palmeiras de Goiás;1;2;3;274
3118601;Contagem;5215702;Palmeiras de Goiás;1;2;3;716
3138401;Leopoldina;5215702;Palmeiras de Goiás;1;2;3;942
3151404;Pitangui;5215702;Palmeiras de Goiás;1;2;3;628
3505500;Barretos;5215702;Palmeiras de Goiás;1;2;3;439
4217600;Siderópolis;5215702;Palmeiras de Goiás;1;2;3;1307
4219309;Videira;5215702;Palmeiras de Goiás;1;2;3;1138
5201108;Anápolis;5215231;Novo Gama;1;2;3;102
3534302;Orlândia;5214838;Nova Crixás;1;2;3;781
3525904;Jundiaí;5214507;Nerópolis;1;2;3;791
5211909;Jataí;5213806;Morrinhos;1;2;3;275
5211503;Itumbiara;5213707;Montes Claros de Goiás;1;2;3;350
3109006;Brumadinho;5213087;Minaçu;1;2;3;855
5211503;Itumbiara;5213004;Maurilândia;1;2;3;124
5208707;Goiânia;5212808;Mara Rosa;1;2;3;296
4118204;Paranaguá;5212501;Luziânia;1;2;3;1035
5211909;Jataí;5212204;Jussara;1;2;3;242
3534401;Osasco;5211909;Jataí;1;2;3;818
5101803;Barra do Garças;5211909;Jataí;1;2;3;239
5106257;Nova Xavantina;5211909;Jataí;1;2;3;364
5208608;Goianésia;5211909;Jataí;1;2;3;394
2928901;São Desidério;5211503;Itumbiara;1;2;3;803
3162922;São Joaquim de Bicas;5211503;Itumbiara;1;2;3;560
4101408;Apucarana;5211503;Itumbiara;1;2;3;618
5100409;Alto Garças;5211503;Itumbiara;1;2;3;480
5210802;Itajá;5211305;Itarumã;1;2;3;39
1100205;Porto Velho;5210406;Itaberaí;1;2;3;1685
5002704;Campo Grande;5210406;Itaberaí;1;2;3;712
5107925;Sorriso;5210000;Inhumas;1;2;3;784
5204250;Cachoeira Dourada;5209937;Inaciolândia;1;2;3;54
2109502;Riachão;5208707;Goiânia;1;2;3;1068
2206605;Monte Alegre do Piauí;5208707;Goiânia;1;2;3;874
3205200;Vila Velha;5208707;Goiânia;1;2;3;1042
3523909;Itu;5208707;Goiânia;1;2;3;761
4100806;Alvorada do Sul;5208707;Goiânia;1;2;3;706
5002951;Chapadão do Sul;5208707;Goiânia;1;2;3;428
3534401;Osasco;5206404;Crixás;1;2;3;1056
4205902;Gaspar;5206206;Cristalina;1;2;3;1128
1100114;Jaru;5205901;Corumbaíba;1;2;3;1687
3104106;Arceburgo;5205109;Catalão;1;2;3;371
3152808;Prata;5205109;Catalão;1;2;3;170
3505708;Barueri;5205109;Catalão;1;2;3;604
3515608;Fernando Prestes;5205109;Catalão;1;2;3;353
5103106;Cocalinho;5205109;Catalão;1;2;3;525
3202603;Iconha;5201405;Aparecida de Goiânia;1;2;3;1012
1701903;Araguacema;5201108;Anápolis;1;2;3;830
3501905;Amparo;5201108;Anápolis;1;2;3;746
3513009;Cotia;5201108;Anápolis;1;2;3;837
3549904;São José dos Campos;5201108;Anápolis;1;2;3;832
5103205;Colíder;5108956;Nova Monte Verde;1;2;3;242
3301702;Duque de Caxias;5108402;Várzea Grande;1;2;3;1612
3556453;Vargem Grande Paulista;5108402;Várzea Grande;1;2;3;1334
4126256;Sarandi;5108402;Várzea Grande;1;2;3;983
5107909;Sinop;5108303;União do Sul;1;2;3;130
5107040;Primavera do Leste;5108105;Tesouro;1;2;3;98
4101507;Arapongas;5107925;Sorriso;1;2;3;1296
4202008;Balneário Camboriú;5107925;Sorriso;1;2;3;1787
4217204;São Miguel do Oeste;5107925;Sorriso;1;2;3;1587
1500800;Ananindeua;5107909;Sinop;1;2;3;1391
3534401;Osasco;5107909;Sinop;1;2;3;1619
4117909;Palotina;5107909;Sinop;1;2;3;1390
5107305;São José do Rio Claro;5107875;Sapezal;1;2;3;226
5107040;Primavera do Leste;5107859;São Félix do Araguaia;1;2;3;588
5107701;Rosário Oeste;5107800;Santo Antônio do Leverger;1;2;3;120
4203105;Caibi;5107602;Rondonópolis;1;2;3;1189
4205902;Gaspar;5107602;Rondonópolis;1;2;3;1323
5105200;Juscimeira;5107297;São José do Povo;1;2;3;83
3534401;Osasco;5107107;São José dos Quatro Marcos;1;2;3;1526
1400100;Boa Vista;5107040;Primavera do Leste;1;2;3;2140
4107256;Douradina;5107040;Primavera do Leste;1;2;3;877
3550308;São Paulo;5107008;Poxoréo;1;2;3;1211
5105002;Jauru;5106828;Porto Esperidião;1;2;3;70
5106224;Nova Mutum;5106802;Porto dos Gaúchos;1;2;3;292
1302603;Manaus;5106752;Pontes e Lacerda;1;2;3;1346
4101507;Arapongas;5106752;Pontes e Lacerda;1;2;3;1252
4107256;Douradina;5106752;Pontes e Lacerda;1;2;3;1117
5103403;Cuiabá;5106281;Novo São Joaquim;1;2;3;340
5105101;Juara;5106273;Novo Horizonte do Norte;1;2;3;26
2911105;Formosa do Rio Preto;5106224;Nova Mutum;1;2;3;1215
3501905;Amparo;5106224;Nova Mutum;1;2;3;1423
4107256;Douradina;5106224;Nova Mutum;1;2;3;1101
1302603;Manaus;5105622;Mirassol d'Oeste;1;2;3;1405
3512902;Cosmorama;5105622;Mirassol d'Oeste;1;2;3;1048
4101507;Arapongas;5105622;Mirassol d'Oeste;1;2;3;1124
5105259;Lucas do Rio Verde;5105580;Marcelândia;1;2;3;275
1100072;Corumbiara;5105507;Vila Bela da Santíssima Trindade;1;2;3;248
5101258;Araputanga;5105507;Vila Bela da Santíssima Trindade;1;2;3;173
5103601;Dom Aquino;5105200;Juscimeira;1;2;3;27
4108502;General Carneiro;5105150;Juína;1;2;3;1865
3550100;São Manuel;5104609;Itiquira;1;2;3;859
4126504;Sertanópolis;5104609;Itiquira;1;2;3;730
5007695;São Gabriel do Oeste;5104609;Itiquira;1;2;3;247
4106902;Curitiba;5104559;Itaúba;1;2;3;1729
5103403;Cuiabá;5103957;Glória d'Oeste;1;2;3;243
3201308;Cariacica;5103403;Cuiabá;1;2;3;1780
3524709;Jaguariúna;5103403;Cuiabá;1;2;3;1274
4107256;Douradina;5103403;Cuiabá;1;2;3;919
4205902;Gaspar;5103403;Cuiabá;1;2;3;1488
4211603;Nova Veneza;5103403;Cuiabá;1;2;3;1625
4313409;Novo Hamburgo;5103403;Cuiabá;1;2;3;1661
5003207;Corumbá;5103403;Cuiabá;1;2;3;421
5006606;Ponta Porã;5103403;Cuiabá;1;2;3;772
5103205;Colíder;5103379;Cotriguaçu;1;2;3;339
3534401;Osasco;5103304;Comodoro;1;2;3;1810
4101507;Arapongas;5103205;Colíder;1;2;3;1466
3529203;Martinópolis;5102702;Canarana;1;2;3;960
4101507;Arapongas;5102637;Campo Novo do Parecis;1;2;3;1295
1302603;Manaus;5102504;Cáceres;1;2;3;1450
4107256;Douradina;5102504;Cáceres;1;2;3;945
4202008;Balneário Camboriú;5101902;Brasnorte;1;2;3;1950
3139003;Machado;5101803;Barra do Garças;1;2;3;948
4101507;Arapongas;5101803;Barra do Garças;1;2;3;846
4107256;Douradina;5101803;Barra do Garças;1;2;3;845
5002704;Campo Grande;5101803;Barra do Garças;1;2;3;572
4101507;Arapongas;5101704;Barra do Bugres;1;2;3;1122
1100189;Pimenta Bueno;5101407;Aripuanã;1;2;3;262
3304557;Rio de Janeiro;5100201;Água Boa;1;2;3;1389
4307708;Esteio;5100201;Água Boa;1;2;3;1753
3525904;Jundiaí;5008305;Três Lagoas;1;2;3;573
3538709;Piracicaba;5008305;Três Lagoas;1;2;3;482
3552205;Sorocaba;5008305;Três Lagoas;1;2;3;537
5002407;Caarapó;5008008;Terenos;1;2;3;245
3505708;Barueri;5007935;Sonora;1;2;3;1079
4101507;Arapongas;5007935;Sonora;1;2;3;742
4115804;Medianeira;5007901;Sidrolândia;1;2;3;494
3509502;Campinas;5007703;Sete Quedas;1;2;3;818
4104808;Cascavel;5007703;Sete Quedas;1;2;3;195
4204806;Curitibanos;5007554;Santa Rita do Pardo;1;2;3;702
4117909;Palotina;5007208;Rio Brilhante;1;2;3;288
5005004;Jardim;5007208;Rio Brilhante;1;2;3;174
3106200;Belo Horizonte;5007109;Ribas do Rio Pardo;1;2;3;1022
5000807;Anaurilândia;5007109;Ribas do Rio Pardo;1;2;3;217
4101507;Arapongas;5006606;Ponta Porã;1;2;3;450
4104303;Campo Mourão;5006606;Ponta Porã;1;2;3;381
3170107;Uberaba;5006309;Paranaíba;1;2;3;344
5004601;Itaquiraí;5006200;Nova Andradina;1;2;3;159
5000807;Anaurilândia;5006002;Nova Alvorada do Sul;1;2;3;185
4107256;Douradina;5005707;Naviraí;1;2;3;102
4117107;Nova Londrina;5005707;Naviraí;1;2;3;128
4117503;Paiçandu;5005681;Mundo Novo;1;2;3;234
4107256;Douradina;5005202;Ladário;1;2;3;667
3550308;São Paulo;5005103;Jateí;1;2;3;802
3304557;Rio de Janeiro;5004908;Jaraguari;1;2;3;1214
4314902;Porto Alegre;5004601;Itaquiraí;1;2;3;793
2304400;Fortaleza;5003702;Dourados;1;2;3;2600
3548807;São Caetano do Sul;5003702;Dourados;1;2;3;867
3556206;Valinhos;5003702;Dourados;1;2;3;811
4208203;Itajaí;5003702;Dourados;1;2;3;822
4219507;Xanxerê;5003702;Dourados;1;2;3;571
4305108;Caxias do Sul;5003702;Dourados;1;2;3;859
4312401;Montenegro;5003702;Dourados;1;2;3;896
3506003;Bauru;5003306;Coxim;1;2;3;747
3526407;Laranjal Paulista;5003306;Coxim;1;2;3;903
1302603;Manaus;5003207;Corumbá;1;2;3;1779
3158607;Santana do Deserto;5003207;Corumbá;1;2;3;1573
4107256;Douradina;5003207;Corumbá;1;2;3;668
3555000;Tupã;5002902;Cassilândia;1;2;3;335
3303906;Petrópolis;5002704;Campo Grande;1;2;3;1225
3500303;Aguaí;5002704;Campo Grande;1;2;3;825
3527405;Lucélia;5002704;Campo Grande;1;2;3;407
4107256;Douradina;5002704;Campo Grande;1;2;3;357
4203006;Caçador;5002704;Campo Grande;1;2;3;802
4117909;Palotina;5002407;Caarapó;1;2;3;212
4312401;Montenegro;5002407;Caarapó;1;2;3;855
4101507;Arapongas;5002100;Bela Vista;1;2;3;551
3547700;Santo Anastácio;5001904;Bataguassu;1;2;3;87
3502804;Araçatuba;5001243;Aral Moreira;1;2;3;559
3158607;Santana do Deserto;5001102;Aquidauana;1;2;3;1334
4115804;Medianeira;5000906;Antônio João;1;2;3;396
4115804;Medianeira;5000609;Amambaí;1;2;3;268
4117909;Palotina;5000609;Amambaí;1;2;3;198
3522406;Itapeva;5000203;Água Clara;1;2;3;574
4314902;Porto Alegre;5000203;Água Clara;1;2;3;1080
4317509;Santo Ângelo;4323754;Vitória das Missões;1;2;3;23
4313300;Nova Prata;4323606;Vista Alegre do Prata;1;2;3;18
4308508;Frederico Westphalen;4323507;Vista Alegre;1;2;3;12
4320800;Soledade;4323408;Vila Maria;1;2;3;51
4308508;Frederico Westphalen;4323101;Vicente Dutra;1;2;3;22
3516200;Franca;4323002;Viamão;1;2;3;1108
3534401;Osasco;4323002;Viamão;1;2;3;826
4209102;Joinville;4323002;Viamão;1;2;3;467
4307708;Esteio;4323002;Viamão;1;2;3;30
3550308;São Paulo;4322855;Vespasiano Correa;1;2;3;778
4308607;Garibaldi;4322855;Vespasiano Correa;1;2;3;38
3550308;São Paulo;4322707;Vera Cruz;1;2;3;869
4202305;Biguaçu;4322608;Venâncio Aires;1;2;3;408
4304705;Carazinho;4322608;Venâncio Aires;1;2;3;156
4321451;Teutônia;4322608;Venâncio Aires;1;2;3;41
4314902;Porto Alegre;4322525;Vale Verde;1;2;3;100
3530607;Moji das Cruzes;4322509;Vacaria;1;2;3;713
4310439;Ipê;4322509;Vacaria;1;2;3;48
4312401;Montenegro;4322509;Vacaria;1;2;3;140
4318705;São Leopoldo;4322509;Vacaria;1;2;3;140
4205407;Florianópolis;4322400;Uruguaiana;1;2;3;854
4317202;Santa Rosa;4322343;Ubiretama;1;2;3;29
4315057;Porto Mauá;4322301;Tuparendi;1;2;3;27
4317905;Santo Cristo;4322301;Tuparendi;1;2;3;19
4205456;Forquilhinha;4322004;Triunfo;1;2;3;250
4315602;Rio Grande;4322004;Triunfo;1;2;3;245
4319109;São Martinho;4321907;Três Passos;1;2;3;27
4204202;Chapecó;4321857;Três Palmeiras;1;2;3;60
4204301;Concórdia;4321808;Três de Maio;1;2;3;227
4208203;Itajaí;4321808;Três de Maio;1;2;3;548
4302220;Boa Vista do Cadeado;4321808;Três de Maio;1;2;3;103
4302238;Boa vista do Incra;4321808;Três de Maio;1;2;3;146
4308201;Flores da Cunha;4321808;Três de Maio;1;2;3;336
4308458;Fortaleza dos Valos;4321808;Três de Maio;1;2;3;154
4316808;Santa Cruz do Sul;4321808;Três de Maio;1;2;3;284
4318002;São Borja;4321808;Três de Maio;1;2;3;201
4306403;Dois Irmãos;4321600;Tramandaí;1;2;3;100
4218806;Turvo;4321501;Torres;1;2;3;45
4303004;Cachoeira do Sul;4321451;Teutônia;1;2;3;124
4304697;Capitão;4321451;Teutônia;1;2;3;27
4305207;Cerro Largo;4321451;Teutônia;1;2;3;316
4315602;Rio Grande;4321451;Teutônia;1;2;3;294
4320701;Sobradinho;4321451;Teutônia;1;2;3;119
4208203;Itajaí;4321303;Taquari;1;2;3;434
4307906;Farroupilha;4321204;Taquara;1;2;3;72
4301909;Barra do Ribeiro;4321105;Tapes;1;2;3;43
4318408;São Jerônimo;4321105;Tapes;1;2;3;84
4304804;Carlos Barbosa;4321006;Tapera;1;2;3;153
4318705;São Leopoldo;4320859;Tabaí;1;2;3;56
4305207;Cerro Largo;4320800;Soledade;1;2;3;225
4307559;Estação;4320800;Soledade;1;2;3;106
4307005;Erechim;4320503;Sertão;1;2;3;39
3304557;Rio de Janeiro;4320404;Serafina Corrêa;1;2;3;1049
4306809;Encantado;4320404;Serafina Corrêa;1;2;3;58
4303509;Camaquã;4320354;Sentinela do Sul;1;2;3;34
4304804;Carlos Barbosa;4320305;Selbach;1;2;3;160
4306106;Cruz Alta;4320305;Selbach;1;2;3;63
4307906;Farroupilha;4320008;Sapucaia do Sul;1;2;3;71
4307708;Esteio;4319901;Sapiranga;1;2;3;28
4317608;Santo Antônio da Patrulha;4319901;Sapiranga;1;2;3;51
4308052;Faxinalzinho;4319703;São Valentim;1;2;3;22
4305207;Cerro Largo;4319604;São Sepé;1;2;3;248
4319406;São Pedro do Sul;4319604;São Sepé;1;2;3;83
4305207;Cerro Largo;4319406;São Pedro do Sul;1;2;3;171
4315503;Restinga Seca;4319406;São Pedro do Sul;1;2;3;81
4317509;Santo Ângelo;4319372;São Pedro do Butiá;1;2;3;64
4317509;Santo Ângelo;4319307;São Paulo das Missões;1;2;3;73
4317202;Santa Rosa;4319158;São Miguel das Missões;1;2;3;77
4305207;Cerro Largo;4318804;São Lourenço do Sul;1;2;3;433
2306306;Itapagé;4318705;São Leopoldo;1;2;3;3069
3301702;Duque de Caxias;4318705;São Leopoldo;1;2;3;1068
4313508;Osório;4318705;São Leopoldo;1;2;3;86
3505708;Barueri;4318432;São João do Polêsine;1;2;3;917
4306767;Eldorado do Sul;4318432;São João do Polêsine;1;2;3;185
4313102;Nova Palma;4318432;São João do Polêsine;1;2;3;16
4303509;Camaquã;4318408;São Jerônimo;1;2;3;98
4313508;Osório;4318408;São Jerônimo;1;2;3;141
4314407;Pelotas;4318408;São Jerônimo;1;2;3;206
4310009;Ibirubá;4318309;São Gabriel;1;2;3;221
4309308;Guaíba;4318200;São Francisco de Paula;1;2;3;104
4312401;Montenegro;4318200;São Francisco de Paula;1;2;3;92
4305207;Cerro Largo;4318101;São Francisco de Assis;1;2;3;160
4311809;Marau;4318051;São Domingos do Sul;1;2;3;32
4306106;Cruz Alta;4318002;São Borja;1;2;3;236
4310207;Ijuí;4318002;São Borja;1;2;3;206
4317905;Santo Cristo;4318002;São Borja;1;2;3;160
4316303;Roque Gonzales;4317905;Santo Cristo;1;2;3;49
4317202;Santa Rosa;4317806;Santo Augusto;1;2;3;67
4310207;Ijuí;4317707;Santo Antônio das Missões;1;2;3;129
4208708;Jacinto Machado;4317608;Santo Antônio da Patrulha;1;2;3;117
4303103;Cachoeirinha;4317509;Santo Ângelo;1;2;3;361
4306007;Crissiumal;4317509;Santo Ângelo;1;2;3;91
4312179;Mato Queimado;4317509;Santo Ângelo;1;2;3;35
4316303;Roque Gonzales;4317509;Santo Ângelo;1;2;3;77
4303103;Cachoeirinha;4317400;Santiago;1;2;3;375
4305207;Cerro Largo;4317400;Santiago;1;2;3;116
3534401;Osasco;4317301;Santa Vitória do Palmar;1;2;3;1252
4300307;Alecrim;4317202;Santa Rosa;1;2;3;38
4302907;Cacequi;4317202;Santa Rosa;1;2;3;227
4303103;Cachoeirinha;4317202;Santa Rosa;1;2;3;405
4303301;Caibaté;4317202;Santa Rosa;1;2;3;53
4305009;Catuípe;4317202;Santa Rosa;1;2;3;61
4305900;Coronel Bicaco;4317202;Santa Rosa;1;2;3;77
4307807;Estrela;4317202;Santa Rosa;1;2;3;307
4310405;Independência;4317202;Santa Rosa;1;2;3;27
4315008;Porto Lucena;4317202;Santa Rosa;1;2;3;55
4303103;Cachoeirinha;4317103;Santana do Livramento;1;2;3;429
3516200;Franca;4316907;Santa Maria;1;2;3;1177
3548807;São Caetano do Sul;4316907;Santa Maria;1;2;3;960
4118501;Pato Branco;4316907;Santa Maria;1;2;3;400
4204608;Criciúma;4316907;Santa Maria;1;2;3;442
4306205;Cruzeiro do Sul;4316907;Santa Maria;1;2;3;175
2903201;Barreiras;4316808;Santa Cruz do Sul;1;2;3;2054
4211702;Orleans;4316808;Santa Cruz do Sul;1;2;3;337
4302402;Bom Retiro do Sul;4316808;Santa Cruz do Sul;1;2;3;49
4305207;Cerro Largo;4316808;Santa Cruz do Sul;1;2;3;281
4306205;Cruzeiro do Sul;4316808;Santa Cruz do Sul;1;2;3;46
4310207;Ijuí;4316709;Santa Bárbara do Sul;1;2;3;66
4314100;Passo Fundo;4316709;Santa Bárbara do Sul;1;2;3;84
4209300;Lages;4316600;Sananduva;1;2;3;146
4304606;Canoas;4316402;Rosário do Sul;1;2;3;364
4305207;Cerro Largo;4316402;Rosário do Sul;1;2;3;235
4310009;Ibirubá;4315701;Rio Pardo;1;2;3;158
4306403;Dois Irmãos;4315602;Rio Grande;1;2;3;296
4314902;Porto Alegre;4315354;Quinze de Novembro;1;2;3;236
3105608;Barbacena;4314902;Porto Alegre;1;2;3;1198
3118304;Conselheiro Lafaiete;4314902;Porto Alegre;1;2;3;1245
3119401;Coronel Fabriciano;4314902;Porto Alegre;1;2;3;1410
3132404;Itajubá;4314902;Porto Alegre;1;2;3;1001
3136207;João Monlevade;4314902;Porto Alegre;1;2;3;1356
3146107;Ouro Preto;4314902;Porto Alegre;1;2;3;1285
3147907;Passos;4314902;Porto Alegre;1;2;3;1119
3168705;Timóteo;4314902;Porto Alegre;1;2;3;1404
3300100;Angra dos Reis;4314902;Porto Alegre;1;2;3;1021
3300704;Cabo Frio;4314902;Porto Alegre;1;2;3;1167
3302007;Itaguaí;4314902;Porto Alegre;1;2;3;1059
3303401;Nova Friburgo;4314902;Porto Alegre;1;2;3;1177
3501905;Amparo;4314902;Porto Alegre;1;2;3;914
3502101;Andradina;4314902;Porto Alegre;1;2;3;1011
3502507;Aparecida;4314902;Porto Alegre;1;2;3;974
3504503;Avaré;4314902;Porto Alegre;1;2;3;799
3505807;Bastos;4314902;Porto Alegre;1;2;3;902
3505906;Batatais;4314902;Porto Alegre;1;2;3;1068
3506102;Bebedouro;4314902;Porto Alegre;1;2;3;1039
3507605;Bragança Paulista;4314902;Porto Alegre;1;2;3;899
3508405;Cabreúva;4314902;Porto Alegre;1;2;3;839
3508504;Caçapava;4314902;Porto Alegre;1;2;3;926
3509700;Campos do Jordão;4314902;Porto Alegre;1;2;3;968
3510500;Caraguatatuba;4314902;Porto Alegre;1;2;3;894
3510807;Casa Branca;4314902;Porto Alegre;1;2;3;994
3511102;Catanduva;4314902;Porto Alegre;1;2;3;1008
3514403;Dracena;4314902;Porto Alegre;1;2;3;945
3515186;Espírito Santo do Pinhal;4314902;Porto Alegre;1;2;3;965
3516705;Garça;4314902;Porto Alegre;1;2;3;880
3517406;Guaíra;4314902;Porto Alegre;1;2;3;1111
3518206;Guararapes;4314902;Porto Alegre;1;2;3;975
3520103;Igarapava;4314902;Porto Alegre;1;2;3;1153
3522703;Itápolis;4314902;Porto Alegre;1;2;3;963
3522802;Itaporanga;4314902;Porto Alegre;1;2;3;721
3523404;Itatiba;4314902;Porto Alegre;1;2;3;881
3524105;Ituverava;4314902;Porto Alegre;1;2;3;1120
3524303;Jaboticabal;4314902;Porto Alegre;1;2;3;1011
3524808;Jales;4314902;Porto Alegre;1;2;3;1085
3525102;Jardinópolis;4314902;Porto Alegre;1;2;3;1050
3526704;Leme;4314902;Porto Alegre;1;2;3;940
3527207;Lorena;4314902;Porto Alegre;1;2;3;992
3527603;Luís Antônio;4314902;Porto Alegre;1;2;3;996
3529302;Matão;4314902;Porto Alegre;1;2;3;972
3530300;Mirassol;4314902;Porto Alegre;1;2;3;1035
3530508;Mococa;4314902;Porto Alegre;1;2;3;1026
3530805;Moji-Mirim;4314902;Porto Alegre;1;2;3;932
3531308;Monte Alto;4314902;Porto Alegre;1;2;3;1003
3532603;Nhandeara;4314902;Porto Alegre;1;2;3;1042
3534302;Orlândia;4314902;Porto Alegre;1;2;3;1079
3537305;Penápolis;4314902;Porto Alegre;1;2;3;961
3538006;Pindamonhangaba;4314902;Porto Alegre;1;2;3;955
3538600;Piracaia;4314902;Porto Alegre;1;2;3;898
3538808;Piraju;4314902;Porto Alegre;1;2;3;779
3542602;Registro;4314902;Porto Alegre;1;2;3;688
3546603;Santa Fé do Sul;4314902;Porto Alegre;1;2;3;1091
3549102;São João da Boa Vista;4314902;Porto Alegre;1;2;3;985
3549706;São José do Rio Pardo;4314902;Porto Alegre;1;2;3;1019
3550407;São Pedro;4314902;Porto Alegre;1;2;3;886
3553401;Tanabi;4314902;Porto Alegre;1;2;3;1054
3553708;Taquaritinga;4314902;Porto Alegre;1;2;3;985
3554508;Tietê;4314902;Porto Alegre;1;2;3;836
3555000;Tupã;4314902;Porto Alegre;1;2;3;901
3557105;Votuporanga;4314902;Porto Alegre;1;2;3;1071
4120903;Quedas do Iguaçu;4314902;Porto Alegre;1;2;3;535
4304622;Capão Bonito do Sul;4314902;Porto Alegre;1;2;3;214
4212106;Palmitos;4314704;Planalto;1;2;3;30
4308607;Garibaldi;4314423;Picada Café;1;2;3;44
3509502;Campinas;4314407;Pelotas;1;2;3;1091
4113700;Londrina;4314407;Pelotas;1;2;3;941
4305207;Cerro Largo;4314407;Pelotas;1;2;3;453
4306403;Dois Irmãos;4314407;Pelotas;1;2;3;267
4308201;Flores da Cunha;4314407;Pelotas;1;2;3;319
3516200;Franca;4314100;Passo Fundo;1;2;3;978
4128203;União da Vitória;4314100;Passo Fundo;1;2;3;250
4205506;Fraiburgo;4314100;Passo Fundo;1;2;3;198
4219507;Xanxerê;4314100;Passo Fundo;1;2;3;155
4304630;Capão da Canoa;4314100;Passo Fundo;1;2;3;286
4308607;Garibaldi;4314100;Passo Fundo;1;2;3;140
4313060;Nova Hartz;4314100;Passo Fundo;1;2;3;208
4303103;Cachoeirinha;4314050;Parobé;1;2;3;45
4301958;Barra Funda;4313706;Palmeira das Missões;1;2;3;28
4305207;Cerro Largo;4313706;Palmeira das Missões;1;2;3;142
4306767;Eldorado do Sul;4313706;Palmeira das Missões;1;2;3;295
4303905;Campo Bom;4313656;Palmares do Sul;1;2;3;83
3534401;Osasco;4313508;Osório;1;2;3;775
4218707;Tubarão;4313508;Osório;1;2;3;194
4212106;Palmitos;4313441;Novo Tiradentes;1;2;3;55
2306306;Itapagé;4313409;Novo Hamburgo;1;2;3;3061
3543402;Ribeirão Preto;4313409;Novo Hamburgo;1;2;3;995
4303004;Cachoeira do Sul;4313391;Novo Cabrais;1;2;3;30
4306809;Encantado;4313375;Nova Santa Rita;1;2;3;92
4307708;Esteio;4313375;Nova Santa Rita;1;2;3;10
4303509;Camaquã;4313300;Nova Prata;1;2;3;228
4307609;Estância Velha;4313201;Nova Petrópolis;1;2;3;31
4311809;Marau;4313201;Nova Petrópolis;1;2;3;147
4311205;Júlio de Castilhos;4313102;Nova Palma;1;2;3;35
3511508;Cerquilho;4313060;Nova Hartz;1;2;3;771
4303905;Campo Bom;4313060;Nova Hartz;1;2;3;18
4304606;Canoas;4312906;Nova Bassano;1;2;3;141
4312401;Montenegro;4312807;Nova Araçá;1;2;3;114
4305207;Cerro Largo;4312708;Nonoai;1;2;3;214
4305108;Caxias do Sul;4312476;Morro Reuter;1;2;3;43
3167202;Sete Lagoas;4312401;Montenegro;1;2;3;1319
4109401;Guarapuava;4312401;Montenegro;1;2;3;474
4111209;Itapejara d'Oeste;4312401;Montenegro;1;2;3;429
4207304;Imbituba;4312401;Montenegro;1;2;3;311
4310439;Ipê;4312401;Montenegro;1;2;3;98
4209300;Lages;4311809;Marau;1;2;3;196
4216602;São José;4311809;Marau;1;2;3;356
4311106;Jaguari;4311759;Manoel Viana;1;2;3;70
4209003;Joaçaba;4311700;Machadinho;1;2;3;48
4305207;Cerro Largo;4311403;Lajeado;1;2;3;297
4209300;Lages;4311304;Lagoa Vermelha;1;2;3;125
4303103;Cachoeirinha;4310603;Itaqui;1;2;3;536
4305207;Cerro Largo;4310603;Itaqui;1;2;3;207
3550308;São Paulo;4310439;Ipê;1;2;3;723
4305108;Caxias do Sul;4310439;Ipê;1;2;3;42
4309902;Ibiraiaras;4310439;Ipê;1;2;3;58
4309209;Gravataí;4310330;Imbé;1;2;3;81
4305405;Chiapetta;4310207;Ijuí;1;2;3;52
3523909;Itu;4310108;Igrejinha;1;2;3;771
4302238;Boa vista do Incra;4310009;Ibirubá;1;2;3;36
4303004;Cachoeira do Sul;4310009;Ibirubá;1;2;3;153
2923001;Nova Viçosa;4309308;Guaíba;1;2;3;1739
4300638;Amaral Ferrador;4309308;Guaíba;1;2;3;123
3516200;Franca;4309209;Gravataí;1;2;3;1093
3552809;Taboão da Serra;4309209;Gravataí;1;2;3;807
4308201;Flores da Cunha;4309209;Gravataí;1;2;3;103
3534401;Osasco;4309100;Gramado;1;2;3;757
4305207;Cerro Largo;4308904;Getúlio Vargas;1;2;3;246
4300059;Água Santa;4308854;Gentil;1;2;3;28
4208203;Itajaí;4308706;Gaurama;1;2;3;337
4308201;Flores da Cunha;4308607;Garibaldi;1;2;3;42
4301602;Bagé;4308508;Frederico Westphalen;1;2;3;446
4305108;Caxias do Sul;4308508;Frederico Westphalen;1;2;3;298
4304408;Canela;4308201;Flores da Cunha;1;2;3;50
4304606;Canoas;4308201;Flores da Cunha;1;2;3;98
2605202;Escada;4307906;Farroupilha;1;2;3;2739
2908903;Coração de Maria;4307906;Farroupilha;1;2;3;2208
3552403;Sumaré;4307906;Farroupilha;1;2;3;807
4103701;Cambé;4307906;Farroupilha;1;2;3;657
4105805;Colombo;4307906;Farroupilha;1;2;3;483
4125605;São Mateus do Sul;4307906;Farroupilha;1;2;3;386
4202008;Balneário Camboriú;4307906;Farroupilha;1;2;3;356
4202701;Botuverá;4307906;Farroupilha;1;2;3;313
4211900;Palhoça;4307906;Farroupilha;1;2;3;306
4300604;Alvorada;4307906;Farroupilha;1;2;3;88
4307708;Esteio;4307906;Farroupilha;1;2;3;71
4305207;Cerro Largo;4307807;Estrela;1;2;3;305
4303905;Campo Bom;4307708;Esteio;1;2;3;22
4204806;Curitibanos;4307005;Erechim;1;2;3;170
4215000;Rio Negrinho;4307005;Erechim;1;2;3;311
4301800;Barracão;4307005;Erechim;1;2;3;81
4303103;Cachoeirinha;4307005;Erechim;1;2;3;282
4305207;Cerro Largo;4307005;Erechim;1;2;3;250
4209102;Joinville;4306809;Encantado;1;2;3;438
4300406;Alegrete;4306809;Encantado;1;2;3;381
4304630;Capão da Canoa;4306809;Encantado;1;2;3;191
4306767;Eldorado do Sul;4306809;Encantado;1;2;3;99
4303004;Cachoeira do Sul;4306767;Eldorado do Sul;1;2;3;125
4305207;Cerro Largo;4306601;Dom Pedrito;1;2;3;312
3106200;Belo Horizonte;4306403;Dois Irmãos;1;2;3;1260
4205407;Florianópolis;4306403;Dois Irmãos;1;2;3;331
4300604;Alvorada;4306403;Dois Irmãos;1;2;3;45
4302105;Bento Gonçalves;4306304;David Canabarro;1;2;3;92
4303004;Cachoeira do Sul;4306205;Cruzeiro do Sul;1;2;3;102
4304606;Canoas;4306205;Cruzeiro do Sul;1;2;3;93
4303103;Cachoeirinha;4306106;Cruz Alta;1;2;3;284
4304606;Canoas;4306106;Cruz Alta;1;2;3;275
4305207;Cerro Largo;4306106;Cruz Alta;1;2;3;124
4306007;Crissiumal;4306106;Cruz Alta;1;2;3;136
4300059;Água Santa;4305504;Ciríaco;1;2;3;24
4300703;Anta Gorda;4305207;Cerro Largo;1;2;3;284
4301404;Arvorezinha;4305207;Cerro Largo;1;2;3;264
4302808;Caçapava do Sul;4305207;Cerro Largo;1;2;3;289
4302907;Cacequi;4305207;Cerro Largo;1;2;3;193
2111300;São Luís;4305108;Caxias do Sul;1;2;3;3013
2306306;Itapagé;4305108;Caxias do Sul;1;2;3;3010
1100205;Porto Velho;4304606;Canoas;1;2;3;2606
4122305;Rio Negro;4304606;Canoas;1;2;3;442
4211306;Navegantes;4304606;Canoas;1;2;3;412
4300802;Antônio Prado;4304606;Canoas;1;2;3;117
4304507;Canguçu;4304606;Canoas;1;2;3;221
4303103;Cachoeirinha;4304507;Canguçu;1;2;3;219
3505708;Barueri;4303509;Camaquã;1;2;3;931
2927408;Salvador;4303103;Cachoeirinha;1;2;3;2202
3524402;Jacareí;4303103;Cachoeirinha;1;2;3;880
3548807;São Caetano do Sul;4303103;Cachoeirinha;1;2;3;822
4300406;Alegrete;4303103;Cachoeirinha;1;2;3;448
4303004;Cachoeira do Sul;4303103;Cachoeirinha;1;2;3;174
3516200;Franca;4302105;Bento Gonçalves;1;2;3;1030
3550308;São Paulo;4301651;Barão;1;2;3;783
4208203;Itajaí;4301008;Arroio do Meio;1;2;3;410
2306306;Itapagé;4300604;Alvorada;1;2;3;3090
4209003;Joaçaba;4219853;Zortéa;1;2;3;34
4104808;Cascavel;4219705;Xaxim;1;2;3;242
4205407;Florianópolis;4219176;Vargem Bonita;1;2;3;329
4204301;Concórdia;4219101;Vargeão;1;2;3;42
4209003;Joaçaba;4219101;Vargeão;1;2;3;70
4216800;São José do Cerrito;4218905;Urubici;1;2;3;105
4204202;Chapecó;4218855;União do Oeste;1;2;3;45
4202909;Brusque;4218806;Turvo;1;2;3;216
4212106;Palmitos;4218756;Tunápolis;1;2;3;50
3122306;Divinópolis;4218707;Tubarão;1;2;3;1003
3534401;Osasco;4218707;Tubarão;1;2;3;590
3509502;Campinas;4218301;Três Barras;1;2;3;480
4207908;Irineópolis;4218251;Timbó Grande;1;2;3;44
3543402;Ribeirão Preto;4218004;Tijucas;1;2;3;679
4208203;Itajaí;4217907;Tangará;1;2;3;248
4208203;Itajaí;4217808;Taió;1;2;3;129
4209300;Lages;4217501;Seara;1;2;3;209
3303401;Nova Friburgo;4216602;São José;1;2;3;831
4104303;Campo Mourão;4216602;São José;1;2;3;532
4118501;Pato Branco;4216602;São José;1;2;3;418
4119905;Ponta Grossa;4216602;São José;1;2;3;310
4128708;Vitorino;4216602;São José;1;2;3;428
1100205;Porto Velho;4216008;São Carlos;1;2;3;2267
3201308;Cariacica;4216008;São Carlos;1;2;3;1431
4204301;Concórdia;4216008;São Carlos;1;2;3;101
4208203;Itajaí;4216008;São Carlos;1;2;3;424
3534401;Osasco;4215802;São Bento do Sul;1;2;3;395
4204806;Curitibanos;4215802;São Bento do Sul;1;2;3;167
4208203;Itajaí;4215406;Salto Veloso;1;2;3;264
4204202;Chapecó;4215208;Romelândia;1;2;3;86
4115200;Maringá;4215109;Rodeio;1;2;3;461
3522307;Itapetininga;4214805;Rio do Sul;1;2;3;433
4202206;Benedito Novo;4214805;Rio do Sul;1;2;3;55
4107207;Dois Vizinhos;4214201;Quilombo;1;2;3;114
4208302;Itapema;4214003;Presidente Getúlio;1;2;3;98
3304557;Rio de Janeiro;4213609;Porto União;1;2;3;854
4204608;Criciúma;4213500;Porto Belo;1;2;3;185
4205902;Gaspar;4213500;Porto Belo;1;2;3;45
4202206;Benedito Novo;4213203;Pomerode;1;2;3;20
4102307;Balsa Nova;4212809;Piçarras;1;2;3;158
4204301;Concórdia;4212270;Passos Maia;1;2;3;49
4122305;Rio Negro;4212205;Papanduva;1;2;3;45
4204202;Chapecó;4212205;Papanduva;1;2;3;261
4202156;Belmonte;4212106;Palmitos;1;2;3;51
4207650;Iporã do Oeste;4212106;Palmitos;1;2;3;39
3516200;Franca;4211900;Palhoça;1;2;3;798
4204202;Chapecó;4211850;Ouro Verde;1;2;3;56
4203600;Campos Novos;4211751;Otacílio Costa;1;2;3;108
4204707;Cunha Porã;4211702;Orleans;1;2;3;408
4204202;Chapecó;4211652;Novo Horizonte;1;2;3;77
1100205;Porto Velho;4211603;Nova Veneza;1;2;3;2566
1200401;Rio Branco;4211603;Nova Veneza;1;2;3;2669
1302603;Manaus;4211603;Nova Veneza;1;2;3;2985
2304400;Fortaleza;4211603;Nova Veneza;1;2;3;2930
2408102;Natal;4211603;Nova Veneza;1;2;3;2845
2704302;Maceió;4211603;Nova Veneza;1;2;3;2455
2800308;Aracaju;4211603;Nova Veneza;1;2;3;2275
3549904;São José dos Campos;4211603;Nova Veneza;1;2;3;694
4106902;Curitiba;4211603;Nova Veneza;1;2;3;355
4204202;Chapecó;4211603;Nova Veneza;1;2;3;347
4209102;Joinville;4211603;Nova Veneza;1;2;3;268
3516200;Franca;4211306;Navegantes;1;2;3;713
4115200;Maringá;4211306;Navegantes;1;2;3;497
4119905;Ponta Grossa;4211306;Navegantes;1;2;3;245
4205308;Faxinal dos Guedes;4210555;Marema;1;2;3;37
4204202;Chapecó;4210308;Major Vieira;1;2;3;244
4204202;Chapecó;4210100;Mafra;1;2;3;300
4205407;Florianópolis;4209706;Lebon Régis;1;2;3;229
4205704;Garopaba;4209409;Laguna;1;2;3;53
3516200;Franca;4209300;Lages;1;2;3;852
3548708;São Bernardo do Campo;4209300;Lages;1;2;3;580
2306306;Itapagé;4209102;Joinville;1;2;3;2649
2602902;Cabo de Santo Agostinho;4209102;Joinville;1;2;3;2386
2905404;Cairu;4209102;Joinville;1;2;3;1703
4118204;Paranaguá;4209102;Joinville;1;2;3;83
4119954;Pontal do Paraná;4209102;Joinville;1;2;3;76
4205506;Fraiburgo;4209102;Joinville;1;2;3;222
4200101;Abelardo Luz;4209003;Joaçaba;1;2;3;101
4207908;Irineópolis;4209003;Joaçaba;1;2;3;125
4208104;Itaiópolis;4209003;Joaçaba;1;2;3;185
2306306;Itapagé;4208906;Jaraguá do Sul;1;2;3;2676
2309607;Pacajus;4208906;Jaraguá do Sul;1;2;3;2663
3516200;Franca;4208906;Jaraguá do Sul;1;2;3;678
3556206;Valinhos;4208906;Jaraguá do Sul;1;2;3;440
4113700;Londrina;4208906;Jaraguá do Sul;1;2;3;407
4201257;Apiúna;4208906;Jaraguá do Sul;1;2;3;69
4204301;Concórdia;4208609;Jaborá;1;2;3;29
4203006;Caçador;4208500;Ituporanga;1;2;3;162
4208203;Itajaí;4208500;Ituporanga;1;2;3;99
3505708;Barueri;4208302;Itapema;1;2;3;432
4202701;Botuverá;4208302;Itapema;1;2;3;45
2602100;Bom Conselho;4208203;Itajaí;1;2;3;2268
3506003;Bauru;4208203;Itajaí;1;2;3;511
3523404;Itatiba;4208203;Itajaí;1;2;3;474
4108403;Francisco Beltrão;4208203;Itajaí;1;2;3;436
4203501;Campo Erê;4208203;Itajaí;1;2;3;433
4203600;Campos Novos;4208203;Itajaí;1;2;3;251
4204806;Curitibanos;4208203;Itajaí;1;2;3;188
4205209;Erval Velho;4208203;Itajaí;1;2;3;270
4205506;Fraiburgo;4208203;Itajaí;1;2;3;216
4204301;Concórdia;4208104;Itaiópolis;1;2;3;233
4204301;Concórdia;4207908;Irineópolis;1;2;3;163
4204202;Chapecó;4207858;Irati;1;2;3;57
4204202;Chapecó;4207684;Ipuaçu;1;2;3;56
4205407;Florianópolis;4207650;Iporã do Oeste;1;2;3;504
3552205;Sorocaba;4206900;Ibirama;1;2;3;442
4203600;Campos Novos;4206801;Ibicaré;1;2;3;40
4204202;Chapecó;4206702;Herval d'Oeste;1;2;3;112
3505708;Barueri;4206504;Guaramirim;1;2;3;389
3549904;São José dos Campos;4206504;Guaramirim;1;2;3;475
4204806;Curitibanos;4206009;Governador Celso Ramos;1;2;3;200
2211209;Uruçuí;4205902;Gaspar;1;2;3;2220
2926202;Riachão das Neves;4205902;Gaspar;1;2;3;1724
2928901;São Desidério;4205902;Gaspar;1;2;3;1656
4118204;Paranaguá;4205902;Gaspar;1;2;3;154
4204806;Curitibanos;4205902;Gaspar;1;2;3;168
4203303;Campo Alegre;4205803;Garuva;1;2;3;45
2306306;Itapagé;4205407;Florianópolis;1;2;3;2772
3143401;Monte Sião;4205407;Florianópolis;1;2;3;602
3534708;Ourinhos;4205407;Florianópolis;1;2;3;528
4201257;Apiúna;4205407;Florianópolis;1;2;3;106
4201703;Ascurra;4205407;Florianópolis;1;2;3;112
4202081;Bandeirante;4205407;Florianópolis;1;2;3;512
4117909;Palotina;4205308;Faxinal dos Guedes;1;2;3;321
4204301;Concórdia;4205209;Erval Velho;1;2;3;57
4204608;Criciúma;4204806;Curitibanos;1;2;3;196
4104808;Cascavel;4204608;Criciúma;1;2;3;568
4118501;Pato Branco;4204608;Criciúma;1;2;3;416
4203204;Camboriú;4204608;Criciúma;1;2;3;193
4203303;Campo Alegre;4204608;Criciúma;1;2;3;274
4201307;Araquari;4204509;Corupá;1;2;3;46
2616407;Vitória de Santo Antão;4204301;Concórdia;1;2;3;2633
3543402;Ribeirão Preto;4204301;Concórdia;1;2;3;786
3548807;São Caetano do Sul;4204301;Concórdia;1;2;3;665
4106571;Cruzeiro do Iguaçu;4204301;Concórdia;1;2;3;208
4117453;Ouro Verde do Oeste;4204301;Concórdia;1;2;3;325
2314102;Viçosa do Ceará;4204202;Chapecó;1;2;3;2820
4202131;Bela Vista do Toldo;4204202;Chapecó;1;2;3;233
4202537;Bom Jesus;4204202;Chapecó;1;2;3;46
4106902;Curitiba;4203907;Capinzal;1;2;3;311
4117701;Palmeira;4203808;Canoinhas;1;2;3;95
4106902;Curitiba;4203600;Campos Novos;1;2;3;290
3534401;Osasco;4203006;Caçador;1;2;3;556
4104303;Campo Mourão;4202909;Brusque;1;2;3;479
4109906;Icaraíma;4202909;Brusque;1;2;3;627
4125357;São Jorge do Patrocínio;4202909;Brusque;1;2;3;615
4202453;Bombinhas;4202701;Botuverá;1;2;3;54
4119905;Ponta Grossa;4202404;Blumenau;1;2;3;231
3549805;São José do Rio Preto;4202008;Balneário Camboriú;1;2;3;686
4104303;Campo Mourão;4202008;Balneário Camboriú;1;2;3;488
4200606;Águas Mornas;4201208;Antônio Carlos;1;2;3;21
4115200;Maringá;4128807;Xambrê;1;2;3;163
4104428;Candói;4128658;Virmond;1;2;3;31
3513801;Diadema;4128104;Umuarama;1;2;3;683
4122602;Rondon;4128104;Umuarama;1;2;3;67
4127403;Terra Roxa;4127957;Tupãssi;1;2;3;76
4101507;Arapongas;4127700;Toledo;1;2;3;275
4101200;Antonina;4127601;Tijucas do Sul;1;2;3;78
4117701;Palmeira;4127502;Tibagi;1;2;3;110
4110409;Indianópolis;4127205;Terra Boa;1;2;3;41
4117909;Palotina;4127205;Terra Boa;1;2;3;151
3304557;Rio de Janeiro;4127106;Telêmaco Borba;1;2;3;766
4101408;Apucarana;4126678;Tamarana;1;2;3;40
4106902;Curitiba;4126678;Tamarana;1;2;3;265
4115200;Maringá;4126678;Tamarana;1;2;3;91
4101507;Arapongas;4126256;Sarandi;1;2;3;44
4115200;Maringá;4126009;São Sebastião da Amoreira;1;2;3;119
4101002;Ampére;4125704;São Miguel do Iguaçu;1;2;3;99
4104907;Castro;4125605;São Mateus do Sul;1;2;3;121
4111506;Ivaiporã;4125605;São Mateus do Sul;1;2;3;221
1505031;Novo Progresso;4125506;São José dos Pinhais;1;2;3;2120
3556701;Vinhedo;4125506;São José dos Pinhais;1;2;3;354
4101606;Arapoti;4125407;São José da Boa Vista;1;2;3;32
4115200;Maringá;4125357;São Jorge do Patrocínio;1;2;3;206
4124509;Santo Inácio;4124905;São João do Caiuá;1;2;3;58
4115200;Maringá;4124707;São Jerônimo da Serra;1;2;3;125
3504503;Avaré;4124103;Santo Antônio da Platina;1;2;3;123
3506003;Bauru;4124103;Santo Antônio da Platina;1;2;3;149
3529005;Marília;4124103;Santo Antônio da Platina;1;2;3;120
3554003;Tatuí;4124103;Santo Antônio da Platina;1;2;3;232
4123501;Santa Helena;4124053;Santa Terezinha de Itaipu;1;2;3;63
4115200;Maringá;4123204;Santa Cecília do Pavão;1;2;3;117
3550308;São Paulo;4123105;Santa Amélia;1;2;3;389
4113700;Londrina;4123105;Santa Amélia;1;2;3;75
2606408;Gravatá;4122404;Rolândia;1;2;3;2282
4104303;Campo Mourão;4122404;Rolândia;1;2;3;132
3304557;Rio de Janeiro;4122305;Rio Negro;1;2;3;738
4103107;Bocaiúva do Sul;4122305;Rio Negro;1;2;3;121
3505708;Barueri;4122206;Rio Branco do Sul;1;2;3;307
4117602;Palmas;4122206;Rio Branco do Sul;1;2;3;307
4102406;Bandeirantes;4121802;Ribeirão Claro;1;2;3;63
4104303;Campo Mourão;4121356;Rancho Alegre d'Oeste;1;2;3;64
3547304;Santana de Parnaíba;4121000;Querência do Norte;1;2;3;675
2927408;Salvador;4120804;Quatro Barras;1;2;3;1712
4104709;Carlópolis;4120705;Quatiguá;1;2;3;25
4113205;Lapa;4119954;Pontal do Paraná;1;2;3;121
4103701;Cambé;4119905;Ponta Grossa;1;2;3;229
4107652;Fazenda Rio Grande;4119905;Ponta Grossa;1;2;3;106
4117909;Palotina;4119608;Pitanga;1;2;3;214
3304557;Rio de Janeiro;4119400;Piraí do Sul;1;2;3;697
2910727;Eunápolis;4119152;Pinhais;1;2;3;1373
2923001;Nova Viçosa;4119152;Pinhais;1;2;3;1267
3304201;Resende;4119152;Pinhais;1;2;3;572
3549805;São José do Rio Preto;4118907;Pérola;1;2;3;544
4113205;Lapa;4118709;Paulo Frontin;1;2;3;116
4103222;Bom Sucesso do Sul;4118501;Pato Branco;1;2;3;24
3534401;Osasco;4118402;Paranavaí;1;2;3;582
3544251;Rosana;4118402;Paranavaí;1;2;3;85
4110409;Indianópolis;4118402;Paranavaí;1;2;3;49
4115804;Medianeira;4118402;Paranavaí;1;2;3;297
4104303;Campo Mourão;4118204;Paranaguá;1;2;3;419
4100707;Alto Piquiri;4117909;Palotina;1;2;3;48
4104303;Campo Mourão;4117800;Palmital;1;2;3;96
4102901;Bituruna;4117602;Palmas;1;2;3;57
4104808;Cascavel;4117602;Palmas;1;2;3;227
4106902;Curitiba;4117305;Ortigueira;1;2;3;217
3505807;Bastos;4116901;Nova Esperança;1;2;3;205
1100023;Ariquemes;4115200;Maringá;1;2;3;1852
4102802;Bela Vista do Paraíso;4115200;Maringá;1;2;3;89
4107553;Farol;4115200;Maringá;1;2;3;103
4106902;Curitiba;4114401;Mangueirinha;1;2;3;294
4106852;Cruzmaltina;4114203;Mandaguari;1;2;3;56
4102109;Astorga;4114104;Mandaguaçu;1;2;3;49
4109500;Guaraqueçaba;4113908;Mallet;1;2;3;257
3532207;Narandiba;4113809;Lupionópolis;1;2;3;41
3146008;Ouro Fino;4113700;Londrina;1;2;3;500
3148004;Patos de Minas;4113700;Londrina;1;2;3;701
3300100;Angra dos Reis;4113700;Londrina;1;2;3;703
3302403;Macaé;4113700;Londrina;1;2;3;950
3303302;Niterói;4113700;Londrina;1;2;3;824
3306305;Volta Redonda;4113700;Londrina;1;2;3;725
3506508;Birigui;4113700;Londrina;1;2;3;236
3507100;Bom Jesus dos Perdões;4113700;Londrina;1;2;3;480
3511102;Catanduva;4113700;Londrina;1;2;3;324
3511607;Cesário Lange;4113700;Londrina;1;2;3;327
3518701;Guarujá;4113700;Londrina;1;2;3;506
3522307;Itapetininga;4113700;Londrina;1;2;3;319
3538709;Piracicaba;4113700;Londrina;1;2;3;363
3541000;Praia Grande;4113700;Londrina;1;2;3;494
3554102;Taubaté;4113700;Londrina;1;2;3;570
4102703;Barra do Jacaré;4113700;Londrina;1;2;3;101
4109708;Ibaiti;4112306;Japira;1;2;3;7
2900405;Água Fria;4112009;Jaguariaíva;1;2;3;1740
2913705;Inhambupe;4112009;Jaguariaíva;1;2;3;1772
3507159;Bom Sucesso de Itararé;4112009;Jaguariaíva;1;2;3;56
3553807;Taquarituba;4111803;Jacarezinho;1;2;3;90
3534401;Osasco;4111506;Ivaiporã;1;2;3;505
4105508;Cianorte;4111100;Itambé;1;2;3;62
4105508;Cianorte;4109807;Ibiporã;1;2;3;165
1100023;Ariquemes;4109708;Ibaiti;1;2;3;1990
1100049;Cacoal;4109708;Ibaiti;1;2;3;1767
1100106;Guajará-Mirim;4109708;Ibaiti;1;2;3;2073
4104303;Campo Mourão;4109658;Honório Serpa;1;2;3;232
3541406;Presidente Prudente;4109401;Guarapuava;1;2;3;361
4103453;Cafelândia;4108601;Goioerê;1;2;3;55
3170206;Uberlândia;4108304;Foz do Iguaçu;1;2;3;954
4101408;Apucarana;4107652;Fazenda Rio Grande;1;2;3;316
4104303;Campo Mourão;4107603;Faxinal;1;2;3;109
1100106;Guajará-Mirim;4107256;Douradina;1;2;3;1831
1100288;Rolim de Moura;4107256;Douradina;1;2;3;1528
1200252;Epitaciolândia;4107256;Douradina;1;2;3;2043
1503606;Itaituba;4107256;Douradina;1;2;3;2135
3203205;Linhares;4107256;Douradina;1;2;3;1410
2903201;Barreiras;4106902;Curitiba;1;2;3;1521
3302502;Magé;4106902;Curitiba;1;2;3;693
3505807;Bastos;4106605;Cruzeiro do Oeste;1;2;3;314
4105508;Cianorte;4106308;Corbélia;1;2;3;143
3550308;São Paulo;4106001;Congonhinhas;1;2;3;399
3536505;Paulínia;4105508;Cianorte;1;2;3;563
1100023;Ariquemes;4104808;Cascavel;1;2;3;1904
1100098;Espigão d'Oeste;4104808;Cascavel;1;2;3;1656
1100114;Jaru;4104808;Cascavel;1;2;3;1830
1100155;Ouro Preto do Oeste;4104808;Cascavel;1;2;3;1790
1100254;Presidente Médici;4104808;Cascavel;1;2;3;1729
3505203;Bariri;4104808;Cascavel;1;2;3;569
4104428;Candói;4104808;Cascavel;1;2;3;153
4102307;Balsa Nova;4104659;Carambeí;1;2;3;87
4104428;Candói;4104451;Cantagalo;1;2;3;32
3511300;Cedral;4104303;Campo Mourão;1;2;3;468
3534401;Osasco;4104303;Campo Mourão;1;2;3;571
4103040;Boa Ventura de São Roque;4104303;Campo Mourão;1;2;3;120
3534401;Osasco;4103701;Cambé;1;2;3;460
4101804;Araucária;4103107;Bocaiúva do Sul;1;2;3;51
3519501;Ibirarema;4102307;Balsa Nova;1;2;3;309
3510609;Carapicuíba;4101903;Assaí;1;2;3;410
2105302;Imperatriz;4101804;Araucária;1;2;3;2229
4100202;Adrianópolis;4101804;Araucária;1;2;3;108
4101408;Apucarana;4101804;Araucária;1;2;3;304
1100114;Jaru;4101507;Arapongas;1;2;3;1806
1100122;Ji-Paraná;4101507;Arapongas;1;2;3;1724
1200302;Feijó;4101507;Arapongas;1;2;3;2507
1200500;Sena Madureira;4101507;Arapongas;1;2;3;2321
3541307;Presidente Epitácio;4101507;Arapongas;1;2;3;193
1302603;Manaus;4101408;Apucarana;1;2;3;2411
2611606;Recife;4101408;Apucarana;1;2;3;2354
3505807;Bastos;4100608;Alto Paraná;1;2;3;210
3529302;Matão;3557105;Votuporanga;1;2;3;210
3532009;Morungaba;3557006;Votorantim;1;2;3;94
3545803;Santa Bárbara d'Oeste;3557006;Votorantim;1;2;3;85
3505500;Barretos;3556800;Viradouro;1;2;3;46
3531506;Monte Azul Paulista;3556800;Viradouro;1;2;3;36
3554102;Taubaté;3556206;Valinhos;1;2;3;145
3503208;Araraquara;3555604;Uchoa;1;2;3;140
3527108;Lins;3555356;Ubarana;1;2;3;58
3535705;Paraíso;3555356;Ubarana;1;2;3;99
3534401;Osasco;3555000;Tupã;1;2;3;428
1400100;Boa Vista;3554508;Tietê;1;2;3;3140
3506904;Bofete;3554508;Tietê;1;2;3;56
3507605;Bragança Paulista;3554508;Tietê;1;2;3;120
3509502;Campinas;3554300;Teodoro Sampaio;1;2;3;530
3543402;Ribeirão Preto;3554300;Teodoro Sampaio;1;2;3;475
3546603;Santa Fé do Sul;3554300;Teodoro Sampaio;1;2;3;287
3513009;Cotia;3554102;Taubaté;1;2;3;153
3516200;Franca;3554102;Taubaté;1;2;3;329
3518305;Guararema;3554102;Taubaté;1;2;3;66
3502200;Angatuba;3554003;Tatuí;1;2;3;60
3510401;Capivari;3554003;Tatuí;1;2;3;52
3540606;Porto Feliz;3554003;Tatuí;1;2;3;36
3537909;Pilar do Sul;3553856;Taquarivaí;1;2;3;100
3505302;Barra Bonita;3553708;Taquaritinga;1;2;3;117
3550308;São Paulo;3553401;Tanabi;1;2;3;460
3506102;Bebedouro;3553302;Tambaú;1;2;3;156
1500800;Ananindeua;3552809;Taboão da Serra;1;2;3;2463
3104007;Araxá;3552809;Taboão da Serra;1;2;3;444
3169307;Três Corações;3552809;Taboão da Serra;1;2;3;265
3515103;Embu-Guaçu;3552809;Taboão da Serra;1;2;3;27
3552403;Sumaré;3552809;Taboão da Serra;1;2;3;99
3529302;Matão;3552601;Tabapuã;1;2;3;97
3516200;Franca;3552502;Suzano;1;2;3;350
1100205;Porto Velho;3552403;Sumaré;1;2;3;2261
1505536;Parauapebas;3552403;Sumaré;1;2;3;1878
3530706;Mogi Guaçu;3552403;Sumaré;1;2;3;64
1100205;Porto Velho;3552205;Sorocaba;1;2;3;2288
3513702;Descalvado;3552205;Sorocaba;1;2;3;175
3513702;Descalvado;3551702;Sertãozinho;1;2;3;93
3510807;Casa Branca;3551603;Serra Negra;1;2;3;101
3533205;Nova Independência;3551504;Serrana;1;2;3;404
3512902;Cosmorama;3551306;Sebastianópolis do Sul;1;2;3;25
3529609;Meridiano;3551306;Sebastianópolis do Sul;1;2;3;42
2927408;Salvador;3551108;Sarapuí;1;2;3;1498
3509502;Campinas;3550902;São Simão;1;2;3;165
3510807;Casa Branca;3550803;São Sebastião da Grama;1;2;3;28
3509700;Campos do Jordão;3550704;São Sebastião;1;2;3;116
3534401;Osasco;3550704;São Sebastião;1;2;3;140
3509502;Campinas;3550407;São Pedro;1;2;3;96
1101104;Itapuã do Oeste;3550308;São Paulo;1;2;3;2277
1500107;Abaetetuba;3550308;São Paulo;1;2;3;2433
1500206;Acará;3550308;São Paulo;1;2;3;2408
1716604;Peixe;3550308;São Paulo;1;2;3;1300
2103307;Codó;3550308;São Paulo;1;2;3;2137
2616308;Vicência;3550308;São Paulo;1;2;3;2088
2909802;Cruz das Almas;3550308;São Paulo;1;2;3;1424
3101508;Além Paraíba;3550308;São Paulo;1;2;3;448
3103801;Arapuá;3550308;São Paulo;1;2;3;514
3121407;Desterro de Entre Rios;3550308;São Paulo;1;2;3;406
3136900;Juruaia;3550308;São Paulo;1;2;3;266
3156106;Ritápolis;3550308;São Paulo;1;2;3;375
3165305;São Vicente de Minas;3550308;São Paulo;1;2;3;310
3203320;Marataízes;3550308;São Paulo;1;2;3;651
3303856;Paty do Alferes;3550308;São Paulo;1;2;3;355
3305307;São Sebastião do Alto;3550308;São Paulo;1;2;3;493
3305901;Trajano de Morais;3550308;São Paulo;1;2;3;497
3501004;Altinópolis;3550308;São Paulo;1;2;3;300
3507407;Borborema;3550308;São Paulo;1;2;3;333
3519907;Iepê;3550308;São Paulo;1;2;3;463
3525607;João Ramalho;3550308;São Paulo;1;2;3;446
3502309;Anhembi;3550100;São Manuel;1;2;3;44
3503208;Araraquara;3550100;São Manuel;1;2;3;112
3509502;Campinas;3550100;São Manuel;1;2;3;157
3509502;Campinas;3550001;São Luís do Paraitinga;1;2;3;182
3522208;Itapecerica da Serra;3549953;São Lourenço da Serra;1;2;3;18
2504009;Campina Grande;3549904;São José dos Campos;1;2;3;2023
3303955;Pinheiral;3549904;São José dos Campos;1;2;3;207
3516200;Franca;3549904;São José dos Campos;1;2;3;332
3543303;Ribeirão Pires;3549904;São José dos Campos;1;2;3;78
3513009;Cotia;3549805;São José do Rio Preto;1;2;3;403
3514957;Embaúba;3549805;São José do Rio Preto;1;2;3;58
3530706;Mogi Guaçu;3549805;São José do Rio Preto;1;2;3;305
3532702;Nipoã;3549805;São José do Rio Preto;1;2;3;41
3548906;São Carlos;3549706;São José do Rio Pardo;1;2;3;115
3509502;Campinas;3549409;São Joaquim da Barra;1;2;3;269
3505203;Bariri;3548906;São Carlos;1;2;3;87
3524402;Jacareí;3548906;São Carlos;1;2;3;248
3537305;Penápolis;3548906;São Carlos;1;2;3;233
2905701;Camaçari;3548807;São Caetano do Sul;1;2;3;1457
3147303;Paraisópolis;3548807;São Caetano do Sul;1;2;3;142
1506807;Santarém;3548708;São Bernardo do Campo;1;2;3;2480
1505536;Parauapebas;3548500;Santos;1;2;3;2008
3201209;Cachoeiro de Itapemirim;3548500;Santos;1;2;3;630
3543303;Ribeirão Pires;3548500;Santos;1;2;3;23
3530706;Mogi Guaçu;3548005;Santo Antônio de Posse;1;2;3;31
3546306;Santa Cruz das Palmeiras;3548005;Santo Antônio de Posse;1;2;3;93
3526902;Limeira;3547809;Santo André;1;2;3;149
3501301;Álvares Machado;3547700;Santo Anastácio;1;2;3;22
3541208;Presidente Bernardes;3547700;Santo Anastácio;1;2;3;11
3505500;Barretos;3547502;Santa Rita do Passa Quatro;1;2;3;171
3519709;Ibiúna;3547502;Santa Rita do Passa Quatro;1;2;3;217
3533908;Olímpia;3547502;Santa Rita do Passa Quatro;1;2;3;182
3537800;Piedade;3547502;Santa Rita do Passa Quatro;1;2;3;222
3534401;Osasco;3546801;Santa Isabel;1;2;3;63
3509502;Campinas;3546603;Santa Fé do Sul;1;2;3;510
3534401;Osasco;3546405;Santa Cruz do Rio Pardo;1;2;3;301
3500303;Aguaí;3546306;Santa Cruz das Palmeiras;1;2;3;38
3513504;Cubatão;3545803;Santa Bárbara d'Oeste;1;2;3;162
3509502;Campinas;3545605;Santa Adélia;1;2;3;259
3514924;Elisiário;3545605;Santa Adélia;1;2;3;33
3519402;Ibirá;3545605;Santa Adélia;1;2;3;49
3535101;Palmares Paulista;3545605;Santa Adélia;1;2;3;18
3539004;Pirangi;3545605;Santa Adélia;1;2;3;23
3170206;Uberlândia;3545308;Salto de Pirapora;1;2;3;530
3502200;Angatuba;3545209;Salto;1;2;3;120
3506904;Bofete;3545209;Salto;1;2;3;100
3518503;Guareí;3545209;Salto;1;2;3;94
3530607;Moji das Cruzes;3545209;Salto;1;2;3;119
3541000;Praia Grande;3545209;Salto;1;2;3;127
3528858;Marapoama;3544806;Sales;1;2;3;38
3529005;Marília;3544608;Sabino;1;2;3;93
2913606;Ilhéus;3543907;Rio Claro;1;2;3;1197
2932507;Una;3543907;Rio Claro;1;2;3;1161
3171006;Vazante;3543907;Rio Claro;1;2;3;491
1506807;Santarém;3543402;Ribeirão Preto;1;2;3;2179
3148004;Patos de Minas;3543402;Ribeirão Preto;1;2;3;315
3518701;Guarujá;3543402;Ribeirão Preto;1;2;3;349
2611606;Recife;3543303;Ribeirão Pires;1;2;3;2058
3138203;Lavras;3543303;Ribeirão Pires;1;2;3;309
3503307;Araras;3543253;Ribeirão Grande;1;2;3;217
3523206;Itararé;3543006;Ribeirão Branco;1;2;3;60
3118601;Contagem;3542602;Registro;1;2;3;634
3522307;Itapetininga;3542503;Reginópolis;1;2;3;224
3509502;Campinas;3541901;Queluz;1;2;3;239
2304400;Fortaleza;3541406;Presidente Prudente;1;2;3;2398
3516200;Franca;3541406;Presidente Prudente;1;2;3;446
3521408;Iracemápolis;3540903;Pradópolis;1;2;3;147
3170107;Uberaba;3539806;Poá;1;2;3;447
3529401;Mauá;3539806;Poá;1;2;3;20
3505609;Barrinha;3539509;Pitangueiras;1;2;3;21
3534401;Osasco;3539509;Pitangueiras;1;2;3;317
3523404;Itatiba;3539301;Pirassununga;1;2;3;127
3509502;Campinas;3539202;Pirapozinho;1;2;3;464
3537404;Pereira Barreto;3539004;Pirangi;1;2;3;258
3509502;Campinas;3538907;Pirajuí;1;2;3;268
3515152;Engenheiro Coelho;3538709;Piracicaba;1;2;3;53
3519709;Ibiúna;3537909;Pilar do Sul;1;2;3;53
3522307;Itapetininga;3537503;Pereiras;1;2;3;56
3509502;Campinas;3537404;Pereira Barreto;1;2;3;493
3534401;Osasco;3537206;Pedro de Toledo;1;2;3;93
3304904;São Gonçalo;3537107;Pedreira;1;2;3;394
3526902;Limeira;3537107;Pedreira;1;2;3;54
3156908;Sacramento;3536307;Patrocínio Paulista;1;2;3;88
3507803;Brodowski;3536307;Patrocínio Paulista;1;2;3;54
3503208;Araraquara;3536109;Pardinho;1;2;3;145
3514957;Embaúba;3535705;Paraíso;1;2;3;10
3517505;Guapiaçu;3535002;Palestina;1;2;3;53
3534203;Orindiúva;3535002;Palestina;1;2;3;26
3521606;Irapuru;3534906;Pacaembu;1;2;3;9
3511409;Cerqueira César;3534708;Ourinhos;1;2;3;76
3516200;Franca;3534708;Ourinhos;1;2;3;371
3504008;Assis;3534609;Osvaldo Cruz;1;2;3;106
1500503;Almeirim;3534401;Osasco;1;2;3;2502
1506807;Santarém;3534401;Osasco;1;2;3;2455
2304202;Crato;3534401;Osasco;1;2;3;1945
2312908;Sobral;3534401;Osasco;1;2;3;2285
2408003;Mossoró;3534401;Osasco;1;2;3;2230
2604106;Caruaru;3534401;Osasco;1;2;3;1992
2900702;Alagoinhas;3534401;Osasco;1;2;3;1508
2918407;Juazeiro;3534401;Osasco;1;2;3;1673
2922003;Mucuri;3534401;Osasco;1;2;3;949
2923001;Nova Viçosa;3534401;Osasco;1;2;3;963
2924009;Paulo Afonso;3534401;Osasco;1;2;3;1770
2925303;Porto Seguro;3534401;Osasco;1;2;3;1097
2928703;Santo Antônio de Jesus;3534401;Osasco;1;2;3;1385
2931350;Teixeira de Freitas;3534401;Osasco;1;2;3;970
3108602;Brasília de Minas;3534401;Osasco;1;2;3;846
3110509;Camanducaia;3534401;Osasco;1;2;3;109
3122306;Divinópolis;3534401;Osasco;1;2;3;420
3134400;Iturama;3534401;Osasco;1;2;3;543
3139409;Manhuaçu;3534401;Osasco;1;2;3;601
3148004;Patos de Minas;3534401;Osasco;1;2;3;549
3152501;Pouso Alegre;3534401;Osasco;1;2;3;169
3156700;Sabará;3534401;Osasco;1;2;3;504
3157807;Santa Luzia;3534401;Osasco;1;2;3;511
3168606;Teófilo Otoni;3534401;Osasco;1;2;3;821
3169604;Tupaciguara;3534401;Osasco;1;2;3;580
3201308;Cariacica;3534401;Osasco;1;2;3;736
3201506;Colatina;3534401;Osasco;1;2;3;762
3201902;Domingos Martins;3534401;Osasco;1;2;3;712
3202405;Guarapari;3534401;Osasco;1;2;3;706
3300209;Araruama;3534401;Osasco;1;2;3;458
3301306;Casimiro de Abreu;3534401;Osasco;1;2;3;481
3302007;Itaguaí;3534401;Osasco;1;2;3;314
3303203;Nilópolis;3534401;Osasco;1;2;3;351
3304144;Queimados;3534401;Osasco;1;2;3;339
3305000;São João da Barra;3534401;Osasco;1;2;3;616
3306008;Três Rios;3534401;Osasco;1;2;3;396
3306107;Valença;3534401;Osasco;1;2;3;342
3500105;Adamantina;3534401;Osasco;1;2;3;482
3503901;Arujá;3534401;Osasco;1;2;3;50
3505500;Barretos;3534401;Osasco;1;2;3;376
3515509;Fernandópolis;3534401;Osasco;1;2;3;502
3527108;Lins;3534401;Osasco;1;2;3;366
3528502;Mairiporã;3534401;Osasco;1;2;3;32
3529708;Miguelópolis;3534302;Orlândia;1;2;3;62
3511102;Catanduva;3534005;Onda Verde;1;2;3;69
3503208;Araraquara;3533908;Olímpia;1;2;3;138
3508801;Cafelândia;3533502;Novo Horizonte;1;2;3;55
3509502;Campinas;3532009;Morungaba;1;2;3;27
3529401;Mauá;3532009;Morungaba;1;2;3;94
3503208;Araraquara;3531308;Monte Alto;1;2;3;64
3519303;Ibaté;3531308;Monte Alto;1;2;3;90
3503703;Ariranha;3530706;Mogi Guaçu;1;2;3;227
1505536;Parauapebas;3530607;Moji das Cruzes;1;2;3;1974
2607208;Ipojuca;3530607;Moji das Cruzes;1;2;3;2001
2905701;Camaçari;3530607;Moji das Cruzes;1;2;3;1431
3131703;Itabira;3530607;Moji das Cruzes;1;2;3;526
3524709;Jaguariúna;3530508;Mococa;1;2;3;137
3501608;Americana;3530300;Mirassol;1;2;3;313
3509502;Campinas;3530102;Mirandópolis;1;2;3;466
1302603;Manaus;3529401;Mauá;1;2;3;2630
1501402;Belém;3529401;Mauá;1;2;3;2473
3506003;Bauru;3529401;Mauá;1;2;3;304
3513009;Cotia;3529401;Mauá;1;2;3;47
3516200;Franca;3529401;Mauá;1;2;3;359
3502309;Anhembi;3529302;Matão;1;2;3;136
3507506;Botucatu;3529302;Matão;1;2;3;142
3524501;Jaci;3529302;Matão;1;2;3;145
3529203;Martinópolis;3529302;Matão;1;2;3;294
3500204;Adolfo;3528858;Marapoama;1;2;3;54
3505708;Barueri;3528403;Mairinque;1;2;3;32
3523909;Itu;3527306;Louveira;1;2;3;42
3502101;Andradina;3527108;Lins;1;2;3;188
3525300;Jaú;3526902;Limeira;1;2;3;125
2910800;Feira de Santana;3525904;Jundiaí;1;2;3;1440
3202603;Iconha;3525904;Jundiaí;1;2;3;673
3522604;Itapira;3525904;Jundiaí;1;2;3;83
3509502;Campinas;3525706;José Bonifácio;1;2;3;343
3509601;Campo Limpo Paulista;3525003;Jandira;1;2;3;38
3513801;Diadema;3525003;Jandira;1;2;3;34
3516309;Francisco Morato;3525003;Jandira;1;2;3;35
1501402;Belém;3524709;Jaguariúna;1;2;3;2363
2304400;Fortaleza;3524402;Jacareí;1;2;3;2281
3151800;Poços de Caldas;3524402;Jacareí;1;2;3;182
3502754;Araçariguama;3523909;Itu;1;2;3;30
3516200;Franca;3523909;Itu;1;2;3;304
2927408;Salvador;3523206;Itararé;1;2;3;1629
3509502;Campinas;3522703;Itápolis;1;2;3;233
3510401;Capivari;3522406;Itapeva;1;2;3;177
3520509;Indaiatuba;3522307;Itapetininga;1;2;3;99
3521150;Ipiguá;3522307;Itapetininga;1;2;3;354
2307304;Juazeiro do Norte;3520509;Indaiatuba;1;2;3;1921
3516200;Franca;3520509;Indaiatuba;1;2;3;283
3509502;Campinas;3520400;Ilhabela;1;2;3;198
3509502;Campinas;3520301;Iguape;1;2;3;206
3510005;Cândido Mota;3519907;Iepê;1;2;3;71
3505708;Barueri;3519709;Ibiúna;1;2;3;39
2927408;Salvador;3519600;Ibitinga;1;2;3;1427
3502804;Araçatuba;3519600;Ibitinga;1;2;3;177
3507407;Borborema;3519105;Iacanga;1;2;3;30
3514908;Elias Fausto;3519071;Hortolândia;1;2;3;26
3300100;Angra dos Reis;3518800;Guarulhos;1;2;3;239
2304400;Fortaleza;3518701;Guarujá;1;2;3;2356
3516200;Franca;3518404;Guaratinguetá;1;2;3;340
3165404;Sapucaí-Mirim;3518305;Guararema;1;2;3;80
3170206;Uberlândia;3517505;Guapiaçu;1;2;3;232
3511102;Catanduva;3517505;Guapiaçu;1;2;3;46
3511102;Catanduva;3517000;Getulina;1;2;3;121
3502101;Andradina;3516705;Garça;1;2;3;230
3304557;Rio de Janeiro;3516408;Franco da Rocha;1;2;3;357
2301109;Aracati;3516200;Franca;1;2;3;2017
2302602;Camocim;3516200;Franca;1;2;3;2055
2604106;Caruaru;3516200;Franca;1;2;3;1782
2609600;Olinda;3516200;Franca;1;2;3;1878
2700300;Arapiraca;3516200;Franca;1;2;3;1613
2905701;Camaçari;3516200;Franca;1;2;3;1270
2913606;Ilhéus;3516200;Franca;1;2;3;1062
2933307;Vitória da Conquista;3516200;Franca;1;2;3;921
3127701;Governador Valadares;3516200;Franca;1;2;3;594
3136702;Juiz de Fora;3516200;Franca;1;2;3;447
3504008;Assis;3516200;Franca;1;2;3;396
3510500;Caraguatatuba;3516200;Franca;1;2;3;397
3513801;Diadema;3516200;Franca;1;2;3;358
3134905;Jacutinga;3515186;Espírito Santo do Pinhal;1;2;3;17
3506102;Bebedouro;3515186;Espírito Santo do Pinhal;1;2;3;231
3109709;Cachoeira de Minas;3513801;Diadema;1;2;3;170
3509205;Cajamar;3513801;Diadema;1;2;3;45
3507159;Bom Sucesso de Itararé;3513702;Descalvado;1;2;3;311
3509502;Campinas;3513108;Cravinhos;1;2;3;186
2600054;Abreu e Lima;3513009;Cotia;1;2;3;2098
3503208;Araraquara;3512100;Colômbia;1;2;3;183
3170206;Uberlândia;3512001;Colina;1;2;3;203
3503208;Araraquara;3512001;Colina;1;2;3;125
3511003;Castilho;3511904;Clementina;1;2;3;132
3506102;Bebedouro;3510807;Casa Branca;1;2;3;176
3509700;Campos do Jordão;3510500;Caraguatatuba;1;2;3;100
2927408;Salvador;3510203;Capão Bonito;1;2;3;1559
3509809;Campos Novos Paulista;3510005;Cândido Mota;1;2;3;42
2306306;Itapagé;3509502;Campinas;1;2;3;2248
3143302;Montes Claros;3509502;Campinas;1;2;3;754
3147907;Passos;3509502;Campinas;1;2;3;247
3149309;Pedro Leopoldo;3509502;Campinas;1;2;3;474
3205101;Viana;3509502;Campinas;1;2;3;715
3502705;Apiaí;3509502;Campinas;1;2;3;256
3506359;Bertioga;3509502;Campinas;1;2;3;138
3170206;Uberlândia;3509403;Cajuru;1;2;3;281
3506102;Bebedouro;3508801;Cafelândia;1;2;3;146
3504404;Avanhandava;3507753;Brejo Alegre;1;2;3;43
3143401;Monte Sião;3507605;Bragança Paulista;1;2;3;57
1501402;Belém;3507506;Botucatu;1;2;3;2378
2927408;Salvador;3506904;Bofete;1;2;3;1483
2927408;Salvador;3506359;Bertioga;1;2;3;1418
3134202;Ituiutaba;3506102;Bebedouro;1;2;3;238
3152808;Prata;3506102;Bebedouro;1;2;3;185
1501402;Belém;3506003;Bauru;1;2;3;2319
2301000;Aquiraz;3505708;Barueri;1;2;3;2322
3125101;Extrema;3505708;Barueri;1;2;3;92
3146107;Ouro Preto;3505708;Barueri;1;2;3;484
3303401;Nova Friburgo;3505708;Barueri;1;2;3;457
3304144;Queimados;3505708;Barueri;1;2;3;346
3505500;Barretos;3505708;Barueri;1;2;3;370
1702109;Araguaína;3505500;Barretos;1;2;3;1478
1302603;Manaus;3503307;Araras;1;2;3;2469
3147907;Passos;3503307;Araras;1;2;3;198
2927408;Salvador;3500758;Alambari;1;2;3;1495
3119302;Coromandel;3500105;Adamantina;1;2;3;535
3300456;Belford Roxo;3306305;Volta Redonda;1;2;3;78
3305158;São José do Vale do Rio Preto;3306008;Três Rios;1;2;3;34
3300225;Areal;3305802;Teresópolis;1;2;3;25
3170701;Varginha;3305109;São João de Meriti;1;2;3;251
3300209;Araruama;3305109;São João de Meriti;1;2;3;106
3301405;Conceição de Macabu;3305109;São João de Meriti;1;2;3;173
3303401;Nova Friburgo;3305109;São João de Meriti;1;2;3;99
3106200;Belo Horizonte;3305000;São João da Barra;1;2;3;356
3149309;Pedro Leopoldo;3304904;São Gonçalo;1;2;3;366
1600105;Amapá;3304557;Rio de Janeiro;1;2;3;2855
2208403;Piripiri;3304557;Rio de Janeiro;1;2;3;2063
2400703;Alto do Rodrigues;3304557;Rio de Janeiro;1;2;3;2048
2503001;Caaporã;3304557;Rio de Janeiro;1;2;3;1889
2601706;Belo Jardim;3304557;Rio de Janeiro;1;2;3;1742
2601904;Bezerros;3304557;Rio de Janeiro;1;2;3;1780
2614501;Surubim;3304557;Rio de Janeiro;1;2;3;1824
2708006;Santana do Ipanema;3304557;Rio de Janeiro;1;2;3;1610
3114600;Carrancas;3304557;Rio de Janeiro;1;2;3;209
3117504;Conceição do Mato Dentro;3304557;Rio de Janeiro;1;2;3;427
3125705;Felixlândia;3304557;Rio de Janeiro;1;2;3;486
3138708;Luminárias;3304557;Rio de Janeiro;1;2;3;226
3145455;Olhos-d'Água;3304557;Rio de Janeiro;1;2;3;608
3151206;Pirapora;3304557;Rio de Janeiro;1;2;3;637
3151602;Planura;3304557;Rio de Janeiro;1;2;3;631
3171105;Veríssimo;3304557;Rio de Janeiro;1;2;3;624
3203502;Montanha;3304557;Rio de Janeiro;1;2;3;605
3301108;Cantagalo;3304557;Rio de Janeiro;1;2;3;138
2927408;Salvador;3304508;Rio das Flores;1;2;3;1138
3136306;João Pinheiro;3304201;Resende;1;2;3;556
2607901;Jaboatão dos Guararapes;3303906;Petrópolis;1;2;3;1789
2800308;Aracaju;3303906;Petrópolis;1;2;3;1426
3170206;Uberlândia;3303906;Petrópolis;1;2;3;652
3303856;Paty do Alferes;3303906;Petrópolis;1;2;3;23
3300407;Barra Mansa;3303807;Parati;1;2;3;93
2933307;Vitória da Conquista;3303708;Paraíba do Sul;1;2;3;845
3157807;Santa Luzia;3303500;Nova Iguaçu;1;2;3;333
3300407;Barra Mansa;3303401;Nova Friburgo;1;2;3;169
2804805;Nossa Senhora do Socorro;3303302;Niterói;1;2;3;1457
3201506;Colatina;3303302;Niterói;1;2;3;446
3301207;Carmo;3303302;Niterói;1;2;3;116
2910800;Feira de Santana;3302858;Mesquita;1;2;3;1245
3300456;Belford Roxo;3302502;Magé;1;2;3;37
3300225;Areal;3302403;Macaé;1;2;3;127
3101607;Alfenas;3302205;Itaperuna;1;2;3;424
3105608;Barbacena;3302205;Itaperuna;1;2;3;198
3138203;Lavras;3302205;Itaperuna;1;2;3;324
2804805;Nossa Senhora do Socorro;3301702;Duque de Caxias;1;2;3;1454
3131307;Ipatinga;3301702;Duque de Caxias;1;2;3;373
3138401;Leopoldina;3301702;Duque de Caxias;1;2;3;150
3300225;Areal;3301108;Cantagalo;1;2;3;83
3201308;Cariacica;3300704;Cabo Frio;1;2;3;333
3205200;Vila Velha;3300209;Araruama;1;2;3;347
3106705;Betim;3205309;Vitória;1;2;3;407
3114204;Carmo do Cajuru;3205309;Vitória;1;2;3;466
3150406;Piedade dos Gerais;3205309;Vitória;1;2;3;411
2611606;Recife;3205200;Vila Velha;1;2;3;1459
3122306;Divinópolis;3205200;Vila Velha;1;2;3;472
3137205;Lagoa da Prata;3205200;Vila Velha;1;2;3;540
3205010;Sooretama;3205200;Vila Velha;1;2;3;129
3203346;Marechal Floriano;3205101;Viana;1;2;3;12
3200102;Afonso Cláudio;3205069;Venda Nova do Imigrante;1;2;3;29
3201506;Colatina;3205036;Vargem Alta;1;2;3;130
2913606;Ilhéus;3205002;Serra;1;2;3;603
3149309;Pedro Leopoldo;3205002;Serra;1;2;3;396
3152170;Ponto dos Volantes;3205002;Serra;1;2;3;394
3167202;Sete Lagoas;3205002;Serra;1;2;3;417
3202108;Ecoporanga;3205002;Serra;1;2;3;206
2925303;Porto Seguro;3204906;São Mateus;1;2;3;269
3202256;Governador Lindenberg;3204708;São Gabriel da Palha;1;2;3;32
3113404;Caratinga;3204559;Santa Maria de Jetibá;1;2;3;154
2904704;Buerarema;3204104;Pinheiros;1;2;3;394
2910727;Eunápolis;3204104;Pinheiros;1;2;3;236
2925303;Porto Seguro;3204104;Pinheiros;1;2;3;248
3201605;Conceição da Barra;3204104;Pinheiros;1;2;3;49
3203205;Linhares;3204104;Pinheiros;1;2;3;107
2927408;Salvador;3204054;Pedro Canário;1;2;3;585
3148509;Pavão;3203908;Nova Venécia;1;2;3;157
3160108;Santo Antônio do Grama;3203908;Nova Venécia;1;2;3;294
2302602;Camocim;3203205;Linhares;1;2;3;1819
2402600;Ceará-Mirim;3203205;Linhares;1;2;3;1588
3202900;Itarana;3203163;Laranja da Terra;1;2;3;19
3201209;Cachoeiro de Itapemirim;3202900;Itarana;1;2;3;108
3151800;Poços de Caldas;3202454;Ibatiba;1;2;3;555
2800308;Aracaju;3201506;Colatina;1;2;3;1025
2931350;Teixeira de Freitas;3201308;Cariacica;1;2;3;309
2203909;Floriano;3201209;Cachoeiro de Itapemirim;1;2;3;1563
2208007;Picos;3201209;Cachoeiro de Itapemirim;1;2;3;1521
2211001;Teresina;3201209;Cachoeiro de Itapemirim;1;2;3;1749
2307304;Juazeiro do Norte;3201209;Cachoeiro de Itapemirim;1;2;3;1515
2504009;Campina Grande;3201209;Cachoeiro de Itapemirim;1;2;3;1595
2601201;Arcoverde;3201209;Cachoeiro de Itapemirim;1;2;3;1428
2604106;Caruaru;3201209;Cachoeiro de Itapemirim;1;2;3;1480
2611101;Petrolina;3201209;Cachoeiro de Itapemirim;1;2;3;1276
2615300;Timbaúba;3201209;Cachoeiro de Itapemirim;1;2;3;1585
2903201;Barreiras;3201209;Cachoeiro de Itapemirim;1;2;3;1032
2917508;Jacobina;3201209;Cachoeiro de Itapemirim;1;2;3;1062
2933307;Vitória da Conquista;3201209;Cachoeiro de Itapemirim;1;2;3;660
3131307;Ipatinga;3201209;Cachoeiro de Itapemirim;1;2;3;213
3152501;Pouso Alegre;3201209;Cachoeiro de Itapemirim;1;2;3;531
3168606;Teófilo Otoni;3201209;Cachoeiro de Itapemirim;1;2;3;331
2910800;Feira de Santana;3200607;Aracruz;1;2;3;843
3135050;Jaíba;3171030;Verdelândia;1;2;3;32
3143500;Morada Nova de Minas;3171030;Verdelândia;1;2;3;383
3170107;Uberaba;3170701;Varginha;1;2;3;324
3104502;Arinos;3170479;Uruana de Minas;1;2;3;23
3126307;Fortaleza de Minas;3170404;Unaí;1;2;3;493
2709301;União dos Palmares;3170206;Uberlândia;1;2;3;1651
2804805;Nossa Senhora do Socorro;3170107;Uberaba;1;2;3;1479
3109402;Buritizeiro;3170107;Uberaba;1;2;3;404
3151107;Pirapetinga;3170107;Uberaba;1;2;3;625
3156403;Romaria;3170107;Uberaba;1;2;3;101
3122306;Divinópolis;3169901;Ubá;1;2;3;223
3111804;Canápolis;3169604;Tupaciguara;1;2;3;55
3152808;Prata;3169604;Tupaciguara;1;2;3;86
3123700;Engenheiro Caldas;3169505;Tumiritinga;1;2;3;50
3100203;Abaeté;3169356;Três Marias;1;2;3;107
3143500;Morada Nova de Minas;3169356;Três Marias;1;2;3;44
3125101;Extrema;3169307;Três Corações;1;2;3;174
3143302;Montes Claros;3168804;Tiradentes;1;2;3;486
3157203;Santa Bárbara;3168705;Timóteo;1;2;3;91
3143450;Montezuma;3168002;Taiobeiras;1;2;3;76
3144656;Ninheira;3168002;Taiobeiras;1;2;3;75
3136702;Juiz de Fora;3167509;Simão Pereira;1;2;3;23
3120102;Couto de Magalhães de Minas;3167202;Sete Lagoas;1;2;3;171
3140852;Matias Cardoso;3167202;Sete Lagoas;1;2;3;509
3143104;Monte Carmelo;3167202;Sete Lagoas;1;2;3;352
3148004;Patos de Minas;3167202;Sete Lagoas;1;2;3;256
3154606;Ribeirão das Neves;3167202;Sete Lagoas;1;2;3;40
3139409;Manhuaçu;3166303;Sericita;1;2;3;51
3102605;Andradas;3165578;Senador Amaral;1;2;3;70
3141108;Matozinhos;3164704;São Sebastião do Paraíso;1;2;3;337
3140001;Mariana;3164001;São Pedro dos Ferros;1;2;3;96
3128303;Guaranésia;3163706;São Lourenço;1;2;3;205
3130200;Igaratinga;3163102;São José da Varginha;1;2;3;31
3104205;Arcos;3162955;São José da Lapa;1;2;3;178
3157807;Santa Luzia;3162955;São José da Lapa;1;2;3;15
3162005;São Gonçalo do Sapucaí;3162500;São João del Rei;1;2;3;160
3151503;Piumhi;3162203;São João Batista do Glória;1;2;3;60
1501782;Breu Branco;3160702;Santos Dumont;1;2;3;2020
3138401;Leopoldina;3160009;Santo Antônio do Aventureiro;1;2;3;28
3113602;Careaçu;3159605;Santa Rita do Sapucaí;1;2;3;23
3117702;Conceição do Rio Verde;3159605;Santa Rita do Sapucaí;1;2;3;76
3117801;Conceição dos Ouros;3159605;Santa Rita do Sapucaí;1;2;3;20
3146008;Ouro Fino;3159605;Santa Rita do Sapucaí;1;2;3;69
3127701;Governador Valadares;3159506;Santa Rita do Itueto;1;2;3;88
3111200;Campo Belo;3159209;Santa Rita de Caldas;1;2;3;167
3106200;Belo Horizonte;3158201;Santa Maria do Suaçuí;1;2;3;252
3142007;Mirabela;3157609;Santa Fé de Minas;1;2;3;141
3106309;Belo Oriente;3157203;Santa Bárbara;1;2;3;127
3156700;Sabará;3157203;Santa Bárbara;1;2;3;43
3133501;Itapecerica;3157104;Salto da Divisa;1;2;3;746
3136504;Jordânia;3157104;Salto da Divisa;1;2;3;26
3127800;Grão Mogol;3157005;Salinas;1;2;3;77
3151800;Poços de Caldas;3156908;Sacramento;1;2;3;232
3154606;Ribeirão das Neves;3156700;Sabará;1;2;3;30
3122306;Divinópolis;3154606;Ribeirão das Neves;1;2;3;94
3148103;Patrocínio;3154606;Ribeirão das Neves;1;2;3;316
3102803;Andrelândia;3154408;Ressaquinha;1;2;3;94
3115300;Cataguases;3154101;Recreio;1;2;3;28
3101508;Além Paraíba;3152501;Pouso Alegre;1;2;3;336
3120151;Crisólita;3152402;Poté;1;2;3;112
2927408;Salvador;3152170;Ponto dos Volantes;1;2;3;525
3151404;Pitangui;3152006;Pompéu;1;2;3;48
3115102;Cássia;3151503;Piumhi;1;2;3;102
3109402;Buritizeiro;3151404;Pitangui;1;2;3;254
3135209;Januária;3151206;Pirapora;1;2;3;214
3114204;Carmo do Cajuru;3148905;Pedra do Indaiá;1;2;3;46
3106200;Belo Horizonte;3148509;Pavão;1;2;3;418
3108008;Bom Sucesso;3147303;Paraisópolis;1;2;3;198
3133808;Itaúna;3147006;Paracatu;1;2;3;405
3140506;Martinho Campos;3147006;Paracatu;1;2;3;295
3144805;Nova Lima;3146107;Ouro Preto;1;2;3;52
3132404;Itajubá;3145604;Oliveira;1;2;3;200
3108008;Bom Sucesso;3145208;Nova Serrana;1;2;3;130
1502152;Canaã dos Carajás;3144805;Nova Lima;1;2;3;1616
3106309;Belo Oriente;3144706;Nova Era;1;2;3;84
3134301;Itumirim;3144508;Nazareno;1;2;3;29
3129301;Iapu;3144300;Nanuque;1;2;3;262
3113404;Caratinga;3143906;Muriaé;1;2;3;140
3118601;Contagem;3143906;Muriaé;1;2;3;221
3138005;Laranjal;3143906;Muriaé;1;2;3;36
3135050;Jaíba;3143500;Morada Nova de Minas;1;2;3;401
3106200;Belo Horizonte;3143450;Montezuma;1;2;3;548
3127701;Governador Valadares;3143104;Monte Carmelo;1;2;3;583
3135100;Janaúba;3143104;Monte Carmelo;1;2;3;543
3136702;Juiz de Fora;3143104;Monte Carmelo;1;2;3;557
3118809;Coração de Jesus;3142007;Mirabela;1;2;3;52
3116100;Chapada do Norte;3141801;Minas Novas;1;2;3;16
2702306;Coruripe;3138625;Limeira do Oeste;1;2;3;1808
3130002;Ibituruna;3138203;Lavras;1;2;3;28
3135209;Januária;3137601;Lagoa Santa;1;2;3;464
3122306;Divinópolis;3137304;Lagoa dos Patos;1;2;3;353
3100203;Abaeté;3136306;João Pinheiro;1;2;3;173
3132503;Itamarandiba;3135050;Jaíba;1;2;3;296
3109808;Cachoeira Dourada;3134202;Ituiutaba;1;2;3;51
3106309;Belo Oriente;3131158;Ipaba;1;2;3;23
3109006;Brumadinho;3129806;Ibirité;1;2;3;20
3113404;Caratinga;3129301;Iapu;1;2;3;41
3118601;Contagem;3127602;Gouveia;1;2;3;168
3103504;Araguari;3127107;Frutal;1;2;3;181
3124104;Esmeraldas;3126703;Francisco Sá;1;2;3;371
3110400;Camacho;3126109;Formiga;1;2;3;33
3109402;Buritizeiro;3125705;Felixlândia;1;2;3;155
2304400;Fortaleza;3122306;Divinópolis;1;2;3;1923
3106200;Belo Horizonte;3122108;Divino das Laranjeiras;1;2;3;292
3118601;Contagem;3121605;Diamantina;1;2;3;195
3106200;Belo Horizonte;3120706;Cruzeiro da Fortaleza;1;2;3;304
2103000;Caxias;3120102;Couto de Magalhães de Minas;1;2;3;1462
3106705;Betim;3119104;Corinto;1;2;3;178
3106200;Belo Horizonte;3113206;Carandaí;1;2;3;118
3112208;Capela Nova;3113206;Carandaí;1;2;3;27
2709301;União dos Palmares;3112604;Capinópolis;1;2;3;1743
3106200;Belo Horizonte;3111606;Campos Gerais;1;2;3;236
3106200;Belo Horizonte;3111101;Campina Verde;1;2;3;581
3106200;Belo Horizonte;3110509;Camanducaia;1;2;3;385
3109303;Buritis;3109451;Cabeceira Grande;1;2;3;84
3105400;Barão de Cocais;3107703;Bom Jesus do Amparo;1;2;3;26
3102902;Antônio Carlos;3106200;Belo Horizonte;1;2;3;159
3102902;Antônio Carlos;3105905;Barroso;1;2;3;28
2611606;Recife;3103504;Araguari;1;2;3;1796
2600054;Abreu e Lima;2933307;Vitória da Conquista;1;2;3;996
2603454;Camaragibe;2933307;Vitória da Conquista;1;2;3;978
2609600;Olinda;2933307;Vitória da Conquista;1;2;3;987
2611101;Petrolina;2933307;Vitória da Conquista;1;2;3;616
2700300;Arapiraca;2933307;Vitória da Conquista;1;2;3;717
2905701;Camaçari;2933307;Vitória da Conquista;1;2;3;361
2917508;Jacobina;2933307;Vitória da Conquista;1;2;3;402
2930105;Senhor do Bonfim;2933307;Vitória da Conquista;1;2;3;494
2931202;Taperoá;2932903;Valença;1;2;3;21
2919207;Lauro de Freitas;2932507;Una;1;2;3;279
2914901;Itacaré;2932309;Ubatã;1;2;3;57
2507507;João Pessoa;2930709;Simões Filho;1;2;3;727
2905206;Caetité;2930709;Simões Filho;1;2;3;469
2910503;Entre Rios;2930709;Simões Filho;1;2;3;102
2910800;Feira de Santana;2929370;São José do Jacuípe;1;2;3;138
2928208;Santana;2929057;São Félix do Coribe;1;2;3;49
2908200;Conceição da Feira;2929008;São Félix;1;2;3;17
2911709;Guanambi;2928208;Santana;1;2;3;201
1504406;Marapanim;2927408;Salvador;1;2;3;1677
2306306;Itapagé;2927408;Salvador;1;2;3;1036
2604502;Chã Grande;2927408;Salvador;1;2;3;618
2606002;Garanhuns;2927408;Salvador;1;2;3;503
2905602;Camacan;2927408;Salvador;1;2;3;292
2917607;Jaguaquara;2927408;Salvador;1;2;3;172
2909901;Curaçá;2927101;Rodelas;1;2;3;123
2804805;Nossa Senhora do Socorro;2926301;Riachão do Jacuípe;1;2;3;261
2911600;Governador Mangabeira;2925956;Rafael Jambeiro;1;2;3;54
2910800;Feira de Santana;2925303;Porto Seguro;1;2;3;458
2902203;Aramari;2925204;Pojuca;1;2;3;43
2920502;Maracás;2925204;Pojuca;1;2;3;254
2924900;Planaltino;2925204;Pojuca;1;2;3;240
2910800;Feira de Santana;2924801;Piritiba;1;2;3;184
2708006;Santana do Ipanema;2924009;Paulo Afonso;1;2;3;121
2804805;Nossa Senhora do Socorro;2924009;Paulo Afonso;1;2;3;206
2914000;Ipirá;2924009;Paulo Afonso;1;2;3;347
2919504;Livramento de Nossa Senhora;2923605;Paramirim;1;2;3;50
2912202;Ibicoara;2923209;Oliveira dos Brejinhos;1;2;3;213
2914000;Ipirá;2921708;Morro do Chapéu;1;2;3;168
2906501;Candeias;2921005;Mata de São João;1;2;3;31
2910800;Feira de Santana;2921005;Mata de São João;1;2;3;77
2902807;Barra da Estiva;2920809;Marcionílio Souza;1;2;3;111
2604007;Carpina;2919553;Luís Eduardo magalhães;1;2;3;1236
2611606;Recife;2919553;Luís Eduardo magalhães;1;2;3;1257
2910800;Feira de Santana;2919553;Luís Eduardo magalhães;1;2;3;746
2804805;Nossa Senhora do Socorro;2919207;Lauro de Freitas;1;2;3;259
2910057;Dias d'Ávila;2919207;Lauro de Freitas;1;2;3;30
2913606;Ilhéus;2918555;Jussari;1;2;3;60
2615607;Trindade;2918407;Juazeiro;1;2;3;187
2910701;Euclides da Cunha;2918100;Jeremoabo;1;2;3;89
2507507;João Pessoa;2918001;Jequié;1;2;3;920
2906006;Campo Formoso;2918001;Jequié;1;2;3;366
2612208;Salgueiro;2917706;Jaguarari;1;2;3;262
2906501;Candeias;2917607;Jaguaquara;1;2;3;179
2904704;Buerarema;2917102;Itororó;1;2;3;82
2803500;Lagarto;2916500;Itapicuru;1;2;3;72
2913903;Ipiaú;2915205;Itagibá;1;2;3;27
2503704;Cajazeiras;2914604;Irecê;1;2;3;607
2903904;Bom Jesus da Lapa;2914109;Ipupiara;1;2;3;186
2903201;Barreiras;2914000;Ipirá;1;2;3;569
2507507;João Pessoa;2913606;Ilhéus;1;2;3;955
2911204;Gandu;2913606;Ilhéus;1;2;3;122
2906501;Candeias;2911709;Guanambi;1;2;3;490
2804805;Nossa Senhora do Socorro;2910602;Esplanada;1;2;3;141
2611101;Petrolina;2909901;Curaçá;1;2;3;79
2907301;Castro Alves;2908507;Conceição do Jacuípe;1;2;3;86
2902658;Banzaê;2907806;Cícero Dantas;1;2;3;18
2604007;Carpina;2903201;Barreiras;1;2;3;1158
2804458;Nossa Senhora Aparecida;2806206;Salgado;1;2;3;68
2801504;Carmópolis;2805703;Propriá;1;2;3;50
2800605;Barra dos Coqueiros;2805307;Pirambu;1;2;3;26
2800670;Boquim;2804805;Nossa Senhora do Socorro;1;2;3;62
2803005;Itabaianinha;2804805;Nossa Senhora do Socorro;1;2;3;85
2804607;Nossa Senhora das Dores;2804805;Nossa Senhora do Socorro;1;2;3;40
2503209;Cabedelo;2800308;Aracaju;1;2;3;489
2706901;Pilar;2709301;União dos Palmares;1;2;3;48
2702405;Delmiro Gouveia;2705804;Olho d'Água do Casado;1;2;3;25
2703502;Jacuípe;2703908;Jundiá;1;2;3;16
2402006;Caicó;2702900;Girau do Ponciano;1;2;3;381
2701001;Boca da Mata;2701407;Campo Alegre;1;2;3;21
2304509;Frecheirinha;2700300;Arapiraca;1;2;3;802
2613602;São José do Egito;2700300;Arapiraca;1;2;3;261
2306306;Itapagé;2616407;Vitória de Santo Antão;1;2;3;680
2601904;Bezerros;2615409;Toritama;1;2;3;39
2608008;Jataúba;2615409;Toritama;1;2;3;49
2506301;Guarabira;2615300;Timbaúba;1;2;3;75
2506806;Ingá;2615300;Timbaúba;1;2;3;43
2513703;Santa Rita;2615300;Timbaúba;1;2;3;54
2606804;Igarassu;2615300;Timbaúba;1;2;3;55
2611002;Petrolândia;2614808;Tacaratu;1;2;3;18
2609709;Orobó;2613800;São Vicente Ferrer;1;2;3;21
2601706;Belo Jardim;2613107;São Caitano;1;2;3;31
2608008;Jataúba;2612406;Sanharó;1;2;3;42
2208007;Picos;2612208;Salgueiro;1;2;3;280
2600401;Água Preta;2611804;Ribeirão;1;2;3;27
2602100;Bom Conselho;2611705;Riacho das Almas;1;2;3;149
2204501;Guadalupe;2611606;Recife;1;2;3;959
2301109;Aracati;2611606;Recife;1;2;3;500
2411205;Santa Cruz;2611606;Recife;1;2;3;239
2504801;Coremas;2611606;Recife;1;2;3;352
2607752;Itapissuma;2611606;Recife;1;2;3;38
2312908;Sobral;2611101;Petrolina;1;2;3;624
2605707;Floresta;2611101;Petrolina;1;2;3;226
2609402;Moreno;2610608;Paudalho;1;2;3;26
1502400;Castanhal;2609907;Ouricuri;1;2;3;1124
2600500;Águas Belas;2608800;Lajedo;1;2;3;102
2601003;Angelim;2608602;Lagoa do Ouro;1;2;3;32
2600708;Aliança;2606200;Goiana;1;2;3;26
2602902;Cabo de Santo Agostinho;2606200;Goiana;1;2;3;80
2604106;Caruaru;2605202;Escada;1;2;3;86
2507507;João Pessoa;2604502;Chã Grande;1;2;3;134
2510808;Patos;2604106;Caruaru;1;2;3;198
2600807;Altinho;2604106;Caruaru;1;2;3;24
2604007;Carpina;2604106;Caruaru;1;2;3;96
2600302;Agrestina;2601706;Belo Jardim;1;2;3;54
2208007;Picos;2601201;Arcoverde;1;2;3;507
2306306;Itapagé;2600054;Abreu e Lima;1;2;3;694
2403400;Equador;2516102;Soledade;1;2;3;43
2500601;Alhandra;2507903;Juripiranga;1;2;3;37
2306306;Itapagé;2507507;João Pessoa;1;2;3;649
2211209;Uruçuí;2506301;Guarabira;1;2;3;1003
2409308;Patu;2504306;Catolé do Rocha;1;2;3;30
2403103;Currais Novos;2503209;Cabedelo;1;2;3;203
2414209;Tibau do Sul;2414704;Várzea;1;2;3;33
2410900;Riachuelo;2413904;Taipu;1;2;3;33
2408102;Natal;2413607;Severiano Melo;1;2;3;300
2404200;Goianinha;2411502;Santo Antônio;1;2;3;34
2400208;Açu;2411205;Santa Cruz;1;2;3;126
2402006;Caicó;2408508;Ouro Branco;1;2;3;34
1100205;Porto Velho;2408102;Natal;1;2;3;3197
2303709;Caucaia;2408102;Natal;1;2;3;444
2400604;Almino Afonso;2408102;Natal;1;2;3;281
2407401;Martins;2408102;Natal;1;2;3;297
2302206;Beberibe;2408003;Mossoró;1;2;3;141
2400505;Alexandria;2407609;Messias Targino;1;2;3;67
2403103;Currais Novos;2407104;Macaíba;1;2;3;136
2404606;Ielmo Marinho;2407104;Macaíba;1;2;3;22
2403103;Currais Novos;2406809;Lajes Pintadas;1;2;3;45
2401453;Baraúna;2404705;Ipanguaçu;1;2;3;96
2402204;Canguaretama;2404507;Guamaré;1;2;3;193
2307304;Juazeiro do Norte;2402006;Caicó;1;2;3;257
2313401;Tianguá;2314102;Viçosa do Ceará;1;2;3;22
2308005;Massapê;2313906;Uruoca;1;2;3;33
2304400;Fortaleza;2313807;Uruburetama;1;2;3;109
2211001;Teresina;2313609;Ubajara;1;2;3;249
2312304;São Benedito;2313500;Trairi;1;2;3;199
2302305;Bela Cruz;2312908;Sobral;1;2;3;71
2310308;Parambu;2312908;Sobral;1;2;3;283
2307650;Maracanaú;2312106;Santana do Cariri;1;2;3;387
1501402;Belém;2311801;Russas;1;2;3;1222
2301901;Barbalha;2311801;Russas;1;2;3;303
2304285;Eusébio;2311801;Russas;1;2;3;126
2301000;Aquiraz;2310852;Pindoretama;1;2;3;17
2301208;Aracoiaba;2309706;Pacatuba;1;2;3;48
2302909;Capistrano;2309102;Mulungu;1;2;3;19
2302305;Bela Cruz;2308005;Massapê;1;2;3;55
2211001;Teresina;2307809;Marco;1;2;3;366
2303006;Caridade;2307700;Maranguape;1;2;3;68
2300150;Acarapé;2307650;Maracanaú;1;2;3;41
2306306;Itapagé;2307304;Juazeiro do Norte;1;2;3;392
2306405;Itapipoca;2307304;Juazeiro do Norte;1;2;3;413
2306405;Itapipoca;2306553;Itarema;1;2;3;74
2305233;Horizonte;2306256;Itaitinga;1;2;3;15
1301209;Coari;2304400;Fortaleza;1;2;3;2732
1500107;Abaetetuba;2304400;Fortaleza;1;2;3;1164
1702109;Araguaína;2304400;Fortaleza;1;2;3;1141
2202307;Canto do Buriti;2304400;Fortaleza;1;2;3;684
2304004;Coreaú;2304400;Fortaleza;1;2;3;237
2303931;Choró;2304301;Farias Brito;1;2;3;236
2204501;Guadalupe;2303501;Cascavel;1;2;3;659
1505635;Piçarra;2302503;Brejo Santo;1;2;3;1094
2302107;Baturité;2302305;Bela Cruz;1;2;3;202
2203107;Cristino Castro;2211308;Valença do Piauí;1;2;3;379
2202901;Corrente;2211209;Uruçuí;1;2;3;363
2200400;Altos;2211100;União;1;2;3;66
2208403;Piripiri;2210656;Sigefredo Pacheco;1;2;3;71
2203107;Cristino Castro;2210607;São Raimundo Nonato;1;2;3;163
2207702;Parnaíba;2210607;São Raimundo Nonato;1;2;3;682
2102804;Carolina;2209203;Santa Filomena;1;2;3;255
2203701;Esperantina;2208403;Piripiri;1;2;3;67
2205508;José de Freitas;2208403;Piripiri;1;2;3;103
2111300;São Luís;2207009;Oeiras;1;2;3;545
2203107;Cristino Castro;2207009;Oeiras;1;2;3;306
2205508;José de Freitas;2205557;Lagoa Alegre;1;2;3;27
2101400;Balsas;2203909;Floriano;1;2;3;345
2203107;Cristino Castro;2203206;Curimatá;1;2;3;135
2202901;Corrente;2203107;Cristino Castro;1;2;3;207
2202653;Caxingó;2202703;Cocal;1;2;3;39
2109106;Presidente Dutra;2112803;Viana;1;2;3;246
2102804;Carolina;2112001;Tasso Fragoso;1;2;3;217
1500602;Altamira;2111300;São Luís;1;2;3;893
1502400;Castanhal;2111300;São Luís;1;2;3;431
1709500;Gurupi;2111300;São Luís;1;2;3;1150
2100808;Anapurus;2111300;São Luís;1;2;3;177
2104800;Grajaú;2109106;Presidente Dutra;1;2;3;190
2109007;Porto Franco;2109106;Presidente Dutra;1;2;3;339
1505502;Paragominas;2105427;Itinga do Maranhão;1;2;3;159
1702208;Araguatins;2105302;Imperatriz;1;2;3;76
1706506;Darcinópolis;2104800;Grajaú;1;2;3;206
1505494;Palestina do Pará;2102804;Carolina;1;2;3;204
1703073;Barra do Ouro;2102804;Carolina;1;2;3;47
1707702;Filadélfia;2102804;Carolina;1;2;3;8
1713205;Miracema do Tocantins;2102804;Carolina;1;2;3;266
2100055;Açailândia;2101608;Barra do Corda;1;2;3;256
1506138;Redenção;1722081;Wanderlândia;1;2;3;258
1709302;Guaraí;1718758;Rio Sono;1;2;3;90
1502707;Conceição do Araguaia;1702109;Araguaína;1;2;3;168
1504059;Mãe do Rio;1508001;Tomé-Açu;1;2;3;78
1502400;Castanhal;1507201;São Domingos do Capim;1;2;3;45
1501402;Belém;1507151;São Domingos do Araguaia;1;2;3;461
1506351;Santa Bárbara do Pará;1507003;Santo Antônio do Tauá;1;2;3;20
1502707;Conceição do Araguaia;1506583;Santa Maria das Barreiras;1;2;3;82
1501303;Barcarena;1506500;Santa Isabel do Pará;1;2;3;57
1500800;Ananindeua;1505809;Portel;1;2;3;276
1503606;Itaituba;1505536;Parauapebas;1;2;3;708
1500800;Ananindeua;1505064;Novo Repartimento;1;2;3;365
1501402;Belém;1504505;Melgaço;1;2;3;263
1501402;Belém;1504455;Medicilândia;1;2;3;542
1501402;Belém;1503754;Jacareacanga;1;2;3;1159
1501808;Breves;1502103;Cametá;1;2;3;123
1501006;Aveiro;1501402;Belém;1;2;3;801
1501105;Bagre;1501402;Belém;1;2;3;207
1500305;Afuá;1500800;Ananindeua;1;2;3;256
1301001;Carauari;1400100;Boa Vista;1;2;3;1102
1302603;Manaus;1303700;Santo Antônio do Içá;1;2;3;882
1300508;Barreirinha;1302603;Manaus;1;2;3;331
1100080;Costa Marques;1100122;Ji-Paraná;1;2;3;305
1100262;Rio Crespo;5300108;Brasília;1;1;2;1721
1100379;Alto Alegre dos Parecis;5300108;Brasília;1;1;2;1535
1100908;Castanheiras;5300108;Brasília;1;1;2;1565
1100924;Chupinguaia;5300108;Brasília;1;1;2;1427
1100940;Cujubim;5300108;Brasília;1;1;2;1707
1101005;Governador Jorge Teixeira;5300108;Brasília;1;1;2;1667
1101104;Itapuã do Oeste;5300108;Brasília;1;1;2;1771
1101435;Nova União;5300108;Brasília;1;1;2;1644
1101450;Parecis;5300108;Brasília;1;1;2;1508
1101468;Pimenteiras do Oeste;5300108;Brasília;1;1;2;1423
1101476;Primavera de Rondônia;5300108;Brasília;1;1;2;1490
1101484;São Felipe d'Oeste;5300108;Brasília;1;1;2;1506
1101559;Teixeirópolis;5300108;Brasília;1;1;2;1613
1101609;Theobroma;5300108;Brasília;1;1;2;1645
1101757;Vale do Anari;5300108;Brasília;1;1;2;1647
1101807;Vale do Paraíso;5300108;Brasília;1;1;2;1619
1200138;Bujari;5300108;Brasília;1;1;2;2222
1200179;Capixaba;5300108;Brasília;1;1;2;2173
1200252;Epitaciolândia;5300108;Brasília;1;1;2;2266
1200328;Jordão;5300108;Brasília;1;1;2;2635
1200351;Marechal Thaumaturgo;5300108;Brasília;1;1;2;2739
1200393;Porto Walter;5300108;Brasília;1;1;2;2753
1200427;Rodrigues Alves;5300108;Brasília;1;1;2;2760
1200435;Santa Rosa do Purus;5300108;Brasília;1;1;2;2489
1200807;Porto Acre;5300108;Brasília;1;1;2;2187
1300029;Alvarães;5300108;Brasília;1;1;2;2252
1300060;Amaturá;5300108;Brasília;1;1;2;2533
1300086;Anamã;5300108;Brasília;1;1;2;1956
1300102;Anori;5300108;Brasília;1;1;2;1960
1300144;Apuí;5300108;Brasília;1;1;2;1581
1300201;Atalaia do Norte;5300108;Brasília;1;1;2;2659
1300300;Autazes;5300108;Brasília;1;1;2;1787
1300409;Barcelos;5300108;Brasília;1;1;2;2271
1300508;Barreirinha;5300108;Brasília;1;1;2;1728
1300607;Benjamin Constant;5300108;Brasília;1;1;2;2645
1300631;Beruri;5300108;Brasília;1;1;2;1925
1300680;Boa Vista do Ramos;5300108;Brasília;1;1;2;1742
1300839;Caapiranga;5300108;Brasília;1;1;2;1964
1300904;Canutama;5300108;Brasília;1;1;2;2016
1301100;Careiro;5300108;Brasília;1;1;2;1861
1301159;Careiro da Várzea;5300108;Brasília;1;1;2;1870
1301308;Codajás;5300108;Brasília;1;1;2;1988
1301506;Envira;5300108;Brasília;1;1;2;2509
1301605;Fonte Boa;5300108;Brasília;1;1;2;2406
1301654;Guajará;5300108;Brasília;1;1;2;2758
1301803;Ipixuna;5300108;Brasília;1;1;2;2691
1301951;Itamarati;5300108;Brasília;1;1;2;2380
1302009;Itapiranga;5300108;Brasília;1;1;2;1792
1302108;Japurá;5300108;Brasília;1;1;2;2491
1302207;Juruá;5300108;Brasília;1;1;2;2336
1302306;Jutaí;5300108;Brasília;1;1;2;2446
1302553;Manaquiri;5300108;Brasília;1;1;2;1894
1302801;Maraã;5300108;Brasília;1;1;2;2410
1303007;Nhamundá;5300108;Brasília;1;1;2;1767
1303106;Nova Olinda do Norte;5300108;Brasília;1;1;2;1762
1303205;Novo Airão;5300108;Brasília;1;1;2;1992
1303304;Novo Aripuanã;5300108;Brasília;1;1;2;1759
1303502;Pauini;5300108;Brasília;1;1;2;2203
1303601;Santa Isabel do Rio Negro;5300108;Brasília;1;1;2;2471
1303700;Santo Antônio do Içá;5300108;Brasília;1;1;2;2530
1303908;São Paulo de Olivença;5300108;Brasília;1;1;2;2595
1303957;São Sebastião do Uatumã;5300108;Brasília;1;1;2;1798
1304005;Silves;5300108;Brasília;1;1;2;1797
1304104;Tapauá;5300108;Brasília;1;1;2;1960
1304237;Tonantins;5300108;Brasília;1;1;2;2529
1304260;Uarini;5300108;Brasília;1;1;2;2291
1304302;Urucará;5300108;Brasília;1;1;2;1793
1400050;Alto Alegre;5300108;Brasília;1;1;2;2505
1400159;Bonfim;5300108;Brasília;1;1;2;2458
1400175;Cantá;5300108;Brasília;1;1;2;2429
1400233;Caroebe;5300108;Brasília;1;1;2;2219
1400282;Iracema;5300108;Brasília;1;1;2;2416
1400407;Normandia;5300108;Brasília;1;1;2;2496
1400605;São Luiz;5300108;Brasília;1;1;2;2250
1500131;Abel Figueiredo;5300108;Brasília;1;1;2;1202
1500347;Água Azul do Norte;5300108;Brasília;1;1;2;1033
1500701;Anajás;5300108;Brasília;1;1;2;1646
1500859;Anapu;5300108;Brasília;1;1;2;1407
1500958;Aurora do Pará;5300108;Brasília;1;1;2;1513
1501006;Aveiro;5300108;Brasília;1;1;2;1552
1501105;Bagre;5300108;Brasília;1;1;2;1552
1501253;Bannach;5300108;Brasília;1;1;2;972
1501451;Belterra;5300108;Brasília;1;1;2;1632
1501600;Bonito;5300108;Brasília;1;1;2;1599
1501758;Brejo Grande do Araguaia;5300108;Brasília;1;1;2;1119
1501907;Bujaru;5300108;Brasília;1;1;2;1579
1501956;Cachoeira do Piriá;5300108;Brasília;1;1;2;1570
1502004;Cachoeira do Arari;5300108;Brasília;1;1;2;1639
1502509;Chaves;5300108;Brasília;1;1;2;1740
1502608;Colares;5300108;Brasília;1;1;2;1644
1502756;Concórdia do Pará;5300108;Brasília;1;1;2;1529
1502764;Cumaru do Norte;5300108;Brasília;1;1;2;933
1502806;Curralinho;5300108;Brasília;1;1;2;1566
1502855;Curuá;5300108;Brasília;1;1;2;1714
1502954;Eldorado dos Carajás;5300108;Brasília;1;1;2;1084
1503002;Faro;5300108;Brasília;1;1;2;1770
1503044;Floresta do Araguaia;5300108;Brasília;1;1;2;932
1503077;Garrafão do Norte;5300108;Brasília;1;1;2;1537
1503101;Gurupá;5300108;Brasília;1;1;2;1632
1503408;Inhangapi;5300108;Brasília;1;1;2;1590
1504000;Limoeiro do Ajuru;5300108;Brasília;1;1;2;1546
1504109;Magalhães Barata;5300108;Brasília;1;1;2;1661
1504307;Maracanã;5300108;Brasília;1;1;2;1659
1504505;Melgaço;5300108;Brasília;1;1;2;1577
1504901;Muaná;5300108;Brasília;1;1;2;1586
1504950;Nova Esperança do Piriá;5300108;Brasília;1;1;2;1501
1504976;Nova Ipixuna;5300108;Brasília;1;1;2;1210
1505205;Oeiras do Pará;5300108;Brasília;1;1;2;1542
1505486;Pacajá;5300108;Brasília;1;1;2;1349
1505494;Palestina do Pará;5300108;Brasília;1;1;2;1114
1505551;Pau d'Arco;5300108;Brasília;1;1;2;910
1505601;Peixe-Boi;5300108;Brasília;1;1;2;1618
1505635;Piçarra;5300108;Brasília;1;1;2;1041
1505650;Placas;5300108;Brasília;1;1;2;1477
1505700;Ponta de Pedras;5300108;Brasília;1;1;2;1598
1506005;Prainha;5300108;Brasília;1;1;2;1658
1506104;Primavera;5300108;Brasília;1;1;2;1646
1506112;Quatipuru;5300108;Brasília;1;1;2;1651
1506302;Salvaterra;5300108;Brasília;1;1;2;1666
1506351;Santa Bárbara do Pará;5300108;Brasília;1;1;2;1613
1506401;Santa Cruz do Arari;5300108;Brasília;1;1;2;1681
1506559;Santa Luzia do Pará;5300108;Brasília;1;1;2;1584
1506583;Santa Maria das Barreiras;5300108;Brasília;1;1;2;792
1506906;Santarém Novo;5300108;Brasília;1;1;2;1646
1507102;São Caetano de Odivelas;5300108;Brasília;1;1;2;1665
1507466;São João da Ponta;5300108;Brasília;1;1;2;1654
1507474;São João de Pirabas;5300108;Brasília;1;1;2;1665
1507508;São João do Araguaia;5300108;Brasília;1;1;2;1160
1507706;São Sebastião da Boa Vista;5300108;Brasília;1;1;2;1575
1507755;Sapucaia;5300108;Brasília;1;1;2;998
1507805;Senador José Porfírio;5300108;Brasília;1;1;2;1521
1507961;Terra Alta;5300108;Brasília;1;1;2;1633
1507979;Terra Santa;5300108;Brasília;1;1;2;1761
1508035;Tracuateua;5300108;Brasília;1;1;2;1633
1508050;Trairão;5300108;Brasília;1;1;2;1487
1600212;Cutias;5300108;Brasília;1;1;2;1881
1600253;Itaubal;5300108;Brasília;1;1;2;1851
1600402;Mazagão;5300108;Brasília;1;1;2;1770
1600550;Pracuúba;5300108;Brasília;1;1;2;1964
1600808;Vitória do Jari;5300108;Brasília;1;1;2;1726
1700251;Abreulândia;5300108;Brasília;1;1;2;697
1700301;Aguiarnópolis;5300108;Brasília;1;1;2;1024
1700400;Almas;5300108;Brasília;1;1;2;473
1701051;Angico;5300108;Brasília;1;1;2;1042
1701101;Aparecida do Rio Negro;5300108;Brasília;1;1;2;649
1701309;Aragominas;5300108;Brasília;1;1;2;959
1701903;Araguacema;5300108;Brasília;1;1;2;790
1702158;Araguanã;5300108;Brasília;1;1;2;1023
1702703;Aurora do Tocantins;5300108;Brasília;1;1;2;379
1702901;Axixá do Tocantins;5300108;Brasília;1;1;2;1127
1703008;Babaçulândia;5300108;Brasília;1;1;2;953
1703057;Bandeirantes do Tocantins;5300108;Brasília;1;1;2;894
1703073;Barra do Ouro;5300108;Brasília;1;1;2;895
1703107;Barrolândia;5300108;Brasília;1;1;2;666
1703206;Bernardo Sayão;5300108;Brasília;1;1;2;884
1703305;Bom Jesus do Tocantins;5300108;Brasília;1;1;2;758
1703602;Brasilândia do Tocantins;5300108;Brasília;1;1;2;823
1703800;Buriti do Tocantins;5300108;Brasília;1;1;2;1161
1703826;Cachoeirinha;5300108;Brasília;1;1;2;1071
1703842;Campos Lindos;5300108;Brasília;1;1;2;868
1703867;Cariri do Tocantins;5300108;Brasília;1;1;2;453
1703883;Carmolândia;5300108;Brasília;1;1;2;972
1703891;Carrasco Bonito;5300108;Brasília;1;1;2;1160
1703909;Caseara;5300108;Brasília;1;1;2;754
1704600;Chapada de Areia;5300108;Brasília;1;1;2;640
1705102;Chapada da Natividade;5300108;Brasília;1;1;2;464
1705607;Conceição do Tocantins;5300108;Brasília;1;1;2;403
1706001;Couto de Magalhães;5300108;Brasília;1;1;2;843
1706258;Crixás do Tocantins;5300108;Brasília;1;1;2;532
1706506;Darcinópolis;5300108;Brasília;1;1;2;1006
1707207;Dois Irmãos do Tocantins;5300108;Brasília;1;1;2;735
1707306;Dueré;5300108;Brasília;1;1;2;514
1707405;Esperantina;5300108;Brasília;1;1;2;1159
1708254;Fortaleza do Tabocão;5300108;Brasília;1;1;2;750
1708304;Goianorte;5300108;Brasília;1;1;2;785
1709807;Ipueiras;5300108;Brasília;1;1;2;508
1710508;Itacajá;5300108;Brasília;1;1;2;815
1710706;Itaguatins;5300108;Brasília;1;1;2;1113
1710904;Itapiratins;5300108;Brasília;1;1;2;822
1711100;Itaporã do Tocantins;5300108;Brasília;1;1;2;805
1711506;Jaú do Tocantins;5300108;Brasília;1;1;2;356
1711951;Lagoa do Tocantins;5300108;Brasília;1;1;2;602
1712009;Lajeado;5300108;Brasília;1;1;2;672
1712157;Lavandeira;5300108;Brasília;1;1;2;368
1712405;Lizarda;5300108;Brasília;1;1;2;703
1712454;Luzinópolis;5300108;Brasília;1;1;2;1065
1712504;Marianópolis do Tocantins;5300108;Brasília;1;1;2;690
1712702;Mateiros;5300108;Brasília;1;1;2;603
1712801;Maurilândia do Tocantins;5300108;Brasília;1;1;2;1091
1713601;Monte do Carmo;5300108;Brasília;1;1;2;559
1713700;Monte Santo do Tocantins;5300108;Brasília;1;1;2;652
1713809;Palmeiras do Tocantins;5300108;Brasília;1;1;2;1018
1713957;Muricilândia;5300108;Brasília;1;1;2;961
1714203;Natividade;5300108;Brasília;1;1;2;451
1714302;Nazaré;5300108;Brasília;1;1;2;1045
1715002;Nova Rosalândia;5300108;Brasília;1;1;2;589
1715101;Novo Acordo;5300108;Brasília;1;1;2;646
1715150;Novo Alegre;5300108;Brasília;1;1;2;349
1715259;Novo Jardim;5300108;Brasília;1;1;2;462
1715507;Oliveira de Fátima;5300108;Brasília;1;1;2;574
1715705;Palmeirante;5300108;Brasília;1;1;2;879
1716307;Pau d'Arco;5300108;Brasília;1;1;2;927
1716653;Pequizeiro;5300108;Brasília;1;1;2;803
1717008;Pindorama do Tocantins;5300108;Brasília;1;1;2;519
1717206;Piraquê;5300108;Brasília;1;1;2;1000
1717503;Pium;5300108;Brasília;1;1;2;608
1717800;Ponte Alta do Bom Jesus;5300108;Brasília;1;1;2;440
1717909;Ponte Alta do Tocantins;5300108;Brasília;1;1;2;558
1718006;Porto Alegre do Tocantins;5300108;Brasília;1;1;2;473
1718303;Praia Norte;5300108;Brasília;1;1;2;1150
1718402;Presidente Kennedy;5300108;Brasília;1;1;2;807
1718451;Pugmil;5300108;Brasília;1;1;2;605
1718501;Recursolândia;5300108;Brasília;1;1;2;787
1718550;Riachinho;5300108;Brasília;1;1;2;1037
1718659;Rio da Conceição;5300108;Brasília;1;1;2;500
1718709;Rio dos Bois;5300108;Brasília;1;1;2;723
1718758;Rio Sono;5300108;Brasília;1;1;2;714
1718808;Sampaio;5300108;Brasília;1;1;2;1157
1718840;Sandolândia;5300108;Brasília;1;1;2;420
1718881;Santa Maria do Tocantins;5300108;Brasília;1;1;2;776
1718899;Santa Rita do Tocantins;5300108;Brasília;1;1;2;557
1718907;Santa Rosa do Tocantins;5300108;Brasília;1;1;2;483
1719004;Santa Tereza do Tocantins;5300108;Brasília;1;1;2;610
1720002;Santa Terezinha do Tocantins;5300108;Brasília;1;1;2;1037
1720101;São Bento do Tocantins;5300108;Brasília;1;1;2;1094
1720150;São Félix do Tocantins;5300108;Brasília;1;1;2;638
1720200;São Miguel do Tocantins;5300108;Brasília;1;1;2;1135
1720259;São Salvador do Tocantins;5300108;Brasília;1;1;2;341
1720499;São Valério da Natividade;5300108;Brasília;1;1;2;425
1720804;Sítio Novo do Tocantins;5300108;Brasília;1;1;2;1129
1720853;Sucupira;5300108;Brasília;1;1;2;437
1720937;Taipas do Tocantins;5300108;Brasília;1;1;2;413
1720978;Talismã;5300108;Brasília;1;1;2;356
1721109;Tocantínia;5300108;Brasília;1;1;2;693
1721257;Tupirama;5300108;Brasília;1;1;2;757
1721307;Tupiratins;5300108;Brasília;1;1;2;821
2100105;Afonso Cunha;5300108;Brasília;1;1;2;1379
2100154;Água Doce do Maranhão;5300108;Brasília;1;1;2;1558
2100402;Altamira do Maranhão;5300108;Brasília;1;1;2;1313
2100436;Alto Alegre do Maranhão;5300108;Brasília;1;1;2;1333
2100477;Alto Alegre do Pindaré;5300108;Brasília;1;1;2;1357
2100501;Alto Parnaíba;5300108;Brasília;1;1;2;771
2100709;Anajatuba;5300108;Brasília;1;1;2;1430
2100808;Anapurus;5300108;Brasília;1;1;2;1434
2100832;Apicum-Açu;5300108;Brasília;1;1;2;1606
2100873;Araguanã;5300108;Brasília;1;1;2;1441
2100956;Arame;5300108;Brasília;1;1;2;1226
2101004;Arari;5300108;Brasília;1;1;2;1406
2101103;Axixá;5300108;Brasília;1;1;2;1491
2101251;Bacabeira;5300108;Brasília;1;1;2;1469
2101772;Bela Vista do Maranhão;5300108;Brasília;1;1;2;1364
2101806;Benedito Leite;5300108;Brasília;1;1;2;1017
2101905;Bequimão;5300108;Brasília;1;1;2;1514
2101970;Boa Vista do Gurupi;5300108;Brasília;1;1;2;1562
2102036;Bom Jesus das Selvas;5300108;Brasília;1;1;2;1265
2102077;Bom Lugar;5300108;Brasília;1;1;2;1317
2102150;Brejo de Areia;5300108;Brasília;1;1;2;1290
2102309;Buriti Bravo;5300108;Brasília;1;1;2;1174
2102358;Buritirana;5300108;Brasília;1;1;2;1134
2102408;Cajapió;5300108;Brasília;1;1;2;1470
2102507;Cajari;5300108;Brasília;1;1;2;1414
2102606;Cândido Mendes;5300108;Brasília;1;1;2;1606
2102754;Capinzal do Norte;5300108;Brasília;1;1;2;1282
2103109;Cedral;5300108;Brasília;1;1;2;1568
2103125;Central do Maranhão;5300108;Brasília;1;1;2;1540
2103158;Centro do Guilherme;5300108;Brasília;1;1;2;1500
2103174;Centro Novo do Maranhão;5300108;Brasília;1;1;2;1527
2103257;Cidelândia;5300108;Brasília;1;1;2;1176
2103554;Conceição do Lago-Açu;5300108;Brasília;1;1;2;1362
2103752;Davinópolis;5300108;Brasília;1;1;2;1135
2103901;Duque Bacelar;5300108;Brasília;1;1;2;1391
2104073;Feira Nova do Maranhão;5300108;Brasília;1;1;2;987
2104206;Fortuna;5300108;Brasília;1;1;2;1183
2104305;Godofredo Viana;5300108;Brasília;1;1;2;1609
2104552;Governador Edison Lobão;5300108;Brasília;1;1;2;1114
2104651;Governador Newton Bello;5300108;Brasília;1;1;2;1390
2104701;Graça Aranha;5300108;Brasília;1;1;2;1211
2104909;Guimarães;5300108;Brasília;1;1;2;1552
2105104;Icatu;5300108;Brasília;1;1;2;1497
2105153;Igarapé do Meio;5300108;Brasília;1;1;2;1373
2105351;Itaipava do Grajaú;5300108;Brasília;1;1;2;1201
2105476;Jenipapo dos Vieiras;5300108;Brasília;1;1;2;1179
2105609;Joselândia;5300108;Brasília;1;1;2;1246
2105807;Lago do Junco;5300108;Brasília;1;1;2;1292
2105906;Lago Verde;5300108;Brasília;1;1;2;1351
2105922;Lagoa do Mato;5300108;Brasília;1;1;2;1175
2105963;Lagoa Grande do Maranhão;5300108;Brasília;1;1;2;1246
2105989;Lajeado Novo;5300108;Brasília;1;1;2;1068
2106201;Luís Domingues;5300108;Brasília;1;1;2;1622
2106300;Magalhães de Almeida;5300108;Brasília;1;1;2;1498
2106326;Maracaçumé;5300108;Brasília;1;1;2;1536
2106375;Maranhãozinho;5300108;Brasília;1;1;2;1508
2106409;Mata Roma;5300108;Brasília;1;1;2;1439
2106508;Matinha;5300108;Brasília;1;1;2;1438
2106631;Matões do Norte;5300108;Brasília;1;1;2;1392
2106904;Monção;5300108;Brasília;1;1;2;1396
2107001;Montes Altos;5300108;Brasília;1;1;2;1107
2107100;Morros;5300108;Brasília;1;1;2;1488
2107209;Nina Rodrigues;5300108;Brasília;1;1;2;1429
2107308;Nova Iorque;5300108;Brasília;1;1;2;1087
2107357;Nova Olinda do Maranhão;5300108;Brasília;1;1;2;1452
2107456;Olinda Nova do Maranhão;5300108;Brasília;1;1;2;1450
2107605;Palmeirândia;5300108;Brasília;1;1;2;1490
2108009;Pastos Bons;5300108;Brasília;1;1;2;1093
2108058;Paulino Neves;5300108;Brasília;1;1;2;1554
2108256;Pedro do Rosário;5300108;Brasília;1;1;2;1445
2108306;Penalva;5300108;Brasília;1;1;2;1416
2108405;Peri Mirim;5300108;Brasília;1;1;2;1498
2108504;Pindaré-Mirim;5300108;Brasília;1;1;2;1375
2108801;Pirapemas;5300108;Brasília;1;1;2;1391
2109056;Porto Rico do Maranhão;5300108;Brasília;1;1;2;1578
2109205;Presidente Juscelino;5300108;Brasília;1;1;2;1481
2109239;Presidente Médici;5300108;Brasília;1;1;2;1501
2109270;Presidente Sarney;5300108;Brasília;1;1;2;1486
2109304;Presidente Vargas;5300108;Brasília;1;1;2;1431
2109403;Primeira Cruz;5300108;Brasília;1;1;2;1545
2109452;Raposa;5300108;Brasília;1;1;2;1534
2110039;Santa Luzia do Paruá;5300108;Brasília;1;1;2;1475
2110104;Santa Quitéria do Maranhão;5300108;Brasília;1;1;2;1472
2110237;Santana do Maranhão;5300108;Brasília;1;1;2;1518
2110278;Santo Amaro do Maranhão;5300108;Brasília;1;1;2;1551
2110401;São Benedito do Rio Preto;5300108;Brasília;1;1;2;1455
2110807;São Félix de Balsas;5300108;Brasília;1;1;2;1019
2111078;São João do Soter;5300108;Brasília;1;1;2;1259
2111532;São Pedro da Água Branca;5300108;Brasília;1;1;2;1184
2111672;São Roberto;5300108;Brasília;1;1;2;1232
2111706;São Vicente Ferrer;5300108;Brasília;1;1;2;1463
2111722;Satubinha;5300108;Brasília;1;1;2;1352
2111763;Senador La Rocque;5300108;Brasília;1;1;2;1148
2111789;Serrano do Maranhão;5300108;Brasília;1;1;2;1571
2111805;Sítio Novo;5300108;Brasília;1;1;2;1103
2111904;Sucupira do Norte;5300108;Brasília;1;1;2;1104
2111953;Sucupira do Riachão;5300108;Brasília;1;1;2;1137
2112274;Tufilândia;5300108;Brasília;1;1;2;1359
2112407;Turiaçu;5300108;Brasília;1;1;2;1588
2112456;Turilândia;5300108;Brasília;1;1;2;1529
2112605;Urbano Santos;5300108;Brasília;1;1;2;1472
2200053;Acauã;5300108;Brasília;1;1;2;1108
2200103;Agricolândia;5300108;Brasília;1;1;2;1237
2200251;Alagoinha do Piauí;5300108;Brasília;1;1;2;1220
2200277;Alegrete do Piauí;5300108;Brasília;1;1;2;1205
2200301;Alto Longá;5300108;Brasília;1;1;2;1313
2200707;Anísio de Abreu;5300108;Brasília;1;1;2;894
2200806;Antônio Almeida;5300108;Brasília;1;1;2;1028
2200905;Aroazes;5300108;Brasília;1;1;2;1251
2200954;Aroeiras do Itaim;5300108;Brasília;1;1;2;1157
2201002;Arraial;5300108;Brasília;1;1;2;1161
2201051;Assunção do Piauí;5300108;Brasília;1;1;2;1317
2201101;Avelino Lopes;5300108;Brasília;1;1;2;755
2201150;Baixa Grande do Ribeiro;5300108;Brasília;1;1;2;926
2201176;Barra d'Alcântara;5300108;Brasília;1;1;2;1196
2201309;Barreiras do Piauí;5300108;Brasília;1;1;2;701
2201408;Barro Duro;5300108;Brasília;1;1;2;1243
2201606;Beneditinos;5300108;Brasília;1;1;2;1286
2201705;Bertolínia;5300108;Brasília;1;1;2;994
2201739;Betânia do Piauí;5300108;Brasília;1;1;2;1133
2201804;Bocaina;5300108;Brasília;1;1;2;1202
2201929;Bonfim do Piauí;5300108;Brasília;1;1;2;908
2201945;Boqueirão do Piauí;5300108;Brasília;1;1;2;1395
2201960;Brasileira;5300108;Brasília;1;1;2;1444
2202059;Cabeceiras do Piauí;5300108;Brasília;1;1;2;1385
2202109;Campinas do Piauí;5300108;Brasília;1;1;2;1104
2202117;Campo Alegre do Fidalgo;5300108;Brasília;1;1;2;1044
2202133;Campo Grande do Piauí;5300108;Brasília;1;1;2;1203
2202174;Campo Largo do Piauí;5300108;Brasília;1;1;2;1438
2202406;Capitão de Campos;5300108;Brasília;1;1;2;1404
2202455;Capitão Gervásio Oliveira;5300108;Brasília;1;1;2;1035
2202505;Caracol;5300108;Brasília;1;1;2;870
2202539;Caraúbas do Piauí;5300108;Brasília;1;1;2;1506
2202554;Caridade do Piauí;5300108;Brasília;1;1;2;1154
2202711;Cocal de Telha;5300108;Brasília;1;1;2;1392
2202729;Cocal dos Alves;5300108;Brasília;1;1;2;1499
2202737;Coivaras;5300108;Brasília;1;1;2;1325
2202752;Colônia do Gurguéia;5300108;Brasília;1;1;2;950
2202802;Conceição do Canindé;5300108;Brasília;1;1;2;1103
2202851;Coronel José Dias;5300108;Brasília;1;1;2;962
2203008;Cristalândia do Piauí;5300108;Brasília;1;1;2;641
2203255;Curralinhos;5300108;Brasília;1;1;2;1254
2203305;Demerval Lobão;5300108;Brasília;1;1;2;1278
2203354;Dirceu Arcoverde;5300108;Brasília;1;1;2;922
2203404;Dom Expedito Lopes;5300108;Brasília;1;1;2;1182
2203420;Domingos Mourão;5300108;Brasília;1;1;2;1456
2203453;Dom Inocêncio;5300108;Brasília;1;1;2;981
2203602;Eliseu Martins;5300108;Brasília;1;1;2;962
2203800;Flores do Piauí;5300108;Brasília;1;1;2;1032
2204006;Francinópolis;5300108;Brasília;1;1;2;1200
2204105;Francisco Ayres;5300108;Brasília;1;1;2;1156
2204550;Guaribas;5300108;Brasília;1;1;2;840
2204600;Hugo Napoleão;5300108;Brasília;1;1;2;1224
2204808;Ipiranga do Piauí;5300108;Brasília;1;1;2;1186
2204907;Isaías Coelho;5300108;Brasília;1;1;2;1110
2205003;Itainópolis;5300108;Brasília;1;1;2;1148
2205151;Jacobina do Piauí;5300108;Brasília;1;1;2;1123
2205276;Jatobá do Piauí;5300108;Brasília;1;1;2;1379
2205300;Jerumenha;5300108;Brasília;1;1;2;1071
2205409;Joaquim Pires;5300108;Brasília;1;1;2;1487
2205458;Joca Marques;5300108;Brasília;1;1;2;1481
2205524;Júlio Borges;5300108;Brasília;1;1;2;722
2205532;Jurema;5300108;Brasília;1;1;2;887
2205540;Lagoinha do Piauí;5300108;Brasília;1;1;2;1236
2205557;Lagoa Alegre;5300108;Brasília;1;1;2;1367
2205565;Lagoa do Barro do Piauí;5300108;Brasília;1;1;2;1055
2205573;Lagoa de São Francisco;5300108;Brasília;1;1;2;1427
2205581;Lagoa do Piauí;5300108;Brasília;1;1;2;1277
2205599;Lagoa do Sítio;5300108;Brasília;1;1;2;1226
2205607;Landri Sales;5300108;Brasília;1;1;2;1036
2205904;Manoel Emídio;5300108;Brasília;1;1;2;962
2205953;Marcolândia;5300108;Brasília;1;1;2;1198
2206001;Marcos Parente;5300108;Brasília;1;1;2;1051
2206050;Massapê do Piauí;5300108;Brasília;1;1;2;1169
2206100;Matias Olímpio;5300108;Brasília;1;1;2;1451
2206308;Miguel Leão;5300108;Brasília;1;1;2;1246
2206407;Monsenhor Gil;5300108;Brasília;1;1;2;1263
2206605;Monte Alegre do Piauí;5300108;Brasília;1;1;2;725
2206704;Nazaré do Piauí;5300108;Brasília;1;1;2;1122
2206720;Nazária;5300108;Brasília;1;1;2;1276
2206753;Nossa Senhora de Nazaré;5300108;Brasília;1;1;2;1376
2206803;Nossa Senhora dos Remédios;5300108;Brasília;1;1;2;1422
2206902;Novo Oriente do Piauí;5300108;Brasília;1;1;2;1212
2207108;Olho d'Água do Piauí;5300108;Brasília;1;1;2;1238
2207207;Padre Marcos;5300108;Brasília;1;1;2;1192
2207306;Paes Landim;5300108;Brasília;1;1;2;1071
2207405;Palmeira do Piauí;5300108;Brasília;1;1;2;875
2207504;Palmeirais;5300108;Brasília;1;1;2;1202
2207603;Parnaguá;5300108;Brasília;1;1;2;710
2207777;Patos do Piauí;5300108;Brasília;1;1;2;1143
2207850;Pavussu;5300108;Brasília;1;1;2;999
2207934;Pedro Laurentino;5300108;Brasília;1;1;2;1043
2207959;Nova Santa Rita;5300108;Brasília;1;1;2;1055
2208106;Pimenteiras;5300108;Brasília;1;1;2;1261
2208502;Porto;5300108;Brasília;1;1;2;1427
2208601;Prata do Piauí;5300108;Brasília;1;1;2;1273
2208650;Queimada Nova;5300108;Brasília;1;1;2;1054
2208700;Redenção do Gurguéia;5300108;Brasília;1;1;2;785
2209005;Rio Grande do Piauí;5300108;Brasília;1;1;2;1022
2209153;Santa Cruz dos Milagres;5300108;Brasília;1;1;2;1272
2209203;Santa Filomena;5300108;Brasília;1;1;2;770
2209302;Santa Luz;5300108;Brasília;1;1;2;858
2209377;Santa Rosa do Piauí;5300108;Brasília;1;1;2;1160
2209401;Santo Antônio de Lisboa;5300108;Brasília;1;1;2;1204
2209500;Santo Inácio do Piauí;5300108;Brasília;1;1;2;1123
2209609;São Félix do Piauí;5300108;Brasília;1;1;2;1252
2209658;São Francisco de Assis do Piauí;5300108;Brasília;1;1;2;1065
2209708;São Francisco do Piauí;5300108;Brasília;1;1;2;1103
2209807;São Gonçalo do Piauí;5300108;Brasília;1;1;2;1217
2209906;São João da Serra;5300108;Brasília;1;1;2;1303
2209955;São João da Varjota;5300108;Brasília;1;1;2;1169
2209971;São João do Arraial;5300108;Brasília;1;1;2;1445
2210052;São José do Divino;5300108;Brasília;1;1;2;1473
2210102;São José do Peixe;5300108;Brasília;1;1;2;1079
2210201;São José do Piauí;5300108;Brasília;1;1;2;1199
2210300;São Julião;5300108;Brasília;1;1;2;1221
2210375;São Luis do Piauí;5300108;Brasília;1;1;2;1213
2210383;São Miguel da Baixa Grande;5300108;Brasília;1;1;2;1255
2210391;São Miguel do Fidalgo;5300108;Brasília;1;1;2;1082
2210623;Sebastião Barros;5300108;Brasília;1;1;2;642
2210631;Sebastião Leal;5300108;Brasília;1;1;2;998
2210706;Simões;5300108;Brasília;1;1;2;1178
2210904;Socorro do Piauí;5300108;Brasília;1;1;2;1049
2211407;Várzea Grande;5300108;Brasília;1;1;2;1186
2300101;Abaiara;5300108;Brasília;1;1;2;1323
2300150;Acarapé;5300108;Brasília;1;1;2;1606
2300507;Alcântaras;5300108;Brasília;1;1;2;1557
2300606;Altaneira;5300108;Brasília;1;1;2;1301
2300903;Apuiarés;5300108;Brasília;1;1;2;1586
2301257;Ararendá;5300108;Brasília;1;1;2;1432
2301406;Aratuba;5300108;Brasília;1;1;2;1567
2301505;Arneiroz;5300108;Brasília;1;1;2;1330
2301802;Baixio;5300108;Brasília;1;1;2;1396
2302057;Barroquinha;5300108;Brasília;1;1;2;1583
2303006;Caridade;5300108;Brasília;1;1;2;1575
2303931;Choró;5300108;Brasília;1;1;2;1524
2304269;Deputado Irapuan Pinheiro;5300108;Brasília;1;1;2;1423
2304277;Ererê;5300108;Brasília;1;1;2;1478
2304608;General Sampaio;5300108;Brasília;1;1;2;1576
2304806;Granjeiro;5300108;Brasília;1;1;2;1347
2304905;Groaíras;5300108;Brasília;1;1;2;1535
2305100;Guaramiranga;5300108;Brasília;1;1;2;1588
2305308;Ibiapina;5300108;Brasília;1;1;2;1508
2305332;Ibicuitinga;5300108;Brasília;1;1;2;1545
2305654;Ipaporanga;5300108;Brasília;1;1;2;1422
2305704;Ipaumirim;5300108;Brasília;1;1;2;1391
2307205;Jati;5300108;Brasília;1;1;2;1300
2307908;Martinópole;5300108;Brasília;1;1;2;1585
2308377;Miraíma;5300108;Brasília;1;1;2;1590
2308807;Moraújo;5300108;Brasília;1;1;2;1562
2310100;Palmácia;5300108;Brasília;1;1;2;1603
2310308;Parambu;5300108;Brasília;1;1;2;1307
2310407;Paramoti;5300108;Brasília;1;1;2;1585
2310605;Penaforte;5300108;Brasília;1;1;2;1284
2310951;Pires Ferreira;5300108;Brasília;1;1;2;1490
2311009;Poranga;5300108;Brasília;1;1;2;1427
2311231;Potiretama;5300108;Brasília;1;1;2;1514
2311264;Quiterianópolis;5300108;Brasília;1;1;2;1339
2311355;Quixelô;5300108;Brasília;1;1;2;1397
2311959;Salitre;5300108;Brasília;1;1;2;1228
2312809;Senador Sá;5300108;Brasília;1;1;2;1584
2313203;Tamboril;5300108;Brasília;1;1;2;1456
2313252;Tarrafas;5300108;Brasília;1;1;2;1326
2313708;Umari;5300108;Brasília;1;1;2;1404
2313955;Varjota;5300108;Brasília;1;1;2;1505
2400406;Água Nova;5300108;Brasília;1;1;2;1468
2400604;Almino Afonso;5300108;Brasília;1;1;2;1511
2400901;Antônio Martins;5300108;Brasília;1;1;2;1496
2401206;Arês;5300108;Brasília;1;1;2;1713
2401305;Augusto Severo;5300108;Brasília;1;1;2;1567
2401404;Baía Formosa;5300108;Brasília;1;1;2;1712
2401503;Barcelona;5300108;Brasília;1;1;2;1668
2401602;Bento Fernandes;5300108;Brasília;1;1;2;1695
2401651;Bodó;5300108;Brasília;1;1;2;1627
2401701;Bom Jesus;5300108;Brasília;1;1;2;1693
2401800;Brejinho;5300108;Brasília;1;1;2;1697
2401859;Caiçara do Norte;5300108;Brasília;1;1;2;1721
2401909;Caiçara do Rio do Vento;5300108;Brasília;1;1;2;1676
2402105;Campo Redondo;5300108;Brasília;1;1;2;1627
2402501;Carnaubais;5300108;Brasília;1;1;2;1642
2402709;Cerro Corá;5300108;Brasília;1;1;2;1628
2402808;Coronel Ezequiel;5300108;Brasília;1;1;2;1614
2402907;Coronel João Pessoa;5300108;Brasília;1;1;2;1453
2403004;Cruzeta;5300108;Brasília;1;1;2;1566
2403202;Doutor Severiano;5300108;Brasília;1;1;2;1471
2403301;Encanto;5300108;Brasília;1;1;2;1475
2403400;Equador;5300108;Brasília;1;1;2;1533
2403509;Espírito Santo;5300108;Brasília;1;1;2;1692
2403608;Extremoz;5300108;Brasília;1;1;2;1735
2403707;Felipe Guerra;5300108;Brasília;1;1;2;1560
2403756;Fernando Pedroza;5300108;Brasília;1;1;2;1639
2403905;Francisco Dantas;5300108;Brasília;1;1;2;1491
2404002;Frutuoso Gomes;5300108;Brasília;1;1;2;1505
2404101;Galinhos;5300108;Brasília;1;1;2;1703
2404408;Grossos;5300108;Brasília;1;1;2;1648
2404606;Ielmo Marinho;5300108;Brasília;1;1;2;1707
2404804;Ipueira;5300108;Brasília;1;1;2;1505
2404853;Itajá;5300108;Brasília;1;1;2;1617
2404903;Itaú;5300108;Brasília;1;1;2;1519
2405009;Jaçanã;5300108;Brasília;1;1;2;1612
2405108;Jandaíra;5300108;Brasília;1;1;2;1695
2405207;Janduís;5300108;Brasília;1;1;2;1548
2405405;Japi;5300108;Brasília;1;1;2;1630
2405504;Jardim de Angicos;5300108;Brasília;1;1;2;1686
2405603;Jardim de Piranhas;5300108;Brasília;1;1;2;1525
2405900;João Dias;5300108;Brasília;1;1;2;1499
2406007;José da Penha;5300108;Brasília;1;1;2;1460
2406155;Jundiá;5300108;Brasília;1;1;2;1693
2406205;Lagoa d'Anta;5300108;Brasília;1;1;2;1664
2406304;Lagoa de Pedras;5300108;Brasília;1;1;2;1693
2406403;Lagoa de Velhos;5300108;Brasília;1;1;2;1668
2406502;Lagoa Nova;5300108;Brasília;1;1;2;1615
2406601;Lagoa Salgada;5300108;Brasília;1;1;2;1690
2406809;Lajes Pintadas;5300108;Brasília;1;1;2;1639
2406908;Lucrécia;5300108;Brasília;1;1;2;1510
2407005;Luís Gomes;5300108;Brasília;1;1;2;1445
2407252;Major Sales;5300108;Brasília;1;1;2;1450
2407302;Marcelino Vieira;5300108;Brasília;1;1;2;1470
2407500;Maxaranguape;5300108;Brasília;1;1;2;1750
2407609;Messias Targino;5300108;Brasília;1;1;2;1535
2407708;Montanhas;5300108;Brasília;1;1;2;1683
2407906;Monte das Gameleiras;5300108;Brasília;1;1;2;1645
2408201;Nísia Floresta;5300108;Brasília;1;1;2;1716
2408409;Olho-d'Água do Borges;5300108;Brasília;1;1;2;1531
2408508;Ouro Branco;5300108;Brasília;1;1;2;1533
2408607;Paraná;5300108;Brasília;1;1;2;1446
2408706;Paraú;5300108;Brasília;1;1;2;1590
2408805;Parazinho;5300108;Brasília;1;1;2;1728
2408953;Rio do Fogo;5300108;Brasília;1;1;2;1754
2409100;Passa e Fica;5300108;Brasília;1;1;2;1657
2409209;Passagem;5300108;Brasília;1;1;2;1690
2409332;Santa Maria;5300108;Brasília;1;1;2;1694
2409506;Pedra Grande;5300108;Brasília;1;1;2;1730
2409605;Pedra Preta;5300108;Brasília;1;1;2;1680
2409803;Pedro Velho;5300108;Brasília;1;1;2;1692
2409902;Pendências;5300108;Brasília;1;1;2;1660
2410009;Pilões;5300108;Brasília;1;1;2;1481
2410108;Poço Branco;5300108;Brasília;1;1;2;1712
2410207;Portalegre;5300108;Brasília;1;1;2;1505
2410405;Pureza;5300108;Brasília;1;1;2;1732
2410504;Rafael Fernandes;5300108;Brasília;1;1;2;1474
2410603;Rafael Godeiro;5300108;Brasília;1;1;2;1521
2410702;Riacho da Cruz;5300108;Brasília;1;1;2;1515
2410801;Riacho de Santana;5300108;Brasília;1;1;2;1462
2410900;Riachuelo;5300108;Brasília;1;1;2;1686
2411007;Rodolfo Fernandes;5300108;Brasília;1;1;2;1515
2411056;Tibau;5300108;Brasília;1;1;2;1648
2411106;Ruy Barbosa;5300108;Brasília;1;1;2;1672
2411429;Santana do Seridó;5300108;Brasília;1;1;2;1545
2411601;São Bento do Norte;5300108;Brasília;1;1;2;1728
2411700;São Bento do Trairí;5300108;Brasília;1;1;2;1627
2411809;São Fernando;5300108;Brasília;1;1;2;1538
2411908;São Francisco do Oeste;5300108;Brasília;1;1;2;1496
2412104;São João do Sabugi;5300108;Brasília;1;1;2;1512
2412401;São José do Seridó;5300108;Brasília;1;1;2;1557
2412559;São Miguel de Touros;5300108;Brasília;1;1;2;1747
2412708;São Pedro;5300108;Brasília;1;1;2;1695
2412807;São Rafael;5300108;Brasília;1;1;2;1604
2412906;São Tomé;5300108;Brasília;1;1;2;1655
2413003;São Vicente;5300108;Brasília;1;1;2;1589
2413102;Senador Elói de Souza;5300108;Brasília;1;1;2;1681
2413201;Senador Georgino Avelino;5300108;Brasília;1;1;2;1718
2413300;Serra de São Bento;5300108;Brasília;1;1;2;1653
2413409;Serra Negra do Norte;5300108;Brasília;1;1;2;1500
2413508;Serrinha;5300108;Brasília;1;1;2;1680
2413557;Serrinha dos Pintos;5300108;Brasília;1;1;2;1500
2413607;Severiano Melo;5300108;Brasília;1;1;2;1526
2413706;Sítio Novo;5300108;Brasília;1;1;2;1658
2413805;Taboleiro Grande;5300108;Brasília;1;1;2;1508
2413904;Taipu;5300108;Brasília;1;1;2;1717
2414001;Tangará;5300108;Brasília;1;1;2;1660
2414100;Tenente Ananias;5300108;Brasília;1;1;2;1456
2414159;Tenente Laurentino Cruz;5300108;Brasília;1;1;2;1591
2414308;Timbaúba dos Batistas;5300108;Brasília;1;1;2;1525
2414456;Triunfo Potiguar;5300108;Brasília;1;1;2;1576
2414605;Upanema;5300108;Brasília;1;1;2;1588
2414704;Várzea;5300108;Brasília;1;1;2;1685
2414753;Venha-Ver;5300108;Brasília;1;1;2;1445
2414803;Vera Cruz;5300108;Brasília;1;1;2;1702
2414902;Viçosa;5300108;Brasília;1;1;2;1510
2415008;Vila Flor;5300108;Brasília;1;1;2;1712
2500106;Água Branca;5300108;Brasília;1;1;2;1420
2500205;Aguiar;5300108;Brasília;1;1;2;1409
2500502;Alagoinha;5300108;Brasília;1;1;2;1631
2500536;Alcantil;5300108;Brasília;1;1;2;1537
2500775;Aparecida;5300108;Brasília;1;1;2;1439
2501203;Areial;5300108;Brasília;1;1;2;1594
2501351;Assunção;5300108;Brasília;1;1;2;1525
2501401;Baía da Traição;5300108;Brasília;1;1;2;1694
2501708;Barra de São Miguel;5300108;Brasília;1;1;2;1514
2501906;Belém;5300108;Brasília;1;1;2;1647
2502003;Belém do Brejo do Cruz;5300108;Brasília;1;1;2;1525
2502052;Bernardino Batista;5300108;Brasília;1;1;2;1430
2502102;Boa Ventura;5300108;Brasília;1;1;2;1382
2502151;Boa Vista;5300108;Brasília;1;1;2;1553
2502201;Bom Jesus;5300108;Brasília;1;1;2;1394
2502300;Bom Sucesso;5300108;Brasília;1;1;2;1476
2502607;Igaracy;5300108;Brasília;1;1;2;1404
2502706;Borborema;5300108;Brasília;1;1;2;1634
2502904;Brejo dos Santos;5300108;Brasília;1;1;2;1489
2503308;Cachoeira dos Índios;5300108;Brasília;1;1;2;1384
2503407;Cacimba de Areia;5300108;Brasília;1;1;2;1486
2503555;Cacimbas;5300108;Brasília;1;1;2;1488
2503803;Caldas Brandão;5300108;Brasília;1;1;2;1640
2503902;Camalaú;5300108;Brasília;1;1;2;1462
2504074;Caraúbas;5300108;Brasília;1;1;2;1501
2504108;Carrapateira;5300108;Brasília;1;1;2;1400
2504207;Catingueira;5300108;Brasília;1;1;2;1450
2504355;Caturité;5300108;Brasília;1;1;2;1560
2504504;Condado;5300108;Brasília;1;1;2;1467
2504603;Conde;5300108;Brasília;1;1;2;1666
2504702;Congo;5300108;Brasília;1;1;2;1482
2505006;Cubati;5300108;Brasília;1;1;2;1569
2505204;Cuitegi;5300108;Brasília;1;1;2;1637
2505238;Cuité de Mamanguape;5300108;Brasília;1;1;2;1658
2505279;Curral de Cima;5300108;Brasília;1;1;2;1670
2505303;Curral Velho;5300108;Brasília;1;1;2;1371
2505352;Damião;5300108;Brasília;1;1;2;1626
2505402;Desterro;5300108;Brasília;1;1;2;1480
2505501;Vista Serrana;5300108;Brasília;1;1;2;1482
2505600;Diamante;5300108;Brasília;1;1;2;1377
2505709;Dona Inês;5300108;Brasília;1;1;2;1646
2505808;Duas Estradas;5300108;Brasília;1;1;2;1659
2505907;Emas;5300108;Brasília;1;1;2;1443
2506202;Frei Martinho;5300108;Brasília;1;1;2;1594
2506509;Gurjão;5300108;Brasília;1;1;2;1533
2506608;Ibiara;5300108;Brasília;1;1;2;1361
2506707;Imaculada;5300108;Brasília;1;1;2;1440
2507200;Itatuba;5300108;Brasília;1;1;2;1597
2507408;Jericó;5300108;Brasília;1;1;2;1477
2507606;Juarez Távora;5300108;Brasília;1;1;2;1614
2507804;Junco do Seridó;5300108;Brasília;1;1;2;1531
2507903;Juripiranga;5300108;Brasília;1;1;2;1631
2508000;Juru;5300108;Brasília;1;1;2;1405
2508109;Lagoa;5300108;Brasília;1;1;2;1468
2508406;Lastro;5300108;Brasília;1;1;2;1452
2508505;Livramento;5300108;Brasília;1;1;2;1486
2508604;Lucena;5300108;Brasília;1;1;2;1685
2508703;Mãe d'Água;5300108;Brasília;1;1;2;1455
2508802;Malta;5300108;Brasília;1;1;2;1473
2509008;Manaíra;5300108;Brasília;1;1;2;1366
2509057;Marcação;5300108;Brasília;1;1;2;1688
2509156;Marizópolis;5300108;Brasília;1;1;2;1415
2509206;Massaranduba;5300108;Brasília;1;1;2;1594
2509305;Mataraca;5300108;Brasília;1;1;2;1695
2509396;Maturéia;5300108;Brasília;1;1;2;1461
2509602;Monte Horebe;5300108;Brasília;1;1;2;1368
2509800;Mulungu;5300108;Brasília;1;1;2;1633
2509909;Natuba;5300108;Brasília;1;1;2;1587
2510006;Nazarezinho;5300108;Brasília;1;1;2;1411
2510105;Nova Floresta;5300108;Brasília;1;1;2;1610
2510204;Nova Olinda;5300108;Brasília;1;1;2;1391
2510303;Nova Palmeira;5300108;Brasília;1;1;2;1577
2510402;Olho d'Água;5300108;Brasília;1;1;2;1432
2510501;Olivedos;5300108;Brasília;1;1;2;1570
2510600;Ouro Velho;5300108;Brasília;1;1;2;1453
2510659;Parari;5300108;Brasília;1;1;2;1514
2510709;Passagem;5300108;Brasília;1;1;2;1494
2511004;Pedra Branca;5300108;Brasília;1;1;2;1392
2511103;Pedra Lavrada;5300108;Brasília;1;1;2;1567
2511905;Pitimbu;5300108;Brasília;1;1;2;1659
2512036;Poço Dantas;5300108;Brasília;1;1;2;1438
2512077;Poço de José de Moura;5300108;Brasília;1;1;2;1423
2512200;Prata;5300108;Brasília;1;1;2;1454
2512408;Puxinanã;5300108;Brasília;1;1;2;1582
2512606;Quixabá;5300108;Brasília;1;1;2;1494
2512721;Pedro Régis;5300108;Brasília;1;1;2;1673
2512747;Riachão;5300108;Brasília;1;1;2;1649
2512804;Riacho dos Cavalos;5300108;Brasília;1;1;2;1498
2513000;Salgadinho;5300108;Brasília;1;1;2;1513
2513208;Santa Cruz;5300108;Brasília;1;1;2;1460
2513307;Santa Helena;5300108;Brasília;1;1;2;1402
2513505;Santana de Mangueira;5300108;Brasília;1;1;2;1362
2513604;Santana dos Garrotes;5300108;Brasília;1;1;2;1402
2513802;Santa Teresinha;5300108;Brasília;1;1;2;1464
2513851;Santo André;5300108;Brasília;1;1;2;1523
2513927;São Bentinho;5300108;Brasília;1;1;2;1457
2513943;São Domingos do Cariri;5300108;Brasília;1;1;2;1512
2513984;São Francisco;5300108;Brasília;1;1;2;1451
2514008;São João do Cariri;5300108;Brasília;1;1;2;1519
2514107;São João do Tigre;5300108;Brasília;1;1;2;1448
2514206;São José da Lagoa Tapada;5300108;Brasília;1;1;2;1421
2514305;São José de Caiana;5300108;Brasília;1;1;2;1387
2514404;São José de Espinharas;5300108;Brasília;1;1;2;1493
2514602;São José do Bonfim;5300108;Brasília;1;1;2;1472
2514701;São José do Sabugi;5300108;Brasília;1;1;2;1538
2514800;São José dos Cordeiros;5300108;Brasília;1;1;2;1497
2515005;São Miguel de Taipu;5300108;Brasília;1;1;2;1641
2515104;São Sebastião de Lagoa de Roça;5300108;Brasília;1;1;2;1598
2515203;São Sebastião do Umbuzeiro;5300108;Brasília;1;1;2;1430
2515609;Serra da Raiz;5300108;Brasília;1;1;2;1657
2515708;Serra Grande;5300108;Brasília;1;1;2;1385
2515807;Serra Redonda;5300108;Brasília;1;1;2;1605
2515971;Sobrado;5300108;Brasília;1;1;2;1645
2516805;Triunfo;5300108;Brasília;1;1;2;1416
2517100;Várzea;5300108;Brasília;1;1;2;1525
2601003;Angelim;5300108;Brasília;1;1;2;1448
2601052;Araçoiaba;5300108;Brasília;1;1;2;1618
2601300;Barra de Guabiraba;5300108;Brasília;1;1;2;1531
2601805;Betânia;5300108;Brasília;1;1;2;1336
2602506;Brejinho;5300108;Brasília;1;1;2;1459
2603207;Caetés;5300108;Brasília;1;1;2;1425
2603306;Calçado;5300108;Brasília;1;1;2;1453
2603405;Calumbi;5300108;Brasília;1;1;2;1349
2603603;Camutanga;5300108;Brasília;1;1;2;1624
2603926;Carnaubeira da Penha;5300108;Brasília;1;1;2;1275
2604155;Casinhas;5300108;Brasília;1;1;2;1566
2604403;Chã de Alegria;5300108;Brasília;1;1;2;1594
2604809;Cortês;5300108;Brasília;1;1;2;1539
2605152;Dormentes;5300108;Brasília;1;1;2;1111
2605459;Fernando de Noronha;5300108;Brasília;1;1;2;2092
2605509;Ferreiros;5300108;Brasília;1;1;2;1625
2606309;Granito;5300108;Brasília;1;1;2;1248
2606705;Ibirajuba;5300108;Brasília;1;1;2;1476
2607109;Ingazeira;5300108;Brasília;1;1;2;1424
2607406;Itacuruba;5300108;Brasília;1;1;2;1243
2607653;Itambé;5300108;Brasília;1;1;2;1639
2607752;Itapissuma;5300108;Brasília;1;1;2;1634
2607802;Itaquitinga;5300108;Brasília;1;1;2;1625
2607950;Jaqueira;5300108;Brasília;1;1;2;1502
2608206;Joaquim Nabuco;5300108;Brasília;1;1;2;1531
2608255;Jucati;5300108;Brasília;1;1;2;1441
2608305;Jupi;5300108;Brasília;1;1;2;1447
2608453;Lagoa do Carro;5300108;Brasília;1;1;2;1595
2608602;Lagoa do Ouro;5300108;Brasília;1;1;2;1420
2609154;Manari;5300108;Brasília;1;1;2;1325
2609204;Maraial;5300108;Brasília;1;1;2;1494
2610301;Paranatama;5300108;Brasília;1;1;2;1413
2610608;Paudalho;5300108;Brasília;1;1;2;1604
2611408;Primavera;5300108;Brasília;1;1;2;1562
2612109;Salgadinho;5300108;Brasília;1;1;2;1562
2612455;Santa Cruz;5300108;Brasília;1;1;2;1159
2612471;Santa Cruz da Baixa Verde;5300108;Brasília;1;1;2;1357
2612554;Santa Filomena;5300108;Brasília;1;1;2;1145
2612703;Santa Maria do Cambucá;5300108;Brasília;1;1;2;1544
2612901;São Benedito do Sul;5300108;Brasília;1;1;2;1483
2613404;São José da Coroa Grande;5300108;Brasília;1;1;2;1550
2614402;Solidão;5300108;Brasília;1;1;2;1413
2614709;Tacaimbó;5300108;Brasília;1;1;2;1481
2615102;Terezinha;5300108;Brasília;1;1;2;1409
2615508;Tracunhaém;5300108;Brasília;1;1;2;1604
2616100;Verdejante;5300108;Brasília;1;1;2;1285
2616183;Vertente do Lério;5300108;Brasília;1;1;2;1553
2616506;Xexéu;5300108;Brasília;1;1;2;1511
2700508;Barra de Santo Antônio;5300108;Brasília;1;1;2;1492
2700805;Belém;5300108;Brasília;1;1;2;1392
2700904;Belo Monte;5300108;Brasília;1;1;2;1306
2701100;Branquinha;5300108;Brasília;1;1;2;1453
2701308;Cajueiro;5300108;Brasília;1;1;2;1433
2701357;Campestre;5300108;Brasília;1;1;2;1516
2701803;Carneiros;5300108;Brasília;1;1;2;1317
2701902;Chã Preta;5300108;Brasília;1;1;2;1427
2702009;Coité do Nóia;5300108;Brasília;1;1;2;1381
2702207;Coqueiro Seco;5300108;Brasília;1;1;2;1453
2702553;Estrela de Alagoas;5300108;Brasília;1;1;2;1378
2702702;Feliz Deserto;5300108;Brasília;1;1;2;1372
2702801;Flexeiras;5300108;Brasília;1;1;2;1479
2703304;Inhapi;5300108;Brasília;1;1;2;1299
2703403;Jacaré dos Homens;5300108;Brasília;1;1;2;1324
2703502;Jacuípe;5300108;Brasília;1;1;2;1526
2703601;Japaratinga;5300108;Brasília;1;1;2;1531
2703700;Jaramataia;5300108;Brasília;1;1;2;1341
2703759;Jequiá da Praia;5300108;Brasília;1;1;2;1412
2703809;Joaquim Gomes;5300108;Brasília;1;1;2;1484
2703908;Jundiá;5300108;Brasília;1;1;2;1510
2704906;Mar Vermelho;5300108;Brasília;1;1;2;1408
2705200;Messias;5300108;Brasília;1;1;2;1462
2705309;Minador do Negrão;5300108;Brasília;1;1;2;1373
2705408;Monteirópolis;5300108;Brasília;1;1;2;1322
2705804;Olho d'Água do Casado;5300108;Brasília;1;1;2;1275
2705903;Olho d'Água Grande;5300108;Brasília;1;1;2;1337
2706109;Ouro Branco;5300108;Brasília;1;1;2;1337
2706208;Palestina;5300108;Brasília;1;1;2;1310
2706422;Pariconha;5300108;Brasília;1;1;2;1275
2706448;Paripueira;5300108;Brasília;1;1;2;1485
2706505;Passo de Camaragibe;5300108;Brasília;1;1;2;1502
2707008;Pindoba;5300108;Brasília;1;1;2;1416
2707404;Porto de Pedras;5300108;Brasília;1;1;2;1524
2707503;Porto Real do Colégio;5300108;Brasília;1;1;2;1333
2707800;Roteiro;5300108;Brasília;1;1;2;1427
2707909;Santa Luzia do Norte;5300108;Brasília;1;1;2;1453
2708105;Santana do Mundaú;5300108;Brasília;1;1;2;1439
2708204;São Brás;5300108;Brasília;1;1;2;1328
2708709;São Miguel dos Milagres;5300108;Brasília;1;1;2;1512
2708907;Satuba;5300108;Brasília;1;1;2;1454
2708956;Senador Rui Palmeira;5300108;Brasília;1;1;2;1313
2709004;Tanque d'Arca;5300108;Brasília;1;1;2;1400
2800100;Amparo de São Francisco;5300108;Brasília;1;1;2;1321
2800506;Areia Branca;5300108;Brasília;1;1;2;1256
2800605;Barra dos Coqueiros;5300108;Brasília;1;1;2;1278
2800704;Brejo Grande;5300108;Brasília;1;1;2;1352
2801108;Canhoba;5300108;Brasília;1;1;2;1317
2801603;Cedro de São João;5300108;Brasília;1;1;2;1320
2801702;Cristinápolis;5300108;Brasília;1;1;2;1181
2801900;Cumbe;5300108;Brasília;1;1;2;1288
2802007;Divina Pastora;5300108;Brasília;1;1;2;1274
2802205;Feira Nova;5300108;Brasília;1;1;2;1280
2802403;Gararu;5300108;Brasília;1;1;2;1311
2802502;General Maynard;5300108;Brasília;1;1;2;1291
2802601;Gracho Cardoso;5300108;Brasília;1;1;2;1293
2802700;Ilha das Flores;5300108;Brasília;1;1;2;1344
2802809;Indiaroba;5300108;Brasília;1;1;2;1201
2803104;Itabi;5300108;Brasília;1;1;2;1306
2803401;Japoatã;5300108;Brasília;1;1;2;1324
2803609;Laranjeiras;5300108;Brasília;1;1;2;1267
2803807;Malhada dos Bois;5300108;Brasília;1;1;2;1311
2803906;Malhador;5300108;Brasília;1;1;2;1261
2804300;Muribeca;5300108;Brasília;1;1;2;1305
2804458;Nossa Senhora Aparecida;5300108;Brasília;1;1;2;1254
2805000;Pedra Mole;5300108;Brasília;1;1;2;1227
2805109;Pedrinhas;5300108;Brasília;1;1;2;1201
2805208;Pinhão;5300108;Brasília;1;1;2;1225
2805307;Pirambu;5300108;Brasília;1;1;2;1301
2805406;Poço Redondo;5300108;Brasília;1;1;2;1271
2805901;Riachuelo;5300108;Brasília;1;1;2;1268
2806107;Rosário do Catete;5300108;Brasília;1;1;2;1286
2806305;Santa Luzia do Itanhy;5300108;Brasília;1;1;2;1213
2806404;Santana do São Francisco;5300108;Brasília;1;1;2;1343
2806503;Santa Rosa de Lima;5300108;Brasília;1;1;2;1270
2806602;Santo Amaro das Brotas;5300108;Brasília;1;1;2;1282
2806909;São Francisco;5300108;Brasília;1;1;2;1317
2807006;São Miguel do Aleixo;5300108;Brasília;1;1;2;1268
2807204;Siriri;5300108;Brasília;1;1;2;1282
2807303;Telha;5300108;Brasília;1;1;2;1322
2900207;Abaré;5300108;Brasília;1;1;2;1217
2900504;Érico Cardoso;5300108;Brasília;1;1;2;671
2900603;Aiquara;5300108;Brasília;1;1;2;878
2900900;Almadina;5300108;Brasília;1;1;2;894
2901304;Andaraí;5300108;Brasília;1;1;2;776
2901502;Anguera;5300108;Brasília;1;1;2;1007
2901700;Antônio Cardoso;5300108;Brasília;1;1;2;1008
2901809;Antônio Gonçalves;5300108;Brasília;1;1;2;996
2901957;Apuarema;5300108;Brasília;1;1;2;899
2902005;Aracatu;5300108;Brasília;1;1;2;707
2902054;Araças;5300108;Brasília;1;1;2;1107
2902252;Arataca;5300108;Brasília;1;1;2;913
2902302;Aratuípe;5300108;Brasília;1;1;2;997
2902401;Aurelino Leal;5300108;Brasília;1;1;2;933
2903102;Barra do Rocha;5300108;Brasília;1;1;2;906
2903300;Governador Lomanto Júnior;5300108;Brasília;1;1;2;910
2903953;Bom Jesus da Serra;5300108;Brasília;1;1;2;808
2904050;Bonito;5300108;Brasília;1;1;2;825
2904308;Brejões;5300108;Brasília;1;1;2;916
2904407;Brejolândia;5300108;Brasília;1;1;2;558
2904753;Buritirama;5300108;Brasília;1;1;2;725
2904803;Caatiba;5300108;Brasília;1;1;2;809
2904852;Cabaceiras do Paraguaçu;5300108;Brasília;1;1;2;995
2905156;Caetanos;5300108;Brasília;1;1;2;766
2905404;Cairu;5300108;Brasília;1;1;2;985
2906808;Cansanção;5300108;Brasília;1;1;2;1058
2906899;Caraíbas;5300108;Brasília;1;1;2;717
2907400;Catolândia;5300108;Brasília;1;1;2;505
2907558;Caturama;5300108;Brasília;1;1;2;660
2907707;Chorrochó;5300108;Brasília;1;1;2;1200
2908804;Contendas do Sincorá;5300108;Brasília;1;1;2;768
2909000;Cordeiros;5300108;Brasília;1;1;2;646
2909406;Cotegipe;5300108;Brasília;1;1;2;572
2909505;Cravolândia;5300108;Brasília;1;1;2;906
2909703;Cristópolis;5300108;Brasília;1;1;2;546
2910008;Dário Meira;5300108;Brasília;1;1;2;867
2910206;Dom Macedo Costa;5300108;Brasília;1;1;2;983
2910305;Elísio Medrado;5300108;Brasília;1;1;2;949
2910750;Fátima;5300108;Brasília;1;1;2;1179
2910776;Feira da Mata;5300108;Brasília;1;1;2;427
2910909;Firmino Alves;5300108;Brasília;1;1;2;860
2911006;Floresta Azul;5300108;Brasília;1;1;2;890
2911253;Gavião;5300108;Brasília;1;1;2;988
2911402;Glória;5300108;Brasília;1;1;2;1243
2911501;Gongogi;5300108;Brasília;1;1;2;916
2911659;Guajeru;5300108;Brasília;1;1;2;654
2911857;Heliópolis;5300108;Brasília;1;1;2;1168
2912202;Ibicoara;5300108;Brasília;1;1;2;756
2912400;Ibipeba;5300108;Brasília;1;1;2;779
2912509;Ibipitanga;5300108;Brasília;1;1;2;667
2912608;Ibiquera;5300108;Brasília;1;1;2;822
2913309;Ichu;5300108;Brasília;1;1;2;1030
2913457;Igrapiúna;5300108;Brasília;1;1;2;962
2913804;Ipecaetá;5300108;Brasília;1;1;2;995
2914208;Irajuba;5300108;Brasília;1;1;2;882
2915304;Itagimirim;5300108;Brasília;1;1;2;892
2915353;Itaguaçu da Bahia;5300108;Brasília;1;1;2;790
2915403;Itaju do Colônia;5300108;Brasília;1;1;2;880
2915700;Itamari;5300108;Brasília;1;1;2;907
2915908;Itanagra;5300108;Brasília;1;1;2;1121
2916302;Itapebi;5300108;Brasília;1;1;2;899
2916856;Itatim;5300108;Brasília;1;1;2;940
2916906;Itiruçu;5300108;Brasília;1;1;2;866
2917201;Ituaçu;5300108;Brasília;1;1;2;740
2917359;Jaborandi;5300108;Brasília;1;1;2;442
2917805;Jaguaripe;5300108;Brasília;1;1;2;1001
2917904;Jandaíra;5300108;Brasília;1;1;2;1174
2918209;Jiquiriçá;5300108;Brasília;1;1;2;933
2918456;Jucuruçu;5300108;Brasília;1;1;2;842
2918555;Jussari;5300108;Brasília;1;1;2;904
2918704;Lafaiete Coutinho;5300108;Brasília;1;1;2;856
2918902;Lajedão;5300108;Brasília;1;1;2;840
2919009;Lajedinho;5300108;Brasília;1;1;2;838
2919108;Lamarão;5300108;Brasília;1;1;2;1057
2919900;Macururé;5300108;Brasília;1;1;2;1191
2919959;Maetinga;5300108;Brasília;1;1;2;699
2920007;Maiquinique;5300108;Brasília;1;1;2;820
2920304;Malhada de Pedras;5300108;Brasília;1;1;2;664
2920403;Manoel Vitorino;5300108;Brasília;1;1;2;842
2920700;Maraú;5300108;Brasília;1;1;2;969
2920809;Marcionílio Souza;5300108;Brasília;1;1;2;847
2920908;Mascote;5300108;Brasília;1;1;2;924
2921054;Matina;5300108;Brasília;1;1;2;581
2921302;Milagres;5300108;Brasília;1;1;2;918
2921450;Mirante;5300108;Brasília;1;1;2;783
2921609;Morpará;5300108;Brasília;1;1;2;682
2922052;Mulungu do Morro;5300108;Brasília;1;1;2;792
2922201;Muniz Ferreira;5300108;Brasília;1;1;2;988
2922250;Muquém de São Francisco;5300108;Brasília;1;1;2;623
2922607;Nilo Peçanha;5300108;Brasília;1;1;2;970
2922730;Nova Fátima;5300108;Brasília;1;1;2;996
2922755;Nova Ibiá;5300108;Brasília;1;1;2;912
2922805;Nova Itarana;5300108;Brasília;1;1;2;891
2922854;Nova Redenção;5300108;Brasília;1;1;2;801
2923035;Novo Horizonte;5300108;Brasília;1;1;2;697
2923050;Novo Triunfo;5300108;Brasília;1;1;2;1177
2923308;Ouriçangas;5300108;Brasília;1;1;2;1074
2923357;Ourolândia;5300108;Brasília;1;1;2;901
2923407;Palmas de Monte Alto;5300108;Brasília;1;1;2;536
2923506;Palmeiras;5300108;Brasília;1;1;2;768
2924058;Pé de Serra;5300108;Brasília;1;1;2;986
2924108;Pedrão;5300108;Brasília;1;1;2;1066
2924207;Pedro Alexandre;5300108;Brasília;1;1;2;1240
2924306;Piatã;5300108;Brasília;1;1;2;718
2924504;Pindaí;5300108;Brasília;1;1;2;578
2924652;Pintadas;5300108;Brasília;1;1;2;959
2924678;Piraí do Norte;5300108;Brasília;1;1;2;939
2924702;Piripá;5300108;Brasília;1;1;2;670
2924900;Planaltino;5300108;Brasília;1;1;2;853
2925402;Potiraguá;5300108;Brasília;1;1;2;862
2925709;Presidente Jânio Quadros;5300108;Brasília;1;1;2;679
2925907;Quijingue;5300108;Brasília;1;1;2;1080
2925931;Quixabeira;5300108;Brasília;1;1;2;960
2925956;Rafael Jambeiro;5300108;Brasília;1;1;2;971
2926657;Ribeirão do Largo;5300108;Brasília;1;1;2;770
2926905;Rio do Pires;5300108;Brasília;1;1;2;672
2927101;Rodelas;5300108;Brasília;1;1;2;1235
2927606;Santa Brígida;5300108;Brasília;1;1;2;1235
2927804;Santa Cruz da Vitória;5300108;Brasília;1;1;2;873
2927903;Santa Inês;5300108;Brasília;1;1;2;908
2928059;Santa Luzia;5300108;Brasília;1;1;2;921
2928505;Santa Teresinha;5300108;Brasília;1;1;2;955
2929354;São José da Vitória;5300108;Brasília;1;1;2;922
2929370;São José do Jacuípe;5300108;Brasília;1;1;2;984
2929750;Saubara;5300108;Brasília;1;1;2;1032
2930402;Serra Preta;5300108;Brasília;1;1;2;998
2930758;Sítio do Mato;5300108;Brasília;1;1;2;562
2930766;Sítio do Quinto;5300108;Brasília;1;1;2;1192
2930808;Souto Soares;5300108;Brasília;1;1;2;782
2930907;Tabocas do Brejo Velho;5300108;Brasília;1;1;2;540
2931301;Tapiramutá;5300108;Brasília;1;1;2;875
2931608;Teolândia;5300108;Brasília;1;1;2;932
2932457;Umburanas;5300108;Brasília;1;1;2;897
2933109;Várzea do Poço;5300108;Brasília;1;1;2;936
2933174;Varzedo;5300108;Brasília;1;1;2;961
2933257;Vereda;5300108;Brasília;1;1;2;857
2933406;Wagner;5300108;Brasília;1;1;2;817
3100401;Acaiaca;5300108;Brasília;1;1;2;723
3100500;Açucena;5300108;Brasília;1;1;2;684
3100609;Água Boa;5300108;Brasília;1;1;2;644
3100708;Água Comprida;5300108;Brasília;1;1;2;470
3100807;Aguanil;5300108;Brasília;1;1;2;631
3101003;Águas Vermelhas;5300108;Brasília;1;1;2;693
3101201;Aiuruoca;5300108;Brasília;1;1;2;771
3101300;Alagoa;5300108;Brasília;1;1;2;790
3101409;Albertina;5300108;Brasília;1;1;2;722
3101631;Alfredo Vasconcelos;5300108;Brasília;1;1;2;743
3101805;Alpercata;5300108;Brasília;1;1;2;732
3102050;Alto Caparaó;5300108;Brasília;1;1;2;833
3102100;Alto Rio Doce;5300108;Brasília;1;1;2;758
3102209;Alvarenga;5300108;Brasília;1;1;2;780
3102407;Alvorada de Minas;5300108;Brasília;1;1;2;589
3102506;Amparo do Serra;5300108;Brasília;1;1;2;761
3102704;Cachoeira de Pajeú;5300108;Brasília;1;1;2;689
3102852;Angelândia;5300108;Brasília;1;1;2;651
3103009;Antônio Dias;5300108;Brasília;1;1;2;693
3103108;Antônio Prado de Minas;5300108;Brasília;1;1;2;853
3103207;Araçaí;5300108;Brasília;1;1;2;546
3103306;Aracitaba;5300108;Brasília;1;1;2;785
3103603;Arantina;5300108;Brasília;1;1;2;785
3103702;Araponga;5300108;Brasília;1;1;2;796
3103751;Araporã;5300108;Brasília;1;1;2;321
3103801;Arapuá;5300108;Brasília;1;1;2;405
3104403;Argirita;5300108;Brasília;1;1;2;848
3104452;Aricanduva;5300108;Brasília;1;1;2;618
3104809;Augusto de Lima;5300108;Brasília;1;1;2;469
3105004;Baldim;5300108;Brasília;1;1;2;576
3105202;Bandeira;5300108;Brasília;1;1;2;789
3105301;Bandeira do Sul;5300108;Brasília;1;1;2;676
3105509;Barão de Monte Alto;5300108;Brasília;1;1;2;863
3106002;Bela Vista de Minas;5300108;Brasília;1;1;2;687
3106101;Belmiro Braga;5300108;Brasília;1;1;2;839
3106408;Belo Vale;5300108;Brasília;1;1;2;662
3106606;Bertópolis;5300108;Brasília;1;1;2;802
3106655;Berizal;5300108;Brasília;1;1;2;662
3106804;Bias Fortes;5300108;Brasília;1;1;2;786
3107000;Biquinhas;5300108;Brasília;1;1;2;420
3107208;Bocaina de Minas;5300108;Brasília;1;1;2;802
3107703;Bom Jesus do Amparo;5300108;Brasília;1;1;2;646
3107802;Bom Jesus do Galho;5300108;Brasília;1;1;2;753
3107901;Bom Repouso;5300108;Brasília;1;1;2;763
3108255;Bonito de Minas;5300108;Brasília;1;1;2;343
3108701;Brás Pires;5300108;Brasília;1;1;2;761
3108800;Braúnas;5300108;Brasília;1;1;2;668
3109253;Bugre;5300108;Brasília;1;1;2;730
3109451;Cabeceira Grande;5300108;Brasília;1;1;2;93
3109600;Cachoeira da Prata;5300108;Brasília;1;1;2;557
3109808;Cachoeira Dourada;5300108;Brasília;1;1;2;344
3110103;Caiana;5300108;Brasília;1;1;2;847
3110202;Cajuri;5300108;Brasília;1;1;2;784
3110400;Camacho;5300108;Brasília;1;1;2;612
3110806;Campanário;5300108;Brasília;1;1;2;718
3111150;Campo Azul;5300108;Brasília;1;1;2;343
3111705;Canaã;5300108;Brasília;1;1;2;789
3111903;Cana Verde;5300108;Brasília;1;1;2;649
3112059;Cantagalo;5300108;Brasília;1;1;2;644
3112109;Caparaó;5300108;Brasília;1;1;2;837
3112208;Capela Nova;5300108;Brasília;1;1;2;734
3112406;Capetinga;5300108;Brasília;1;1;2;540
3112505;Capim Branco;5300108;Brasília;1;1;2;582
3112653;Capitão Andrade;5300108;Brasília;1;1;2;748
3112802;Capitólio;5300108;Brasília;1;1;2;569
3112901;Caputira;5300108;Brasília;1;1;2;780
3113107;Caranaíba;5300108;Brasília;1;1;2;722
3113503;Carbonita;5300108;Brasília;1;1;2;561
3113602;Careaçu;5300108;Brasília;1;1;2;731
3113800;Carmésia;5300108;Brasília;1;1;2;632
3113909;Carmo da Cachoeira;5300108;Brasília;1;1;2;691
3114105;Carmo de Minas;5300108;Brasília;1;1;2;762
3114550;Carneirinho;5300108;Brasília;1;1;2;524
3114709;Carvalhópolis;5300108;Brasília;1;1;2;699
3114808;Carvalhos;5300108;Brasília;1;1;2;782
3114907;Casa Grande;5300108;Brasília;1;1;2;702
3115003;Cascalho Rico;5300108;Brasília;1;1;2;306
3115201;Conceição da Barra de Minas;5300108;Brasília;1;1;2;698
3115409;Catas Altas da Noruega;5300108;Brasília;1;1;2;723
3115458;Catuji;5300108;Brasília;1;1;2;709
3115474;Catuti;5300108;Brasília;1;1;2;528
3115607;Cedro do Abaeté;5300108;Brasília;1;1;2;440
3115904;Chácara;5300108;Brasília;1;1;2;827
3116100;Chapada do Norte;5300108;Brasília;1;1;2;596
3116209;Chiador;5300108;Brasília;1;1;2;867
3116308;Cipotânea;5300108;Brasília;1;1;2;751
3116407;Claraval;5300108;Brasília;1;1;2;513
3116803;Coluna;5300108;Brasília;1;1;2;610
3116902;Comendador Gomes;5300108;Brasília;1;1;2;448
3117207;Conceição das Pedras;5300108;Brasília;1;1;2;753
3117405;Conceição de Ipanema;5300108;Brasília;1;1;2;814
3117801;Conceição dos Ouros;5300108;Brasília;1;1;2;767
3117836;Cônego Marinho;5300108;Brasília;1;1;2;379
3117900;Congonhal;5300108;Brasília;1;1;2;732
3118106;Congonhas do Norte;5300108;Brasília;1;1;2;566
3118502;Consolação;5300108;Brasília;1;1;2;778
3119005;Cordislândia;5300108;Brasília;1;1;2;705
3119500;Coronel Murta;5300108;Brasília;1;1;2;623
3119708;Coronel Xavier Chaves;5300108;Brasília;1;1;2;704
3119807;Córrego Danta;5300108;Brasília;1;1;2;495
3119906;Córrego do Bom Jesus;5300108;Brasília;1;1;2;783
3119955;Córrego Fundo;5300108;Brasília;1;1;2;574
3120003;Córrego Novo;5300108;Brasília;1;1;2;746
3120102;Couto de Magalhães de Minas;5300108;Brasília;1;1;2;541
3120151;Crisólita;5300108;Brasília;1;1;2;770
3120409;Cristiano Otoni;5300108;Brasília;1;1;2;714
3120607;Crucilândia;5300108;Brasília;1;1;2;639
3120706;Cruzeiro da Fortaleza;5300108;Brasília;1;1;2;372
3120839;Cuparaque;5300108;Brasília;1;1;2;816
3120870;Curral de Dentro;5300108;Brasília;1;1;2;652
3121001;Datas;5300108;Brasília;1;1;2;545
3121100;Delfim Moreira;5300108;Brasília;1;1;2;796
3121209;Delfinópolis;5300108;Brasília;1;1;2;515
3121258;Delta;5300108;Brasília;1;1;2;458
3121407;Desterro de Entre Rios;5300108;Brasília;1;1;2;663
3121506;Desterro do Melo;5300108;Brasília;1;1;2;761
3121704;Diogo de Vasconcelos;5300108;Brasília;1;1;2;729
3121902;Divinésia;5300108;Brasília;1;1;2;784
3122108;Divino das Laranjeiras;5300108;Brasília;1;1;2;770
3122207;Divinolândia de Minas;5300108;Brasília;1;1;2;663
3122355;Divisa Alegre;5300108;Brasília;1;1;2;705
3122454;Divisópolis;5300108;Brasília;1;1;2;742
3122470;Dom Bosco;5300108;Brasília;1;1;2;200
3122504;Dom Cavati;5300108;Brasília;1;1;2;743
3122603;Dom Joaquim;5300108;Brasília;1;1;2;614
3122801;Dom Viçoso;5300108;Brasília;1;1;2;773
3122900;Dona Eusébia;5300108;Brasília;1;1;2;825
3123007;Dores de Campos;5300108;Brasília;1;1;2;724
3123106;Dores de Guanhães;5300108;Brasília;1;1;2;649
3123304;Dores do Turvo;5300108;Brasília;1;1;2;769
3123403;Doresópolis;5300108;Brasília;1;1;2;542
3123502;Douradoquara;5300108;Brasília;1;1;2;292
3123528;Durandé;5300108;Brasília;1;1;2;823
3123700;Engenheiro Caldas;5300108;Brasília;1;1;2;739
3123809;Engenheiro Navarro;5300108;Brasília;1;1;2;457
3123858;Entre Folhas;5300108;Brasília;1;1;2;745
3124401;Espírito Santo do Dourado;5300108;Brasília;1;1;2;723
3124609;Estrela Dalva;5300108;Brasília;1;1;2;886
3124708;Estrela do Indaiá;5300108;Brasília;1;1;2;471
3124906;Eugenópolis;5300108;Brasília;1;1;2;855
3125002;Ewbank da Câmara;5300108;Brasília;1;1;2;795
3125200;Fama;5300108;Brasília;1;1;2;664
3125309;Faria Lemos;5300108;Brasília;1;1;2;845
3125408;Felício dos Santos;5300108;Brasília;1;1;2;563
3125507;São Gonçalo do Rio Preto;5300108;Brasília;1;1;2;545
3125606;Felisburgo;5300108;Brasília;1;1;2;775
3125705;Felixlândia;5300108;Brasília;1;1;2;462
3125804;Fernandes Tourinho;5300108;Brasília;1;1;2;730
3125952;Fervedouro;5300108;Brasília;1;1;2;819
3126000;Florestal;5300108;Brasília;1;1;2;589
3126208;Formoso;5300108;Brasília;1;1;2;205
3126307;Fortaleza de Minas;5300108;Brasília;1;1;2;573
3126406;Fortuna de Minas;5300108;Brasília;1;1;2;560
3126752;Franciscópolis;5300108;Brasília;1;1;2;680
3126802;Frei Gaspar;5300108;Brasília;1;1;2;741
3126901;Frei Inocêncio;5300108;Brasília;1;1;2;715
3126950;Frei Lagonegro;5300108;Brasília;1;1;2;614
3127057;Fronteira dos Vales;5300108;Brasília;1;1;2;761
3127073;Fruta de Leite;5300108;Brasília;1;1;2;579
3127206;Funilândia;5300108;Brasília;1;1;2;575
3127339;Gameleiras;5300108;Brasília;1;1;2;520
3127354;Glaucilândia;5300108;Brasília;1;1;2;471
3127370;Goiabeira;5300108;Brasília;1;1;2;805
3127388;Goianá;5300108;Brasília;1;1;2;816
3127503;Gonzaga;5300108;Brasília;1;1;2;673
3127602;Gouveia;5300108;Brasília;1;1;2;535
3127909;Grupiara;5300108;Brasília;1;1;2;298
3128105;Guapé;5300108;Brasília;1;1;2;590
3128204;Guaraciaba;5300108;Brasília;1;1;2;750
3128253;Guaraciama;5300108;Brasília;1;1;2;476
3128501;Guarará;5300108;Brasília;1;1;2;842
3128600;Guarda-Mor;5300108;Brasília;1;1;2;235
3129103;Gurinhatã;5300108;Brasília;1;1;2;427
3129400;Ibertioga;5300108;Brasília;1;1;2;757
3129608;Ibiaí;5300108;Brasília;1;1;2;345
3129657;Ibiracatu;5300108;Brasília;1;1;2;403
3129905;Ibitiúra de Minas;5300108;Brasília;1;1;2;711
3130002;Ibituruna;5300108;Brasília;1;1;2;685
3130200;Igaratinga;5300108;Brasília;1;1;2;576
3130309;Iguatama;5300108;Brasília;1;1;2;539
3130408;Ijaci;5300108;Brasília;1;1;2;677
3130507;Ilicínea;5300108;Brasília;1;1;2;611
3130556;Imbé de Minas;5300108;Brasília;1;1;2;769
3130655;Indaiabira;5300108;Brasília;1;1;2;614
3130804;Ingaí;5300108;Brasília;1;1;2;700
3131000;Inhaúma;5300108;Brasília;1;1;2;559
3131109;Inimutaba;5300108;Brasília;1;1;2;502
3131406;Ipiaçu;5300108;Brasília;1;1;2;386
3132008;Itacambira;5300108;Brasília;1;1;2;515
3132305;Itaipé;5300108;Brasília;1;1;2;696
3132602;Itamarati de Minas;5300108;Brasília;1;1;2;832
3132800;Itambé do Mato Dentro;5300108;Brasília;1;1;2;638
3132909;Itamogi;5300108;Brasília;1;1;2;591
3133600;Itapeva;5300108;Brasília;1;1;2;791
3133709;Itatiaiuçu;5300108;Brasília;1;1;2;616
3133907;Itaverava;5300108;Brasília;1;1;2;714
3134103;Itueta;5300108;Brasília;1;1;2;831
3134301;Itumirim;5300108;Brasília;1;1;2;694
3134509;Itutinga;5300108;Brasília;1;1;2;704
3135001;Jaguaraçu;5300108;Brasília;1;1;2;703
3135076;Jampruca;5300108;Brasília;1;1;2;723
3135308;Japaraíba;5300108;Brasília;1;1;2;547
3135357;Japonvar;5300108;Brasília;1;1;2;392
3135407;Jeceaba;5300108;Brasília;1;1;2;676
3135456;Jenipapo de Minas;5300108;Brasília;1;1;2;625
3135605;Jequitaí;5300108;Brasília;1;1;2;405
3135704;Jequitibá;5300108;Brasília;1;1;2;567
3135902;Jesuânia;5300108;Brasília;1;1;2;743
3136108;Joanésia;5300108;Brasília;1;1;2;678
3136405;Joaquim Felício;5300108;Brasília;1;1;2;458
3136504;Jordânia;5300108;Brasília;1;1;2;830
3136520;José Gonçalves de Minas;5300108;Brasília;1;1;2;584
3136553;José Raydan;5300108;Brasília;1;1;2;643
3136579;Josenópolis;5300108;Brasília;1;1;2;586
3136603;Nova União;5300108;Brasília;1;1;2;637
3136801;Juramento;5300108;Brasília;1;1;2;480
3136959;Juvenília;5300108;Brasília;1;1;2;437
3137304;Lagoa dos Patos;5300108;Brasília;1;1;2;382
3137536;Lagoa Grande;5300108;Brasília;1;1;2;271
3137908;Lamim;5300108;Brasília;1;1;2;733
3138005;Laranjal;5300108;Brasília;1;1;2;855
3138104;Lassance;5300108;Brasília;1;1;2;425
3138302;Leandro Ferreira;5300108;Brasília;1;1;2;534
3138351;Leme do Prado;5300108;Brasília;1;1;2;580
3138625;Limeira do Oeste;5300108;Brasília;1;1;2;504
3138658;Lontra;5300108;Brasília;1;1;2;388
3138674;Luisburgo;5300108;Brasília;1;1;2;813
3138682;Luislândia;5300108;Brasília;1;1;2;359
3138708;Luminárias;5300108;Brasília;1;1;2;712
3138906;Machacalis;5300108;Brasília;1;1;2;787
3139102;Madre de Deus de Minas;5300108;Brasília;1;1;2;740
3139250;Mamonas;5300108;Brasília;1;1;2;536
3139706;Maravilhas;5300108;Brasília;1;1;2;540
3139805;Mar de Espanha;5300108;Brasília;1;1;2;858
3140100;Marilac;5300108;Brasília;1;1;2;697
3140159;Mário Campos;5300108;Brasília;1;1;2;620
3140209;Maripá de Minas;5300108;Brasília;1;1;2;847
3140308;Marliéria;5300108;Brasília;1;1;2;709
3140407;Marmelópolis;5300108;Brasília;1;1;2;794
3140530;Martins Soares;5300108;Brasília;1;1;2;820
3140555;Mata Verde;5300108;Brasília;1;1;2;772
3140605;Materlândia;5300108;Brasília;1;1;2;602
3140852;Matias Cardoso;5300108;Brasília;1;1;2;447
3141207;Matutina;5300108;Brasília;1;1;2;433
3141306;Medeiros;5300108;Brasília;1;1;2;499
3141504;Mendes Pimentel;5300108;Brasília;1;1;2;771
3142403;Moema;5300108;Brasília;1;1;2;523
3142502;Monjolos;5300108;Brasília;1;1;2;496
3142700;Montalvânia;5300108;Brasília;1;1;2;403
3143153;Monte Formoso;5300108;Brasília;1;1;2;726
3143450;Montezuma;5300108;Brasília;1;1;2;585
3143609;Morro da Garça;5300108;Brasília;1;1;2;469
3143708;Morro do Pilar;5300108;Brasília;1;1;2;620
3143807;Munhoz;5300108;Brasília;1;1;2;772
3144201;Nacip Raydan;5300108;Brasília;1;1;2;679
3144359;Naque;5300108;Brasília;1;1;2;714
3144375;Natalândia;5300108;Brasília;1;1;2;172
3144409;Natércia;5300108;Brasília;1;1;2;746
3144508;Nazareno;5300108;Brasília;1;1;2;699
3144656;Ninheira;5300108;Brasília;1;1;2;663
3144672;Nova Belém;5300108;Brasília;1;1;2;799
3144904;Nova Módica;5300108;Brasília;1;1;2;751
3145059;Nova Porteirinha;5300108;Brasília;1;1;2;495
3145356;Novo Oriente de Minas;5300108;Brasília;1;1;2;743
3145372;Novorizonte;5300108;Brasília;1;1;2;592
3145406;Olaria;5300108;Brasília;1;1;2;796
3145455;Olhos-d'Água;5300108;Brasília;1;1;2;500
3145703;Oliveira Fortes;5300108;Brasília;1;1;2;780
3145802;Onça de Pitangui;5300108;Brasília;1;1;2;550
3145851;Oratórios;5300108;Brasília;1;1;2;755
3145877;Orizânia;5300108;Brasília;1;1;2;809
3146206;Ouro Verde de Minas;5300108;Brasília;1;1;2;760
3146255;Padre Carvalho;5300108;Brasília;1;1;2;584
3146404;Paineiras;5300108;Brasília;1;1;2;429
3146552;Pai Pedro;5300108;Brasília;1;1;2;521
3146602;Paiva;5300108;Brasília;1;1;2;778
3146701;Palma;5300108;Brasília;1;1;2;867
3146750;Palmópolis;5300108;Brasília;1;1;2;812
3146909;Papagaios;5300108;Brasília;1;1;2;529
3147501;Passabém;5300108;Brasília;1;1;2;649
3147808;Passa-Vinte;5300108;Brasília;1;1;2;815
3147956;Patis;5300108;Brasília;1;1;2;413
3148202;Patrocínio do Muriaé;5300108;Brasília;1;1;2;857
3148301;Paula Cândido;5300108;Brasília;1;1;2;776
3148400;Paulistas;5300108;Brasília;1;1;2;618
3148509;Pavão;5300108;Brasília;1;1;2;764
3148756;Pedra Bonita;5300108;Brasília;1;1;2;798
3148806;Pedra do Anta;5300108;Brasília;1;1;2;775
3148905;Pedra do Indaiá;5300108;Brasília;1;1;2;574
3149002;Pedra Dourada;5300108;Brasília;1;1;2;838
3149150;Pedras de Maria da Cruz;5300108;Brasília;1;1;2;379
3149408;Pedro Teixeira;5300108;Brasília;1;1;2;796
3149606;Pequi;5300108;Brasília;1;1;2;551
3149705;Perdigão;5300108;Brasília;1;1;2;552
3149952;Periquito;5300108;Brasília;1;1;2;717
3150000;Pescador;5300108;Brasília;1;1;2;738
3150109;Piau;5300108;Brasília;1;1;2;805
3150158;Piedade de Caratinga;5300108;Brasília;1;1;2;769
3150208;Piedade de Ponte Nova;5300108;Brasília;1;1;2;747
3150307;Piedade do Rio Grande;5300108;Brasília;1;1;2;746
3150406;Piedade dos Gerais;5300108;Brasília;1;1;2;654
3150505;Pimenta;5300108;Brasília;1;1;2;566
3150539;Pingo-d'Água;5300108;Brasília;1;1;2;738
3150570;Pintópolis;5300108;Brasília;1;1;2;298
3150703;Pirajuba;5300108;Brasília;1;1;2;461
3150901;Piranguçu;5300108;Brasília;1;1;2;790
3151008;Piranguinho;5300108;Brasília;1;1;2;774
3151909;Pocrane;5300108;Brasília;1;1;2;801
3152131;Ponto Chique;5300108;Brasília;1;1;2;320
3152170;Ponto dos Volantes;5300108;Brasília;1;1;2;697
3152303;Porto Firme;5300108;Brasília;1;1;2;752
3152600;Pouso Alto;5300108;Brasília;1;1;2;777
3152709;Prados;5300108;Brasília;1;1;2;716
3153004;Pratinha;5300108;Brasília;1;1;2;467
3153103;Presidente Bernardes;5300108;Brasília;1;1;2;752
3153202;Presidente Juscelino;5300108;Brasília;1;1;2;520
3153301;Presidente Kubitschek;5300108;Brasília;1;1;2;564
3153509;Alto Jequitibá;5300108;Brasília;1;1;2;824
3153608;Prudente de Morais;5300108;Brasília;1;1;2;576
3153707;Quartel Geral;5300108;Brasília;1;1;2;461
3153905;Raposos;5300108;Brasília;1;1;2;641
3154101;Recreio;5300108;Brasília;1;1;2;868
3154150;Reduto;5300108;Brasília;1;1;2;808
3154408;Ressaquinha;5300108;Brasília;1;1;2;737
3154705;Ribeirão Vermelho;5300108;Brasília;1;1;2;668
3154804;Rio Acima;5300108;Brasília;1;1;2;652
3155009;Rio Doce;5300108;Brasília;1;1;2;730
3155108;Rio do Prado;5300108;Brasília;1;1;2;794
3155207;Rio Espera;5300108;Brasília;1;1;2;739
3155306;Rio Manso;5300108;Brasília;1;1;2;630
3156007;Rio Vermelho;5300108;Brasília;1;1;2;597
3156106;Ritápolis;5300108;Brasília;1;1;2;697
3156205;Rochedo de Minas;5300108;Brasília;1;1;2;837
3156452;Rosário da Limeira;5300108;Brasília;1;1;2;821
3156502;Rubelita;5300108;Brasília;1;1;2;611
3157252;Santa Bárbara do Leste;5300108;Brasília;1;1;2;778
3157278;Santa Bárbara do Monte Verde;5300108;Brasília;1;1;2;822
3157302;Santa Bárbara do Tugúrio;5300108;Brasília;1;1;2;766
3157336;Santa Cruz de Minas;5300108;Brasília;1;1;2;711
3157377;Santa Cruz de Salinas;5300108;Brasília;1;1;2;663
3157401;Santa Cruz do Escalvado;5300108;Brasília;1;1;2;740
3157609;Santa Fé de Minas;5300108;Brasília;1;1;2;287
3157658;Santa Helena de Minas;5300108;Brasília;1;1;2;789
3158102;Santa Maria do Salto;5300108;Brasília;1;1;2;835
3158409;Santana de Cataguases;5300108;Brasília;1;1;2;842
3158508;Santana de Pirapama;5300108;Brasília;1;1;2;549
3158607;Santana do Deserto;5300108;Brasília;1;1;2;855
3158706;Santana do Garambéu;5300108;Brasília;1;1;2;764
3158904;Santana do Manhuaçu;5300108;Brasília;1;1;2;806
3159100;Santana dos Montes;5300108;Brasília;1;1;2;718
3159308;Santa Rita de Jacutinga;5300108;Brasília;1;1;2;814
3159357;Santa Rita de Minas;5300108;Brasília;1;1;2;772
3159407;Santa Rita de Ibitipoca;5300108;Brasília;1;1;2;772
3159506;Santa Rita do Itueto;5300108;Brasília;1;1;2;810
3159704;Santa Rosa da Serra;5300108;Brasília;1;1;2;463
3160009;Santo Antônio do Aventureiro;5300108;Brasília;1;1;2;862
3160108;Santo Antônio do Grama;5300108;Brasília;1;1;2;762
3160207;Santo Antônio do Itambé;5300108;Brasília;1;1;2;578
3160454;Santo Antônio do Retiro;5300108;Brasília;1;1;2;570
3160504;Santo Antônio do Rio Abaixo;5300108;Brasília;1;1;2;631
3160603;Santo Hipólito;5300108;Brasília;1;1;2;485
3160801;São Bento Abade;5300108;Brasília;1;1;2;710
3160900;São Brás do Suaçuí;5300108;Brasília;1;1;2;684
3160959;São Domingos das Dores;5300108;Brasília;1;1;2;758
3161056;São Félix de Minas;5300108;Brasília;1;1;2;760
3161205;São Francisco de Paula;5300108;Brasília;1;1;2;629
3161304;São Francisco de Sales;5300108;Brasília;1;1;2;491
3161403;São Francisco do Glória;5300108;Brasília;1;1;2;825
3161502;São Geraldo;5300108;Brasília;1;1;2;791
3161601;São Geraldo da Piedade;5300108;Brasília;1;1;2;693
3161650;São Geraldo do Baixio;5300108;Brasília;1;1;2;787
3161809;São Gonçalo do Pará;5300108;Brasília;1;1;2;569
3162203;São João Batista do Glória;5300108;Brasília;1;1;2;556
3162252;São João da Lagoa;5300108;Brasília;1;1;2;401
3162302;São João da Mata;5300108;Brasília;1;1;2;712
3162450;São João das Missões;5300108;Brasília;1;1;2;417
3162559;São João do Manhuaçu;5300108;Brasília;1;1;2;806
3162575;São João do Manteninha;5300108;Brasília;1;1;2;798
3162658;São João do Pacuí;5300108;Brasília;1;1;2;375
3162955;São José da Lapa;5300108;Brasília;1;1;2;607
3163003;São José da Safira;5300108;Brasília;1;1;2;683
3163102;São José da Varginha;5300108;Brasília;1;1;2;565
3163201;São José do Alegre;5300108;Brasília;1;1;2;768
3163300;São José do Divino;5300108;Brasília;1;1;2;764
3163409;São José do Goiabal;5300108;Brasília;1;1;2;726
3163508;São José do Jacuri;5300108;Brasília;1;1;2;629
3163607;São José do Mantimento;5300108;Brasília;1;1;2;812
3163805;São Miguel do Anta;5300108;Brasília;1;1;2;783
3164100;São Pedro do Suaçuí;5300108;Brasília;1;1;2;640
3164308;São Roque de Minas;5300108;Brasília;1;1;2;519
3164431;São Sebastião da Vargem Alegre;5300108;Brasília;1;1;2;815
3164472;São Sebastião do Anta;5300108;Brasília;1;1;2;761
3164506;São Sebastião do Maranhão;5300108;Brasília;1;1;2;629
3164605;São Sebastião do Oeste;5300108;Brasília;1;1;2;587
3164803;São Sebastião do Rio Preto;5300108;Brasília;1;1;2;642
3164902;São Sebastião do Rio Verde;5300108;Brasília;1;1;2;777
3165206;São Thomé das Letras;5300108;Brasília;1;1;2;729
3165503;Sardoá;5300108;Brasília;1;1;2;683
3165537;Sarzedo;5300108;Brasília;1;1;2;622
3165552;Setubinha;5300108;Brasília;1;1;2;644
3165560;Sem-Peixe;5300108;Brasília;1;1;2;728
3165578;Senador Amaral;5300108;Brasília;1;1;2;774
3165602;Senador Cortes;5300108;Brasília;1;1;2;857
3165800;Senador José Bento;5300108;Brasília;1;1;2;729
3165909;Senador Modestino Gonçalves;5300108;Brasília;1;1;2;559
3166006;Senhora de Oliveira;5300108;Brasília;1;1;2;743
3166105;Senhora do Porto;5300108;Brasília;1;1;2;624
3166204;Senhora dos Remédios;5300108;Brasília;1;1;2;746
3166303;Sericita;5300108;Brasília;1;1;2;784
3166402;Seritinga;5300108;Brasília;1;1;2;770
3166501;Serra Azul de Minas;5300108;Brasília;1;1;2;585
3166600;Serra da Saudade;5300108;Brasília;1;1;2;463
3166709;Serra dos Aimorés;5300108;Brasília;1;1;2;855
3166907;Serrania;5300108;Brasília;1;1;2;667
3166956;Serranópolis de Minas;5300108;Brasília;1;1;2;541
3167004;Serranos;5300108;Brasília;1;1;2;766
3167301;Silveirânia;5300108;Brasília;1;1;2;783
3167509;Simão Pereira;5300108;Brasília;1;1;2;847
3167707;Sobrália;5300108;Brasília;1;1;2;733
3167806;Soledade de Minas;5300108;Brasília;1;1;2;760
3167905;Tabuleiro;5300108;Brasília;1;1;2;798
3168051;Taparuba;5300108;Brasília;1;1;2;811
3168101;Tapira;5300108;Brasília;1;1;2;471
3168200;Tapiraí;5300108;Brasília;1;1;2;495
3168309;Taquaraçu de Minas;5300108;Brasília;1;1;2;627
3168804;Tiradentes;5300108;Brasília;1;1;2;714
3168903;Tiros;5300108;Brasília;1;1;2;412
3169059;Tocos do Moji;5300108;Brasília;1;1;2;753
3169109;Toledo;5300108;Brasília;1;1;2;783
3169208;Tombos;5300108;Brasília;1;1;2;854
3169505;Tumiritinga;5300108;Brasília;1;1;2;764
3169802;Turvolândia;5300108;Brasília;1;1;2;711
3170057;Ubaporanga;5300108;Brasília;1;1;2;759
3170305;Umburatiba;5300108;Brasília;1;1;2;803
3170438;União de Minas;5300108;Brasília;1;1;2;488
3170479;Uruana de Minas;5300108;Brasília;1;1;2;181
3170503;Urucânia;5300108;Brasília;1;1;2;754
3170529;Urucuia;5300108;Brasília;1;1;2;237
3170578;Vargem Alegre;5300108;Brasília;1;1;2;738
3170602;Vargem Bonita;5300108;Brasília;1;1;2;532
3170651;Vargem Grande do Rio Pardo;5300108;Brasília;1;1;2;603
3170750;Varjão de MInas;5300108;Brasília;1;1;2;350
3171030;Verdelândia;5300108;Brasília;1;1;2;463
3171071;Veredinha;5300108;Brasília;1;1;2;585
3171105;Veríssimo;5300108;Brasília;1;1;2;429
3171154;Vermelho Novo;5300108;Brasília;1;1;2;771
3171402;Vieiras;5300108;Brasília;1;1;2;831
3171501;Mathias Lobato;5300108;Brasília;1;1;2;719
3171600;Virgem da Lapa;5300108;Brasília;1;1;2;609
3172103;Volta Grande;5300108;Brasília;1;1;2;883
3172202;Wenceslau Braz;5300108;Brasília;1;1;2;794
3200136;Águia Branca;5300108;Brasília;1;1;2;852
3200169;Água Doce do Norte;5300108;Brasília;1;1;2;808
3200359;Alto Rio Novo;5300108;Brasília;1;1;2;828
3200508;Apiacá;5300108;Brasília;1;1;2;908
3200706;Atilio Vivacqua;5300108;Brasília;1;1;2;924
3201100;Bom Jesus do Norte;5300108;Brasília;1;1;2;898
3201803;Divino de São Lourenço;5300108;Brasília;1;1;2;861
3202009;Dores do Rio Preto;5300108;Brasília;1;1;2;856
3202207;Fundão;5300108;Brasília;1;1;2;934
3202256;Governador Lindenberg;5300108;Brasília;1;1;2;892
3202553;Ibitirama;5300108;Brasília;1;1;2;858
3202652;Irupi;5300108;Brasília;1;1;2;846
3203106;Jerônimo Monteiro;5300108;Brasília;1;1;2;898
3203163;Laranja da Terra;5300108;Brasília;1;1;2;871
3203304;Mantenópolis;5300108;Brasília;1;1;2;809
3203601;Mucurici;5300108;Brasília;1;1;2;838
3204252;Ponto Belo;5300108;Brasília;1;1;2;836
3204658;São Domingos do Norte;5300108;Brasília;1;1;2;871
3205150;Vila Pavão;5300108;Brasília;1;1;2;848
3300159;Aperibé;5300108;Brasília;1;1;2;898
3300233;Armação dos Búzios;5300108;Brasília;1;1;2;1008
3301157;Cardoso Moreira;5300108;Brasília;1;1;2;931
3301850;Guapimirim;5300108;Brasília;1;1;2;920
3302304;Laje do Muriaé;5300108;Brasília;1;1;2;869
3305307;São Sebastião do Alto;5300108;Brasília;1;1;2;923
3305901;Trajano de Morais;5300108;Brasília;1;1;2;942
3500204;Adolfo;5300108;Brasília;1;1;2;629
3500758;Alambari;5300108;Brasília;1;1;2;857
3500907;Altair;5300108;Brasília;1;1;2;536
3501152;Alumínio;5300108;Brasília;1;1;2;858
3501806;Américo de Campos;5300108;Brasília;1;1;2;534
3502002;Analândia;5300108;Brasília;1;1;2;700
3502606;Aparecida d'Oeste;5300108;Brasília;1;1;2;608
3503000;Aramina;5300108;Brasília;1;1;2;474
3503109;Arandu;5300108;Brasília;1;1;2;820
3503158;Arapeí;5300108;Brasília;1;1;2;849
3503356;Arco-Íris;5300108;Brasília;1;1;2;716
3503505;Areias;5300108;Brasília;1;1;2;828
3503950;Aspásia;5300108;Brasília;1;1;2;574
3504701;Balbinos;5300108;Brasília;1;1;2;692
3505005;Barão de Antonina;5300108;Brasília;1;1;2;884
3505104;Barbosa;5300108;Brasília;1;1;2;646
3505351;Barra do Chapéu;5300108;Brasília;1;1;2;967
3505401;Barra do Turvo;5300108;Brasília;1;1;2;992
3506201;Bento de Abreu;5300108;Brasília;1;1;2;681
3506706;Boa Esperança do Sul;5300108;Brasília;1;1;2;686
3506904;Bofete;5300108;Brasília;1;1;2;808
3507100;Bom Jesus dos Perdões;5300108;Brasília;1;1;2;826
3507159;Bom Sucesso de Itararé;5300108;Brasília;1;1;2;951
3507209;Borá;5300108;Brasília;1;1;2;770
3507308;Boracéia;5300108;Brasília;1;1;2;713
3507456;Borebi;5300108;Brasília;1;1;2;757
3507704;Braúna;5300108;Brasília;1;1;2;681
3507753;Brejo Alegre;5300108;Brasília;1;1;2;643
3508207;Buritizal;5300108;Brasília;1;1;2;486
3508900;Caiabu;5300108;Brasília;1;1;2;776
3509106;Caiuá;5300108;Brasília;1;1;2;801
3509908;Cananéia;5300108;Brasília;1;1;2;1021
3509957;Canas;5300108;Brasília;1;1;2;825
3510153;Canitar;5300108;Brasília;1;1;2;822
3510906;Cássia dos Coqueiros;5300108;Brasília;1;1;2;611
3511201;Catiguá;5300108;Brasília;1;1;2;593
3511904;Clementina;5300108;Brasília;1;1;2;693
3512100;Colômbia;5300108;Brasília;1;1;2;494
3512605;Coronel Macedo;5300108;Brasília;1;1;2;879
3512902;Cosmorama;5300108;Brasília;1;1;2;555
3513207;Cristais Paulista;5300108;Brasília;1;1;2;511
3513850;Dirce Reis;5300108;Brasília;1;1;2;593
3514007;Dobrada;5300108;Brasília;1;1;2;634
3514205;Dolcinópolis;5300108;Brasília;1;1;2;557
3514304;Dourado;5300108;Brasília;1;1;2;698
3514809;Eldorado;5300108;Brasília;1;1;2;965
3514924;Elisiário;5300108;Brasília;1;1;2;607
3514957;Embaúba;5300108;Brasília;1;1;2;580
3515129;Emilianópolis;5300108;Brasília;1;1;2;771
3515194;Espírito Santo do Turvo;5300108;Brasília;1;1;2;779
3515301;Estrela do Norte;5300108;Brasília;1;1;2;844
3515806;Flora Rica;5300108;Brasília;1;1;2;751
3515905;Floreal;5300108;Brasília;1;1;2;590
3516101;Florínia;5300108;Brasília;1;1;2;842
3516507;Gabriel Monteiro;5300108;Brasília;1;1;2;695
3516606;Gália;5300108;Brasília;1;1;2;739
3516804;Gastão Vidigal;5300108;Brasília;1;1;2;605
3516853;Gavião Peixoto;5300108;Brasília;1;1;2;670
3517208;Guaiçara;5300108;Brasília;1;1;2;675
3517307;Guaimbê;5300108;Brasília;1;1;2;709
3517901;Guaraci;5300108;Brasília;1;1;2;531
3518008;Guarani d'Oeste;5300108;Brasília;1;1;2;541
3518859;Guatapará;5300108;Brasília;1;1;2;630
3518909;Guzolândia;5300108;Brasília;1;1;2;613
3519204;Iacri;5300108;Brasília;1;1;2;734
3520426;Ilha Comprida;5300108;Brasília;1;1;2;990
3520608;Indiana;5300108;Brasília;1;1;2;793
3521150;Ipiguá;5300108;Brasília;1;1;2;559
3521200;Iporanga;5300108;Brasília;1;1;2;974
3521606;Irapuru;5300108;Brasília;1;1;2;739
3522158;Itaóca;5300108;Brasília;1;1;2;983
3522653;Itapirapuã Paulista;5300108;Brasília;1;1;2;980
3523008;Itapura;5300108;Brasília;1;1;2;662
3523305;Itariri;5300108;Brasília;1;1;2;942
3523800;Itobi;5300108;Brasília;1;1;2;664
3524204;Jaborandi;5300108;Brasília;1;1;2;543
3526209;Juquitiba;5300108;Brasília;1;1;2;904
3526506;Lavínia;5300108;Brasília;1;1;2;683
3526605;Lavrinhas;5300108;Brasília;1;1;2;818
3527009;Lindóia;5300108;Brasília;1;1;2;754
3527256;Lourdes;5300108;Brasília;1;1;2;623
3527702;Luiziânia;5300108;Brasília;1;1;2;700
3527900;Lutécia;5300108;Brasília;1;1;2;771
3528205;Macedônia;5300108;Brasília;1;1;2;539
3528304;Magda;5300108;Brasília;1;1;2;591
3529104;Marinópolis;5300108;Brasília;1;1;2;605
3529500;Mendonça;5300108;Brasília;1;1;2;620
3529609;Meridiano;5300108;Brasília;1;1;2;560
3529658;Mesópolis;5300108;Brasília;1;1;2;546
3530003;Mira Estrela;5300108;Brasília;1;1;2;520
3530409;Mirassolândia;5300108;Brasília;1;1;2;557
3530904;Mombuca;5300108;Brasília;1;1;2;789
3531209;Monte Alegre do Sul;5300108;Brasília;1;1;2;773
3531605;Monte Castelo;5300108;Brasília;1;1;2;726
3532058;Motuca;5300108;Brasília;1;1;2;631
3532108;Murutinga do Sul;5300108;Brasília;1;1;2;680
3532157;Nantes;5300108;Brasília;1;1;2;836
3532207;Narandiba;5300108;Brasília;1;1;2;829
3532306;Natividade da Serra;5300108;Brasília;1;1;2;881
3532405;Nazaré Paulista;5300108;Brasília;1;1;2;833
3532827;Nova Campina;5300108;Brasília;1;1;2;926
3532843;Nova Canaã Paulista;5300108;Brasília;1;1;2;604
3532868;Nova Castilho;5300108;Brasília;1;1;2;608
3533205;Nova Independência;5300108;Brasília;1;1;2;703
3533254;Novais;5300108;Brasília;1;1;2;584
3533304;Nova Luzitânia;5300108;Brasília;1;1;2;616
3533809;Óleo;5300108;Brasília;1;1;2;805
3534203;Orindiúva;5300108;Brasília;1;1;2;508
3534500;Oscar Bressane;5300108;Brasília;1;1;2;765
3534807;Ouro Verde;5300108;Brasília;1;1;2;753
3535101;Palmares Paulista;5300108;Brasília;1;1;2;592
3535903;Paranapuã;5300108;Brasília;1;1;2;558
3536109;Pardinho;5300108;Brasília;1;1;2;806
3536257;Parisi;5300108;Brasília;1;1;2;548
3536406;Paulicéia;5300108;Brasília;1;1;2;743
3536570;Paulistânia;5300108;Brasília;1;1;2;766
3536802;Pedra Bela;5300108;Brasília;1;1;2;790
3536901;Pedranópolis;5300108;Brasília;1;1;2;546
3540259;Pontalinda;5300108;Brasília;1;1;2;585
3540309;Pontes Gestal;5300108;Brasília;1;1;2;521
3540408;Populina;5300108;Brasília;1;1;2;539
3540507;Porangaba;5300108;Brasília;1;1;2;816
3540754;Potim;5300108;Brasília;1;1;2;828
3540853;Pracinha;5300108;Brasília;1;1;2;752
3541059;Pratânia;5300108;Brasília;1;1;2;779
3541109;Presidente Alves;5300108;Brasília;1;1;2;716
3541653;Quadra;5300108;Brasília;1;1;2;829
3541802;Queiroz;5300108;Brasília;1;1;2;709
3541901;Queluz;5300108;Brasília;1;1;2;819
3542107;Rafard;5300108;Brasília;1;1;2;798
3542701;Restinga;5300108;Brasília;1;1;2;533
3542800;Ribeira;5300108;Brasília;1;1;2;987
3543204;Ribeirão do Sul;5300108;Brasília;1;1;2;803
3543253;Ribeirão Grande;5300108;Brasília;1;1;2;919
3543501;Riversul;5300108;Brasília;1;1;2;903
3543600;Rifaina;5300108;Brasília;1;1;2;478
3544202;Riolândia;5300108;Brasília;1;1;2;500
3544509;Rubinéia;5300108;Brasília;1;1;2;587
3544806;Sales;5300108;Brasília;1;1;2;635
3545001;Salesópolis;5300108;Brasília;1;1;2;885
3545506;Sandovalina;5300108;Brasília;1;1;2;847
3545704;Santa Albertina;5300108;Brasília;1;1;2;557
3546256;Santa Cruz da Esperança;5300108;Brasília;1;1;2;609
3546900;Santa Lúcia;5300108;Brasília;1;1;2;651
3547007;Santa Maria da Serra;5300108;Brasília;1;1;2;748
3547106;Santa Mercedes;5300108;Brasília;1;1;2;742
3547205;Santana da Ponte Pensa;5300108;Brasília;1;1;2;582
3547403;Santa Rita d'Oeste;5300108;Brasília;1;1;2;574
3547908;Santo Antônio da Alegria;5300108;Brasília;1;1;2;590
3548104;Santo Antônio do Jardim;5300108;Brasília;1;1;2;711
3548302;Santo Expedito;5300108;Brasília;1;1;2;768
3548401;Santópolis do Aguapeí;5300108;Brasília;1;1;2;704
3549003;São Francisco;5300108;Brasília;1;1;2;589
3549201;São João das Duas Pontes;5300108;Brasília;1;1;2;573
3549250;São João de Iracema;5300108;Brasília;1;1;2;583
3550506;São Pedro do Turvo;5300108;Brasília;1;1;2;793
3552007;Silveiras;5300108;Brasília;1;1;2;830
3552551;Suzanápolis;5300108;Brasília;1;1;2;619
3552908;Taciba;5300108;Brasília;1;1;2;816
3553005;Taguaí;5300108;Brasília;1;1;2;862
3553104;Taiaçu;5300108;Brasília;1;1;2;594
3553500;Tapiraí;5300108;Brasília;1;1;2;904
3553856;Taquarivaí;5300108;Brasília;1;1;2;902
3553906;Tarabai;5300108;Brasília;1;1;2;824
3554201;Tejupá;5300108;Brasília;1;1;2;849
3554409;Terra Roxa;5300108;Brasília;1;1;2;553
3554656;Torre de Pedra;5300108;Brasília;1;1;2;824
3554755;Trabiju;5300108;Brasília;1;1;2;691
3554953;Tuiuti;5300108;Brasília;1;1;2;787
3555208;Turiúba;5300108;Brasília;1;1;2;615
3555307;Turmalina;5300108;Brasília;1;1;2;549
3555356;Ubarana;5300108;Brasília;1;1;2;624
3555703;União Paulista;5300108;Brasília;1;1;2;602
3555901;Uru;5300108;Brasília;1;1;2;678
3556958;Vitória Brasil;5300108;Brasília;1;1;2;563
3557154;Zacarias;5300108;Brasília;1;1;2;625
4100202;Adrianópolis;5300108;Brasília;1;1;2;989
4100301;Agudos do Sul;5300108;Brasília;1;1;2;1138
4100459;Altamira do Paraná;5300108;Brasília;1;1;2;1126
4100905;Amaporã;5300108;Brasília;1;1;2;966
4101051;Anahy;5300108;Brasília;1;1;2;1134
4101150;Ângulo;5300108;Brasília;1;1;2;927
4101309;Antônio Olinto;5300108;Brasília;1;1;2;1154
4101655;Arapuã;5300108;Brasília;1;1;2;1033
4101853;Ariranha do Ivaí;5300108;Brasília;1;1;2;1031
4102208;Atalaia;5300108;Brasília;1;1;2;930
4102604;Barracão;5300108;Brasília;1;1;2;1315
4102703;Barra do Jacaré;5300108;Brasília;1;1;2;846
4102752;Bela Vista da Caroba;5300108;Brasília;1;1;2;1283
4103040;Boa Ventura de São Roque;5300108;Brasília;1;1;2;1083
4103057;Boa Vista da Aparecida;5300108;Brasília;1;1;2;1225
4103156;Bom Jesus do Sul;5300108;Brasília;1;1;2;1310
4103206;Bom Sucesso;5300108;Brasília;1;1;2;971
4103354;Braganey;5300108;Brasília;1;1;2;1149
4103370;Brasilândia do Sul;5300108;Brasília;1;1;2;1114
4103404;Cafeara;5300108;Brasília;1;1;2;877
4103479;Cafezal do Sul;5300108;Brasília;1;1;2;1088
4103503;Califórnia;5300108;Brasília;1;1;2;946
4103800;Cambira;5300108;Brasília;1;1;2;950
4104055;Campo Bonito;5300108;Brasília;1;1;2;1163
4104105;Campo do Tenente;5300108;Brasília;1;1;2;1142
4106001;Congonhinhas;5300108;Brasília;1;1;2;904
4106100;Conselheiro Mairinck;5300108;Brasília;1;1;2;900
4106555;Corumbataí do Sul;5300108;Brasília;1;1;2;1027
4106704;Cruzeiro do Sul;5300108;Brasília;1;1;2;917
4106852;Cruzmaltina;5300108;Brasília;1;1;2;988
4107108;Diamante do Norte;5300108;Brasília;1;1;2;930
4107157;Diamante d'Oeste;5300108;Brasília;1;1;2;1219
4107256;Douradina;5300108;Brasília;1;1;2;1024
4107306;Doutor Camargo;5300108;Brasília;1;1;2;978
4107405;Enéas Marques;5300108;Brasília;1;1;2;1262
4107546;Espigão Alto do Iguaçu;5300108;Brasília;1;1;2;1194
4107702;Fênix;5300108;Brasília;1;1;2;1002
4107736;Fernandes Pinheiro;5300108;Brasília;1;1;2;1102
4107751;Figueira;5300108;Brasília;1;1;2;931
4107801;Floraí;5300108;Brasília;1;1;2;959
4107850;Flor da Serra do Sul;5300108;Brasília;1;1;2;1296
4107900;Floresta;5300108;Brasília;1;1;2;975
4108106;Flórida;5300108;Brasília;1;1;2;918
4108320;Francisco Alves;5300108;Brasília;1;1;2;1122
4108551;Godoy Moreira;5300108;Brasília;1;1;2;1025
4108650;Goioxim;5300108;Brasília;1;1;2;1132
4108908;Guairaçá;5300108;Brasília;1;1;2;945
4108957;Guamiranga;5300108;Brasília;1;1;2;1086
4109005;Guapirama;5300108;Brasília;1;1;2;884
4109104;Guaporema;5300108;Brasília;1;1;2;989
4109203;Guaraci;5300108;Brasília;1;1;2;892
4109500;Guaraqueçaba;5300108;Brasília;1;1;2;1052
4109658;Honório Serpa;5300108;Brasília;1;1;2;1246
4109757;Ibema;5300108;Brasília;1;1;2;1172
4110052;Iguatu;5300108;Brasília;1;1;2;1138
4110300;Inajá;5300108;Brasília;1;1;2;899
4110409;Indianópolis;5300108;Brasília;1;1;2;997
4110656;Iracema do Oeste;5300108;Brasília;1;1;2;1125
4110904;Itaguajé;5300108;Brasília;1;1;2;873
4111001;Itambaracá;5300108;Brasília;1;1;2;843
4111258;Itaperuçu;5300108;Brasília;1;1;2;1054
4111308;Itaúna do Sul;5300108;Brasília;1;1;2;939
4111555;Ivaté;5300108;Brasília;1;1;2;1031
4111605;Ivatuba;5300108;Brasília;1;1;2;984
4111704;Jaboti;5300108;Brasília;1;1;2;909
4112306;Japira;5300108;Brasília;1;1;2;919
4112603;Jardim Olinda;5300108;Brasília;1;1;2;874
4112900;Jundiaí do Sul;5300108;Brasília;1;1;2;882
4113007;Jussara;5300108;Brasília;1;1;2;998
4113106;Kaloré;5300108;Brasília;1;1;2;977
4113254;Laranjal;5300108;Brasília;1;1;2;1123
4113403;Leópolis;5300108;Brasília;1;1;2;862
4113429;Lidianópolis;5300108;Brasília;1;1;2;1006
4113452;Lindoeste;5300108;Brasília;1;1;2;1218
4113734;Luiziana;5300108;Brasília;1;1;2;1053
4113759;Lunardelli;5300108;Brasília;1;1;2;1007
4114351;Manfrinópolis;5300108;Brasília;1;1;2;1290
4114708;Maria Helena;5300108;Brasília;1;1;2;1040
4115002;Marilena;5300108;Brasília;1;1;2;949
4115457;Marquinho;5300108;Brasília;1;1;2;1135
4115507;Marumbi;5300108;Brasília;1;1;2;964
4115739;Mato Rico;5300108;Brasília;1;1;2;1089
4115754;Mauá da Serra;5300108;Brasília;1;1;2;966
4115853;Mercedes;5300108;Brasília;1;1;2;1177
4115903;Mirador;5300108;Brasília;1;1;2;981
4116000;Miraselva;5300108;Brasília;1;1;2;883
4116307;Munhoz de Melo;5300108;Brasília;1;1;2;915
4116406;Nossa Senhora das Graças;5300108;Brasília;1;1;2;893
4116505;Nova Aliança do Ivaí;5300108;Brasília;1;1;2;963
4116604;Nova América da Colina;5300108;Brasília;1;1;2;887
4117008;Nova Fátima;5300108;Brasília;1;1;2;892
4117206;Nova Olímpia;5300108;Brasília;1;1;2;1020
4117214;Nova Santa Bárbara;5300108;Brasília;1;1;2;915
4117271;Nova Tebas;5300108;Brasília;1;1;2;1052
4117297;Novo Itacolomi;5300108;Brasília;1;1;2;964
4117404;Ourizona;5300108;Brasília;1;1;2;962
4117453;Ouro Verde do Oeste;5300108;Brasília;1;1;2;1194
4118303;Paranapoema;5300108;Brasília;1;1;2;882
4118451;Pato Bragado;5300108;Brasília;1;1;2;1197
4118600;Paula Freitas;5300108;Brasília;1;1;2;1198
4118709;Paulo Frontin;5300108;Brasília;1;1;2;1177
4118857;Perobal;5300108;Brasília;1;1;2;1079
4119004;Pérola d'Oeste;5300108;Brasília;1;1;2;1281
4119202;Pinhalão;5300108;Brasília;1;1;2;914
4119251;Pinhal de São Bento;5300108;Brasília;1;1;2;1287
4119657;Pitangueiras;5300108;Brasília;1;1;2;914
4119707;Planaltina do Paraná;5300108;Brasília;1;1;2;966
4120101;Porto Amazonas;5300108;Brasília;1;1;2;1099
4120309;Porto Vitória;5300108;Brasília;1;1;2;1203
4120333;Prado Ferreira;5300108;Brasília;1;1;2;888
4120358;Pranchita;5300108;Brasília;1;1;2;1300
4120408;Presidente Castelo Branco;5300108;Brasília;1;1;2;947
4120655;Quarto Centenário;5300108;Brasília;1;1;2;1095
4120705;Quatiguá;5300108;Brasília;1;1;2;886
4121109;Quinta do Sol;5300108;Brasília;1;1;2;1003
4121257;Ramilândia;5300108;Brasília;1;1;2;1230
4121307;Rancho Alegre;5300108;Brasília;1;1;2;868
4121356;Rancho Alegre d'Oeste;5300108;Brasília;1;1;2;1091
4121604;Renascença;5300108;Brasília;1;1;2;1274
4122107;Rio Bom;5300108;Brasília;1;1;2;960
4122651;Rosário do Ivaí;5300108;Brasília;1;1;2;1007
4122701;Sabáudia;5300108;Brasília;1;1;2;921
4122800;Salgado Filho;5300108;Brasília;1;1;2;1295
4122909;Salto do Itararé;5300108;Brasília;1;1;2;883
4123105;Santa Amélia;5300108;Brasília;1;1;2;870
4123600;Santa Inês;5300108;Brasília;1;1;2;872
4123824;Santa Lúcia;5300108;Brasília;1;1;2;1231
4123956;Santa Mônica;5300108;Brasília;1;1;2;987
4124004;Santana do Itararé;5300108;Brasília;1;1;2;899
4124202;Santo Antônio do Caiuá;5300108;Brasília;1;1;2;906
4124301;Santo Antônio do Paraíso;5300108;Brasília;1;1;2;901
4124608;São Carlos do Ivaí;5300108;Brasília;1;1;2;969
4124905;São João do Caiuá;5300108;Brasília;1;1;2;916
4125407;São José da Boa Vista;5300108;Brasília;1;1;2;917
4125555;São Manoel do Paraná;5300108;Brasília;1;1;2;987
4125902;São Pedro do Paraná;5300108;Brasília;1;1;2;969
4126009;São Sebastião da Amoreira;5300108;Brasília;1;1;2;903
4126108;São Tomé;5300108;Brasília;1;1;2;997
4126207;Sapopema;5300108;Brasília;1;1;2;943
4126272;Saudade do Iguaçu;5300108;Brasília;1;1;2;1211
4126652;Sulina;5300108;Brasília;1;1;2;1216
4126702;Tamboara;5300108;Brasília;1;1;2;957
4126900;Tapira;5300108;Brasília;1;1;2;1004
4127882;Tunas do Paraná;5300108;Brasília;1;1;2;1023
4128302;Uniflor;5300108;Brasília;1;1;2;929
4128534;Ventania;5300108;Brasília;1;1;2;968
4128625;Alto Paraíso;5300108;Brasília;1;1;2;1063
4128633;Doutor Ulysses;5300108;Brasília;1;1;2;983
4128658;Virmond;5300108;Brasília;1;1;2;1160
4128708;Vitorino;5300108;Brasília;1;1;2;1277
4128807;Xambrê;5300108;Brasília;1;1;2;1069
4200754;Alto Bela Vista;5300108;Brasília;1;1;2;1362
4201273;Arabutã;5300108;Brasília;1;1;2;1341
4201653;Arvoredo;5300108;Brasília;1;1;2;1345
4201950;Balneário Arroio do Silva;5300108;Brasília;1;1;2;1465
4202081;Bandeirante;5300108;Brasília;1;1;2;1369
4202099;Barra Bonita;5300108;Brasília;1;1;2;1347
4202156;Belmonte;5300108;Brasília;1;1;2;1374
4202438;Bocaina do Sul;5300108;Brasília;1;1;2;1340
4202453;Bombinhas;5300108;Brasília;1;1;2;1257
4202537;Bom Jesus;5300108;Brasília;1;1;2;1308
4202578;Bom Jesus do Oeste;5300108;Brasília;1;1;2;1334
4202859;Braço do Trombudo;5300108;Brasília;1;1;2;1297
4204350;Cordilheira Alta;5300108;Brasília;1;1;2;1343
4205175;Entre Rios;5300108;Brasília;1;1;2;1314
4205357;Flor do Sertão;5300108;Brasília;1;1;2;1355
4206751;Ibiam;5300108;Brasília;1;1;2;1312
4207577;Iomerê;5300108;Brasília;1;1;2;1293
4210050;Macieira;5300108;Brasília;1;1;2;1282
4211652;Novo Horizonte;5300108;Brasília;1;1;2;1297
4211850;Ouro Verde;5300108;Brasília;1;1;2;1299
4212056;Palmeira;5300108;Brasília;1;1;2;1327
4213153;Planalto Alegre;5300108;Brasília;1;1;2;1363
4214151;Princesa;5300108;Brasília;1;1;2;1334
4215059;Rio Rufino;5300108;Brasília;1;1;2;1350
4215356;Saltinho;5300108;Brasília;1;1;2;1324
4215455;Sangão;5300108;Brasília;1;1;2;1427
4215554;Santa Helena;5300108;Brasília;1;1;2;1384
4215679;Santa Terezinha;5300108;Brasília;1;1;2;1236
4215695;Santiago do Sul;5300108;Brasília;1;1;2;1310
4216354;São João do Itaperiú;5300108;Brasília;1;1;2;1201
4217253;São Pedro de Alcântara;5300108;Brasília;1;1;2;1305
4217758;Sul Brasil;5300108;Brasília;1;1;2;1332
4219150;Vargem;5300108;Brasília;1;1;2;1337
4219176;Vargem Bonita;5300108;Brasília;1;1;2;1310
4219853;Zortéa;5300108;Brasília;1;1;2;1351
4300034;Aceguá;5300108;Brasília;1;1;2;1912
4300455;Alegria;5300108;Brasília;1;1;2;1495
4300554;Alto Alegre;5300108;Brasília;1;1;2;1543
4300570;Alto Feliz;5300108;Brasília;1;1;2;1550
4300638;Amaral Ferrador;5300108;Brasília;1;1;2;1738
4300646;Ametista do Sul;5300108;Brasília;1;1;2;1406
4300661;André da Rocha;5300108;Brasília;1;1;2;1477
4300703;Anta Gorda;5300108;Brasília;1;1;2;1527
4300851;Arambaré;5300108;Brasília;1;1;2;1721
4300877;Araricá;5300108;Brasília;1;1;2;1565
4301057;Arroio do Sal;5300108;Brasília;1;1;2;1536
4301636;Balneário Pinhal;5300108;Brasília;1;1;2;1619
4301651;Barão;5300108;Brasília;1;1;2;1555
4301701;Barão de Cotegipe;5300108;Brasília;1;1;2;1398
4301750;Barão do Triunfo;5300108;Brasília;1;1;2;1670
4301859;Barra do Guarita;5300108;Brasília;1;1;2;1416
4301875;Barra do Quaraí;5300108;Brasília;1;1;2;1926
4301958;Barra Funda;5300108;Brasília;1;1;2;1457
4302154;Boa Vista das Missões;5300108;Brasília;1;1;2;1444
4302253;Boa Vista do Sul;5300108;Brasília;1;1;2;1557
4302584;Bozano;5300108;Brasília;1;1;2;1536
4302600;Braga;5300108;Brasília;1;1;2;1458
4303202;Cacique Doble;5300108;Brasília;1;1;2;1388
4303400;Caiçara;5300108;Brasília;1;1;2;1409
4303558;Camargo;5300108;Brasília;1;1;2;1493
4303608;Cambará do Sul;5300108;Brasília;1;1;2;1487
4304101;Campos Borges;5300108;Brasília;1;1;2;1555
4304713;Caraá;5300108;Brasília;1;1;2;1573
4304952;Caseiros;5300108;Brasília;1;1;2;1442
4305116;Centenário;5300108;Brasília;1;1;2;1399
4305132;Cerro Branco;5300108;Brasília;1;1;2;1634
4305157;Cerro Grande;5300108;Brasília;1;1;2;1430
4305371;Charrua;5300108;Brasília;1;1;2;1419
4305405;Chiapetta;5300108;Brasília;1;1;2;1499
4305504;Ciríaco;5300108;Brasília;1;1;2;1456
4305587;Colinas;5300108;Brasília;1;1;2;1567
4305871;Coronel Barros;5300108;Brasília;1;1;2;1551
4305959;Cotiporã;5300108;Brasília;1;1;2;1519
4305975;Coxilha;5300108;Brasília;1;1;2;1448
4306320;Derrubadas;5300108;Brasília;1;1;2;1429
4306379;Dilermando de Aguiar;5300108;Brasília;1;1;2;1692
4306551;Dom Pedro de Alcântara;5300108;Brasília;1;1;2;1517
4306700;Dona Francisca;5300108;Brasília;1;1;2;1646
4306759;Doutor Ricardo;5300108;Brasília;1;1;2;1539
4306957;Entre Rios do Sul;5300108;Brasília;1;1;2;1403
4306973;Erebango;5300108;Brasília;1;1;2;1420
4307054;Ernestina;5300108;Brasília;1;1;2;1498
4307104;Herval;5300108;Brasília;1;1;2;1899
4307203;Erval Grande;5300108;Brasília;1;1;2;1382
4307450;Esperança do Sul;5300108;Brasília;1;1;2;1445
4307559;Estação;5300108;Brasília;1;1;2;1424
4307831;Eugênio de Castro;5300108;Brasília;1;1;2;1570
4308078;Fazenda Vilanova;5300108;Brasília;1;1;2;1587
4308656;Garruchos;5300108;Brasília;1;1;2;1617
4308854;Gentil;5300108;Brasília;1;1;2;1471
4309050;Glorinha;5300108;Brasília;1;1;2;1590
4309159;Gramado Xavier;5300108;Brasília;1;1;2;1578
4309258;Guabiju;5300108;Brasília;1;1;2;1471
4309506;Guarani das Missões;5300108;Brasília;1;1;2;1552
4309555;Harmonia;5300108;Brasília;1;1;2;1571
4309654;Hulha Negra;5300108;Brasília;1;1;2;1852
4309704;Humaitá;5300108;Brasília;1;1;2;1465
4309753;Ibarama;5300108;Brasília;1;1;2;1616
4309951;Ibirapuitã;5300108;Brasília;1;1;2;1508
4310363;Imigrante;5300108;Brasília;1;1;2;1561
4310538;Itaara;5300108;Brasília;1;1;2;1662
4310553;Itacurubi;5300108;Brasília;1;1;2;1653
4310702;Itatiba do Sul;5300108;Brasília;1;1;2;1377
4310850;Jaboticaba;5300108;Brasília;1;1;2;1438
4310900;Jacutinga;5300108;Brasília;1;1;2;1416
4311155;Jóia;5300108;Brasília;1;1;2;1581
4311254;Lagoão;5300108;Brasília;1;1;2;1583
4311270;Lagoa dos Três Cantos;5300108;Brasília;1;1;2;1516
4311429;Lajeado do Bugre;5300108;Brasília;1;1;2;1439
4311601;Liberato Salzano;5300108;Brasília;1;1;2;1425
4311627;Lindolfo Collor;5300108;Brasília;1;1;2;1571
4311643;Linha Nova;5300108;Brasília;1;1;2;1556
4311718;Maçambara;5300108;Brasília;1;1;2;1732
4311734;Mampituba;5300108;Brasília;1;1;2;1501
4311759;Manoel Viana;5300108;Brasília;1;1;2;1742
4311775;Maquiné;5300108;Brasília;1;1;2;1556
4311791;Maratá;5300108;Brasília;1;1;2;1575
4311981;Mariana Pimentel;5300108;Brasília;1;1;2;1662
4312005;Mariano Moro;5300108;Brasília;1;1;2;1361
4312054;Marques de Souza;5300108;Brasília;1;1;2;1568
4312153;Mato Leitão;5300108;Brasília;1;1;2;1590
4312252;Minas do Leão;5300108;Brasília;1;1;2;1652
4312302;Miraguaí;5300108;Brasília;1;1;2;1445
4312351;Montauri;5300108;Brasília;1;1;2;1495
4312443;Morrinhos do Sul;5300108;Brasília;1;1;2;1518
4312450;Morro Redondo;5300108;Brasília;1;1;2;1826
4312476;Morro Reuter;5300108;Brasília;1;1;2;1561
4312617;Muitos Capões;5300108;Brasília;1;1;2;1431
4312807;Nova Araçá;5300108;Brasília;1;1;2;1485
4312955;Nova Boa Vista;5300108;Brasília;1;1;2;1462
4313334;Nova Ramada;5300108;Brasília;1;1;2;1501
4313391;Novo Cabrais;5300108;Brasília;1;1;2;1643
4313425;Novo Machado;5300108;Brasília;1;1;2;1494
4313441;Novo Tiradentes;5300108;Brasília;1;1;2;1426
4313466;Novo Xingu;5300108;Brasília;1;1;2;1440
4313490;Novo Barreiro;5300108;Brasília;1;1;2;1458
4313607;Paim Filho;5300108;Brasília;1;1;2;1385
4314035;Pareci Novo;5300108;Brasília;1;1;2;1579
4314068;Passa Sete;5300108;Brasília;1;1;2;1612
4314456;Pinhal;5300108;Brasília;1;1;2;1423
4314498;Pinheirinho do Vale;5300108;Brasília;1;1;2;1411
4314753;Poço das Antas;5300108;Brasília;1;1;2;1567
4314779;Pontão;5300108;Brasília;1;1;2;1456
4315008;Porto Lucena;5300108;Brasília;1;1;2;1550
4315057;Porto Mauá;5300108;Brasília;1;1;2;1503
4315149;Presidente Lucena;5300108;Brasília;1;1;2;1561
4315172;Protásio Alves;5300108;Brasília;1;1;2;1487
4315206;Putinga;5300108;Brasília;1;1;2;1535
4315354;Quinze de Novembro;5300108;Brasília;1;1;2;1544
4315552;Rio dos Índios;5300108;Brasília;1;1;2;1384
4315750;Riozinho;5300108;Brasília;1;1;2;1558
4315909;Rodeio Bonito;5300108;Brasília;1;1;2;1416
4316428;Sagrada Família;5300108;Brasília;1;1;2;1439
4316956;Santa Maria do Herval;5300108;Brasília;1;1;2;1554
4317251;Santa Tereza;5300108;Brasília;1;1;2;1539
4317707;Santo Antônio das Missões;5300108;Brasília;1;1;2;1625
4317954;Santo Expedito do Sul;5300108;Brasília;1;1;2;1402
4318051;São Domingos do Sul;5300108;Brasília;1;1;2;1476
4318424;São João da Urtiga;5300108;Brasília;1;1;2;1399
4318432;São João do Polêsine;5300108;Brasília;1;1;2;1649
4318457;São José das Missões;5300108;Brasília;1;1;2;1446
4318481;São José do Hortêncio;5300108;Brasília;1;1;2;1564
4318499;São José do Inhacorá;5300108;Brasília;1;1;2;1489
4318614;São José do Sul;5300108;Brasília;1;1;2;1571
4319125;São Martinho da Serra;5300108;Brasília;1;1;2;1659
4319307;São Paulo das Missões;5300108;Brasília;1;1;2;1561
4319356;São Pedro da Serra;5300108;Brasília;1;1;2;1560
4319372;São Pedro do Butiá;5300108;Brasília;1;1;2;1568
4319711;São Valentim do Sul;5300108;Brasília;1;1;2;1527
4319752;São Vendelino;5300108;Brasília;1;1;2;1550
4320230;Sede Nova;5300108;Brasília;1;1;2;1470
4320263;Segredo;5300108;Brasília;1;1;2;1595
4320354;Sentinela do Sul;5300108;Brasília;1;1;2;1690
4320651;Silveira Martins;5300108;Brasília;1;1;2;1658
4320859;Tabaí;5300108;Brasília;1;1;2;1589
4321329;Taquaruçu do Sul;5300108;Brasília;1;1;2;1423
4321352;Tavares;5300108;Brasília;1;1;2;1751
4321469;Tio Hugo;5300108;Brasília;1;1;2;1507
4321477;Tiradentes do Sul;5300108;Brasília;1;1;2;1454
4321493;Toropi;5300108;Brasília;1;1;2;1670
4321626;Travesseiro;5300108;Brasília;1;1;2;1563
4321634;Três Arroios;5300108;Brasília;1;1;2;1377
4321832;Três Forquilhas;5300108;Brasília;1;1;2;1537
4321956;Trindade do Sul;5300108;Brasília;1;1;2;1409
4322152;Tunas;5300108;Brasília;1;1;2;1576
4322525;Vale Verde;5300108;Brasília;1;1;2;1620
4322541;Vale Real;5300108;Brasília;1;1;2;1549
4322855;Vespasiano Correa;5300108;Brasília;1;1;2;1532
4323101;Vicente Dutra;5300108;Brasília;1;1;2;1396
4323309;Vila Flores;5300108;Brasília;1;1;2;1500
4323358;Vila Lângaro;5300108;Brasília;1;1;2;1440
4323507;Vista Alegre;5300108;Brasília;1;1;2;1422
4323606;Vista Alegre do Prata;5300108;Brasília;1;1;2;1503
4323754;Vitória das Missões;5300108;Brasília;1;1;2;1570
4323804;Xangri-lá;5300108;Brasília;1;1;2;1567
5000252;Alcinópolis;5300108;Brasília;1;1;2;683
5002803;Caracol;5300108;Brasília;1;1;2;1207
5003108;Corguinho;5300108;Brasília;1;1;2;875
5003157;Coronel Sapucaia;5300108;Brasília;1;1;2;1173
5004809;Japorã;5300108;Brasília;1;1;2;1143
5004908;Jaraguari;5300108;Brasília;1;1;2;850
5006259;Novo Horizonte do Sul;5300108;Brasília;1;1;2;999
5007505;Rochedo;5300108;Brasília;1;1;2;885
5007976;Taquarussu;5300108;Brasília;1;1;2;947
5100102;Acorizal;5300108;Brasília;1;1;2;904
5100359;Alto Boa Vista;5300108;Brasília;1;1;2;587
5101001;Araguaiana;5300108;Brasília;1;1;2;425
5101209;Araguainha;5300108;Brasília;1;1;2;562
5101605;Barão de Melgaço;5300108;Brasília;1;1;2;865
5101852;Bom Jesus do Araguaia;5300108;Brasília;1;1;2;553
5102694;CanaBrava do Norte;5300108;Brasília;1;1;2;670
5102793;Carlinda;5300108;Brasília;1;1;2;1058
5102850;Castanheira;5300108;Brasília;1;1;2;1252
5103106;Cocalinho;5300108;Brasília;1;1;2;363
5103809;Figueirópolis d'Oeste;5300108;Brasília;1;1;2;1159
5103908;General Carneiro;5300108;Brasília;1;1;2;520
5104500;Indiavaí;5300108;Brasília;1;1;2;1140
5104906;Jangada;5300108;Brasília;1;1;2;919
5105176;Juruena;5300108;Brasília;1;1;2;1262
5105309;Luciára;5300108;Brasília;1;1;2;588
5106109;Nossa Senhora do Livramento;5300108;Brasília;1;1;2;906
5106158;Nova Bandeirantes;5300108;Brasília;1;1;2;1244
5106174;Nova Nazaré;5300108;Brasília;1;1;2;460
5106182;Nova Lacerda;5300108;Brasília;1;1;2;1257
5106208;Nova Brasilândia;5300108;Brasília;1;1;2;759
5106265;Novo Mundo;5300108;Brasília;1;1;2;1006
5106273;Novo Horizonte do Norte;5300108;Brasília;1;1;2;1110
5106653;Pontal do Araguaia;5300108;Brasília;1;1;2;474
5106703;Ponte Branca;5300108;Brasília;1;1;2;541
5106778;Porto Alegre do Norte;5300108;Brasília;1;1;2;671
5106851;Porto Estrela;5300108;Brasília;1;1;2;996
5107156;Reserva do Cabaçal;5300108;Brasília;1;1;2;1131
5107248;Santa Carmem;5300108;Brasília;1;1;2;888
5107354;São José do Xingu;5300108;Brasília;1;1;2;753
5107743;Santa Cruz do Xingu;5300108;Brasília;1;1;2;785
5107750;Salto do Céu;5300108;Brasília;1;1;2;1095
5107776;Santa Terezinha;5300108;Brasília;1;1;2;651
5108105;Tesouro;5300108;Brasília;1;1;2;610
5108303;União do Sul;5300108;Brasília;1;1;2;830
5108808;Nova Guarita;5300108;Brasília;1;1;2;999
5200050;Abadia de Goiás;5300108;Brasília;1;1;2;193
5200159;Adelândia;5300108;Brasília;1;1;2;251
5200175;Água Fria de Goiás;5300108;Brasília;1;1;2;92
5200209;Água Limpa;5300108;Brasília;1;1;2;266
5200506;Aloândia;5300108;Brasília;1;1;2;270
5200829;Amaralina;5300108;Brasília;1;1;2;255
5200852;Americano do Brasil;5300108;Brasília;1;1;2;226
5200902;Amorinópolis;5300108;Brasília;1;1;2;352
5201207;Anhanguera;5300108;Brasília;1;1;2;280
5201603;Araçu;5300108;Brasília;1;1;2;198
5201702;Aragarças;5300108;Brasília;1;1;2;465
5201801;Aragoiânia;5300108;Brasília;1;1;2;204
5202155;Araguapaz;5300108;Brasília;1;1;2;304
5202353;Arenópolis;5300108;Brasília;1;1;2;395
5202502;Aruanã;5300108;Brasília;1;1;2;352
5202601;Aurilândia;5300108;Brasília;1;1;2;289
5202809;Avelinópolis;5300108;Brasília;1;1;2;210
5203104;Baliza;5300108;Brasília;1;1;2;497
5203203;Barro Alto;5300108;Brasília;1;1;2;141
5203559;Bonfinópolis;5300108;Brasília;1;1;2;143
5203575;Bonópolis;5300108;Brasília;1;1;2;313
5203609;Brazabrantes;5300108;Brasília;1;1;2;172
5203807;Britânia;5300108;Brasília;1;1;2;352
5203939;Buriti de Goiás;5300108;Brasília;1;1;2;272
5203962;Buritinópolis;5300108;Brasília;1;1;2;222
5204201;Cachoeira de Goiás;5300108;Brasília;1;1;2;307
5204607;Campestre de Goiás;5300108;Brasília;1;1;2;217
5204656;Campinaçu;5300108;Brasília;1;1;2;233
5204953;Campos Verdes;5300108;Brasília;1;1;2;253
5205059;Castelândia;5300108;Brasília;1;1;2;352
5205208;Caturaí;5300108;Brasília;1;1;2;183
5205455;Cezarina;5300108;Brasília;1;1;2;237
5205521;Colinas do Sul;5300108;Brasília;1;1;2;185
5205703;Córrego do Ouro;5300108;Brasília;1;1;2;287
5206305;Cristianópolis;5300108;Brasília;1;1;2;175
5206503;Cromínia;5300108;Brasília;1;1;2;227
5206602;Cumari;5300108;Brasília;1;1;2;273
5206701;Damianópolis;5300108;Brasília;1;1;2;232
5206800;Damolândia;5300108;Brasília;1;1;2;163
5206909;Davinópolis;5300108;Brasília;1;1;2;262
5207105;Diorama;5300108;Brasília;1;1;2;360
5207352;Edealina;5300108;Brasília;1;1;2;259
5207501;Estrela do Norte;5300108;Brasília;1;1;2;247
5207535;Faina;5300108;Brasília;1;1;2;266
5208103;Formoso;5300108;Brasília;1;1;2;256
5208152;Gameleira de Goiás;5300108;Brasília;1;1;2;108
5209291;Guaraíta;5300108;Brasília;1;1;2;226
5209408;Guarani de Goiás;5300108;Brasília;1;1;2;258
5209457;Guarinos;5300108;Brasília;1;1;2;224
5209606;Heitoraí;5300108;Brasília;1;1;2;204
5209804;Hidrolina;5300108;Brasília;1;1;2;204
5210158;Ipiranga de Goiás;5300108;Brasília;1;1;2;200
5210307;Israelândia;5300108;Brasília;1;1;2;325
5210562;Itaguari;5300108;Brasília;1;1;2;180
5211404;Itauçu;5300108;Brasília;1;1;2;186
5211602;Ivolândia;5300108;Brasília;1;1;2;320
5212006;Jaupaci;5300108;Brasília;1;1;2;327
5212055;Jesúpolis;5300108;Brasília;1;1;2;156
5212253;Lagoa Santa;5300108;Brasília;1;1;2;526
5212600;Mairipotaba;5300108;Brasília;1;1;2;236
5212709;Mambaí;5300108;Brasília;1;1;2;242
5212907;Marzagão;5300108;Brasília;1;1;2;252
5213053;Mimoso de Goiás;5300108;Brasília;1;1;2;87
5213400;Moiporá;5300108;Brasília;1;1;2;313
5213509;Monte Alegre de Goiás;5300108;Brasília;1;1;2;300
5213772;Montividiu do Norte;5300108;Brasília;1;1;2;307
5213855;Morro Agudo de Goiás;5300108;Brasília;1;1;2;235
5213905;Mossâmedes;5300108;Brasília;1;1;2;248
5214051;Mundo Novo;5300108;Brasília;1;1;2;338
5214101;Mutunópolis;5300108;Brasília;1;1;2;271
5214408;Nazário;5300108;Brasília;1;1;2;227
5214705;Nova América;5300108;Brasília;1;1;2;228
5214861;Nova Glória;5300108;Brasília;1;1;2;191
5214879;Nova Iguaçu de Goiás;5300108;Brasília;1;1;2;230
5214903;Nova Roma;5300108;Brasília;1;1;2;254
5215207;Novo Brasil;5300108;Brasília;1;1;2;300
5215256;Novo Planalto;5300108;Brasília;1;1;2;330
5215405;Ouro Verde de Goiás;5300108;Brasília;1;1;2;144
5215504;Ouvidor;5300108;Brasília;1;1;2;269
5215652;Palestina de Goiás;5300108;Brasília;1;1;2;401
5215801;Palmelo;5300108;Brasília;1;1;2;176
5215900;Palminópolis;5300108;Brasília;1;1;2;264
5216007;Panamá;5300108;Brasília;1;1;2;304
5216304;Paranaiguara;5300108;Brasília;1;1;2;453
5216452;Perolândia;5300108;Brasília;1;1;2;484
5216908;Pilar de Goiás;5300108;Brasília;1;1;2;211
5218052;Porteirão;5300108;Brasília;1;1;2;328
5218391;Professor Jamil;5300108;Brasília;1;1;2;214
5219100;Santa Bárbara de Goiás;5300108;Brasília;1;1;2;208
5219209;Santa Cruz de Goiás;5300108;Brasília;1;1;2;177
5219258;Santa Fé de Goiás;5300108;Brasília;1;1;2;341
5219357;Santa Isabel;5300108;Brasília;1;1;2;171
5219407;Santa Rita do Araguaia;5300108;Brasília;1;1;2;592
5219456;Santa Rita do Novo Destino;5300108;Brasília;1;1;2;148
5219506;Santa Rosa de Goiás;5300108;Brasília;1;1;2;171
5219605;Santa Tereza de Goiás;5300108;Brasília;1;1;2;266
5219902;São Francisco de Goiás;5300108;Brasília;1;1;2;144
5220058;São João da Paraúna;5300108;Brasília;1;1;2;289
5220157;São Luíz do Norte;5300108;Brasília;1;1;2;183
5220264;São Miguel do Passa Quatro;5300108;Brasília;1;1;2;159
5220280;São Patrício;5300108;Brasília;1;1;2;209
5220702;Sítio d'Abadia;5300108;Brasília;1;1;2;211
5221007;Taquaral de Goiás;5300108;Brasília;1;1;2;182
5221452;Trombas;5300108;Brasília;1;1;2;269
5221551;Turvelândia;5300108;Brasília;1;1;2;342
5221577;Uirapuru;5300108;Brasília;1;1;2;272
5221809;Urutaí;5300108;Brasília;1;1;2;186
5221908;Varjão;5300108;Brasília;1;1;2;229
3550308;São Paulo;5222302;Vila Propício;1;1;2;940
4314902;Porto Alegre;5222302;Vila Propício;1;1;2;1637
5220405;São Simão;5222302;Vila Propício;1;1;2;431
5221601;Uruaçu;5222302;Vila Propício;1;1;2;108
5212709;Mambaí;5222203;Vila Boa;1;1;2;118
5207352;Edealina;5222054;Vicentinópolis;1;1;2;37
5207402;Edéia;5222054;Vicentinópolis;1;1;2;44
5219308;Santa Helena de Goiás;5222054;Vicentinópolis;1;1;2;84
3534401;Osasco;5222005;Vianópolis;1;1;2;775
4205902;Gaspar;5222005;Vianópolis;1;1;2;1129
5200308;Alexânia;5222005;Vianópolis;1;1;2;73
5201108;Anápolis;5222005;Vianópolis;1;1;2;66
5201405;Aparecida de Goiânia;5222005;Vianópolis;1;1;2;80
5208004;Formosa;5222005;Vianópolis;1;1;2;184
5208806;Goianira;5222005;Vianópolis;1;1;2;102
5210109;Ipameri;5222005;Vianópolis;1;1;2;116
5211503;Itumbiara;5222005;Vianópolis;1;1;2;200
5211909;Jataí;5222005;Vianópolis;1;1;2;364
5212600;Mairipotaba;5222005;Vianópolis;1;1;2;121
5221551;Turvelândia;5222005;Vianópolis;1;1;2;227
3550308;São Paulo;5221908;Varjão;1;1;2;800
1721000;Palmas;5221858;Valparaíso de Goiás;1;1;2;633
2304285;Eusébio;5221858;Valparaíso de Goiás;1;1;2;1676
2304400;Fortaleza;5221858;Valparaíso de Goiás;1;1;2;1682
2927408;Salvador;5221858;Valparaíso de Goiás;1;1;2;1066
2930154;Serra do Ramalho;5221858;Valparaíso de Goiás;1;1;2;542
3106200;Belo Horizonte;5221858;Valparaíso de Goiás;1;1;2;606
3143104;Monte Carmelo;5221858;Valparaíso de Goiás;1;1;2;299
3170404;Unaí;5221858;Valparaíso de Goiás;1;1;2;119
3505708;Barueri;5221858;Valparaíso de Goiás;1;1;2;833
3536505;Paulínia;5221858;Valparaíso de Goiás;1;1;2;747
3556206;Valinhos;5221858;Valparaíso de Goiás;1;1;2;772
3556453;Vargem Grande Paulista;5221858;Valparaíso de Goiás;1;1;2;841
4106902;Curitiba;5221858;Valparaíso de Goiás;1;1;2;1047
4113700;Londrina;5221858;Valparaíso de Goiás;1;1;2;873
4305108;Caxias do Sul;5221858;Valparaíso de Goiás;1;1;2;1493
4314902;Porto Alegre;5221858;Valparaíso de Goiás;1;1;2;1590
5206206;Cristalina;5221858;Valparaíso de Goiás;1;1;2;89
5213103;Mineiros;5221858;Valparaíso de Goiás;1;1;2;520
5214507;Nerópolis;5221858;Valparaíso de Goiás;1;1;2;138
3550308;São Paulo;5221809;Urutaí;1;1;2;705
5217401;Pires do Rio;5221809;Urutaí;1;1;2;22
3170206;Uberlândia;5221700;Uruana;1;1;2;406
3534401;Osasco;5221700;Uruana;1;1;2;944
3550308;São Paulo;5221700;Uruana;1;1;2;962
5201108;Anápolis;5221700;Uruana;1;1;2;120
5205000;Carmo do Rio Verde;5221700;Uruana;1;1;2;16
5208707;Goiânia;5221700;Uruana;1;1;2;139
5208806;Goianira;5221700;Uruana;1;1;2;116
5211800;Jaraguá;5221700;Uruana;1;1;2;46
5211909;Jataí;5221700;Uruana;1;1;2;344
5217104;Piracanjuba;5221700;Uruana;1;1;2;212
1506138;Redenção;5221601;Uruaçu;1;1;2;725
1721000;Palmas;5221601;Uruaçu;1;1;2;468
2800308;Aracaju;5221601;Uruaçu;1;1;2;1353
2919553;Luís Eduardo magalhães;5221601;Uruaçu;1;1;2;449
3143104;Monte Carmelo;5221601;Uruaçu;1;1;2;500
3170206;Uberlândia;5221601;Uruaçu;1;1;2;495
3509502;Campinas;5221601;Uruaçu;1;1;2;957
3534401;Osasco;5221601;Uruaçu;1;1;2;1032
4317509;Santo Ângelo;5221601;Uruaçu;1;1;2;1630
5101803;Barra do Garças;5221601;Uruaçu;1;1;2;364
5200555;Alto Horizonte;5221601;Uruaçu;1;1;2;40
5203203;Barro Alto;5221601;Uruaçu;1;1;2;57
5204508;Caldas Novas;5221601;Uruaçu;1;1;2;361
5210208;Iporá;5221601;Uruaçu;1;1;2;301
5210406;Itaberaí;5221601;Uruaçu;1;1;2;184
5211909;Jataí;5221601;Uruaçu;1;1;2;465
5213087;Minaçu;5221601;Uruaçu;1;1;2;151
5214002;Mozarlândia;5221601;Uruaçu;1;1;2;154
5218300;Posse;5221601;Uruaçu;1;1;2;306
5218805;Rio Verde;5221601;Uruaçu;1;1;2;410
5220603;Silvânia;5221601;Uruaçu;1;1;2;245
5221403;Trindade;5221601;Uruaçu;1;1;2;241
3304557;Rio de Janeiro;5221577;Uirapuru;1;1;2;1202
3550308;São Paulo;5221577;Uirapuru;1;1;2;1098
5205059;Castelândia;5221551;Turvelândia;1;1;2;28
5208608;Goianésia;5221551;Turvelândia;1;1;2;307
5211800;Jaraguá;5221551;Turvelândia;1;1;2;252
5213103;Mineiros;5221551;Turvelândia;1;1;2;242
5217302;Pirenópolis;5221551;Turvelândia;1;1;2;262
5220108;São Luís de Montes Belos;5221551;Turvelândia;1;1;2;145
5215702;Palmeiras de Goiás;5221502;Turvânia;1;1;2;31
5221403;Trindade;5221502;Turvânia;1;1;2;67
4207007;Içara;5221452;Trombas;1;1;2;1684
5208103;Formoso;5221452;Trombas;1;1;2;22
1302603;Manaus;5221403;Trindade;1;1;2;1857
1702109;Araguaína;5221403;Trindade;1;1;2;1057
1709500;Gurupi;5221403;Trindade;1;1;2;551
1721000;Palmas;5221403;Trindade;1;1;2;709
2111300;São Luís;5221403;Trindade;1;1;2;1657
2307650;Maracanaú;5221403;Trindade;1;1;2;1814
2611606;Recife;5221403;Trindade;1;1;2;1797
2927408;Salvador;5221403;Trindade;1;1;2;1236
3143104;Monte Carmelo;5221403;Trindade;1;1;2;313
3302205;Itaperuna;5221403;Trindade;1;1;2;961
3305505;Saquarema;5221403;Trindade;1;1;2;1026
3505708;Barueri;5221403;Trindade;1;1;2;810
3513009;Cotia;5221403;Trindade;1;1;2;818
3516200;Franca;5221403;Trindade;1;1;2;485
3534401;Osasco;5221403;Trindade;1;1;2;815
3548807;São Caetano do Sul;5221403;Trindade;1;1;2;832
5003702;Dourados;5221403;Trindade;1;1;2;841
5101803;Barra do Garças;5221403;Trindade;1;1;2;309
5107602;Rondonópolis;5221403;Trindade;1;1;2;551
5107909;Sinop;5221403;Trindade;1;1;2;826
5200050;Abadia de Goiás;5221403;Trindade;1;1;2;12
5201306;Anicuns;5221403;Trindade;1;1;2;52
5204508;Caldas Novas;5221403;Trindade;1;1;2;152
5209200;Guapó;5221403;Trindade;1;1;2;18
5211206;Itapuranga;5221403;Trindade;1;1;2;136
5211800;Jaraguá;5221403;Trindade;1;1;2;102
5212204;Jussara;5221403;Trindade;1;1;2;169
5212501;Luziânia;5221403;Trindade;1;1;2;173
5215702;Palmeiras de Goiás;5221403;Trindade;1;1;2;47
5219001;Sanclerlândia;5221403;Trindade;1;1;2;100
5219100;Santa Bárbara de Goiás;5221403;Trindade;1;1;2;22
5220108;São Luís de Montes Belos;5221403;Trindade;1;1;2;93
3160702;Santos Dumont;5221197;Terezópolis de Goiás;1;1;2;822
4202404;Blumenau;5221197;Terezópolis de Goiás;1;1;2;1169
5208400;Goianápolis;5221197;Terezópolis de Goiás;1;1;2;14
5208707;Goiânia;5221197;Terezópolis de Goiás;1;1;2;40
2307650;Maracanaú;5221007;Taquaral de Goiás;1;1;2;1771
5210562;Itaguari;5221007;Taquaral de Goiás;1;1;2;15
3520301;Iguape;5220702;Sítio d'Abadia;1;1;2;1106
5208707;Goiânia;5220702;Sítio d'Abadia;1;1;2;389
3118601;Contagem;5220686;Simolândia;1;1;2;660
5200803;Alvorada do Norte;5220686;Simolândia;1;1;2;4
5208707;Goiânia;5220686;Simolândia;1;1;2;392
5211503;Itumbiara;5220686;Simolândia;1;1;2;531
5213806;Morrinhos;5220686;Simolândia;1;1;2;462
5218300;Posse;5220686;Simolândia;1;1;2;42
3104007;Araxá;5220603;Silvânia;1;1;2;370
3106200;Belo Horizonte;5220603;Silvânia;1;1;2;614
3534401;Osasco;5220603;Silvânia;1;1;2;786
4109807;Ibiporã;5220603;Silvânia;1;1;2;778
4114203;Mandaguari;5220603;Silvânia;1;1;2;835
4317509;Santo Ângelo;5220603;Silvânia;1;1;2;1434
5201405;Aparecida de Goiânia;5220603;Silvânia;1;1;2;72
5203302;Bela Vista de Goiás;5220603;Silvânia;1;1;2;51
5204508;Caldas Novas;5220603;Silvânia;1;1;2;119
5206206;Cristalina;5220603;Silvânia;1;1;2;99
5208152;Gameleira de Goiás;5220603;Silvânia;1;1;2;23
5210000;Inhumas;5220603;Silvânia;1;1;2;103
5211503;Itumbiara;5220603;Silvânia;1;1;2;205
5212501;Luziânia;5220603;Silvânia;1;1;2;84
5214507;Nerópolis;5220603;Silvânia;1;1;2;71
5216809;Petrolina de Goiás;5220603;Silvânia;1;1;2;100
5217401;Pires do Rio;5220603;Silvânia;1;1;2;77
5218607;Rialma;5220603;Silvânia;1;1;2;182
5218805;Rio Verde;5220603;Silvânia;1;1;2;279
5219902;São Francisco de Goiás;5220603;Silvânia;1;1;2;106
2703759;Jequiá da Praia;5220504;Serranópolis;1;1;2;1889
3518909;Guzolândia;5220504;Serranópolis;1;1;2;294
3550308;São Paulo;5220504;Serranópolis;1;1;2;822
5214051;Mundo Novo;5220504;Serranópolis;1;1;2;532
5216304;Paranaiguara;5220504;Serranópolis;1;1;2;154
5220405;São Simão;5220504;Serranópolis;1;1;2;168
1100049;Cacoal;5220454;Senador Canedo;1;1;2;1428
1600600;Santana;5220454;Senador Canedo;1;1;2;1860
1709500;Gurupi;5220454;Senador Canedo;1;1;2;553
1721000;Palmas;5220454;Senador Canedo;1;1;2;707
2511202;Pedras de Fogo;5220454;Senador Canedo;1;1;2;1791
2804805;Nossa Senhora do Socorro;5220454;Senador Canedo;1;1;2;1415
2905701;Camaçari;5220454;Senador Canedo;1;1;2;1221
2927408;Salvador;5220454;Senador Canedo;1;1;2;1196
2930154;Serra do Ramalho;5220454;Senador Canedo;1;1;2;677
3104007;Araxá;5220454;Senador Canedo;1;1;2;393
3106200;Belo Horizonte;5220454;Senador Canedo;1;1;2;654
3134202;Ituiutaba;5220454;Senador Canedo;1;1;2;254
3143104;Monte Carmelo;5220454;Senador Canedo;1;1;2;281
3162922;São Joaquim de Bicas;5220454;Senador Canedo;1;1;2;637
3502804;Araçatuba;5220454;Senador Canedo;1;1;2;521
3509205;Cajamar;5220454;Senador Canedo;1;1;2;774
3518800;Guarulhos;5220454;Senador Canedo;1;1;2;794
3525102;Jardinópolis;5220454;Senador Canedo;1;1;2;498
3526902;Limeira;5220454;Senador Canedo;1;1;2;674
3534401;Osasco;5220454;Senador Canedo;1;1;2;796
3538709;Piracicaba;5220454;Senador Canedo;1;1;2;687
3543402;Ribeirão Preto;5220454;Senador Canedo;1;1;2;512
3552809;Taboão da Serra;5220454;Senador Canedo;1;1;2;803
3557006;Votorantim;5220454;Senador Canedo;1;1;2;777
4101804;Araucária;5220454;Senador Canedo;1;1;2;984
4105508;Cianorte;5220454;Senador Canedo;1;1;2;859
4120655;Quarto Centenário;5220454;Senador Canedo;1;1;2;944
5002704;Campo Grande;5220454;Senador Canedo;1;1;2;727
5107602;Rondonópolis;5220454;Senador Canedo;1;1;2;595
5219738;Santo Antônio de Goiás;5220454;Senador Canedo;1;1;2;34
5220108;São Luís de Montes Belos;5220454;Senador Canedo;1;1;2;138
3106200;Belo Horizonte;5220405;São Simão;1;1;2;701
3159803;Santa Vitória;5220405;São Simão;1;1;2;47
3170107;Uberaba;5220405;São Simão;1;1;2;290
3205309;Vitória;5220405;São Simão;1;1;2;1092
3502309;Anhembi;5220405;São Simão;1;1;2;493
3534401;Osasco;5220405;São Simão;1;1;2;643
4101408;Apucarana;5220405;São Simão;1;1;2;515
4202008;Balneário Camboriú;5220405;São Simão;1;1;2;908
5102702;Canarana;5220405;São Simão;1;1;2;629
5201504;Aporé;5220405;São Simão;1;1;2;142
5208608;Goianésia;5220405;São Simão;1;1;2;433
5210802;Itajá;5220405;São Simão;1;1;2;104
5211305;Itarumã;5220405;São Simão;1;1;2;88
5211503;Itumbiara;5220405;São Simão;1;1;2;151
5211909;Jataí;5220405;São Simão;1;1;2;171
5212253;Lagoa Santa;5220405;São Simão;1;1;2;88
5218805;Rio Verde;5220405;São Simão;1;1;2;139
5208707;Goiânia;5220264;São Miguel do Passa Quatro;1;1;2;78
1716109;Paraíso do Tocantins;5220207;São Miguel do Araguaia;1;1;2;370
3534401;Osasco;5220207;São Miguel do Araguaia;1;1;2;1196
4106902;Curitiba;5220207;São Miguel do Araguaia;1;1;2;1349
5202502;Aruanã;5220207;São Miguel do Araguaia;1;1;2;206
5207535;Faina;5220207;São Miguel do Araguaia;1;1;2;244
5208905;Goiás;5220207;São Miguel do Araguaia;1;1;2;300
5211909;Jataí;5220207;São Miguel do Araguaia;1;1;2;539
5214606;Niquelândia;5220207;São Miguel do Araguaia;1;1;2;226
5217203;Piranhas;5220207;São Miguel do Araguaia;1;1;2;393
5218003;Porangatu;5220207;São Miguel do Araguaia;1;1;2;108
1100023;Ariquemes;5220108;São Luís de Montes Belos;1;1;2;1519
1508407;Xinguara;5220108;São Luís de Montes Belos;1;1;2;1047
1721000;Palmas;5220108;São Luís de Montes Belos;1;1;2;716
3134400;Iturama;5220108;São Luís de Montes Belos;1;1;2;354
3143104;Monte Carmelo;5220108;São Luís de Montes Belos;1;1;2;391
3534401;Osasco;5220108;São Luís de Montes Belos;1;1;2;866
5201306;Anicuns;5220108;São Luís de Montes Belos;1;1;2;44
5201405;Aparecida de Goiânia;5220108;São Luís de Montes Belos;1;1;2;122
5202601;Aurilândia;5220108;São Luís de Montes Belos;1;1;2;18
5207600;Fazenda Nova;5220108;São Luís de Montes Belos;1;1;2;59
5207808;Firminópolis;5220108;São Luís de Montes Belos;1;1;2;8
5210000;Inhumas;5220108;São Luís de Montes Belos;1;1;2;91
5210307;Israelândia;5220108;São Luís de Montes Belos;1;1;2;63
5210406;Itaberaí;5220108;São Luís de Montes Belos;1;1;2;80
5211909;Jataí;5220108;São Luís de Montes Belos;1;1;2;207
5213806;Morrinhos;5220108;São Luís de Montes Belos;1;1;2;187
5214002;Mozarlândia;5220108;São Luís de Montes Belos;1;1;2;201
5217401;Pires do Rio;5220108;São Luís de Montes Belos;1;1;2;236
5218805;Rio Verde;5220108;São Luís de Montes Belos;1;1;2;151
3104502;Arinos;5220009;São João d'Aliança;1;1;2;204
3147709;Passa Tempo;5220009;São João d'Aliança;1;1;2;737
3167202;Sete Lagoas;5220009;São João d'Aliança;1;1;2;635
5107602;Rondonópolis;5220009;São João d'Aliança;1;1;2;796
3550308;São Paulo;5219902;São Francisco de Goiás;1;1;2;901
5211909;Jataí;5219902;São Francisco de Goiás;1;1;2;342
5212055;Jesúpolis;5219902;São Francisco de Goiás;1;1;2;12
5219357;Santa Isabel;5219902;São Francisco de Goiás;1;1;2;72
3534401;Osasco;5219803;São Domingos;1;1;2;1119
4110201;Inácio Martins;5219803;São Domingos;1;1;2;1445
5208707;Goiânia;5219803;São Domingos;1;1;2;485
5209408;Guarani de Goiás;5219803;São Domingos;1;1;2;58
2111201;São José de Ribamar;5219753;Santo Antônio do Descoberto;1;1;2;1549
2507507;João Pessoa;5219753;Santo Antônio do Descoberto;1;1;2;1715
3143104;Monte Carmelo;5219753;Santo Antônio do Descoberto;1;1;2;320
3532827;Nova Campina;5219753;Santo Antônio do Descoberto;1;1;2;908
3534401;Osasco;5219753;Santo Antônio do Descoberto;1;1;2;857
5200308;Alexânia;5219753;Santo Antônio do Descoberto;1;1;2;27
5212501;Luziânia;5219753;Santo Antônio do Descoberto;1;1;2;52
5215231;Novo Gama;5219753;Santo Antônio do Descoberto;1;1;2;31
2111300;São Luís;5219738;Santo Antônio de Goiás;1;1;2;1631
5200134;Acreúna;5219712;Santo Antônio da Barra;1;1;2;33
5218508;Quirinópolis;5219712;Santo Antônio da Barra;1;1;2;101
3304557;Rio de Janeiro;5219704;Santa Terezinha de Goiás;1;1;2;1181
3534401;Osasco;5219704;Santa Terezinha de Goiás;1;1;2;1064
3550308;São Paulo;5219704;Santa Terezinha de Goiás;1;1;2;1081
5201405;Aparecida de Goiânia;5219704;Santa Terezinha de Goiás;1;1;2;273
5206404;Crixás;5219704;Santa Terezinha de Goiás;1;1;2;31
5208608;Goianésia;5219704;Santa Terezinha de Goiás;1;1;2;123
5212501;Luziânia;5219704;Santa Terezinha de Goiás;1;1;2;284
3530706;Mogi Guaçu;5219605;Santa Tereza de Goiás;1;1;2;987
5208707;Goiânia;5219605;Santa Tereza de Goiás;1;1;2;336
5218607;Rialma;5219605;Santa Tereza de Goiás;1;1;2;187
2919553;Luís Eduardo magalhães;5219407;Santa Rita do Araguaia;1;1;2;968
3103504;Araguari;5219407;Santa Rita do Araguaia;1;1;2;553
3534401;Osasco;5219407;Santa Rita do Araguaia;1;1;2;977
5002704;Campo Grande;5219407;Santa Rita do Araguaia;1;1;2;377
5107602;Rondonópolis;5219407;Santa Rita do Araguaia;1;1;2;185
5208707;Goiânia;5219407;Santa Rita do Araguaia;1;1;2;422
3550308;São Paulo;5219357;Santa Isabel;1;1;2;974
5212501;Luziânia;5219357;Santa Isabel;1;1;2;192
2611606;Recife;5219308;Santa Helena de Goiás;1;1;2;1948
3143104;Monte Carmelo;5219308;Santa Helena de Goiás;1;1;2;344
3170107;Uberaba;5219308;Santa Helena de Goiás;1;1;2;357
3517406;Guaíra;5219308;Santa Helena de Goiás;1;1;2;370
3520103;Igarapava;5219308;Santa Helena de Goiás;1;1;2;392
3525904;Jundiaí;5219308;Santa Helena de Goiás;1;1;2;716
3534401;Osasco;5219308;Santa Helena de Goiás;1;1;2;756
4106902;Curitiba;5219308;Santa Helena de Goiás;1;1;2;857
4115606;Matelândia;5219308;Santa Helena de Goiás;1;1;2;903
4202404;Blumenau;5219308;Santa Helena de Goiás;1;1;2;1026
4219507;Xanxerê;5219308;Santa Helena de Goiás;1;1;2;1022
4311403;Lajeado;5219308;Santa Helena de Goiás;1;1;2;1297
4316808;Santa Cruz do Sul;5219308;Santa Helena de Goiás;1;1;2;1335
5002704;Campo Grande;5219308;Santa Helena de Goiás;1;1;2;521
5201405;Aparecida de Goiânia;5219308;Santa Helena de Goiás;1;1;2;179
5203500;Bom Jesus de Goiás;5219308;Santa Helena de Goiás;1;1;2;98
5205901;Corumbaíba;5219308;Santa Helena de Goiás;1;1;2;219
5209952;Indiara;5219308;Santa Helena de Goiás;1;1;2;98
5213806;Morrinhos;5219308;Santa Helena de Goiás;1;1;2;157
3103504;Araguari;5219258;Santa Fé de Goiás;1;1;2;446
3550308;São Paulo;5219258;Santa Fé de Goiás;1;1;2;1000
5210208;Iporá;5219258;Santa Fé de Goiás;1;1;2;75
5211909;Jataí;5219258;Santa Fé de Goiás;1;1;2;245
3541406;Presidente Prudente;5219209;Santa Cruz de Goiás;1;1;2;619
5217104;Piracanjuba;5219209;Santa Cruz de Goiás;1;1;2;58
5217401;Pires do Rio;5219209;Santa Cruz de Goiás;1;1;2;19
1718451;Pugmil;5219100;Santa Bárbara de Goiás;1;1;2;686
3509403;Cajuru;5219100;Santa Bárbara de Goiás;1;1;2;581
3550308;São Paulo;5219100;Santa Bárbara de Goiás;1;1;2;851
5201405;Aparecida de Goiânia;5219100;Santa Bárbara de Goiás;1;1;2;53
3534401;Osasco;5219001;Sanclerlândia;1;1;2;899
5201306;Anicuns;5219001;Sanclerlândia;1;1;2;50
5201801;Aragoiânia;5219001;Sanclerlândia;1;1;2;122
5211909;Jataí;5219001;Sanclerlândia;1;1;2;241
3304557;Rio de Janeiro;5218904;Rubiataba;1;1;2;1119
3534401;Osasco;5218904;Rubiataba;1;1;2;987
5200555;Alto Horizonte;5218904;Rubiataba;1;1;2;116
5210000;Inhumas;5218904;Rubiataba;1;1;2;141
5211909;Jataí;5218904;Rubiataba;1;1;2;368
5214507;Nerópolis;5218904;Rubiataba;1;1;2;154
1100304;Vilhena;5218805;Rio Verde;1;1;2;1113
1302603;Manaus;5218805;Rio Verde;1;1;2;1875
1500503;Almeirim;5218805;Rio Verde;1;1;2;1811
1504208;Marabá;5218805;Rio Verde;1;1;2;1388
1508084;Tucumã;5218805;Rio Verde;1;1;2;1222
1508407;Xinguara;5218805;Rio Verde;1;1;2;1188
1702109;Araguaína;5218805;Rio Verde;1;1;2;1207
1718204;Porto Nacional;5218805;Rio Verde;1;1;2;829
2101400;Balsas;5218805;Rio Verde;1;1;2;1246
2111300;São Luís;5218805;Rio Verde;1;1;2;1824
2304400;Fortaleza;5218805;Rio Verde;1;1;2;2012
2607901;Jaboatão dos Guararapes;5218805;Rio Verde;1;1;2;1968
2803609;Laranjeiras;5218805;Rio Verde;1;1;2;1632
3103504;Araguari;5218805;Rio Verde;1;1;2;305
3104007;Araxá;5218805;Rio Verde;1;1;2;469
3106705;Betim;5218805;Rio Verde;1;1;2;759
3118007;Congonhas;5218805;Rio Verde;1;1;2;811
3127107;Frutal;5218805;Rio Verde;1;1;2;331
3147907;Passos;5218805;Rio Verde;1;1;2;562
3205101;Viana;5218805;Rio Verde;1;1;2;1145
3205309;Vitória;5218805;Rio Verde;1;1;2;1168
3503307;Araras;5218805;Rio Verde;1;1;2;634
3505708;Barueri;5218805;Rio Verde;1;1;2;770
3505906;Batatais;5218805;Rio Verde;1;1;2;494
3506003;Bauru;5218805;Rio Verde;1;1;2;541
3511102;Catanduva;5218805;Rio Verde;1;1;2;426
3512803;Cosmópolis;5218805;Rio Verde;1;1;2;671
3513504;Cubatão;5218805;Rio Verde;1;1;2;833
3516200;Franca;5218805;Rio Verde;1;1;2;485
3517703;Guará;5218805;Rio Verde;1;1;2;442
3517901;Guaraci;5218805;Rio Verde;1;1;2;367
3518800;Guarulhos;5218805;Rio Verde;1;1;2;783
3534906;Pacaembu;5218805;Rio Verde;1;1;2;418
3537305;Penápolis;5218805;Rio Verde;1;1;2;413
3538709;Piracicaba;5218805;Rio Verde;1;1;2;653
3540705;Porto Ferreira;5218805;Rio Verde;1;1;2;583
3540903;Pradópolis;5218805;Rio Verde;1;1;2;500
3543907;Rio Claro;5218805;Rio Verde;1;1;2;626
3549805;São José do Rio Preto;5218805;Rio Verde;1;1;2;374
3550902;São Simão;5218805;Rio Verde;1;1;2;546
3552502;Suzano;5218805;Rio Verde;1;1;2;809
3553955;Tarumã;5218805;Rio Verde;1;1;2;550
3556206;Valinhos;5218805;Rio Verde;1;1;2;713
4101408;Apucarana;5218805;Rio Verde;1;1;2;641
4114807;Marialva;5218805;Rio Verde;1;1;2;637
4124806;São João;5218805;Rio Verde;1;1;2;910
4125506;São José dos Pinhais;5218805;Rio Verde;1;1;2;878
4128104;Umuarama;5218805;Rio Verde;1;1;2;707
4201406;Araranguá;5218805;Rio Verde;1;1;2;1245
4208906;Jaraguá do Sul;5218805;Rio Verde;1;1;2;983
4209300;Lages;5218805;Rio Verde;1;1;2;1110
4305108;Caxias do Sul;5218805;Rio Verde;1;1;2;1259
4305306;Chapada;5218805;Rio Verde;1;1;2;1160
4307005;Erechim;5218805;Rio Verde;1;1;2;1099
4320404;Serafina Corrêa;5218805;Rio Verde;1;1;2;1214
5002951;Chapadão do Sul;5218805;Rio Verde;1;1;2;211
5003306;Coxim;5218805;Rio Verde;1;1;2;413
5003702;Dourados;5218805;Rio Verde;1;1;2;642
5107040;Primavera do Leste;5218805;Rio Verde;1;1;2;438
5107180;Ribeirão Cascalheira;5218805;Rio Verde;1;1;2;545
5200258;Águas Lindas de Goiás;5218805;Rio Verde;1;1;2;359
5205471;Chapadão do Céu;5218805;Rio Verde;1;1;2;184
5209101;Goiatuba;5218805;Rio Verde;1;1;2;168
5211701;Jandaia;5218805;Rio Verde;1;1;2;118
5212105;Joviânia;5218805;Rio Verde;1;1;2;140
5214606;Niquelândia;5218805;Rio Verde;1;1;2;450
5215702;Palmeiras de Goiás;5218805;Rio Verde;1;1;2;153
1200401;Rio Branco;5218789;Rio Quente;1;1;2;2164
1302603;Manaus;5218789;Rio Quente;1;1;2;1995
2507507;João Pessoa;5218789;Rio Quente;1;1;2;1858
2611606;Recife;5218789;Rio Quente;1;1;2;1791
2704302;Maceió;5218789;Rio Quente;1;1;2;1628
2927408;Salvador;5218789;Rio Quente;1;1;2;1202
3106200;Belo Horizonte;5218789;Rio Quente;1;1;2;563
3170206;Uberlândia;5218789;Rio Quente;1;1;2;136
3304557;Rio de Janeiro;5218789;Rio Quente;1;1;2;820
3547809;Santo André;5218789;Rio Quente;1;1;2;694
4106902;Curitiba;5218789;Rio Quente;1;1;2;850
4205407;Florianópolis;5218789;Rio Quente;1;1;2;1088
5002704;Campo Grande;5218789;Rio Quente;1;1;2;693
5103403;Cuiabá;5218789;Rio Quente;1;1;2;811
5204854;Campo Limpo de Goiás;5218789;Rio Quente;1;1;2;167
5213806;Morrinhos;5218789;Rio Quente;1;1;2;37
1504059;Mãe do Rio;5218706;Rianápolis;1;1;2;1498
1709500;Gurupi;5218706;Rianápolis;1;1;2;416
3106200;Belo Horizonte;5218706;Rianápolis;1;1;2;777
5201108;Anápolis;5218706;Rianápolis;1;1;2;113
5205406;Ceres;5218706;Rianápolis;1;1;2;23
5208608;Goianésia;5218706;Rianápolis;1;1;2;44
5208806;Goianira;5218706;Rianápolis;1;1;2;119
5210604;Itaguaru;5218706;Rianápolis;1;1;2;37
5218003;Porangatu;5218706;Rianápolis;1;1;2;226
3503307;Araras;5218607;Rialma;1;1;2;818
5204953;Campos Verdes;5218607;Rialma;1;1;2;116
5214051;Mundo Novo;5218607;Rialma;1;1;2;185
5214606;Niquelândia;5218607;Rialma;1;1;2;147
5214838;Nova Crixás;5218607;Rialma;1;1;2;156
1721000;Palmas;5218508;Quirinópolis;1;1;2;921
3104007;Araxá;5218508;Quirinópolis;1;1;2;392
3143104;Monte Carmelo;5218508;Quirinópolis;1;1;2;313
3159803;Santa Vitória;5218508;Quirinópolis;1;1;2;56
3170107;Uberaba;5218508;Quirinópolis;1;1;2;305
3170206;Uberlândia;5218508;Quirinópolis;1;1;2;237
3500105;Adamantina;5218508;Quirinópolis;1;1;2;364
3503208;Araraquara;5218508;Quirinópolis;1;1;2;442
3513108;Cravinhos;5218508;Quirinópolis;1;1;2;432
3534302;Orlândia;5218508;Quirinópolis;1;1;2;371
3534401;Osasco;5218508;Quirinópolis;1;1;2;686
3537305;Penápolis;5218508;Quirinópolis;1;1;2;332
3538709;Piracicaba;5218508;Quirinópolis;1;1;2;563
3543402;Ribeirão Preto;5218508;Quirinópolis;1;1;2;412
3547601;Santa Rosa de Viterbo;5218508;Quirinópolis;1;1;2;470
3551702;Sertãozinho;5218508;Quirinópolis;1;1;2;397
5107602;Rondonópolis;5218508;Quirinópolis;1;1;2;497
5201108;Anápolis;5218508;Quirinópolis;1;1;2;285
5203500;Bom Jesus de Goiás;5218508;Quirinópolis;1;1;2;77
5205901;Corumbaíba;5218508;Quirinópolis;1;1;2;203
5209150;Gouvelândia;5218508;Quirinópolis;1;1;2;42
5209937;Inaciolândia;5218508;Quirinópolis;1;1;2;50
5210406;Itaberaí;5218508;Quirinópolis;1;1;2;274
5213103;Mineiros;5218508;Quirinópolis;1;1;2;243
5213806;Morrinhos;5218508;Quirinópolis;1;1;2;162
5216403;Paraúna;5218508;Quirinópolis;1;1;2;166
2615607;Trindade;5218300;Posse;1;1;2;952
2917359;Jaborandi;5218300;Posse;1;1;2;212
3148004;Patos de Minas;5218300;Posse;1;1;2;497
3534401;Osasco;5218300;Posse;1;1;2;1047
4314902;Porto Alegre;5218300;Posse;1;1;2;1850
5200803;Alvorada do Norte;5218300;Posse;1;1;2;46
5205406;Ceres;5218300;Posse;1;1;2;377
5209408;Guarani de Goiás;5218300;Posse;1;1;2;21
5211800;Jaraguá;5218300;Posse;1;1;2;373
5212501;Luziânia;5218300;Posse;1;1;2;295
3550308;São Paulo;5218102;Portelândia;1;1;2;955
5103403;Cuiabá;5218102;Portelândia;1;1;2;413
5106703;Ponte Branca;5218102;Portelândia;1;1;2;75
5108402;Várzea Grande;5218102;Portelândia;1;1;2;415
5211503;Itumbiara;5218102;Portelândia;1;1;2;382
3170206;Uberlândia;5218052;Porteirão;1;1;2;235
3509502;Campinas;5218052;Porteirão;1;1;2;655
5203500;Bom Jesus de Goiás;5218052;Porteirão;1;1;2;59
5208707;Goiânia;5218052;Porteirão;1;1;2;155
5213004;Maurilândia;5218052;Porteirão;1;1;2;26
1702000;Araguaçu;5218003;Porangatu;1;1;2;90
1716604;Peixe;5218003;Porangatu;1;1;2;171
3106200;Belo Horizonte;5218003;Porangatu;1;1;2;916
3143104;Monte Carmelo;5218003;Porangatu;1;1;2;614
3201209;Cachoeiro de Itapemirim;5218003;Porangatu;1;1;2;1211
3534302;Orlândia;5218003;Porangatu;1;1;2;819
3534401;Osasco;5218003;Porangatu;1;1;2;1149
5201405;Aparecida de Goiânia;5218003;Porangatu;1;1;2;374
5206404;Crixás;5218003;Porangatu;1;1;2;150
5208608;Goianésia;5218003;Porangatu;1;1;2;209
5211800;Jaraguá;5218003;Porangatu;1;1;2;258
5214002;Mozarlândia;5218003;Porangatu;1;1;2;210
5217203;Piranhas;5218003;Porangatu;1;1;2;438
1506583;Santa Maria das Barreiras;5217708;Pontalina;1;1;2;959
3106200;Belo Horizonte;5217708;Pontalina;1;1;2;641
3170206;Uberlândia;5217708;Pontalina;1;1;2;198
3304557;Rio de Janeiro;5217708;Pontalina;1;1;2;893
3524303;Jaboticabal;5217708;Pontalina;1;1;2;432
3534401;Osasco;5217708;Pontalina;1;1;2;725
5203500;Bom Jesus de Goiás;5217708;Pontalina;1;1;2;84
5207352;Edealina;5217708;Pontalina;1;1;2;25
5208806;Goianira;5217708;Pontalina;1;1;2;111
5211503;Itumbiara;5217708;Pontalina;1;1;2;99
5211909;Jataí;5217708;Pontalina;1;1;2;243
5212105;Joviânia;5217708;Pontalina;1;1;2;36
3143104;Monte Carmelo;5217609;Planaltina;1;1;2;364
3170206;Uberlândia;5217609;Planaltina;1;1;2;390
3304557;Rio de Janeiro;5217609;Planaltina;1;1;2;951
3534401;Osasco;5217609;Planaltina;1;1;2;901
3548807;São Caetano do Sul;5217609;Planaltina;1;1;2;912
4117909;Palotina;5217609;Planaltina;1;1;2;1195
4202404;Blumenau;5217609;Planaltina;1;1;2;1285
5204003;Cabeceiras;5217609;Planaltina;1;1;2;83
5212501;Luziânia;5217609;Planaltina;1;1;2;98
5214606;Niquelândia;5217609;Planaltina;1;1;2;142
5215603;Padre Bernardo;5217609;Planaltina;1;1;2;83
2927408;Salvador;5217401;Pires do Rio;1;1;2;1139
3104007;Araxá;5217401;Pires do Rio;1;1;2;293
3106200;Belo Horizonte;5217401;Pires do Rio;1;1;2;546
3134202;Ituiutaba;5217401;Pires do Rio;1;1;2;223
3143104;Monte Carmelo;5217401;Pires do Rio;1;1;2;180
3170404;Unaí;5217401;Pires do Rio;1;1;2;177
3509205;Cajamar;5217401;Pires do Rio;1;1;2;689
3534401;Osasco;5217401;Pires do Rio;1;1;2;711
4118204;Paranaguá;5217401;Pires do Rio;1;1;2;919
4127700;Toledo;5217401;Pires do Rio;1;1;2;1015
4219309;Videira;5217401;Pires do Rio;1;1;2;1120
4318481;São José do Hortêncio;5217401;Pires do Rio;1;1;2;1394
5211800;Jaraguá;5217401;Pires do Rio;1;1;2;202
5211909;Jataí;5217401;Pires do Rio;1;1;2;368
5213806;Morrinhos;5217401;Pires do Rio;1;1;2;99
2905404;Cairu;5217302;Pirenópolis;1;1;2;1093
3143104;Monte Carmelo;5217302;Pirenópolis;1;1;2;353
3534401;Osasco;5217302;Pirenópolis;1;1;2;882
3536505;Paulínia;5217302;Pirenópolis;1;1;2;788
4313375;Nova Santa Rita;5217302;Pirenópolis;1;1;2;1571
5205802;Corumbá de Goiás;5217302;Pirenópolis;1;1;2;17
5210000;Inhumas;5217302;Pirenópolis;1;1;2;84
3534401;Osasco;5217203;Piranhas;1;1;2;956
4106902;Curitiba;5217203;Piranhas;1;1;2;1033
5108204;Torixoréu;5217203;Piranhas;1;1;2;91
5201702;Aragarças;5217203;Piranhas;1;1;2;79
5210000;Inhumas;5217203;Piranhas;1;1;2;242
5211909;Jataí;5217203;Piranhas;1;1;2;162
5213087;Minaçu;5217203;Piranhas;1;1;2;499
5213707;Montes Claros de Goiás;5217203;Piranhas;1;1;2;64
3103504;Araguari;5217104;Piracanjuba;1;1;2;172
3106200;Belo Horizonte;5217104;Piracanjuba;1;1;2;612
3509502;Campinas;5217104;Piracanjuba;1;1;2;655
3534302;Orlândia;5217104;Piracanjuba;1;1;2;397
3534401;Osasco;5217104;Piracanjuba;1;1;2;731
5201108;Anápolis;5217104;Piracanjuba;1;1;2;110
5201405;Aparecida de Goiânia;5217104;Piracanjuba;1;1;2;60
5209705;Hidrolândia;5217104;Piracanjuba;1;1;2;44
5210000;Inhumas;5217104;Piracanjuba;1;1;2;115
5211503;Itumbiara;5217104;Piracanjuba;1;1;2;123
5211909;Jataí;5217104;Piracanjuba;1;1;2;293
5213806;Morrinhos;5217104;Piracanjuba;1;1;2;48
3550308;São Paulo;5216908;Pilar de Goiás;1;1;2;1036
5214606;Niquelândia;5216908;Pilar de Goiás;1;1;2;123
1302603;Manaus;5216809;Petrolina de Goiás;1;1;2;1820
3534401;Osasco;5216809;Petrolina de Goiás;1;1;2;869
5201405;Aparecida de Goiânia;5216809;Petrolina de Goiás;1;1;2;80
5208806;Goianira;5216809;Petrolina de Goiás;1;1;2;48
5211800;Jaraguá;5216809;Petrolina de Goiás;1;1;2;37
5214507;Nerópolis;5216809;Petrolina de Goiás;1;1;2;37
3550308;São Paulo;5216452;Perolândia;1;1;2;896
5211503;Itumbiara;5216452;Perolândia;1;1;2;314
3204906;São Mateus;5216403;Paraúna;1;1;2;1151
3534401;Osasco;5216403;Paraúna;1;1;2;831
3543907;Rio Claro;5216403;Paraúna;1;1;2;680
4106902;Curitiba;5216403;Paraúna;1;1;2;948
4202404;Blumenau;5216403;Paraúna;1;1;2;1117
5201306;Anicuns;5216403;Paraúna;1;1;2;75
5201405;Aparecida de Goiânia;5216403;Paraúna;1;1;2;130
5202601;Aurilândia;5216403;Paraúna;1;1;2;30
5205406;Ceres;5216403;Paraúna;1;1;2;206
3540903;Pradópolis;5216304;Paranaiguara;1;1;2;386
3550308;São Paulo;5216304;Paranaiguara;1;1;2;677
5204102;Cachoeira Alta;5216304;Paranaiguara;1;1;2;35
5205901;Corumbaíba;5216007;Panamá;1;1;2;84
3550308;São Paulo;5215900;Palminópolis;1;1;2;850
5211701;Jandaia;5215900;Palminópolis;1;1;2;28
5214408;Nazário;5215900;Palminópolis;1;1;2;38
5215702;Palmeiras de Goiás;5215900;Palminópolis;1;1;2;25
3550308;São Paulo;5215801;Palmelo;1;1;2;726
1702109;Araguaína;5215702;Palmeiras de Goiás;1;1;2;1078
1711902;Lagoa da Confusão;5215702;Palmeiras de Goiás;1;1;2;666
1718204;Porto Nacional;5215702;Palmeiras de Goiás;1;1;2;695
3130200;Igaratinga;5215702;Palmeiras de Goiás;1;1;2;661
3147105;Pará de Minas;5215702;Palmeiras de Goiás;1;1;2;663
3148301;Paula Cândido;5215702;Palmeiras de Goiás;1;1;2;874
3163102;São José da Varginha;5215702;Palmeiras de Goiás;1;1;2;661
3171303;Viçosa;5215702;Palmeiras de Goiás;1;1;2;875
3205002;Serra;5215702;Palmeiras de Goiás;1;1;2;1099
3300225;Areal;5215702;Palmeiras de Goiás;1;1;2;950
3302007;Itaguaí;5215702;Palmeiras de Goiás;1;1;2;939
3304557;Rio de Janeiro;5215702;Palmeiras de Goiás;1;1;2;988
3525003;Jandira;5215702;Palmeiras de Goiás;1;1;2;814
3534401;Osasco;5215702;Palmeiras de Goiás;1;1;2;819
4307807;Estrela;5215702;Palmeiras de Goiás;1;1;2;1424
5101803;Barra do Garças;5215702;Palmeiras de Goiás;1;1;2;272
5207402;Edéia;5215702;Palmeiras de Goiás;1;1;2;61
5208608;Goianésia;5215702;Palmeiras de Goiás;1;1;2;185
5209952;Indiara;5215702;Palmeiras de Goiás;1;1;2;38
5210000;Inhumas;5215702;Palmeiras de Goiás;1;1;2;63
5211909;Jataí;5215702;Palmeiras de Goiás;1;1;2;225
5210208;Iporá;5215652;Palestina de Goiás;1;1;2;54
5211909;Jataí;5215652;Palestina de Goiás;1;1;2;131
3534401;Osasco;5215603;Padre Bernardo;1;1;2;944
5203203;Barro Alto;5215603;Padre Bernardo;1;1;2;66
5215306;Orizona;5215603;Padre Bernardo;1;1;2;209
1707306;Dueré;5215504;Ouvidor;1;1;2;777
5201108;Anápolis;5215405;Ouro Verde de Goiás;1;1;2;28
3104007;Araxá;5215306;Orizona;1;1;2;318
3106200;Belo Horizonte;5215306;Orizona;1;1;2;562
3524105;Ituverava;5215306;Orizona;1;1;2;370
3534401;Osasco;5215306;Orizona;1;1;2;738
3548005;Santo Antônio de Posse;5215306;Orizona;1;1;2;635
5201108;Anápolis;5215306;Orizona;1;1;2;105
5205109;Catalão;5215306;Orizona;1;1;2;130
5208707;Goiânia;5215306;Orizona;1;1;2;112
5211909;Jataí;5215306;Orizona;1;1;2;376
3529302;Matão;5215256;Novo Planalto;1;1;2;933
5207501;Estrela do Norte;5215256;Novo Planalto;1;1;2;83
1100288;Rolim de Moura;5215231;Novo Gama;1;1;2;1523
3119302;Coromandel;5215231;Novo Gama;1;1;2;281
3143104;Monte Carmelo;5215231;Novo Gama;1;1;2;301
3304557;Rio de Janeiro;5215231;Novo Gama;1;1;2;917
3534401;Osasco;5215231;Novo Gama;1;1;2;839
5200258;Águas Lindas de Goiás;5215231;Novo Gama;1;1;2;42
5211008;Itapirapuã;5215207;Novo Brasil;1;1;2;22
3161205;São Francisco de Paula;5215009;Nova Veneza;1;1;2;671
3550308;São Paulo;5215009;Nova Veneza;1;1;2;857
5201405;Aparecida de Goiânia;5215009;Nova Veneza;1;1;2;49
5204854;Campo Limpo de Goiás;5215009;Nova Veneza;1;1;2;26
3205002;Serra;5214903;Nova Roma;1;1;2;1006
3157807;Santa Luzia;5214861;Nova Glória;1;1;2;806
3534401;Osasco;5214861;Nova Glória;1;1;2;978
5211909;Jataí;5214861;Nova Glória;1;1;2;383
5214606;Niquelândia;5214861;Nova Glória;1;1;2;139
3170206;Uberlândia;5214838;Nova Crixás;1;1;2;578
3543907;Rio Claro;5214838;Nova Crixás;1;1;2;969
5202502;Aruanã;5214838;Nova Crixás;1;1;2;119
5211909;Jataí;5214838;Nova Crixás;1;1;2;446
5205901;Corumbaíba;5214804;Nova Aurora;1;1;2;34
3550308;São Paulo;5214705;Nova América;1;1;2;1020
5203939;Buriti de Goiás;5214705;Nova América;1;1;2;141
3106200;Belo Horizonte;5214606;Niquelândia;1;1;2;777
3118601;Contagem;5214606;Niquelândia;1;1;2;771
3126307;Fortaleza de Minas;5214606;Niquelândia;1;1;2;732
3157807;Santa Luzia;5214606;Niquelândia;1;1;2;775
3164704;São Sebastião do Paraíso;5214606;Niquelândia;1;1;2;734
3170206;Uberlândia;5214606;Niquelândia;1;1;2;491
3304557;Rio de Janeiro;5214606;Niquelândia;1;1;2;1095
3526902;Limeira;5214606;Niquelândia;1;1;2;904
3534401;Osasco;5214606;Niquelândia;1;1;2;1021
4314902;Porto Alegre;5214606;Niquelândia;1;1;2;1753
5106752;Pontes e Lacerda;5214606;Niquelândia;1;1;2;1176
5200605;Alto Paraíso de Goiás;5214606;Niquelândia;1;1;2;111
5201306;Anicuns;5214606;Niquelândia;1;1;2;276
5204904;Campos Belos;5214606;Niquelândia;1;1;2;247
5205000;Carmo do Rio Verde;5214606;Niquelândia;1;1;2;165
5205109;Catalão;5214606;Niquelândia;1;1;2;413
5206404;Crixás;5214606;Niquelândia;1;1;2;162
5208608;Goianésia;5214606;Niquelândia;1;1;2;117
5210109;Ipameri;5214606;Niquelândia;1;1;2;363
5211800;Jaraguá;5214606;Niquelândia;1;1;2;172
5211909;Jataí;5214606;Niquelândia;1;1;2;517
5212501;Luziânia;5214606;Niquelândia;1;1;2;206
5213087;Minaçu;5214606;Niquelândia;1;1;2;108
1716505;Pedro Afonso;5214507;Nerópolis;1;1;2;826
3301702;Duque de Caxias;5214507;Nerópolis;1;1;2;953
3513801;Diadema;5214507;Nerópolis;1;1;2;854
3534401;Osasco;5214507;Nerópolis;1;1;2;832
3547304;Santana de Parnaíba;5214507;Nerópolis;1;1;2;819
4207007;Içara;5214507;Nerópolis;1;1;2;1364
5203609;Brazabrantes;5214507;Nerópolis;1;1;2;18
5204508;Caldas Novas;5214507;Nerópolis;1;1;2;161
5206404;Crixás;5214507;Nerópolis;1;1;2;222
5211909;Jataí;5214507;Nerópolis;1;1;2;314
3170206;Uberlândia;5214408;Nazário;1;1;2;310
3511003;Castilho;5214408;Nazário;1;1;2;506
3530508;Mococa;5214408;Nazário;1;1;2;622
3550308;São Paulo;5214408;Nazário;1;1;2;858
4208005;Itá;5214408;Nazário;1;1;2;1216
5006309;Paranaíba;5214408;Nazário;1;1;2;367
5202809;Avelinópolis;5214408;Nazário;1;1;2;18
5207808;Firminópolis;5214408;Nazário;1;1;2;45
5208707;Goiânia;5214408;Nazário;1;1;2;65
5208608;Goianésia;5214101;Mutunópolis;1;1;2;176
3550308;São Paulo;5214051;Mundo Novo;1;1;2;1166
5201108;Anápolis;5214051;Mundo Novo;1;1;2;317
1505437;Ourilândia do Norte;5214002;Mozarlândia;1;1;2;885
3304557;Rio de Janeiro;5214002;Mozarlândia;1;1;2;1209
3511003;Castilho;5214002;Mozarlândia;1;1;2;686
3534302;Orlândia;5214002;Mozarlândia;1;1;2;725
3534401;Osasco;5214002;Mozarlândia;1;1;2;1059
5103106;Cocalinho;5214002;Mozarlândia;1;1;2;58
5202502;Aruanã;5214002;Mozarlândia;1;1;2;56
5203807;Britânia;5214002;Mozarlândia;1;1;2;83
5210000;Inhumas;5214002;Mozarlândia;1;1;2;215
5211909;Jataí;5214002;Mozarlândia;1;1;2;370
3550308;São Paulo;5213905;Mossâmedes;1;1;2;920
3139003;Machado;5213806;Morrinhos;1;1;2;556
3143104;Monte Carmelo;5213806;Morrinhos;1;1;2;204
3170206;Uberlândia;5213806;Morrinhos;1;1;2;159
3502101;Andradina;5213806;Morrinhos;1;1;2;431
3505708;Barueri;5213806;Morrinhos;1;1;2;685
3534302;Orlândia;5213806;Morrinhos;1;1;2;357
3534401;Osasco;5213806;Morrinhos;1;1;2;690
3549409;São Joaquim da Barra;5213806;Morrinhos;1;1;2;345
4204301;Concórdia;5213806;Morrinhos;1;1;2;1098
4314902;Porto Alegre;5213806;Morrinhos;1;1;2;1384
5200209;Água Limpa;5213806;Morrinhos;1;1;2;54
5200506;Aloândia;5213806;Morrinhos;1;1;2;38
5201405;Aparecida de Goiânia;5213806;Morrinhos;1;1;2;102
5207352;Edealina;5213806;Morrinhos;1;1;2;67
5207402;Edéia;5213806;Morrinhos;1;1;2;96
5209952;Indiara;5213806;Morrinhos;1;1;2;112
1715754;Palmeirópolis;5213772;Montividiu do Norte;1;1;2;24
3205002;Serra;5213772;Montividiu do Norte;1;1;2;1200
5212808;Mara Rosa;5213772;Montividiu do Norte;1;1;2;118
3524303;Jaboticabal;5213756;Montividiu;1;1;2;523
3526902;Limeira;5213756;Montividiu;1;1;2;698
3537800;Piedade;5213756;Montividiu;1;1;2;804
3544004;Rio das Pedras;5213756;Montividiu;1;1;2;711
4205902;Gaspar;5213756;Montividiu;1;1;2;1078
4207007;Içara;5213756;Montividiu;1;1;2;1266
4208203;Itajaí;5213756;Montividiu;1;1;2;1085
5208707;Goiânia;5213756;Montividiu;1;1;2;217
5211503;Itumbiara;5213756;Montividiu;1;1;2;230
5211909;Jataí;5213756;Montividiu;1;1;2;76
3534401;Osasco;5213707;Montes Claros de Goiás;1;1;2;973
3547809;Santo André;5213707;Montes Claros de Goiás;1;1;2;999
5203401;Bom Jardim de Goiás;5213707;Montes Claros de Goiás;1;1;2;86
5207253;Doverlândia;5213707;Montes Claros de Goiás;1;1;2;127
5208707;Goiânia;5213707;Montes Claros de Goiás;1;1;2;238
5209705;Hidrolândia;5213707;Montes Claros de Goiás;1;1;2;255
5212204;Jussara;5213707;Montes Claros de Goiás;1;1;2;58
3550308;São Paulo;5213509;Monte Alegre de Goiás;1;1;2;1148
5205307;Cavalcante;5213509;Monte Alegre de Goiás;1;1;2;84
3143104;Monte Carmelo;5213103;Mineiros;1;1;2;554
3506003;Bauru;5213103;Mineiros;1;1;2;648
3530607;Moji das Cruzes;5213103;Mineiros;1;1;2;957
3534401;Osasco;5213103;Mineiros;1;1;2;909
3541604;Promissão;5213103;Mineiros;1;1;2;527
4104659;Carambeí;5213103;Mineiros;1;1;2;857
4205902;Gaspar;5213103;Mineiros;1;1;2;1110
4311809;Marau;5213103;Mineiros;1;1;2;1206
5003256;Costa Rica;5213103;Mineiros;1;1;2;122
5006309;Paranaíba;5213103;Mineiros;1;1;2;273
5100409;Alto Garças;5213103;Mineiros;1;1;2;125
5103403;Cuiabá;5213103;Mineiros;1;1;2;435
5105101;Juara;5213103;Mineiros;1;1;2;868
5106703;Ponte Branca;5213103;Mineiros;1;1;2;100
5107602;Rondonópolis;5213103;Mineiros;1;1;2;256
5200258;Águas Lindas de Goiás;5213103;Mineiros;1;1;2;494
5204300;Caçu;5213103;Mineiros;1;1;2;188
5204409;Caiapônia;5213103;Mineiros;1;1;2;103
5205471;Chapadão do Céu;5213103;Mineiros;1;1;2;93
5207253;Doverlândia;5213103;Mineiros;1;1;2;97
5209705;Hidrolândia;5213103;Mineiros;1;1;2;360
5211503;Itumbiara;5213103;Mineiros;1;1;2;363
1505536;Parauapebas;5213087;Minaçu;1;1;2;850
2925105;Poções;5213087;Minaçu;1;1;2;860
3143104;Monte Carmelo;5213087;Minaçu;1;1;2;581
3170206;Uberlândia;5213087;Minaçu;1;1;2;595
3509502;Campinas;5213087;Minaçu;1;1;2;1046
3534401;Osasco;5213087;Minaçu;1;1;2;1119
4105409;Chopinzinho;5213087;Minaçu;1;1;2;1448
4211900;Palhoça;5213087;Minaçu;1;1;2;1565
5204656;Campinaçu;5213087;Minaçu;1;1;2;50
5211909;Jataí;5213087;Minaçu;1;1;2;617
3550308;São Paulo;5213053;Mimoso de Goiás;1;1;2;966
1508084;Tucumã;5213004;Maurilândia;1;1;2;1245
3109402;Buritizeiro;5213004;Maurilândia;1;1;2;572
3121605;Diamantina;5213004;Maurilândia;1;1;2;714
3170206;Uberlândia;5213004;Maurilândia;1;1;2;243
3506359;Bertioga;5213004;Maurilândia;1;1;2;789
3517406;Guaíra;5213004;Maurilândia;1;1;2;338
3534401;Osasco;5213004;Maurilândia;1;1;2;725
3550308;São Paulo;5213004;Maurilândia;1;1;2;744
5208707;Goiânia;5213004;Maurilândia;1;1;2;181
3543402;Ribeirão Preto;5212956;Matrinchã;1;1;2;709
5208707;Goiânia;5212956;Matrinchã;1;1;2;209
5211008;Itapirapuã;5212956;Matrinchã;1;1;2;47
3170206;Uberlândia;5212907;Marzagão;1;1;2;109
2903201;Barreiras;5212808;Mara Rosa;1;1;2;493
3144805;Nova Lima;5212808;Mara Rosa;1;1;2;884
3534401;Osasco;5212808;Mara Rosa;1;1;2;1086
5204706;Campinorte;5212808;Mara Rosa;1;1;2;33
5207501;Estrela do Norte;5212808;Mara Rosa;1;1;2;20
5210000;Inhumas;5212808;Mara Rosa;1;1;2;265
2908101;Cocos;5212709;Mambaí;1;1;2;173
3109303;Buritis;5212709;Mambaí;1;1;2;131
4106902;Curitiba;5212709;Mambaí;1;1;2;1262
5200803;Alvorada do Norte;5212709;Mambaí;1;1;2;42
5206701;Damianópolis;5212709;Mambaí;1;1;2;11
5207907;Flores de Goiás;5212709;Mambaí;1;1;2;94
5208707;Goiânia;5212709;Mambaí;1;1;2;422
1302603;Manaus;5212501;Luziânia;1;1;2;1926
1503606;Itaituba;5212501;Luziânia;1;1;2;1575
1715754;Palmeirópolis;5212501;Luziânia;1;1;2;358
2111300;São Luís;5212501;Luziânia;1;1;2;1567
2304400;Fortaleza;5212501;Luziânia;1;1;2;1696
2607901;Jaboatão dos Guararapes;5212501;Luziânia;1;1;2;1629
2903904;Bom Jesus da Lapa;5212501;Luziânia;1;1;2;586
2919553;Luís Eduardo magalhães;5212501;Luziânia;1;1;2;512
2930709;Simões Filho;5212501;Luziânia;1;1;2;1082
3136306;João Pinheiro;5212501;Luziânia;1;1;2;249
3143104;Monte Carmelo;5212501;Luziânia;1;1;2;277
3157807;Santa Luzia;5212501;Luziânia;1;1;2;588
3202504;Ibiraçu;5212501;Luziânia;1;1;2;908
3301702;Duque de Caxias;5212501;Luziânia;1;1;2;879
3304110;Porto Real;5212501;Luziânia;1;1;2;785
3304201;Resende;5212501;Luziânia;1;1;2;790
3510401;Capivari;5212501;Luziânia;1;1;2;747
3512407;Cordeirópolis;5212501;Luziânia;1;1;2;691
3540002;Pompéia;5212501;Luziânia;1;1;2;692
3543907;Rio Claro;5212501;Luziânia;1;1;2;682
3548500;Santos;5212501;Luziânia;1;1;2;863
3552205;Sorocaba;5212501;Luziânia;1;1;2;801
4104808;Cascavel;5212501;Luziânia;1;1;2;1137
4202008;Balneário Camboriú;5212501;Luziânia;1;1;2;1191
4204608;Criciúma;5212501;Luziânia;1;1;2;1383
4205902;Gaspar;5212501;Luziânia;1;1;2;1187
4208203;Itajaí;5212501;Luziânia;1;1;2;1186
4308607;Garibaldi;5212501;Luziânia;1;1;2;1494
4309308;Guaíba;5212501;Luziânia;1;1;2;1581
4314902;Porto Alegre;5212501;Luziânia;1;1;2;1571
5107602;Rondonópolis;5212501;Luziânia;1;1;2;720
5107925;Sorriso;5212501;Luziânia;1;1;2;924
5108402;Várzea Grande;5212501;Luziânia;1;1;2;881
5200175;Água Fria de Goiás;5212501;Luziânia;1;1;2;142
5205406;Ceres;5212501;Luziânia;1;1;2;211
5208608;Goianésia;5212501;Luziânia;1;1;2;163
5208400;Goianápolis;5212303;Leopoldo de Bulhões;1;1;2;32
5208707;Goiânia;5212303;Leopoldo de Bulhões;1;1;2;58
3511102;Catanduva;5212253;Lagoa Santa;1;1;2;334
3553401;Tanabi;5212253;Lagoa Santa;1;1;2;243
5107180;Ribeirão Cascalheira;5212253;Lagoa Santa;1;1;2;690
5201504;Aporé;5212253;Lagoa Santa;1;1;2;61
1100304;Vilhena;5212204;Jussara;1;1;2;1046
1721000;Palmas;5212204;Jussara;1;1;2;665
3143104;Monte Carmelo;5212204;Jussara;1;1;2;481
3170206;Uberlândia;5212204;Jussara;1;1;2;437
3501004;Altinópolis;5212204;Jussara;1;1;2;685
3534401;Osasco;5212204;Jussara;1;1;2;958
3543402;Ribeirão Preto;5212204;Jussara;1;1;2;673
3551702;Sertãozinho;5212204;Jussara;1;1;2;661
5207808;Firminópolis;5212204;Jussara;1;1;2;99
5210901;Itapaci;5212204;Jussara;1;1;2;174
5200506;Aloândia;5212105;Joviânia;1;1;2;17
5203500;Bom Jesus de Goiás;5212105;Joviânia;1;1;2;48
5211503;Itumbiara;5212105;Joviânia;1;1;2;75
1504208;Marabá;5211909;Jataí;1;1;2;1413
1703909;Caseara;5211909;Jataí;1;1;2;971
1709500;Gurupi;5211909;Jataí;1;1;2;739
1721000;Palmas;5211909;Jataí;1;1;2;904
2304400;Fortaleza;5211909;Jataí;1;1;2;2071
2806107;Rosário do Catete;5211909;Jataí;1;1;2;1725
2927408;Salvador;5211909;Jataí;1;1;2;1488
3111101;Campina Verde;5211909;Jataí;1;1;2;296
3118601;Contagem;5211909;Jataí;1;1;2;842
3119302;Coromandel;5211909;Jataí;1;1;2;482
3127107;Frutal;5211909;Jataí;1;1;2;380
3134202;Ituiutaba;5211909;Jataí;1;1;2;266
3134400;Iturama;5211909;Jataí;1;1;2;258
3136702;Juiz de Fora;5211909;Jataí;1;1;2;993
3138625;Limeira do Oeste;5211909;Jataí;1;1;2;218
3143104;Monte Carmelo;5211909;Jataí;1;1;2;455
3152808;Prata;5211909;Jataí;1;1;2;329
3306008;Três Rios;5211909;Jataí;1;1;2;1019
3503307;Araras;5211909;Jataí;1;1;2;678
3506003;Bauru;5211909;Jataí;1;1;2;566
3511102;Catanduva;5211909;Jataí;1;1;2;462
3514403;Dracena;5211909;Jataí;1;1;2;401
3518800;Guarulhos;5211909;Jataí;1;1;2;826
3530805;Moji-Mirim;5211909;Jataí;1;1;2;714
3534708;Ourinhos;5211909;Jataí;1;1;2;595
3534906;Pacaembu;5211909;Jataí;1;1;2;408
3538709;Piracicaba;5211909;Jataí;1;1;2;692
3540804;Potirendaba;5211909;Jataí;1;1;2;427
3543402;Ribeirão Preto;5211909;Jataí;1;1;2;551
3548807;São Caetano do Sul;5211909;Jataí;1;1;2;840
3549805;São José do Rio Preto;5211909;Jataí;1;1;2;407
4104808;Cascavel;5211909;Jataí;1;1;2;803
4201406;Araranguá;5211909;Jataí;1;1;2;1247
4204707;Cunha Porã;5211909;Jataí;1;1;2;1008
4210407;Maracajá;5211909;Jataí;1;1;2;1237
4314902;Porto Alegre;5211909;Jataí;1;1;2;1347
4318705;São Leopoldo;5211909;Jataí;1;1;2;1314
5002704;Campo Grande;5211909;Jataí;1;1;2;421
5002902;Cassilândia;5211909;Jataí;1;1;2;137
5002951;Chapadão do Sul;5211909;Jataí;1;1;2;140
5100201;Água Boa;5211909;Jataí;1;1;2;430
5102603;Campinápolis;5211909;Jataí;1;1;2;395
5102637;Campo Novo do Parecis;5211909;Jataí;1;1;2;801
5102678;Campo Verde;5211909;Jataí;1;1;2;450
5104203;Guiratinga;5211909;Jataí;1;1;2;277
5104609;Itiquira;5211909;Jataí;1;1;2;270
5105200;Juscimeira;5211909;Jataí;1;1;2;395
5106224;Nova Mutum;5211909;Jataí;1;1;2;643
5106307;Paranatinga;5211909;Jataí;1;1;2;455
5106372;Pedra Preta;5211909;Jataí;1;1;2;326
5107180;Ribeirão Cascalheira;5211909;Jataí;1;1;2;549
5107958;Tangará da Serra;5211909;Jataí;1;1;2;708
5108204;Torixoréu;5211909;Jataí;1;1;2;211
5200258;Águas Lindas de Goiás;5211909;Jataí;1;1;2;431
5200308;Alexânia;5211909;Jataí;1;1;2;393
5201306;Anicuns;5211909;Jataí;1;1;2;241
5201702;Aragarças;5211909;Jataí;1;1;2;230
5203203;Barro Alto;5211909;Jataí;1;1;2;438
5203401;Bom Jardim de Goiás;5211909;Jataí;1;1;2;194
5203500;Bom Jesus de Goiás;5211909;Jataí;1;1;2;207
5204706;Campinorte;5211909;Jataí;1;1;2;478
5205406;Ceres;5211909;Jataí;1;1;2;364
5205455;Cezarina;5211909;Jataí;1;1;2;228
5205471;Chapadão do Céu;5211909;Jataí;1;1;2;105
5206206;Cristalina;5211909;Jataí;1;1;2;440
5207600;Fazenda Nova;5211909;Jataí;1;1;2;214
5207808;Firminópolis;5211909;Jataí;1;1;2;208
5208806;Goianira;5211909;Jataí;1;1;2;283
5208905;Goiás;5211909;Jataí;1;1;2;266
5209101;Goiatuba;5211909;Jataí;1;1;2;248
5209705;Hidrolândia;5211909;Jataí;1;1;2;281
5209952;Indiara;5211909;Jataí;1;1;2;200
5210000;Inhumas;5211909;Jataí;1;1;2;284
5210109;Ipameri;5211909;Jataí;1;1;2;376
5210406;Itaberaí;5211909;Jataí;1;1;2;285
5211008;Itapirapuã;5211909;Jataí;1;1;2;254
5211206;Itapuranga;5211909;Jataí;1;1;2;322
5211305;Itarumã;5211909;Jataí;1;1;2;103
5211404;Itauçu;5211909;Jataí;1;1;2;290
5211800;Jaraguá;5211909;Jataí;1;1;2;343
1100155;Ouro Preto do Oeste;5211800;Jaraguá;1;1;2;1481
1502400;Castanhal;5211800;Jaraguá;1;1;2;1607
1721000;Palmas;5211800;Jaraguá;1;1;2;607
3118601;Contagem;5211800;Jaraguá;1;1;2;733
3143104;Monte Carmelo;5211800;Jaraguá;1;1;2;384
3304557;Rio de Janeiro;5211800;Jaraguá;1;1;2;1032
3509502;Campinas;5211800;Jaraguá;1;1;2;829
3549805;São José do Rio Preto;5211800;Jaraguá;1;1;2;560
4106902;Curitiba;5211800;Jaraguá;1;1;2;1071
5107602;Rondonópolis;5211800;Jaraguá;1;1;2;575
5205109;Catalão;5211800;Jaraguá;1;1;2;306
5208103;Formoso;5211800;Jaraguá;1;1;2;237
5208905;Goiás;5211800;Jaraguá;1;1;2;93
3534401;Osasco;5211701;Jandaia;1;1;2;805
5103353;Confresa;5211701;Jandaia;1;1;2;724
3550308;São Paulo;5211602;Ivolândia;1;1;2;902
1503606;Itaituba;5211503;Itumbiara;1;1;2;1713
1504208;Marabá;5211503;Itumbiara;1;1;2;1441
1709500;Gurupi;5211503;Itumbiara;1;1;2;740
2104057;Estreito;5211503;Itumbiara;1;1;2;1322
2304400;Fortaleza;5211503;Itumbiara;1;1;2;1957
2905701;Camaçari;5211503;Itumbiara;1;1;2;1302
2909307;Correntina;5211503;Itumbiara;1;1;2;738
3104007;Araxá;5211503;Itumbiara;1;1;2;278
3111804;Canápolis;5211503;Itumbiara;1;1;2;37
3128600;Guarda-Mor;5211503;Itumbiara;1;1;2;238
3133808;Itaúna;5211503;Itumbiara;1;1;2;531
3136702;Juiz de Fora;5211503;Itumbiara;1;1;2;734
3143104;Monte Carmelo;5211503;Itumbiara;1;1;2;189
3147006;Paracatu;5211503;Itumbiara;1;1;2;278
3148004;Patos de Minas;5211503;Itumbiara;1;1;2;292
3152808;Prata;5211503;Itumbiara;1;1;2;106
3170701;Varginha;5211503;Itumbiara;1;1;2;536
3201308;Cariacica;5211503;Itumbiara;1;1;2;960
3301702;Duque de Caxias;5211503;Itumbiara;1;1;2;800
3306008;Três Rios;5211503;Itumbiara;1;1;2;761
3502101;Andradina;5211503;Itumbiara;1;1;2;362
3502309;Anhembi;5211503;Itumbiara;1;1;2;502
3503000;Aramina;5211503;Itumbiara;1;1;2;240
3503307;Araras;5211503;Itumbiara;1;1;2;483
3505906;Batatais;5211503;Itumbiara;1;1;2;327
3506003;Bauru;5211503;Itumbiara;1;1;2;437
3509007;Caieiras;5211503;Itumbiara;1;1;2;613
3513009;Cotia;5211503;Itumbiara;1;1;2;629
3513801;Diadema;5211503;Itumbiara;1;1;2;651
3516200;Franca;5211503;Itumbiara;1;1;2;309
3517406;Guaíra;5211503;Itumbiara;1;1;2;235
3518404;Guaratinguetá;5211503;Itumbiara;1;1;2;657
3520103;Igarapava;5211503;Itumbiara;1;1;2;243
3527108;Lins;5211503;Itumbiara;1;1;2;368
3529005;Marília;5211503;Itumbiara;1;1;2;430
3529302;Matão;5211503;Itumbiara;1;1;2;366
3534302;Orlândia;5211503;Itumbiara;1;1;2;296
3536703;Pederneiras;5211503;Itumbiara;1;1;2;441
3538709;Piracicaba;5211503;Itumbiara;1;1;2;512
3539400;Piratininga;5211503;Itumbiara;1;1;2;445
3540200;Pontal;5211503;Itumbiara;1;1;2;319
3543402;Ribeirão Preto;5211503;Itumbiara;1;1;2;343
3548500;Santos;5211503;Itumbiara;1;1;2;685
3548708;São Bernardo do Campo;5211503;Itumbiara;1;1;2;656
3548807;São Caetano do Sul;5211503;Itumbiara;1;1;2;646
3551504;Serrana;5211503;Itumbiara;1;1;2;359
4103701;Cambé;5211503;Itumbiara;1;1;2;584
4122404;Rolândia;5211503;Itumbiara;1;1;2;589
4126256;Sarandi;5211503;Itumbiara;1;1;2;625
4202404;Blumenau;5211503;Itumbiara;1;1;2;947
4204301;Concórdia;5211503;Itumbiara;1;1;2;1022
4208203;Itajaí;5211503;Itumbiara;1;1;2;948
4211306;Navegantes;5211503;Itumbiara;1;1;2;941
4214805;Rio do Sul;5211503;Itumbiara;1;1;2;980
4216602;São José;5211503;Itumbiara;1;1;2;1019
4304200;Candelária;5211503;Itumbiara;1;1;2;1311
4305108;Caxias do Sul;5211503;Itumbiara;1;1;2;1210
5003256;Costa Rica;5211503;Itumbiara;1;1;2;414
5100201;Água Boa;5211503;Itumbiara;1;1;2;570
5100607;Alto Taquari;5211503;Itumbiara;1;1;2;431
5102702;Canarana;5211503;Itumbiara;1;1;2;622
5103403;Cuiabá;5211503;Itumbiara;1;1;2;783
5103858;Gaúcha do Norte;5211503;Itumbiara;1;1;2;696
5106224;Nova Mutum;5211503;Itumbiara;1;1;2;873
5107065;Querência;5211503;Itumbiara;1;1;2;731
5107909;Sinop;5211503;Itumbiara;1;1;2;971
5107925;Sorriso;5211503;Itumbiara;1;1;2;936
5204409;Caiapônia;5211503;Itumbiara;1;1;2;315
5204805;Campo Alegre de Goiás;5211503;Itumbiara;1;1;2;177
5205471;Chapadão do Céu;5211503;Itumbiara;1;1;2;347
5209150;Gouvelândia;5211503;Itumbiara;1;1;2;92
5209705;Hidrolândia;5211503;Itumbiara;1;1;2;159
5210109;Ipameri;5211503;Itumbiara;1;1;2;138
3170206;Uberlândia;5211404;Itauçu;1;1;2;332
3505500;Barretos;5211404;Itauçu;1;1;2;494
3550308;São Paulo;5211404;Itauçu;1;1;2;886
5208707;Goiânia;5211404;Itauçu;1;1;2;65
3134202;Ituiutaba;5211305;Itarumã;1;1;2;200
3170107;Uberaba;5211305;Itarumã;1;1;2;378
3541406;Presidente Prudente;5211305;Itarumã;1;1;2;373
3550308;São Paulo;5211305;Itarumã;1;1;2;739
5006309;Paranaíba;5211305;Itarumã;1;1;2;98
2604809;Cortês;5211206;Itapuranga;1;1;2;1713
3143104;Monte Carmelo;5211206;Itapuranga;1;1;2;443
3534401;Osasco;5211206;Itapuranga;1;1;2;953
3543402;Ribeirão Preto;5211206;Itapuranga;1;1;2;667
4115200;Maringá;5211206;Itapuranga;1;1;2;903
5101803;Barra do Garças;5211206;Itapuranga;1;1;2;251
5208905;Goiás;5211206;Itapuranga;1;1;2;58
5210406;Itaberaí;5211206;Itapuranga;1;1;2;60
5201405;Aparecida de Goiânia;5211008;Itapirapuã;1;1;2;180
2604809;Cortês;5210901;Itapaci;1;1;2;1653
3304557;Rio de Janeiro;5210901;Itapaci;1;1;2;1119
3525904;Jundiaí;5210901;Itapaci;1;1;2;958
3534401;Osasco;5210901;Itapaci;1;1;2;999
3543402;Ribeirão Preto;5210901;Itapaci;1;1;2;715
5205406;Ceres;5210901;Itapaci;1;1;2;38
5205901;Corumbaíba;5210901;Itapaci;1;1;2;371
5209457;Guarinos;5210901;Itapaci;1;1;2;27
1100155;Ouro Preto do Oeste;5210802;Itajá;1;1;2;1443
1501402;Belém;5210802;Itajá;1;1;2;1983
3107406;Bom Despacho;5210802;Itajá;1;1;2;665
3134202;Ituiutaba;5210802;Itajá;1;1;2;219
3550308;São Paulo;5210802;Itajá;1;1;2;727
5002902;Cassilândia;5210802;Itajá;1;1;2;24
5002951;Chapadão do Sul;5210802;Itajá;1;1;2;119
5003702;Dourados;5210802;Itajá;1;1;2;492
5006309;Paranaíba;5210802;Itajá;1;1;2;72
5204102;Cachoeira Alta;5210802;Itajá;1;1;2;71
5208707;Goiânia;5210802;Itajá;1;1;2;353
5208707;Goiânia;5210604;Itaguaru;1;1;2;110
5210406;Itaberaí;5210604;Itaguaru;1;1;2;39
5210406;Itaberaí;5210562;Itaguari;1;1;2;28
1500800;Ananindeua;5210406;Itaberaí;1;1;2;1631
3143104;Monte Carmelo;5210406;Itaberaí;1;1;2;388
3534401;Osasco;5210406;Itaberaí;1;1;2;893
3541406;Presidente Prudente;5210406;Itaberaí;1;1;2;695
4106902;Curitiba;5210406;Itaberaí;1;1;2;1041
5107909;Sinop;5210406;Itaberaí;1;1;2;759
5201306;Anicuns;5210406;Itaberaí;1;1;2;51
5205000;Carmo do Rio Verde;5210406;Itaberaí;1;1;2;78
5205208;Caturaí;5210406;Itaberaí;1;1;2;57
5208608;Goianésia;5210406;Itaberaí;1;1;2;111
5207808;Firminópolis;5210307;Israelândia;1;1;2;71
5208905;Goiás;5210307;Israelândia;1;1;2;85
5210208;Iporá;5210307;Israelândia;1;1;2;27
1100098;Espigão d'Oeste;5210208;Iporá;1;1;2;1178
3143104;Monte Carmelo;5210208;Iporá;1;1;2;463
3205002;Serra;5210208;Iporá;1;1;2;1237
3304557;Rio de Janeiro;5210208;Iporá;1;1;2;1113
3534401;Osasco;5210208;Iporá;1;1;2;916
5100201;Água Boa;5210208;Iporá;1;1;2;288
5200902;Amorinópolis;5210208;Iporá;1;1;2;19
5201108;Anápolis;5210208;Iporá;1;1;2;233
5207253;Doverlândia;5210208;Iporá;1;1;2;131
5210000;Inhumas;5210208;Iporá;1;1;2;170
1507300;São Félix do Xingu;5210109;Ipameri;1;1;2;1283
3143104;Monte Carmelo;5210109;Ipameri;1;1;2;130
3170206;Uberlândia;5210109;Ipameri;1;1;2;130
3534401;Osasco;5210109;Ipameri;1;1;2;659
3548708;São Bernardo do Campo;5210109;Ipameri;1;1;2;685
5206206;Cristalina;5210109;Ipameri;1;1;2;111
5210000;Inhumas;5210109;Ipameri;1;1;2;208
1100122;Ji-Paraná;5210000;Inhumas;1;1;2;1438
1200401;Rio Branco;5210000;Inhumas;1;1;2;2054
1504208;Marabá;5210000;Inhumas;1;1;2;1220
1713304;Miranorte;5210000;Inhumas;1;1;2;767
2111300;São Luís;5210000;Inhumas;1;1;2;1629
3111804;Canápolis;5210000;Inhumas;1;1;2;261
3115805;Centralina;5210000;Inhumas;1;1;2;245
3143104;Monte Carmelo;5210000;Inhumas;1;1;2;338
3513702;Descalvado;5210000;Inhumas;1;1;2;645
3530607;Moji das Cruzes;5210000;Inhumas;1;1;2;874
3534401;Osasco;5210000;Inhumas;1;1;2;846
3536505;Paulínia;5210000;Inhumas;1;1;2;752
3548807;São Caetano do Sul;5210000;Inhumas;1;1;2;863
3548906;São Carlos;5210000;Inhumas;1;1;2;649
4106902;Curitiba;5210000;Inhumas;1;1;2;1002
4303905;Campo Bom;5210000;Inhumas;1;1;2;1482
5004700;Ivinhema;5210000;Inhumas;1;1;2;804
5103403;Cuiabá;5210000;Inhumas;1;1;2;706
5107040;Primavera do Leste;5210000;Inhumas;1;1;2;522
5200100;Abadiânia;5210000;Inhumas;1;1;2;90
5201108;Anápolis;5210000;Inhumas;1;1;2;63
5202155;Araguapaz;5210000;Inhumas;1;1;2;185
5203302;Bela Vista de Goiás;5210000;Inhumas;1;1;2;90
5203906;Buriti Alegre;5210000;Inhumas;1;1;2;202
5204656;Campinaçu;5210000;Inhumas;1;1;2;303
5205208;Caturaí;5210000;Inhumas;1;1;2;8
5207352;Edealina;5210000;Inhumas;1;1;2;116
5207402;Edéia;5210000;Inhumas;1;1;2;116
5208905;Goiás;5210000;Inhumas;1;1;2;83
5209200;Guapó;5210000;Inhumas;1;1;2;49
3534401;Osasco;5209952;Indiara;1;1;2;788
3550308;São Paulo;5209952;Indiara;1;1;2;807
5205455;Cezarina;5209952;Indiara;1;1;2;29
3170206;Uberlândia;5209937;Inaciolândia;1;1;2;188
3503307;Araras;5209937;Inaciolândia;1;1;2;511
3550308;São Paulo;5209937;Inaciolândia;1;1;2;675
5208707;Goiânia;5209937;Inaciolândia;1;1;2;212
1703867;Cariri do Tocantins;5209903;Iaciara;1;1;2;370
1707652;Figueirópolis;5209903;Iaciara;1;1;2;356
3511003;Castilho;5209903;Iaciara;1;1;2;921
3534401;Osasco;5209903;Iaciara;1;1;2;1043
3550308;São Paulo;5209804;Hidrolina;1;1;2;1036
5208707;Goiânia;5209804;Hidrolina;1;1;2;219
3304557;Rio de Janeiro;5209705;Hidrolândia;1;1;2;921
3534401;Osasco;5209705;Hidrolândia;1;1;2;774
3549805;São José do Rio Preto;5209705;Hidrolândia;1;1;2;428
3553708;Taquaritinga;5209705;Hidrolândia;1;1;2;501
4102307;Balsa Nova;5209705;Hidrolândia;1;1;2;956
4120804;Quatro Barras;5209705;Hidrolândia;1;1;2;931
4311809;Marau;5209705;Hidrolândia;1;1;2;1314
5200902;Amorinópolis;5209705;Hidrolândia;1;1;2;202
5201405;Aparecida de Goiânia;5209705;Hidrolândia;1;1;2;17
5207253;Doverlândia;5209705;Hidrolândia;1;1;2;330
2909307;Correntina;5209408;Guarani de Goiás;1;1;2;209
3550308;São Paulo;5209408;Guarani de Goiás;1;1;2;1076
5208004;Formosa;5209408;Guarani de Goiás;1;1;2;200
3113206;Carandaí;5209200;Guapó;1;1;2;763
3534401;Osasco;5209200;Guapó;1;1;2;800
5201405;Aparecida de Goiânia;5209200;Guapó;1;1;2;29
3111804;Canápolis;5209150;Gouvelândia;1;1;2;95
3205309;Vitória;5209150;Gouvelândia;1;1;2;1055
3503307;Araras;5209150;Gouvelândia;1;1;2;506
1709500;Gurupi;5209101;Goiatuba;1;1;2;698
1718204;Porto Nacional;5209101;Goiatuba;1;1;2;815
3104007;Araxá;5209101;Goiatuba;1;1;2;311
3106200;Belo Horizonte;5209101;Goiatuba;1;1;2;611
3172004;Visconde do Rio Branco;5209101;Goiatuba;1;1;2;773
3549805;São José do Rio Preto;5209101;Goiatuba;1;1;2;312
4104808;Cascavel;5209101;Goiatuba;1;1;2;887
4106902;Curitiba;5209101;Goiatuba;1;1;2;822
4112108;Jandaia do Sul;5209101;Goiatuba;1;1;2;666
4314902;Porto Alegre;5209101;Goiatuba;1;1;2;1349
5103403;Cuiabá;5209101;Goiatuba;1;1;2;759
5103858;Gaúcha do Norte;5209101;Goiatuba;1;1;2;655
5201108;Anápolis;5209101;Goiatuba;1;1;2;192
5203906;Buriti Alegre;5209101;Goiatuba;1;1;2;38
1506161;Rio Maria;5208905;Goiás;1;1;2;959
3104007;Araxá;5208905;Goiás;1;1;2;531
3106200;Belo Horizonte;5208905;Goiás;1;1;2;799
3304557;Rio de Janeiro;5208905;Goiás;1;1;2;1074
3515202;Estrela d'Oeste;5208905;Goiás;1;1;2;477
3534401;Osasco;5208905;Goiás;1;1;2;914
3546603;Santa Fé do Sul;5208905;Goiás;1;1;2;474
3551801;Sete Barras;5208905;Goiás;1;1;2;963
1713304;Miranorte;5208806;Goianira;1;1;2;780
1718451;Pugmil;5208806;Goianira;1;1;2;677
1721000;Palmas;5208806;Goianira;1;1;2;691
3516200;Franca;5208806;Goianira;1;1;2;497
3534401;Osasco;5208806;Goianira;1;1;2;829
3554003;Tatuí;5208806;Goianira;1;1;2;776
5201405;Aparecida de Goiânia;5208806;Goianira;1;1;2;38
1500107;Abaetetuba;5208707;Goiânia;1;1;2;1654
1502152;Canaã dos Carajás;5208707;Goiânia;1;1;2;1130
1502954;Eldorado dos Carajás;5208707;Goiânia;1;1;2;1171
1504422;Marituba;5208707;Goiânia;1;1;2;1699
1505031;Novo Progresso;5208707;Goiânia;1;1;2;1235
1505437;Ourilândia do Norte;5208707;Goiânia;1;1;2;1115
1505502;Paragominas;5208707;Goiânia;1;1;2;1526
1506195;Rurópolis;5208707;Goiânia;1;1;2;1512
1506807;Santarém;5208707;Goiânia;1;1;2;1672
1507300;São Félix do Xingu;5208707;Goiânia;1;1;2;1142
1508159;Uruará;5208707;Goiânia;1;1;2;1511
1600600;Santana;5208707;Goiânia;1;1;2;1856
1702000;Araguaçu;5208707;Goiânia;1;1;2;420
1703107;Barrolândia;5208707;Goiânia;1;1;2;761
1706258;Crixás do Tocantins;5208707;Goiânia;1;1;2;620
1707009;Dianópolis;5208707;Goiânia;1;1;2;615
1707652;Figueirópolis;5208707;Goiânia;1;1;2;505
1713205;Miracema do Tocantins;5208707;Goiânia;1;1;2;795
1714880;Nova Olinda;5208707;Goiânia;1;1;2;1006
1717503;Pium;5208707;Goiânia;1;1;2;692
1718402;Presidente Kennedy;5208707;Goiânia;1;1;2;906
2100501;Alto Parnaíba;5208707;Goiânia;1;1;2;909
2101509;Barão de Grajaú;5208707;Goiânia;1;1;2;1284
2102036;Bom Jesus das Selvas;5208707;Goiânia;1;1;2;1383
2103505;Colinas;5208707;Goiânia;1;1;2;1288
2104057;Estreito;5208707;Goiânia;1;1;2;1137
2106102;Loreto;5208707;Goiânia;1;1;2;1148
2109700;Sambaíba;5208707;Goiânia;1;1;2;1134
2201903;Bom Jesus;5208707;Goiânia;1;1;2;989
2307650;Maracanaú;5208707;Goiânia;1;1;2;1801
2507507;João Pessoa;5208707;Goiânia;1;1;2;1840
2604106;Caruaru;5208707;Goiânia;1;1;2;1675
2607208;Ipojuca;5208707;Goiânia;1;1;2;1751
2613107;São Caitano;5208707;Goiânia;1;1;2;1660
2700300;Arapiraca;5208707;Goiânia;1;1;2;1529
2804805;Nossa Senhora do Socorro;5208707;Goiânia;1;1;2;1432
2903904;Bom Jesus da Lapa;5208707;Goiânia;1;1;2;731
2909307;Correntina;5208707;Goiânia;1;1;2;616
2925303;Porto Seguro;5208707;Goiânia;1;1;2;1082
2930709;Simões Filho;5208707;Goiânia;1;1;2;1229
2932903;Valença;5208707;Goiânia;1;1;2;1138
3103751;Araporã;5208707;Goiânia;1;1;2;193
3104007;Araxá;5208707;Goiânia;1;1;2;407
3105608;Barbacena;5208707;Goiânia;1;1;2;775
3111804;Canápolis;5208707;Goiânia;1;1;2;225
3112604;Capinópolis;5208707;Goiânia;1;1;2;223
3117876;Confins;5208707;Goiânia;1;1;2;655
3119401;Coronel Fabriciano;5208707;Goiânia;1;1;2;781
3122306;Divinópolis;5208707;Goiânia;1;1;2;610
3127701;Governador Valadares;5208707;Goiânia;1;1;2;818
3133808;Itaúna;5208707;Goiânia;1;1;2;631
3136306;João Pinheiro;5208707;Goiânia;1;1;2;350
3137601;Lagoa Santa;5208707;Goiânia;1;1;2;665
3139003;Machado;5208707;Goiânia;1;1;2;661
3143302;Montes Claros;5208707;Goiânia;1;1;2;577
3143906;Muriaé;5208707;Goiânia;1;1;2;893
3146107;Ouro Preto;5208707;Goiânia;1;1;2;741
3149309;Pedro Leopoldo;5208707;Goiânia;1;1;2;648
3154606;Ribeirão das Neves;5208707;Goiânia;1;1;2;655
3156700;Sabará;5208707;Goiânia;1;1;2;686
3161700;São Gonçalo do Abaeté;5208707;Goiânia;1;1;2;412
3164407;São Sebastião da Bela Vista;5208707;Goiânia;1;1;2;716
3170701;Varginha;5208707;Goiânia;1;1;2;678
3171204;Vespasiano;5208707;Goiânia;1;1;2;665
3201209;Cachoeiro de Itapemirim;5208707;Goiânia;1;1;2;996
3205036;Vargem Alta;5208707;Goiânia;1;1;2;996
3301009;Campos dos Goytacazes;5208707;Goiânia;1;1;2;1030
3301900;Itaboraí;5208707;Goiânia;1;1;2;967
3302205;Itaperuna;5208707;Goiânia;1;1;2;938
3302502;Magé;5208707;Goiânia;1;1;2;942
3302700;Maricá;5208707;Goiânia;1;1;2;984
3304201;Resende;5208707;Goiânia;1;1;2;830
3304300;Rio Bonito;5208707;Goiânia;1;1;2;983
3305109;São João de Meriti;5208707;Goiânia;1;1;2;931
3305802;Teresópolis;5208707;Goiânia;1;1;2;930
3306008;Três Rios;5208707;Goiânia;1;1;2;885
3500709;Agudos;5208707;Goiânia;1;1;2;642
3501905;Amparo;5208707;Goiânia;1;1;2;719
3503208;Araraquara;5208707;Goiânia;1;1;2;576
3503307;Araras;5208707;Goiânia;1;1;2;660
3504008;Assis;5208707;Goiânia;1;1;2;673
3513108;Cravinhos;5208707;Goiânia;1;1;2;541
3513801;Diadema;5208707;Goiânia;1;1;2;826
3514304;Dourado;5208707;Goiânia;1;1;2;608
3524709;Jaguariúna;5208707;Goiânia;1;1;2;711
3525102;Jardinópolis;5208707;Goiânia;1;1;2;506
3525706;José Bonifácio;5208707;Goiânia;1;1;2;485
3526704;Leme;5208707;Goiânia;1;1;2;642
3527207;Lorena;5208707;Goiânia;1;1;2;809
3528403;Mairinque;5208707;Goiânia;1;1;2;792
3529203;Martinópolis;5208707;Goiânia;1;1;2;637
3530102;Mirandópolis;5208707;Goiânia;1;1;2;529
3530805;Moji-Mirim;5208707;Goiânia;1;1;2;683
3531803;Monte Mor;5208707;Goiânia;1;1;2;725
3532207;Narandiba;5208707;Goiânia;1;1;2;678
3536307;Patrocínio Paulista;5208707;Goiânia;1;1;2;486
3536703;Pederneiras;5208707;Goiânia;1;1;2;629
3538006;Pindamonhangaba;5208707;Goiânia;1;1;2;805
3539806;Poá;5208707;Goiânia;1;1;2;820
3542206;Rancharia;5208707;Goiânia;1;1;2;637
3549904;São José dos Campos;5208707;Goiânia;1;1;2;809
3553856;Taquarivaí;5208707;Goiânia;1;1;2;803
3554003;Tatuí;5208707;Goiânia;1;1;2;753
3554102;Taubaté;5208707;Goiânia;1;1;2;806
3556453;Vargem Grande Paulista;5208707;Goiânia;1;1;2;803
4101507;Arapongas;5208707;Goiânia;1;1;2;780
4103701;Cambé;5208707;Goiânia;1;1;2;762
4104659;Carambeí;5208707;Goiânia;1;1;2;915
4107652;Fazenda Rio Grande;5208707;Goiânia;1;1;2;993
4109401;Guarapuava;5208707;Goiânia;1;1;2;992
4119509;Piraquara;5208707;Goiânia;1;1;2;969
4123402;Santa Fé;5208707;Goiânia;1;1;2;754
4124103;Santo Antônio da Platina;5208707;Goiânia;1;1;2;737
4202008;Balneário Camboriú;5208707;Goiânia;1;1;2;1142
4202800;Braço do Norte;5208707;Goiânia;1;1;2;1283
4204301;Concórdia;5208707;Goiânia;1;1;2;1204
4204608;Criciúma;5208707;Goiânia;1;1;2;1325
4205100;Dona Emma;5208707;Goiânia;1;1;2;1141
4207502;Indaial;5208707;Goiânia;1;1;2;1130
4211603;Nova Veneza;5208707;Goiânia;1;1;2;1323
4212908;Pinhalzinho;5208707;Goiânia;1;1;2;1196
4213203;Pomerode;5208707;Goiânia;1;1;2;1113
4217600;Siderópolis;5208707;Goiânia;1;1;2;1318
4303103;Cachoeirinha;5208707;Goiânia;1;1;2;1482
4307609;Estância Velha;5208707;Goiânia;1;1;2;1450
4307807;Estrela;5208707;Goiânia;1;1;2;1449
4308607;Garibaldi;5208707;Goiânia;1;1;2;1413
4309209;Gravataí;5208707;Goiânia;1;1;2;1479
4309308;Guaíba;5208707;Goiânia;1;1;2;1504
4314407;Pelotas;5208707;Goiânia;1;1;2;1701
4319901;Sapiranga;5208707;Goiânia;1;1;2;1446
5001508;Bandeirantes;5208707;Goiânia;1;1;2;659
5003256;Costa Rica;5208707;Goiânia;1;1;2;462
5003306;Coxim;5208707;Goiânia;1;1;2;618
5004700;Ivinhema;5208707;Goiânia;1;1;2;792
5006002;Nova Alvorada do Sul;5208707;Goiânia;1;1;2;764
5006309;Paranaíba;5208707;Goiânia;1;1;2;385
5006606;Ponta Porã;5208707;Goiânia;1;1;2;948
5007109;Ribas do Rio Pardo;5208707;Goiânia;1;1;2;636
5007935;Sonora;5208707;Goiânia;1;1;2;595
5100359;Alto Boa Vista;5208707;Goiânia;1;1;2;598
5100409;Alto Garças;5208707;Goiânia;1;1;2;458
5100508;Alto Paraguai;5208707;Goiânia;1;1;2;800
5101852;Bom Jesus do Araguaia;5208707;Goiânia;1;1;2;552
5101902;Brasnorte;5208707;Goiânia;1;1;2;1047
5102603;Campinápolis;5208707;Goiânia;1;1;2;452
5103106;Cocalinho;5208707;Goiânia;1;1;2;312
5103205;Colíder;5208707;Goiânia;1;1;2;920
5103858;Gaúcha do Norte;5208707;Goiânia;1;1;2;554
5104104;Guarantã do Norte;5208707;Goiânia;1;1;2;951
5104807;Jaciara;5208707;Goiânia;1;1;2;614
5106653;Pontal do Araguaia;5208707;Goiânia;1;1;2;337
5106802;Porto dos Gaúchos;5208707;Goiânia;1;1;2;1027
5107875;Sapezal;5208707;Goiânia;1;1;2;1083
5107925;Sorriso;5208707;Goiânia;1;1;2;823
5108600;Vila Rica;5208707;Goiânia;1;1;2;766
5200100;Abadiânia;5208707;Goiânia;1;1;2;82
5201801;Aragoiânia;5208707;Goiânia;1;1;2;30
5203609;Brazabrantes;5208707;Goiânia;1;1;2;31
5204102;Cachoeira Alta;5208707;Goiânia;1;1;2;290
5204300;Caçu;5208707;Goiânia;1;1;2;288
5204656;Campinaçu;5208707;Goiânia;1;1;2;328
5204904;Campos Belos;5208707;Goiânia;1;1;2;489
5205455;Cezarina;5208707;Goiânia;1;1;2;61
5205471;Chapadão do Céu;5208707;Goiânia;1;1;2;398
5205513;Cocalzinho de Goiás;5208707;Goiânia;1;1;2;113
5206503;Cromínia;5208707;Goiânia;1;1;2;67
5207352;Edealina;5208707;Goiânia;1;1;2;91
5207402;Edéia;5208707;Goiânia;1;1;2;102
5207535;Faina;5208707;Goiânia;1;1;2;179
5208400;Goianápolis;5208707;Goiânia;1;1;2;34
1702000;Araguaçu;5208608;Goianésia;1;1;2;275
1714203;Natividade;5208608;Goianésia;1;1;2;421
1718840;Sandolândia;5208608;Goianésia;1;1;2;320
2609501;Nazaré da Mata;5208608;Goianésia;1;1;2;1693
3105400;Barão de Cocais;5208608;Goianésia;1;1;2;796
3106200;Belo Horizonte;5208608;Goianésia;1;1;2;755
3109006;Brumadinho;5208608;Goianésia;1;1;2;756
3113404;Caratinga;5208608;Goianésia;1;1;2;901
3118601;Contagem;5208608;Goianésia;1;1;2;747
3143104;Monte Carmelo;5208608;Goianésia;1;1;2;416
3502101;Andradina;5208608;Goianésia;1;1;2;669
3505500;Barretos;5208608;Goianésia;1;1;2;582
3534401;Osasco;5208608;Goianésia;1;1;2;945
4107652;Fazenda Rio Grande;5208608;Goianésia;1;1;2;1145
4118501;Pato Branco;5208608;Goianésia;1;1;2;1270
4202404;Blumenau;5208608;Goianésia;1;1;2;1288
5002704;Campo Grande;5208608;Goianésia;1;1;2;826
5103403;Cuiabá;5208608;Goianésia;1;1;2;750
5205109;Catalão;5208608;Goianésia;1;1;2;339
3304557;Rio de Janeiro;5208509;Goiandira;1;1;2;738
5205901;Corumbaíba;5208509;Goiandira;1;1;2;50
3534401;Osasco;5208400;Goianápolis;1;1;2;815
3550308;São Paulo;5208400;Goianápolis;1;1;2;832
5201405;Aparecida de Goiânia;5208400;Goianápolis;1;1;2;42
5205109;Catalão;5208400;Goianápolis;1;1;2;216
5204003;Cabeceiras;5208301;Divinópolis de Goiás;1;1;2;283
5200902;Amorinópolis;5208152;Gameleira de Goiás;1;1;2;260
3550308;São Paulo;5208103;Formoso;1;1;2;1131
2111300;São Luís;5208004;Formosa;1;1;2;1475
2304400;Fortaleza;5208004;Formosa;1;1;2;1596
2609402;Moreno;5208004;Formosa;1;1;2;1531
2908101;Cocos;5208004;Formosa;1;1;2;334
2927408;Salvador;5208004;Formosa;1;1;2;986
3118601;Contagem;5208004;Formosa;1;1;2;599
3126208;Formoso;5208004;Formosa;1;1;2;134
3143104;Monte Carmelo;5208004;Formosa;1;1;2;353
3148004;Patos de Minas;5208004;Formosa;1;1;2;348
3149309;Pedro Leopoldo;5208004;Formosa;1;1;2;573
3504503;Avaré;5208004;Formosa;1;1;2;855
3524709;Jaguariúna;5208004;Formosa;1;1;2;794
3534401;Osasco;5208004;Formosa;1;1;2;887
3548807;São Caetano do Sul;5208004;Formosa;1;1;2;898
4106902;Curitiba;5208004;Formosa;1;1;2;1117
4125605;São Mateus do Sul;5208004;Formosa;1;1;2;1189
4205902;Gaspar;5208004;Formosa;1;1;2;1274
4314902;Porto Alegre;5208004;Formosa;1;1;2;1665
4316907;Santa Maria;5208004;Formosa;1;1;2;1729
4322509;Vacaria;5208004;Formosa;1;1;2;1492
5002704;Campo Grande;5208004;Formosa;1;1;2;963
5003702;Dourados;5208004;Formosa;1;1;2;1102
5200175;Água Fria de Goiás;5208004;Formosa;1;1;2;78
5200258;Águas Lindas de Goiás;5208004;Formosa;1;1;2;105
5201108;Anápolis;5208004;Formosa;1;1;2;195
3550308;São Paulo;5207808;Firminópolis;1;1;2;878
5200852;Americano do Brasil;5207808;Firminópolis;1;1;2;50
5201306;Anicuns;5207808;Firminópolis;1;1;2;38
3550308;São Paulo;5207600;Fazenda Nova;1;1;2;942
5202155;Araguapaz;5207535;Faina;1;1;2;49
3550308;São Paulo;5207501;Estrela do Norte;1;1;2;1116
3104007;Araxá;5207402;Edéia;1;1;2;404
3513108;Cravinhos;5207402;Edéia;1;1;2;501
3534401;Osasco;5207402;Edéia;1;1;2;764
5200134;Acreúna;5207402;Edéia;1;1;2;47
3550308;São Paulo;5207352;Edealina;1;1;2;763
3550308;São Paulo;5207253;Doverlândia;1;1;2;985
3556107;Valentim Gentil;5207253;Doverlândia;1;1;2;473
3304557;Rio de Janeiro;5206909;Davinópolis;1;1;2;698
3550308;São Paulo;5206909;Davinópolis;1;1;2;617
3550308;São Paulo;5206800;Damolândia;1;1;2;871
5205109;Catalão;5206602;Cumari;1;1;2;25
5205901;Corumbaíba;5206602;Cumari;1;1;2;45
3106200;Belo Horizonte;5206503;Cromínia;1;1;2;647
3550308;São Paulo;5206503;Cromínia;1;1;2;764
3144805;Nova Lima;5206404;Crixás;1;1;2;903
3304557;Rio de Janeiro;5206404;Crixás;1;1;2;1183
5205000;Carmo do Rio Verde;5206404;Crixás;1;1;2;95
5205208;Caturaí;5206404;Crixás;1;1;2;217
2908507;Conceição do Jacuípe;5206305;Cristianópolis;1;1;2;1175
5201405;Aparecida de Goiânia;5206305;Cristianópolis;1;1;2;73
1600303;Macapá;5206206;Cristalina;1;1;2;1902
3103504;Araguari;5206206;Cristalina;1;1;2;208
3104007;Araxá;5206206;Cristalina;1;1;2;316
3106200;Belo Horizonte;5206206;Cristalina;1;1;2;525
3143104;Monte Carmelo;5206206;Cristalina;1;1;2;211
3168606;Teófilo Otoni;5206206;Cristalina;1;1;2;671
3170107;Uberaba;5206206;Cristalina;1;1;2;324
3170206;Uberlândia;5206206;Cristalina;1;1;2;238
3170404;Unaí;5206206;Cristalina;1;1;2;95
3203346;Marechal Floriano;5206206;Cristalina;1;1;2;854
3529302;Matão;5206206;Cristalina;1;1;2;534
3534401;Osasco;5206206;Cristalina;1;1;2;749
4104808;Cascavel;5206206;Cristalina;1;1;2;1098
4114203;Mandaguari;5206206;Cristalina;1;1;2;864
4118204;Paranaguá;5206206;Cristalina;1;1;2;974
4219507;Xanxerê;5206206;Cristalina;1;1;2;1226
4308607;Garibaldi;5206206;Cristalina;1;1;2;1441
4314902;Porto Alegre;5206206;Cristalina;1;1;2;1516
5203500;Bom Jesus de Goiás;5206206;Cristalina;1;1;2;270
5205109;Catalão;5206206;Cristalina;1;1;2;150
1100023;Ariquemes;5205901;Corumbaíba;1;1;2;1755
1100155;Ouro Preto do Oeste;5205901;Corumbaíba;1;1;2;1647
1100189;Pimenta Bueno;5205901;Corumbaíba;1;1;2;1501
1100338;Nova Mamoré;5205901;Corumbaíba;1;1;2;1942
1100346;Alvorada d'Oeste;5205901;Corumbaíba;1;1;2;1618
1101435;Nova União;5205901;Corumbaíba;1;1;2;1662
1101757;Vale do Anari;5205901;Corumbaíba;1;1;2;1685
1302603;Manaus;5205901;Corumbaíba;1;1;2;2038
1508407;Xinguara;5205901;Corumbaíba;1;1;2;1230
3103504;Araguari;5205901;Corumbaíba;1;1;2;67
3103751;Araporã;5205901;Corumbaíba;1;1;2;74
3142809;Monte Alegre de Minas;5205901;Corumbaíba;1;1;2;87
3170107;Uberaba;5205901;Corumbaíba;1;1;2;190
4314100;Passo Fundo;5205901;Corumbaíba;1;1;2;1196
4316204;Rondinha;5205901;Corumbaíba;1;1;2;1173
5200209;Água Limpa;5205901;Corumbaíba;1;1;2;22
5205109;Catalão;5205901;Corumbaíba;1;1;2;66
3550308;São Paulo;5205802;Corumbá de Goiás;1;1;2;888
5205513;Cocalzinho de Goiás;5205802;Corumbá de Goiás;1;1;2;15
5202502;Aruanã;5205703;Córrego do Ouro;1;1;2;164
3164704;São Sebastião do Paraíso;5205513;Cocalzinho de Goiás;1;1;2;601
3304557;Rio de Janeiro;5205513;Cocalzinho de Goiás;1;1;2;989
3549904;São José dos Campos;5205513;Cocalzinho de Goiás;1;1;2;878
3550308;São Paulo;5205513;Cocalzinho de Goiás;1;1;2;901
5200134;Acreúna;5205513;Cocalzinho de Goiás;1;1;2;247
5201108;Anápolis;5205513;Cocalzinho de Goiás;1;1;2;61
5201405;Aparecida de Goiânia;5205513;Cocalzinho de Goiás;1;1;2;124
1100205;Porto Velho;5205497;Cidade Ocidental;1;1;2;1865
3143104;Monte Carmelo;5205497;Cidade Ocidental;1;1;2;297
3170206;Uberlândia;5205497;Cidade Ocidental;1;1;2;315
3534401;Osasco;5205497;Cidade Ocidental;1;1;2;835
4300604;Alvorada;5205497;Cidade Ocidental;1;1;2;1581
4319505;São Sebastião do Caí;5205497;Cidade Ocidental;1;1;2;1545
5201108;Anápolis;5205497;Cidade Ocidental;1;1;2;113
5201405;Aparecida de Goiânia;5205497;Cidade Ocidental;1;1;2;165
3543907;Rio Claro;5205471;Chapadão do Céu;1;1;2;693
3549805;São José do Rio Preto;5205471;Chapadão do Céu;1;1;2;429
4113700;Londrina;5205471;Chapadão do Céu;1;1;2;562
4117909;Palotina;5205471;Chapadão do Céu;1;1;2;667
4205902;Gaspar;5205471;Chapadão do Céu;1;1;2;1022
4303905;Campo Bom;5205471;Chapadão do Céu;1;1;2;1259
4314902;Porto Alegre;5205471;Chapadão do Céu;1;1;2;1299
5001003;Aparecida do Taboado;5205471;Chapadão do Céu;1;1;2;241
5007695;São Gabriel do Oeste;5205471;Chapadão do Céu;1;1;2;241
5100607;Alto Taquari;5205471;Chapadão do Céu;1;1;2;102
5103403;Cuiabá;5205471;Chapadão do Céu;1;1;2;488
5107602;Rondonópolis;5205471;Chapadão do Céu;1;1;2;313
5200134;Acreúna;5205471;Chapadão do Céu;1;1;2;255
5201504;Aporé;5205471;Chapadão do Céu;1;1;2;91
3104205;Arcos;5205455;Cezarina;1;1;2;585
3127107;Frutal;5205455;Cezarina;1;1;2;358
3507605;Bragança Paulista;5205455;Cezarina;1;1;2;748
3509502;Campinas;5205455;Cezarina;1;1;2;719
4314902;Porto Alegre;5205455;Cezarina;1;1;2;1457
5201405;Aparecida de Goiânia;5205455;Cezarina;1;1;2;57
1702109;Araguaína;5205406;Ceres;1;1;2;906
1709500;Gurupi;5205406;Ceres;1;1;2;399
1715754;Palmeirópolis;5205406;Ceres;1;1;2;279
1716109;Paraíso do Tocantins;5205406;Ceres;1;1;2;570
1721000;Palmas;5205406;Ceres;1;1;2;560
2919553;Luís Eduardo magalhães;5205406;Ceres;1;1;2;537
3106200;Belo Horizonte;5205406;Ceres;1;1;2;800
3143104;Monte Carmelo;5205406;Ceres;1;1;2;446
3170206;Uberlândia;5205406;Ceres;1;1;2;428
3534401;Osasco;5205406;Ceres;1;1;2;966
5201108;Anápolis;5205406;Ceres;1;1;2;137
5201405;Aparecida de Goiânia;5205406;Ceres;1;1;2;175
5205000;Carmo do Rio Verde;5205406;Ceres;1;1;2;12
2905206;Caetité;5205307;Cavalcante;1;1;2;536
3153004;Pratinha;5205307;Cavalcante;1;1;2;669
3505708;Barueri;5205307;Cavalcante;1;1;2;1077
4205407;Florianópolis;5205307;Cavalcante;1;1;2;1532
5201405;Aparecida de Goiânia;5205307;Cavalcante;1;1;2;387
3170206;Uberlândia;5205208;Caturaí;1;1;2;302
5201405;Aparecida de Goiânia;5205208;Caturaí;1;1;2;47
1501402;Belém;5205109;Catalão;1;1;2;1857
1707306;Dueré;5205109;Catalão;1;1;2;767
2304400;Fortaleza;5205109;Catalão;1;1;2;1863
2906006;Campo Formoso;5205109;Catalão;1;1;2;1160
2909307;Correntina;5205109;Catalão;1;1;2;635
2927408;Salvador;5205109;Catalão;1;1;2;1142
3104007;Araxá;5205109;Catalão;1;1;2;190
3118601;Contagem;5205109;Catalão;1;1;2;454
3119302;Coromandel;5205109;Catalão;1;1;2;85
3128600;Guarda-Mor;5205109;Catalão;1;1;2;99
3133758;Itaú de Minas;5205109;Catalão;1;1;2;311
3148004;Patos de Minas;5205109;Catalão;1;1;2;159
3151800;Poços de Caldas;5205109;Catalão;1;1;2;427
3156908;Sacramento;5205109;Catalão;1;1;2;195
3201308;Cariacica;5205109;Catalão;1;1;2;832
3205309;Vitória;5205109;Catalão;1;1;2;845
3304003;Piraí;5205109;Catalão;1;1;2;658
3509007;Caieiras;5205109;Catalão;1;1;2;591
3509601;Campo Limpo Paulista;5205109;Catalão;1;1;2;572
3511102;Catanduva;5205109;Catalão;1;1;2;349
3513009;Cotia;5205109;Catalão;1;1;2;613
3517703;Guará;5205109;Catalão;1;1;2;252
3524709;Jaguariúna;5205109;Catalão;1;1;2;514
3530706;Mogi Guaçu;5205109;Catalão;1;1;2;474
3536505;Paulínia;5205109;Catalão;1;1;2;516
3538709;Piracicaba;5205109;Catalão;1;1;2;510
3548005;Santo Antônio de Posse;5205109;Catalão;1;1;2;504
3548807;São Caetano do Sul;5205109;Catalão;1;1;2;622
3549805;São José do Rio Preto;5205109;Catalão;1;1;2;334
3551009;São Vicente;5205109;Catalão;1;1;2;662
3551702;Sertãozinho;5205109;Catalão;1;1;2;330
3552809;Taboão da Serra;5205109;Catalão;1;1;2;615
4103701;Cambé;5205109;Catalão;1;1;2;672
4113700;Londrina;5205109;Catalão;1;1;2;666
4114203;Mandaguari;5205109;Catalão;1;1;2;722
4115200;Maringá;5205109;Catalão;1;1;2;725
4116208;Morretes;5205109;Catalão;1;1;2;816
4125506;São José dos Pinhais;5205109;Catalão;1;1;2;828
4218707;Tubarão;5205109;Catalão;1;1;2;1150
4304705;Carazinho;5205109;Catalão;1;1;2;1242
4314803;Portão;5205109;Catalão;1;1;2;1329
4314902;Porto Alegre;5205109;Catalão;1;1;2;1366
5002704;Campo Grande;5205109;Catalão;1;1;2;758
3205309;Vitória;5205059;Castelândia;1;1;2;1081
3534401;Osasco;5205059;Castelândia;1;1;2;706
3550308;São Paulo;5205059;Castelândia;1;1;2;725
5203500;Bom Jesus de Goiás;5205059;Castelândia;1;1;2;46
3534401;Osasco;5205000;Carmo do Rio Verde;1;1;2;961
4115200;Maringá;5205000;Carmo do Rio Verde;1;1;2;927
3304557;Rio de Janeiro;5204953;Campos Verdes;1;1;2;1188
3534401;Osasco;5204953;Campos Verdes;1;1;2;1076
3550308;São Paulo;5204953;Campos Verdes;1;1;2;1093
1506138;Redenção;5204904;Campos Belos;1;1;2;656
2211001;Teresina;5204904;Campos Belos;1;1;2;972
2903904;Bom Jesus da Lapa;5204904;Campos Belos;1;1;2;365
3304557;Rio de Janeiro;5204904;Campos Belos;1;1;2;1158
3534401;Osasco;5204904;Campos Belos;1;1;2;1164
5200803;Alvorada do Norte;5204904;Campos Belos;1;1;2;164
5201108;Anápolis;5204904;Campos Belos;1;1;2;439
1711951;Lagoa do Tocantins;5204854;Campo Limpo de Goiás;1;1;2;675
3550308;São Paulo;5204854;Campo Limpo de Goiás;1;1;2;857
3134202;Ituiutaba;5204805;Campo Alegre de Goiás;1;1;2;232
3501608;Americana;5204805;Campo Alegre de Goiás;1;1;2;567
3548708;São Bernardo do Campo;5204805;Campo Alegre de Goiás;1;1;2;685
4114203;Mandaguari;5204805;Campo Alegre de Goiás;1;1;2;781
5201108;Anápolis;5204805;Campo Alegre de Goiás;1;1;2;192
3104007;Araxá;5204706;Campinorte;1;1;2;633
3147907;Passos;5204706;Campinorte;1;1;2;761
3534401;Osasco;5204706;Campinorte;1;1;2;1054
5201108;Anápolis;5204706;Campinorte;1;1;2;223
5201405;Aparecida de Goiânia;5204607;Campestre de Goiás;1;1;2;46
1600303;Macapá;5204508;Caldas Novas;1;1;2;1986
2607208;Ipojuca;5204508;Caldas Novas;1;1;2;1746
2910727;Eunápolis;5204508;Caldas Novas;1;1;2;965
3103504;Araguari;5204508;Caldas Novas;1;1;2;109
3106200;Belo Horizonte;5204508;Caldas Novas;1;1;2;550
3137502;Lagoa Formosa;5204508;Caldas Novas;1;1;2;262
3505708;Barueri;5204508;Caldas Novas;1;1;2;666
3513009;Cotia;5204508;Caldas Novas;1;1;2;675
3516200;Franca;5204508;Caldas Novas;1;1;2;336
3534401;Osasco;5204508;Caldas Novas;1;1;2;672
3548807;São Caetano do Sul;5204508;Caldas Novas;1;1;2;687
3548906;São Carlos;5204508;Caldas Novas;1;1;2;481
4104907;Castro;5204508;Caldas Novas;1;1;2;796
4106902;Curitiba;5204508;Caldas Novas;1;1;2;856
4113700;Londrina;5204508;Caldas Novas;1;1;2;674
4119905;Ponta Grossa;5204508;Caldas Novas;1;1;2;833
5103403;Cuiabá;5204508;Caldas Novas;1;1;2;826
5201405;Aparecida de Goiânia;5204508;Caldas Novas;1;1;2;123
5203302;Bela Vista de Goiás;5204508;Caldas Novas;1;1;2;92
3537107;Pedreira;5204409;Caiapônia;1;1;2;835
4208203;Itajaí;5204409;Caiapônia;1;1;2;1157
2909307;Correntina;5204300;Caçu;1;1;2;891
3106200;Belo Horizonte;5204300;Caçu;1;1;2;774
3134202;Ituiutaba;5204300;Caçu;1;1;2;183
3170438;União de Minas;5204300;Caçu;1;1;2;136
3304557;Rio de Janeiro;5204300;Caçu;1;1;2;969
3507605;Bragança Paulista;5204300;Caçu;1;1;2;689
3534401;Osasco;5204300;Caçu;1;1;2;721
3550308;São Paulo;5204300;Caçu;1;1;2;741
4106902;Curitiba;5204300;Caçu;1;1;2;785
3303302;Niterói;5204250;Cachoeira Dourada;1;1;2;838
3503307;Araras;5204250;Cachoeira Dourada;1;1;2;483
3550308;São Paulo;5204250;Cachoeira Dourada;1;1;2;647
4106902;Curitiba;5204250;Cachoeira Dourada;1;1;2;769
3550308;São Paulo;5204201;Cachoeira de Goiás;1;1;2;887
2503209;Cabedelo;5204102;Cachoeira Alta;1;1;2;2101
3304557;Rio de Janeiro;5204102;Cachoeira Alta;1;1;2;939
3530607;Moji das Cruzes;5204102;Cachoeira Alta;1;1;2;735
3534401;Osasco;5204102;Cachoeira Alta;1;1;2;690
5201504;Aporé;5204102;Cachoeira Alta;1;1;2;102
1707009;Dianópolis;5204003;Cabeceiras;1;1;2;461
3550308;São Paulo;5204003;Cabeceiras;1;1;2;870
5200803;Alvorada do Norte;5203962;Buritinópolis;1;1;2;12
3164704;São Sebastião do Paraíso;5203906;Buriti Alegre;1;1;2;379
3502101;Andradina;5203906;Buriti Alegre;1;1;2;398
3521309;Ipuã;5203906;Buriti Alegre;1;1;2;277
3534401;Osasco;5203807;Britânia;1;1;2;1036
3551702;Sertãozinho;5203807;Britânia;1;1;2;739
5202155;Araguapaz;5203807;Britânia;1;1;2;54
3147907;Passos;5203559;Bonfinópolis;1;1;2;518
5201108;Anápolis;5203559;Bonfinópolis;1;1;2;34
2602902;Cabo de Santo Agostinho;5203500;Bom Jesus de Goiás;1;1;2;1881
2910800;Feira de Santana;5203500;Bom Jesus de Goiás;1;1;2;1304
3104007;Araxá;5203500;Bom Jesus de Goiás;1;1;2;337
3117900;Congonhal;5203500;Bom Jesus de Goiás;1;1;2;593
3143104;Monte Carmelo;5203500;Bom Jesus de Goiás;1;1;2;248
3148004;Patos de Minas;5203500;Bom Jesus de Goiás;1;1;2;349
3170107;Uberaba;5203500;Bom Jesus de Goiás;1;1;2;261
3201308;Cariacica;5203500;Bom Jesus de Goiás;1;1;2;1020
3534302;Orlândia;5203500;Bom Jesus de Goiás;1;1;2;344
3534401;Osasco;5203500;Bom Jesus de Goiás;1;1;2;672
3540903;Pradópolis;5203500;Bom Jesus de Goiás;1;1;2;394
3551306;Sebastianópolis do Sul;5203500;Bom Jesus de Goiás;1;1;2;272
4205902;Gaspar;5203500;Bom Jesus de Goiás;1;1;2;970
5201405;Aparecida de Goiânia;5203500;Bom Jesus de Goiás;1;1;2;164
3534401;Osasco;5203401;Bom Jardim de Goiás;1;1;2;1001
5106653;Pontal do Araguaia;5203401;Bom Jardim de Goiás;1;1;2;36
5201702;Aragarças;5203401;Bom Jardim de Goiás;1;1;2;37
3104007;Araxá;5203302;Bela Vista de Goiás;1;1;2;361
3131604;Iraí de Minas;5203302;Bela Vista de Goiás;1;1;2;274
3133709;Itatiaiuçu;5203302;Bela Vista de Goiás;1;1;2;604
3159803;Santa Vitória;5203302;Bela Vista de Goiás;1;1;2;243
3534401;Osasco;5203302;Bela Vista de Goiás;1;1;2;763
4210506;Maravilha;5203302;Bela Vista de Goiás;1;1;2;1179
4307807;Estrela;5203302;Bela Vista de Goiás;1;1;2;1427
5201405;Aparecida de Goiânia;5203302;Bela Vista de Goiás;1;1;2;37
3104007;Araxá;5203203;Barro Alto;1;1;2;554
3106200;Belo Horizonte;5203203;Barro Alto;1;1;2;766
3118601;Contagem;5203203;Barro Alto;1;1;2;759
3131307;Ipatinga;5203203;Barro Alto;1;1;2;854
3137601;Lagoa Santa;5203203;Barro Alto;1;1;2;752
3138203;Lavras;5203203;Barro Alto;1;1;2;814
3151800;Poços de Caldas;5203203;Barro Alto;1;1;2;796
3164704;São Sebastião do Paraíso;5203203;Barro Alto;1;1;2;693
5201108;Anápolis;5203203;Barro Alto;1;1;2;149
3502804;Araçatuba;5203104;Baliza;1;1;2;601
3550308;São Paulo;5202601;Aurilândia;1;1;2;876
1702000;Araguaçu;5202502;Aruanã;1;1;2;255
3511003;Castilho;5202502;Aruanã;1;1;2;662
3106200;Belo Horizonte;5202353;Arenópolis;1;1;2;906
3534401;Osasco;5202155;Araguapaz;1;1;2;1025
2102804;Carolina;5201702;Aragarças;1;1;2;1072
3106200;Belo Horizonte;5201702;Aragarças;1;1;2;1000
3303302;Niterói;5201702;Aragarças;1;1;2;1265
3304557;Rio de Janeiro;5201702;Aragarças;1;1;2;1251
4126678;Tamarana;5201702;Aragarças;1;1;2;876
5002605;Camapuã;5201702;Aragarças;1;1;2;447
5107602;Rondonópolis;5201702;Aragarças;1;1;2;265
3304557;Rio de Janeiro;5201504;Aporé;1;1;2;1019
3516200;Franca;5201504;Aporé;1;1;2;507
3527108;Lins;5201504;Aporé;1;1;2;378
3533502;Novo Horizonte;5201504;Aporé;1;1;2;399
5002902;Cassilândia;5201504;Aporé;1;1;2;27
5002951;Chapadão do Sul;5201504;Aporé;1;1;2;79
3304557;Rio de Janeiro;5201454;Aparecida do Rio Doce;1;1;2;986
1200401;Rio Branco;5201405;Aparecida de Goiânia;1;1;2;2091
1500800;Ananindeua;5201405;Aparecida de Goiânia;1;1;2;1711
1503606;Itaituba;5201405;Aparecida de Goiânia;1;1;2;1558
1504422;Marituba;5201405;Aparecida de Goiânia;1;1;2;1712
1505502;Paragominas;5201405;Aparecida de Goiânia;1;1;2;1538
1506807;Santarém;5201405;Aparecida de Goiânia;1;1;2;1685
1702000;Araguaçu;5201405;Aparecida de Goiânia;1;1;2;434
1709500;Gurupi;5201405;Aparecida de Goiânia;1;1;2;565
1717503;Pium;5201405;Aparecida de Goiânia;1;1;2;705
1718204;Porto Nacional;5201405;Aparecida de Goiânia;1;1;2;682
2105302;Imperatriz;5201405;Aparecida de Goiânia;1;1;2;1264
2306256;Itaitinga;5201405;Aparecida de Goiânia;1;1;2;1807
2307650;Maracanaú;5201405;Aparecida de Goiânia;1;1;2;1810
2408102;Natal;5201405;Aparecida de Goiânia;1;1;2;1902
2503209;Cabedelo;5201405;Aparecida de Goiânia;1;1;2;1853
2507507;João Pessoa;5201405;Aparecida de Goiânia;1;1;2;1844
2604106;Caruaru;5201405;Aparecida de Goiânia;1;1;2;1679
2607901;Jaboatão dos Guararapes;5201405;Aparecida de Goiânia;1;1;2;1773
2610707;Paulista;5201405;Aparecida de Goiânia;1;1;2;1797
2700300;Arapiraca;5201405;Aparecida de Goiânia;1;1;2;1533
2704302;Maceió;5201405;Aparecida de Goiânia;1;1;2;1625
2800308;Aracaju;5201405;Aparecida de Goiânia;1;1;2;1438
2803203;Itaporanga d'Ajuda;5201405;Aparecida de Goiânia;1;1;2;1413
2905701;Camaçari;5201405;Aparecida de Goiânia;1;1;2;1241
2918001;Jequié;5201405;Aparecida de Goiânia;1;1;2;1028
2926004;Remanso;5201405;Aparecida de Goiânia;1;1;2;1098
3103504;Araguari;5201405;Aparecida de Goiânia;1;1;2;232
3110608;Cambuí;5201405;Aparecida de Goiânia;1;1;2;729
3113305;Carangola;5201405;Aparecida de Goiânia;1;1;2;892
3127701;Governador Valadares;5201405;Aparecida de Goiânia;1;1;2;811
3129806;Ibirité;5201405;Aparecida de Goiânia;1;1;2;663
3136702;Juiz de Fora;5201405;Aparecida de Goiânia;1;1;2;843
3143302;Montes Claros;5201405;Aparecida de Goiânia;1;1;2;574
3144805;Nova Lima;5201405;Aparecida de Goiânia;1;1;2;681
3171204;Vespasiano;5201405;Aparecida de Goiânia;1;1;2;656
3203205;Linhares;5201405;Aparecida de Goiânia;1;1;2;1030
3205101;Viana;5201405;Aparecida de Goiânia;1;1;2;1017
3303906;Petrópolis;5201405;Aparecida de Goiânia;1;1;2;911
3304201;Resende;5201405;Aparecida de Goiânia;1;1;2;818
3501608;Americana;5201405;Aparecida de Goiânia;1;1;2;689
3504107;Atibaia;5201405;Aparecida de Goiânia;1;1;2;758
3505302;Barra Bonita;5201405;Aparecida de Goiânia;1;1;2;634
3509700;Campos do Jordão;5201405;Aparecida de Goiânia;1;1;2;766
3511102;Catanduva;5201405;Aparecida de Goiânia;1;1;2;481
3513504;Cubatão;5201405;Aparecida de Goiânia;1;1;2;843
3515103;Embu-Guaçu;5201405;Aparecida de Goiânia;1;1;2;822
3516200;Franca;5201405;Aparecida de Goiânia;1;1;2;459
3522208;Itapecerica da Serra;5201405;Aparecida de Goiânia;1;1;2;808
3522604;Itapira;5201405;Aparecida de Goiânia;1;1;2;676
3525003;Jandira;5201405;Aparecida de Goiânia;1;1;2;787
3526803;Lençóis Paulista;5201405;Aparecida de Goiânia;1;1;2;643
3527108;Lins;5201405;Aparecida de Goiânia;1;1;2;542
3528502;Mairiporã;5201405;Aparecida de Goiânia;1;1;2;777
3530706;Mogi Guaçu;5201405;Aparecida de Goiânia;1;1;2;660
3530805;Moji-Mirim;5201405;Aparecida de Goiânia;1;1;2;670
3541406;Presidente Prudente;5201405;Aparecida de Goiânia;1;1;2;633
3543907;Rio Claro;5201405;Aparecida de Goiânia;1;1;2;646
3544103;Rio Grande da Serra;5201405;Aparecida de Goiânia;1;1;2;827
3546801;Santa Isabel;5201405;Aparecida de Goiânia;1;1;2;792
3548500;Santos;5201405;Aparecida de Goiânia;1;1;2;846
3548708;São Bernardo do Campo;5201405;Aparecida de Goiânia;1;1;2;818
3548906;São Carlos;5201405;Aparecida de Goiânia;1;1;2;596
3551009;São Vicente;5201405;Aparecida de Goiânia;1;1;2;848
3552205;Sorocaba;5201405;Aparecida de Goiânia;1;1;2;763
3552403;Sumaré;5201405;Aparecida de Goiânia;1;1;2;700
3552502;Suzano;5201405;Aparecida de Goiânia;1;1;2;811
3554102;Taubaté;5201405;Aparecida de Goiânia;1;1;2;793
3555406;Ubatuba;5201405;Aparecida de Goiânia;1;1;2;857
3556206;Valinhos;5201405;Aparecida de Goiânia;1;1;2;725
3556453;Vargem Grande Paulista;5201405;Aparecida de Goiânia;1;1;2;790
4100806;Alvorada do Sul;5201405;Aparecida de Goiânia;1;1;2;694
4101804;Araucária;5201405;Aparecida de Goiânia;1;1;2;972
4107652;Fazenda Rio Grande;5201405;Aparecida de Goiânia;1;1;2;979
4115200;Maringá;5201405;Aparecida de Goiânia;1;1;2;788
4119152;Pinhais;5201405;Aparecida de Goiânia;1;1;2;956
4119905;Ponta Grossa;5201405;Aparecida de Goiânia;1;1;2;923
4122404;Rolândia;5201405;Aparecida de Goiânia;1;1;2;755
4127700;Toledo;5201405;Aparecida de Goiânia;1;1;2;1004
4201406;Araranguá;5201405;Aparecida de Goiânia;1;1;2;1344
4204202;Chapecó;5201405;Aparecida de Goiânia;1;1;2;1199
4206504;Guaramirim;5201405;Aparecida de Goiânia;1;1;2;1070
4208906;Jaraguá do Sul;5201405;Aparecida de Goiânia;1;1;2;1071
4211603;Nova Veneza;5201405;Aparecida de Goiânia;1;1;2;1310
4216602;São José;5201405;Aparecida de Goiânia;1;1;2;1194
4218004;Tijucas;5201405;Aparecida de Goiânia;1;1;2;1157
4219705;Xaxim;5201405;Aparecida de Goiânia;1;1;2;1180
4304606;Canoas;5201405;Aparecida de Goiânia;1;1;2;1466
4313300;Nova Prata;5201405;Aparecida de Goiânia;1;1;2;1351
4313409;Novo Hamburgo;5201405;Aparecida de Goiânia;1;1;2;1441
5003702;Dourados;5201405;Aparecida de Goiânia;1;1;2;848
5104807;Jaciara;5201405;Aparecida de Goiânia;1;1;2;618
5108600;Vila Rica;5201405;Aparecida de Goiânia;1;1;2;779
2604809;Cortês;5201306;Anicuns;1;1;2;1755
2611606;Recife;5201306;Anicuns;1;1;2;1829
3157807;Santa Luzia;5201306;Anicuns;1;1;2;752
3534401;Osasco;5201306;Anicuns;1;1;2;853
3543402;Ribeirão Preto;5201306;Anicuns;1;1;2;567
3550308;São Paulo;5201306;Anicuns;1;1;2;871
5107040;Primavera do Leste;5201306;Anicuns;1;1;2;479
5201108;Anápolis;5201306;Anicuns;1;1;2;110
5201108;Anápolis;5201207;Anhanguera;1;1;2;236
1505486;Pacajá;5201108;Anápolis;1;1;2;1386
1506138;Redenção;5201108;Anápolis;1;1;2;925
1506807;Santarém;5201108;Anápolis;1;1;2;1645
1702406;Arraias;5201108;Anápolis;1;1;2;428
1707009;Dianópolis;5201108;Anápolis;1;1;2;562
1707652;Figueirópolis;5201108;Anápolis;1;1;2;464
1711902;Lagoa da Confusão;5201108;Anápolis;1;1;2;615
1721000;Palmas;5201108;Anápolis;1;1;2;662
2101400;Balsas;5201108;Anápolis;1;1;2;1021
2304285;Eusébio;5201108;Anápolis;1;1;2;1759
2501807;Bayeux;5201108;Anápolis;1;1;2;1788
2607752;Itapissuma;5201108;Anápolis;1;1;2;1750
2609600;Olinda;5201108;Anápolis;1;1;2;1739
2616407;Vitória de Santo Antão;5201108;Anápolis;1;1;2;1698
2704302;Maceió;5201108;Anápolis;1;1;2;1575
2927408;Salvador;5201108;Anápolis;1;1;2;1171
3103504;Araguari;5201108;Anápolis;1;1;2;270
3104007;Araxá;5201108;Anápolis;1;1;2;422
3112604;Capinópolis;5201108;Anápolis;1;1;2;271
3134202;Ituiutaba;5201108;Anápolis;1;1;2;299
3143104;Monte Carmelo;5201108;Anápolis;1;1;2;309
3143302;Montes Claros;5201108;Anápolis;1;1;2;545
3147006;Paracatu;5201108;Anápolis;1;1;2;239
3154606;Ribeirão das Neves;5201108;Anápolis;1;1;2;649
3170107;Uberaba;5201108;Anápolis;1;1;2;395
3201209;Cachoeiro de Itapemirim;5201108;Anápolis;1;1;2;987
3201308;Cariacica;5201108;Anápolis;1;1;2;1018
3205101;Viana;5201108;Anápolis;1;1;2;1013
3205200;Vila Velha;5201108;Anápolis;1;1;2;1029
3301702;Duque de Caxias;5201108;Anápolis;1;1;2;941
3303500;Nova Iguaçu;5201108;Anápolis;1;1;2;930
3306008;Três Rios;5201108;Anápolis;1;1;2;889
3502804;Araçatuba;5201108;Anápolis;1;1;2;568
3503109;Arandu;5201108;Anápolis;1;1;2;755
3504107;Atibaia;5201108;Anápolis;1;1;2;797
3509205;Cajamar;5201108;Anápolis;1;1;2;812
3512803;Cosmópolis;5201108;Anápolis;1;1;2;726
3522505;Itapevi;5201108;Anápolis;1;1;2;830
3524402;Jacareí;5201108;Anápolis;1;1;2;841
3524709;Jaguariúna;5201108;Anápolis;1;1;2;739
3525904;Jundiaí;5201108;Anápolis;1;1;2;792
3530805;Moji-Mirim;5201108;Anápolis;1;1;2;710
3531902;Morro Agudo;5201108;Anápolis;1;1;2;498
3533007;Nova Granada;5201108;Anápolis;1;1;2;469
3534302;Orlândia;5201108;Anápolis;1;1;2;501
3539301;Pirassununga;5201108;Anápolis;1;1;2;651
3541406;Presidente Prudente;5201108;Anápolis;1;1;2;697
3544905;Sales Oliveira;5201108;Anápolis;1;1;2;508
3547304;Santana de Parnaíba;5201108;Anápolis;1;1;2;820
3547809;Santo André;5201108;Anápolis;1;1;2;854
3548906;São Carlos;5201108;Anápolis;1;1;2;642
3549805;São José do Rio Preto;5201108;Anápolis;1;1;2;502
3552205;Sorocaba;5201108;Anápolis;1;1;2;809
3552403;Sumaré;5201108;Anápolis;1;1;2;743
3554003;Tatuí;5201108;Anápolis;1;1;2;788
3556206;Valinhos;5201108;Anápolis;1;1;2;767
4108304;Foz do Iguaçu;5201108;Anápolis;1;1;2;1187
4112108;Jandaia do Sul;5201108;Anápolis;1;1;2;859
4115200;Maringá;5201108;Anápolis;1;1;2;852
4119152;Pinhais;5201108;Anápolis;1;1;2;1011
4119905;Ponta Grossa;5201108;Anápolis;1;1;2;982
4202008;Balneário Camboriú;5201108;Anápolis;1;1;2;1182
4209102;Joinville;5201108;Anápolis;1;1;2;1103
4211603;Nova Veneza;5201108;Anápolis;1;1;2;1366
4219309;Videira;5201108;Anápolis;1;1;2;1209
4305108;Caxias do Sul;5201108;Anápolis;1;1;2;1444
4306767;Eldorado do Sul;5201108;Anápolis;1;1;2;1554
4314407;Pelotas;5201108;Anápolis;1;1;2;1750
4318705;São Leopoldo;5201108;Anápolis;1;1;2;1509
5107040;Primavera do Leste;5201108;Anápolis;1;1;2;582
5107800;Santo Antônio do Leverger;5201108;Anápolis;1;1;2;762
5107925;Sorriso;5201108;Anápolis;1;1;2;832
5108402;Várzea Grande;5201108;Anápolis;1;1;2;774
3167202;Sete Lagoas;5200852;Americano do Brasil;1;1;2;713
3543402;Ribeirão Preto;5200852;Americano do Brasil;1;1;2;592
5107107;São José dos Quatro Marcos;5200852;Americano do Brasil;1;1;2;877
3511003;Castilho;5200829;Amaralina;1;1;2;806
3534401;Osasco;5200803;Alvorada do Norte;1;1;2;1002
4201406;Araranguá;5200803;Alvorada do Norte;1;1;2;1636
3550308;São Paulo;5200605;Alto Paraíso de Goiás;1;1;2;1058
3144805;Nova Lima;5200555;Alto Horizonte;1;1;2;881
3304557;Rio de Janeiro;5200555;Alto Horizonte;1;1;2;1172
3518404;Guaratinguetá;5200555;Alto Horizonte;1;1;2;1060
3552403;Sumaré;5200555;Alto Horizonte;1;1;2;982
3534401;Osasco;5200506;Aloândia;1;1;2;705
3505708;Barueri;5200308;Alexânia;1;1;2;841
3518800;Guarulhos;5200308;Alexânia;1;1;2;841
3522505;Itapevi;5200308;Alexânia;1;1;2;844
3523909;Itu;5200308;Alexânia;1;1;2;808
3530607;Moji das Cruzes;5200308;Alexânia;1;1;2;865
4202404;Blumenau;5200308;Alexânia;1;1;2;1205
4314050;Parobé;5200308;Alexânia;1;1;2;1522
5200258;Águas Lindas de Goiás;5200308;Alexânia;1;1;2;43
2111201;São José de Ribamar;5200258;Águas Lindas de Goiás;1;1;2;1529
2211001;Teresina;5200258;Águas Lindas de Goiás;1;1;2;1314
2408003;Mossoró;5200258;Águas Lindas de Goiás;1;1;2;1640
3304557;Rio de Janeiro;5200258;Águas Lindas de Goiás;1;1;2;960
3534401;Osasco;5200258;Águas Lindas de Goiás;1;1;2;876
3548807;São Caetano do Sul;5200258;Águas Lindas de Goiás;1;1;2;889
3104007;Araxá;5200134;Acreúna;1;1;2;440
3106200;Belo Horizonte;5200134;Acreúna;1;1;2;739
3143302;Montes Claros;5200134;Acreúna;1;1;2;694
3161205;São Francisco de Paula;5200134;Acreúna;1;1;2;685
3170206;Uberlândia;5200134;Acreúna;1;1;2;280
3534401;Osasco;5200134;Acreúna;1;1;2;783
4101804;Araucária;5200134;Acreúna;1;1;2;913
4118204;Paranaguá;5200134;Acreúna;1;1;2;928
4219507;Xanxerê;5200134;Acreúna;1;1;2;1071
5100201;Água Boa;5200134;Acreúna;1;1;2;417
5103403;Cuiabá;5200134;Acreúna;1;1;2;639
2607901;Jaboatão dos Guararapes;5200100;Abadiânia;1;1;2;1694
3304557;Rio de Janeiro;5200100;Abadiânia;1;1;2;948
1721000;Palmas;5200050;Abadia de Goiás;1;1;2;717
3205309;Vitória;5200050;Abadia de Goiás;1;1;2;1057
5103106;Cocalinho;5200050;Abadia de Goiás;1;1;2;309
3118205;Conquista;5108956;Nova Monte Verde;1;1;2;1565
4211702;Orleans;5108956;Nova Monte Verde;1;1;2;2234
5103379;Cotriguaçu;5108956;Nova Monte Verde;1;1;2;99
5105150;Juína;5108956;Nova Monte Verde;1;1;2;203
2611606;Recife;5108907;Nova Maringá;1;1;2;2444
3550308;São Paulo;5108907;Nova Maringá;1;1;2;1653
3551306;Sebastianópolis do Sul;5108907;Nova Maringá;1;1;2;1156
4115200;Maringá;5108907;Nova Maringá;1;1;2;1286
5101902;Brasnorte;5108907;Nova Maringá;1;1;2;138
5102637;Campo Novo do Parecis;5108907;Nova Maringá;1;1;2;115
5107909;Sinop;5108907;Nova Maringá;1;1;2;214
5107925;Sorriso;5108907;Nova Maringá;1;1;2;153
4208203;Itajaí;5108857;Nova Marilândia;1;1;2;1668
4219309;Videira;5108857;Nova Marilândia;1;1;2;1544
5103403;Cuiabá;5108857;Nova Marilândia;1;1;2;162
5107263;Santo Afonso;5108857;Nova Marilândia;1;1;2;16
5107958;Tangará da Serra;5108857;Nova Marilândia;1;1;2;63
5108402;Várzea Grande;5108857;Nova Marilândia;1;1;2;167
3550308;São Paulo;5108808;Nova Guarita;1;1;2;1776
5103205;Colíder;5108808;Nova Guarita;1;1;2;56
5108055;Terra Nova do Norte;5108808;Nova Guarita;1;1;2;30
1506138;Redenção;5108600;Vila Rica;1;1;2;256
2105302;Imperatriz;5108600;Vila Rica;1;1;2;643
3550308;São Paulo;5108600;Vila Rica;1;1;2;1594
4107256;Douradina;5108600;Vila Rica;1;1;2;1499
5100201;Água Boa;5108600;Vila Rica;1;1;2;460
5105259;Lucas do Rio Verde;5108600;Vila Rica;1;1;2;621
5105309;Luciára;5108600;Vila Rica;1;1;2;143
5106257;Nova Xavantina;5108600;Vila Rica;1;1;2;535
5107354;São José do Xingu;5108600;Vila Rica;1;1;2;193
5107743;Santa Cruz do Xingu;5108600;Vila Rica;1;1;2;135
5107776;Santa Terezinha;5108600;Vila Rica;1;1;2;86
5107909;Sinop;5108600;Vila Rica;1;1;2;517
1302603;Manaus;5108501;Vera;1;1;2;1137
3534401;Osasco;5108501;Vera;1;1;2;1565
3543402;Ribeirão Preto;5108501;Vera;1;1;2;1286
3550308;São Paulo;5108501;Vera;1;1;2;1585
4107256;Douradina;5108501;Vera;1;1;2;1246
4117909;Palotina;5108501;Vera;1;1;2;1338
4128203;União da Vitória;5108501;Vera;1;1;2;1616
5100250;Alta Floresta;5108501;Vera;1;1;2;281
5103403;Cuiabá;5108501;Vera;1;1;2;370
5105259;Lucas do Rio Verde;5108501;Vera;1;1;2;106
1100049;Cacoal;5108402;Várzea Grande;1;1;2;732
1100106;Guajará-Mirim;5108402;Várzea Grande;1;1;2;1110
1100122;Ji-Paraná;5108402;Várzea Grande;1;1;2;802
1100189;Pimenta Bueno;5108402;Várzea Grande;1;1;2;694
1100254;Presidente Médici;5108402;Várzea Grande;1;1;2;783
1200401;Rio Branco;5108402;Várzea Grande;1;1;2;1384
1500800;Ananindeua;5108402;Várzea Grande;1;1;2;1779
1501402;Belém;5108402;Várzea Grande;1;1;2;1775
1503606;Itaituba;5108402;Várzea Grande;1;1;2;1264
1506195;Rurópolis;5108402;Várzea Grande;1;1;2;1285
1508159;Uruará;5108402;Várzea Grande;1;1;2;1347
1709500;Gurupi;5108402;Várzea Grande;1;1;2;872
1721000;Palmas;5108402;Várzea Grande;1;1;2;1013
2101202;Bacabal;5108402;Várzea Grande;1;1;2;1745
2111300;São Luís;5108402;Várzea Grande;1;1;2;1917
2304400;Fortaleza;5108402;Várzea Grande;1;1;2;2272
2309706;Pacatuba;5108402;Várzea Grande;1;1;2;2251
2408102;Natal;5108402;Várzea Grande;1;1;2;2458
2607208;Ipojuca;5108402;Várzea Grande;1;1;2;2372
2607901;Jaboatão dos Guararapes;5108402;Várzea Grande;1;1;2;2384
2611606;Recife;5108402;Várzea Grande;1;1;2;2394
2905701;Camaçari;5108402;Várzea Grande;1;1;2;1929
2927408;Salvador;5108402;Várzea Grande;1;1;2;1910
3118601;Contagem;5108402;Várzea Grande;1;1;2;1393
3129806;Ibirité;5108402;Várzea Grande;1;1;2;1400
3141108;Matozinhos;5108402;Várzea Grande;1;1;2;1380
3143302;Montes Claros;5108402;Várzea Grande;1;1;2;1328
3170404;Unaí;5108402;Várzea Grande;1;1;2;997
3171204;Vespasiano;5108402;Várzea Grande;1;1;2;1401
3205200;Vila Velha;5108402;Várzea Grande;1;1;2;1794
3205309;Vitória;5108402;Várzea Grande;1;1;2;1797
3502101;Andradina;5108402;Várzea Grande;1;1;2;781
3509205;Cajamar;5108402;Várzea Grande;1;1;2;1328
3510500;Caraguatatuba;5108402;Várzea Grande;1;1;2;1469
3513801;Diadema;5108402;Várzea Grande;1;1;2;1374
3515202;Estrela d'Oeste;5108402;Várzea Grande;1;1;2;810
3518206;Guararapes;5108402;Várzea Grande;1;1;2;864
3518701;Guarujá;5108402;Várzea Grande;1;1;2;1423
3518800;Guarulhos;5108402;Várzea Grande;1;1;2;1361
3526803;Lençóis Paulista;5108402;Várzea Grande;1;1;2;1113
3526902;Limeira;5108402;Várzea Grande;1;1;2;1227
3541000;Praia Grande;5108402;Várzea Grande;1;1;2;1416
3541406;Presidente Prudente;5108402;Várzea Grande;1;1;2;887
3542602;Registro;5108402;Várzea Grande;1;1;2;1340
3549805;São José do Rio Preto;5108402;Várzea Grande;1;1;2;933
3551009;São Vicente;5108402;Várzea Grande;1;1;2;1409
4103701;Cambé;5108402;Várzea Grande;1;1;2;1002
4105508;Cianorte;5108402;Várzea Grande;1;1;2;969
4107850;Flor da Serra do Sul;5108402;Várzea Grande;1;1;2;1212
4110003;Iguaraçu;5108402;Várzea Grande;1;1;2;961
4111902;Jaguapitã;5108402;Várzea Grande;1;1;2;969
4119152;Pinhais;5108402;Várzea Grande;1;1;2;1330
4119905;Ponta Grossa;5108402;Várzea Grande;1;1;2;1238
4120804;Quatro Barras;5108402;Várzea Grande;1;1;2;1330
4125506;São José dos Pinhais;5108402;Várzea Grande;1;1;2;1339
4128104;Umuarama;5108402;Várzea Grande;1;1;2;949
4128203;União da Vitória;5108402;Várzea Grande;1;1;2;1301
4128807;Xambrê;5108402;Várzea Grande;1;1;2;942
4202909;Brusque;5108402;Várzea Grande;1;1;2;1501
4203006;Caçador;5108402;Várzea Grande;1;1;2;1357
4211009;Mondaí;5108402;Várzea Grande;1;1;2;1302
4219705;Xaxim;5108402;Várzea Grande;1;1;2;1316
4305108;Caxias do Sul;5108402;Várzea Grande;1;1;2;1597
4311809;Marau;5108402;Várzea Grande;1;1;2;1484
4314407;Pelotas;5108402;Várzea Grande;1;1;2;1831
4323002;Viamão;5108402;Várzea Grande;1;1;2;1699
5003702;Dourados;5108402;Várzea Grande;1;1;2;743
5006200;Nova Andradina;5108402;Várzea Grande;1;1;2;789
5008305;Três Lagoas;5108402;Várzea Grande;1;1;2;743
5100805;Apiacás;5108402;Várzea Grande;1;1;2;690
5101258;Araputanga;5108402;Várzea Grande;1;1;2;237
5101902;Brasnorte;5108402;Várzea Grande;1;1;2;433
5102702;Canarana;5108402;Várzea Grande;1;1;2;477
5103056;Cláudia;5108402;Várzea Grande;1;1;2;478
5103304;Comodoro;5108402;Várzea Grande;1;1;2;444
5103601;Dom Aquino;5108402;Várzea Grande;1;1;2;135
5104807;Jaciara;5108402;Várzea Grande;1;1;2;130
5104906;Jangada;5108402;Várzea Grande;1;1;2;57
5105101;Juara;5108402;Várzea Grande;1;1;2;506
5105200;Juscimeira;5108402;Várzea Grande;1;1;2;143
5105580;Marcelândia;5108402;Várzea Grande;1;1;2;542
5106000;Nortelândia;5108402;Várzea Grande;1;1;2;148
5106109;Nossa Senhora do Livramento;5108402;Várzea Grande;1;1;2;26
5106422;Peixoto de Azevedo;5108402;Várzea Grande;1;1;2;610
5107305;São José do Rio Claro;5108402;Várzea Grande;1;1;2;253
5107701;Rosário Oeste;5108402;Várzea Grande;1;1;2;98
5107859;São Félix do Araguaia;5108402;Várzea Grande;1;1;2;731
5107875;Sapezal;5108402;Várzea Grande;1;1;2;404
5108006;Tapurah;5108402;Várzea Grande;1;1;2;321
3504008;Assis;5108352;Vale de São  Domingos;1;1;2;1248
5103056;Cláudia;5108303;União do Sul;1;1;2;58
5107925;Sorriso;5108303;União do Sul;1;1;2;189
3501608;Americana;5108204;Torixoréu;1;1;2;924
5103403;Cuiabá;5108204;Torixoréu;1;1;2;380
5106257;Nova Xavantina;5108204;Torixoréu;1;1;2;170
5107198;Ribeirãozinho;5108204;Torixoréu;1;1;2;32
5107602;Rondonópolis;5108204;Torixoréu;1;1;2;222
5102793;Carlinda;5108055;Terra Nova do Norte;1;1;2;90
5105606;Matupá;5108055;Terra Nova do Norte;1;1;2;49
1302603;Manaus;5108006;Tapurah;1;1;2;1131
4107256;Douradina;5108006;Tapurah;1;1;2;1229
4321808;Três de Maio;5108006;Tapurah;1;1;2;1678
5100250;Alta Floresta;5108006;Tapurah;1;1;2;323
5101902;Brasnorte;5108006;Tapurah;1;1;2;169
5103700;Feliz Natal;5108006;Tapurah;1;1;2;182
5104526;Ipiranga do Norte;5108006;Tapurah;1;1;2;73
5106224;Nova Mutum;5108006;Tapurah;1;1;2;129
1100049;Cacoal;5107958;Tangará da Serra;1;1;2;553
1100288;Rolim de Moura;5107958;Tangará da Serra;1;1;2;549
1501402;Belém;5107958;Tangará da Serra;1;1;2;1749
1505536;Parauapebas;5107958;Tangará da Serra;1;1;2;1251
1600303;Macapá;5107958;Tangará da Serra;1;1;2;1760
2408102;Natal;5107958;Tangará da Serra;1;1;2;2554
3106200;Belo Horizonte;5107958;Tangará da Serra;1;1;2;1587
3301702;Duque de Caxias;5107958;Tangará da Serra;1;1;2;1803
3304151;Quissamã;5107958;Tangará da Serra;1;1;2;1947
3304557;Rio de Janeiro;5107958;Tangará da Serra;1;1;2;1815
3503208;Araraquara;5107958;Tangará da Serra;1;1;2;1295
3518800;Guarulhos;5107958;Tangará da Serra;1;1;2;1552
3524709;Jaguariúna;5107958;Tangará da Serra;1;1;2;1462
3528403;Mairinque;5107958;Tangará da Serra;1;1;2;1507
3541604;Promissão;5107958;Tangará da Serra;1;1;2;1134
4109708;Ibaiti;5107958;Tangará da Serra;1;1;2;1302
4112009;Jaguariaíva;5107958;Tangará da Serra;1;1;2;1373
4125506;São José dos Pinhais;5107958;Tangará da Serra;1;1;2;1521
4126306;Sengés;5107958;Tangará da Serra;1;1;2;1375
4205902;Gaspar;5107958;Tangará da Serra;1;1;2;1663
5005400;Maracaju;5107958;Tangará da Serra;1;1;2;813
5007695;São Gabriel do Oeste;5107958;Tangará da Serra;1;1;2;617
5100201;Água Boa;5107958;Tangará da Serra;1;1;2;574
5101258;Araputanga;5107958;Tangará da Serra;1;1;2;131
5101902;Brasnorte;5107958;Tangará da Serra;1;1;2;278
5103205;Colíder;5107958;Tangará da Serra;1;1;2;473
5103304;Comodoro;5107958;Tangará da Serra;1;1;2;269
5103437;Curvelândia;5107958;Tangará da Serra;1;1;2;119
5103957;Glória d'Oeste;5107958;Tangará da Serra;1;1;2;158
5104906;Jangada;5107958;Tangará da Serra;1;1;2;127
5105150;Juína;5107958;Tangará da Serra;1;1;2;382
5105176;Juruena;5107958;Tangará da Serra;1;1;2;485
5105903;Nobres;5107958;Tangará da Serra;1;1;2;119
5106000;Nortelândia;5107958;Tangará da Serra;1;1;2;77
5106158;Nova Bandeirantes;5107958;Tangará da Serra;1;1;2;532
5106778;Porto Alegre do Norte;5107958;Tangará da Serra;1;1;2;749
5106802;Porto dos Gaúchos;5107958;Tangará da Serra;1;1;2;343
5106828;Porto Esperidião;5107958;Tangará da Serra;1;1;2;171
5107156;Reserva do Cabaçal;5107958;Tangará da Serra;1;1;2;117
5107305;São José do Rio Claro;5107958;Tangará da Serra;1;1;2;155
5107750;Salto do Céu;5107958;Tangará da Serra;1;1;2;89
3147709;Passa Tempo;5107941;Tabaporã;1;1;2;1725
3543402;Ribeirão Preto;5107941;Tabaporã;1;1;2;1490
3550308;São Paulo;5107941;Tabaporã;1;1;2;1788
4106902;Curitiba;5107941;Tabaporã;1;1;2;1788
4205902;Gaspar;5107941;Tabaporã;1;1;2;1954
5103205;Colíder;5107941;Tabaporã;1;1;2;154
5103403;Cuiabá;5107941;Tabaporã;1;1;2;485
5106802;Porto dos Gaúchos;5107941;Tabaporã;1;1;2;69
1200401;Rio Branco;5107925;Sorriso;1;1;2;1336
1302603;Manaus;5107925;Sorriso;1;1;2;1140
3148004;Patos de Minas;5107925;Sorriso;1;1;2;1218
3303302;Niterói;5107925;Sorriso;1;1;2;1816
3304557;Rio de Janeiro;5107925;Sorriso;1;1;2;1802
3505708;Barueri;5107925;Sorriso;1;1;2;1567
3518800;Guarulhos;5107925;Sorriso;1;1;2;1583
3524105;Ituverava;5107925;Sorriso;1;1;2;1231
3534401;Osasco;5107925;Sorriso;1;1;2;1575
3541406;Presidente Prudente;5107925;Sorriso;1;1;2;1167
3543402;Ribeirão Preto;5107925;Sorriso;1;1;2;1299
3551306;Sebastianópolis do Sul;5107925;Sorriso;1;1;2;1106
4101804;Araucária;5107925;Sorriso;1;1;2;1611
4107256;Douradina;5107925;Sorriso;1;1;2;1231
4114401;Mangueirinha;5107925;Sorriso;1;1;2;1537
4118501;Pato Branco;5107925;Sorriso;1;1;2;1555
4125605;São Mateus do Sul;5107925;Sorriso;1;1;2;1590
5003801;Fátima do Sul;5107925;Sorriso;1;1;2;1098
5101308;Arenápolis;5107925;Sorriso;1;1;2;242
5101902;Brasnorte;5107925;Sorriso;1;1;2;246
5102504;Cáceres;5107925;Sorriso;1;1;2;439
5102686;Campos de Júlio;5107925;Sorriso;1;1;2;400
5103502;Diamantino;5107925;Sorriso;1;1;2;220
5104542;Itanhangá;5107925;Sorriso;1;1;2;110
5104807;Jaciara;5107925;Sorriso;1;1;2;386
5105101;Juara;5107925;Sorriso;1;1;2;238
5105606;Matupá;5107925;Sorriso;1;1;2;275
5105903;Nobres;5107925;Sorriso;1;1;2;251
5106307;Paranatinga;5107925;Sorriso;1;1;2;281
5106372;Pedra Preta;5107925;Sorriso;1;1;2;473
5107248;Santa Carmem;5107925;Sorriso;1;1;2;89
5107305;São José do Rio Claro;5107925;Sorriso;1;1;2;145
5107768;Santa Rita do Trivelato;5107925;Sorriso;1;1;2;150
5107792;Santo Antônio do Leste;5107925;Sorriso;1;1;2;339
1100122;Ji-Paraná;5107909;Sinop;1;1;2;704
1400100;Boa Vista;5107909;Sinop;1;1;2;1722
1501204;Baião;5107909;Sinop;1;1;2;1185
1501402;Belém;5107909;Sinop;1;1;2;1386
1505031;Novo Progresso;5107909;Sinop;1;1;2;521
1600303;Macapá;5107909;Sinop;1;1;2;1403
2304400;Fortaleza;5107909;Sinop;1;1;2;2035
3147907;Passos;5107909;Sinop;1;1;2;1389
3168804;Tiradentes;5107909;Sinop;1;1;2;1624
3203908;Nova Venécia;5107909;Sinop;1;1;2;1835
3205200;Vila Velha;5107909;Sinop;1;1;2;1925
3205309;Vitória;5107909;Sinop;1;1;2;1926
3301702;Duque de Caxias;5107909;Sinop;1;1;2;1820
3303302;Niterói;5107909;Sinop;1;1;2;1847
3509502;Campinas;5107909;Sinop;1;1;2;1544
3518800;Guarulhos;5107909;Sinop;1;1;2;1626
3519709;Ibiúna;5107909;Sinop;1;1;2;1602
3536505;Paulínia;5107909;Sinop;1;1;2;1525
3543402;Ribeirão Preto;5107909;Sinop;1;1;2;1339
3549805;São José do Rio Preto;5107909;Sinop;1;1;2;1202
3554003;Tatuí;5107909;Sinop;1;1;2;1533
4103701;Cambé;5107909;Sinop;1;1;2;1351
4107520;Esperança Nova;5107909;Sinop;1;1;2;1327
4107652;Fazenda Rio Grande;5107909;Sinop;1;1;2;1679
4109708;Ibaiti;5107909;Sinop;1;1;2;1455
4111902;Jaguapitã;5107909;Sinop;1;1;2;1322
4113304;Laranjeiras do Sul;5107909;Sinop;1;1;2;1541
4114203;Mandaguari;5107909;Sinop;1;1;2;1363
4115804;Medianeira;5107909;Sinop;1;1;2;1495
4118204;Paranaguá;5107909;Sinop;1;1;2;1709
4121703;Reserva;5107909;Sinop;1;1;2;1509
4122206;Rio Branco do Sul;5107909;Sinop;1;1;2;1631
4204301;Concórdia;5107909;Sinop;1;1;2;1745
4205902;Gaspar;5107909;Sinop;1;1;2;1825
4208906;Jaraguá do Sul;5107909;Sinop;1;1;2;1774
4212007;Palma Sola;5107909;Sinop;1;1;2;1623
4219309;Videira;5107909;Sinop;1;1;2;1747
4219507;Xanxerê;5107909;Sinop;1;1;2;1697
5004304;Iguatemi;5107909;Sinop;1;1;2;1312
5004700;Ivinhema;5107909;Sinop;1;1;2;1173
5101704;Barra do Bugres;5107909;Sinop;1;1;2;397
5102678;Campo Verde;5107909;Sinop;1;1;2;406
5102793;Carlinda;5107909;Sinop;1;1;2;213
5103007;Chapada dos Guimarães;5107909;Sinop;1;1;2;399
5103254;Colniza;5107909;Sinop;1;1;2;485
5103700;Feliz Natal;5107909;Sinop;1;1;2;86
5104807;Jaciara;5107909;Sinop;1;1;2;456
5106158;Nova Bandeirantes;5107909;Sinop;1;1;2;342
5106190;Nova Santa Helena;5107909;Sinop;1;1;2;117
5106216;Nova Canaã do Norte;5107909;Sinop;1;1;2;139
5106232;Nova Olímpia;5107909;Sinop;1;1;2;380
5106240;Nova Ubiratã;5107909;Sinop;1;1;2;128
5106299;Paranaíta;5107909;Sinop;1;1;2;264
5106752;Pontes e Lacerda;5107909;Sinop;1;1;2;565
5106802;Porto dos Gaúchos;5107909;Sinop;1;1;2;208
5107305;São José do Rio Claro;5107909;Sinop;1;1;2;220
3547502;Santa Rita do Passa Quatro;5107883;Serra Nova Dourada;1;1;2;1151
1712702;Mateiros;5107875;Sapezal;1;1;2;1360
3534401;Osasco;5107875;Sapezal;1;1;2;1773
3541406;Presidente Prudente;5107875;Sapezal;1;1;2;1301
4101507;Arapongas;5107875;Sapezal;1;1;2;1413
4102802;Bela Vista do Paraíso;5107875;Sapezal;1;1;2;1392
4107256;Douradina;5107875;Sapezal;1;1;2;1302
4118204;Paranaguá;5107875;Sapezal;1;1;2;1804
4125704;São Miguel do Iguaçu;5107875;Sapezal;1;1;2;1459
4128104;Umuarama;5107875;Sapezal;1;1;2;1336
4205902;Gaspar;5107875;Sapezal;1;1;2;1898
4313904;Panambi;5107875;Sapezal;1;1;2;1794
4314100;Passo Fundo;5107875;Sapezal;1;1;2;1837
4314902;Porto Alegre;5107875;Sapezal;1;1;2;2076
5101407;Aripuanã;5107875;Sapezal;1;1;2;316
5104807;Jaciara;5107875;Sapezal;1;1;2;526
5105150;Juína;5107875;Sapezal;1;1;2;177
5105176;Juruena;5107875;Sapezal;1;1;2;298
5105259;Lucas do Rio Verde;5107875;Sapezal;1;1;2;311
5106224;Nova Mutum;5107875;Sapezal;1;1;2;306
5106232;Nova Olímpia;5107875;Sapezal;1;1;2;257
5107040;Primavera do Leste;5107875;Sapezal;1;1;2;558
5107602;Rondonópolis;5107875;Sapezal;1;1;2;587
3170107;Uberaba;5107859;São Félix do Araguaia;1;1;2;951
3504503;Avaré;5107859;São Félix do Araguaia;1;1;2;1285
3534401;Osasco;5107859;São Félix do Araguaia;1;1;2;1390
3536406;Paulicéia;5107859;São Félix do Araguaia;1;1;2;1080
3550308;São Paulo;5107859;São Félix do Araguaia;1;1;2;1407
4113700;Londrina;5107859;São Félix do Araguaia;1;1;2;1293
4205902;Gaspar;5107859;São Félix do Araguaia;1;1;2;1706
5102694;CanaBrava do Norte;5107859;São Félix do Araguaia;1;1;2;136
5106299;Paranaíta;5107859;São Félix do Araguaia;1;1;2;662
5106778;Porto Alegre do Norte;5107859;São Félix do Araguaia;1;1;2;128
5107354;São José do Xingu;5107859;São Félix do Araguaia;1;1;2;238
5107743;Santa Cruz do Xingu;5107859;São Félix do Araguaia;1;1;2;244
3304557;Rio de Janeiro;5107800;Santo Antônio do Leverger;1;1;2;1603
3553005;Taguaí;5107800;Santo Antônio do Leverger;1;1;2;1115
4104808;Cascavel;5107800;Santo Antônio do Leverger;1;1;2;1050
5000906;Antônio João;5107800;Santo Antônio do Leverger;1;1;2;703
5101605;Barão de Melgaço;5107800;Santo Antônio do Leverger;1;1;2;41
5104203;Guiratinga;5107800;Santo Antônio do Leverger;1;1;2;255
5106372;Pedra Preta;5107800;Santo Antônio do Leverger;1;1;2;192
5106505;Poconé;5107800;Santo Antônio do Leverger;1;1;2;77
5107040;Primavera do Leste;5107800;Santo Antônio do Leverger;1;1;2;187
3550308;São Paulo;5107792;Santo Antônio do Leste;1;1;2;1248
5102678;Campo Verde;5107792;Santo Antônio do Leste;1;1;2;183
3304557;Rio de Janeiro;5107776;Santa Terezinha;1;1;2;1598
3550308;São Paulo;5107776;Santa Terezinha;1;1;2;1522
5103353;Confresa;5107776;Santa Terezinha;1;1;2;112
3144300;Nanuque;5107768;Santa Rita do Trivelato;1;1;2;1688
3304557;Rio de Janeiro;5107768;Santa Rita do Trivelato;1;1;2;1666
4205902;Gaspar;5107768;Santa Rita do Trivelato;1;1;2;1616
5107040;Primavera do Leste;5107768;Santa Rita do Trivelato;1;1;2;215
5104906;Jangada;5107750;Salto do Céu;1;1;2;177
5105002;Jauru;5107750;Salto do Céu;1;1;2;81
5100201;Água Boa;5107743;Santa Cruz do Xingu;1;1;2;431
5103353;Confresa;5107743;Santa Cruz do Xingu;1;1;2;106
5103403;Cuiabá;5107743;Santa Cruz do Xingu;1;1;2;725
3532702;Nipoã;5107701;Rosário Oeste;1;1;2;995
3550308;São Paulo;5107701;Rosário Oeste;1;1;2;1459
4107256;Douradina;5107701;Rosário Oeste;1;1;2;1011
4302808;Caçapava do Sul;5107701;Rosário Oeste;1;1;2;1770
5105259;Lucas do Rio Verde;5107701;Rosário Oeste;1;1;2;202
5105903;Nobres;5107701;Rosário Oeste;1;1;2;12
5106224;Nova Mutum;5107701;Rosário Oeste;1;1;2;114
1100304;Vilhena;5107602;Rondonópolis;1;1;2;706
1400100;Boa Vista;5107602;Rondonópolis;1;1;2;2223
1501402;Belém;5107602;Rondonópolis;1;1;2;1786
1504208;Marabá;5107602;Rondonópolis;1;1;2;1354
1707652;Figueirópolis;5107602;Rondonópolis;1;1;2;749
1721000;Palmas;5107602;Rondonópolis;1;1;2;944
2611101;Petrolina;5107602;Rondonópolis;1;1;2;1683
2903201;Barreiras;5107602;Rondonópolis;1;1;2;1126
2906501;Candeias;5107602;Rondonópolis;1;1;2;1758
2909307;Correntina;5107602;Rondonópolis;1;1;2;1117
3115805;Centralina;5107602;Rondonópolis;1;1;2;632
3133758;Itaú de Minas;5107602;Rondonópolis;1;1;2;978
3147006;Paracatu;5107602;Rondonópolis;1;1;2;834
3201209;Cachoeiro de Itapemirim;5107602;Rondonópolis;1;1;2;1548
3202603;Iconha;5107602;Rondonópolis;1;1;2;1576
3205309;Vitória;5107602;Rondonópolis;1;1;2;1608
3504107;Atibaia;5107602;Rondonópolis;1;1;2;1154
3506003;Bauru;5107602;Rondonópolis;1;1;2;893
3507001;Boituva;5107602;Rondonópolis;1;1;2;1076
3509502;Campinas;5107602;Rondonópolis;1;1;2;1096
3511102;Catanduva;5107602;Rondonópolis;1;1;2;808
3513504;Cubatão;5107602;Rondonópolis;1;1;2;1223
3517406;Guaíra;5107602;Rondonópolis;1;1;2;811
3524303;Jaboticabal;5107602;Rondonópolis;1;1;2;873
3534302;Orlândia;5107602;Rondonópolis;1;1;2;874
3537701;Piacatu;5107602;Rondonópolis;1;1;2;723
3542404;Regente Feijó;5107602;Rondonópolis;1;1;2;739
3543907;Rio Claro;5107602;Rondonópolis;1;1;2;1017
3544905;Sales Oliveira;5107602;Rondonópolis;1;1;2;882
3547809;Santo André;5107602;Rondonópolis;1;1;2;1195
3551306;Sebastianópolis do Sul;5107602;Rondonópolis;1;1;2;695
3554003;Tatuí;5107602;Rondonópolis;1;1;2;1068
3556206;Valinhos;5107602;Rondonópolis;1;1;2;1106
3557105;Votuporanga;5107602;Rondonópolis;1;1;2;674
4100400;Almirante Tamandaré;5107602;Rondonópolis;1;1;2;1148
4103701;Cambé;5107602;Rondonópolis;1;1;2;846
4104303;Campo Mourão;5107602;Rondonópolis;1;1;2;880
4108403;Francisco Beltrão;5107602;Rondonópolis;1;1;2;1084
4108601;Goioerê;5107602;Rondonópolis;1;1;2;880
4109401;Guarapuava;5107602;Rondonópolis;1;1;2;1054
4114005;Mamborê;5107602;Rondonópolis;1;1;2;905
4116208;Morretes;5107602;Rondonópolis;1;1;2;1190
4117909;Palotina;5107602;Rondonópolis;1;1;2;877
4119509;Piraquara;5107602;Rondonópolis;1;1;2;1173
4119905;Ponta Grossa;5107602;Rondonópolis;1;1;2;1081
4125506;São José dos Pinhais;5107602;Rondonópolis;1;1;2;1176
4126504;Sertanópolis;5107602;Rondonópolis;1;1;2;835
4128005;Ubiratã;5107602;Rondonópolis;1;1;2;919
4128104;Umuarama;5107602;Rondonópolis;1;1;2;824
4201406;Araranguá;5107602;Rondonópolis;1;1;2;1502
4202305;Biguaçu;5107602;Rondonópolis;1;1;2;1393
4203501;Campo Erê;5107602;Rondonópolis;1;1;2;1118
4204202;Chapecó;5107602;Rondonópolis;1;1;2;1205
4204301;Concórdia;5107602;Rondonópolis;1;1;2;1231
4204608;Criciúma;5107602;Rondonópolis;1;1;2;1477
4205407;Florianópolis;5107602;Rondonópolis;1;1;2;1412
4209102;Joinville;5107602;Rondonópolis;1;1;2;1265
4211603;Nova Veneza;5107602;Rondonópolis;1;1;2;1469
4214805;Rio do Sul;5107602;Rondonópolis;1;1;2;1322
4216602;São José;5107602;Rondonópolis;1;1;2;1402
4304606;Canoas;5107602;Rondonópolis;1;1;2;1543
4305108;Caxias do Sul;5107602;Rondonópolis;1;1;2;1463
4306106;Cruz Alta;5107602;Rondonópolis;1;1;2;1359
4308201;Flores da Cunha;5107602;Rondonópolis;1;1;2;1449
4309308;Guaíba;5107602;Rondonópolis;1;1;2;1561
4314100;Passo Fundo;5107602;Rondonópolis;1;1;2;1334
4321956;Trindade do Sul;5107602;Rondonópolis;1;1;2;1245
5000708;Anastácio;5107602;Rondonópolis;1;1;2;466
5002605;Camapuã;5107602;Rondonópolis;1;1;2;351
5002951;Chapadão do Sul;5107602;Rondonópolis;1;1;2;342
5003306;Coxim;5107602;Rondonópolis;1;1;2;222
5003801;Fátima do Sul;5107602;Rondonópolis;1;1;2;661
5006606;Ponta Porã;5107602;Rondonópolis;1;1;2;684
5008008;Terenos;5107602;Rondonópolis;1;1;2;444
5008305;Três Lagoas;5107602;Rondonópolis;1;1;2;576
5100607;Alto Taquari;5107602;Rondonópolis;1;1;2;213
5101258;Araputanga;5107602;Rondonópolis;1;1;2;409
5101605;Barão de Melgaço;5107602;Rondonópolis;1;1;2;143
5102702;Canarana;5107602;Rondonópolis;1;1;2;408
5103353;Confresa;5107602;Rondonópolis;1;1;2;718
5103858;Gaúcha do Norte;5107602;Rondonópolis;1;1;2;390
5104104;Guarantã do Norte;5107602;Rondonópolis;1;1;2;715
5105101;Juara;5107602;Rondonópolis;1;1;2;644
5105903;Nobres;5107602;Rondonópolis;1;1;2;262
5106778;Porto Alegre do Norte;5107602;Rondonópolis;1;1;2;690
5107008;Poxoréo;5107602;Rondonópolis;1;1;2;71
5107297;São José do Povo;5107602;Rondonópolis;1;1;2;45
3304557;Rio de Janeiro;5107578;Rondolândia;1;1;2;2441
3555109;Tupi Paulista;5107578;Rondolândia;1;1;2;1606
4204202;Chapecó;5107578;Rondolândia;1;1;2;2061
5105200;Juscimeira;5107404;São Pedro da Cipa;1;1;2;6
3502804;Araçatuba;5107354;São José do Xingu;1;1;2;1181
3550308;São Paulo;5107354;São José do Xingu;1;1;2;1579
5100201;Água Boa;5107354;São José do Xingu;1;1;2;364
5107065;Querência;5107354;São José do Xingu;1;1;2;189
5107180;Ribeirão Cascalheira;5107354;São José do Xingu;1;1;2;257
1302603;Manaus;5107305;São José do Rio Claro;1;1;2;1195
3304805;São Fidélis;5107305;São José do Rio Claro;1;1;2;1891
3534401;Osasco;5107305;São José do Rio Claro;1;1;2;1572
4107256;Douradina;5107305;São José do Rio Claro;1;1;2;1165
4205902;Gaspar;5107305;São José do Rio Claro;1;1;2;1731
5101308;Arenápolis;5107305;São José do Rio Claro;1;1;2;112
5101852;Bom Jesus do Araguaia;5107305;São José do Rio Claro;1;1;2;581
5106505;Poconé;5107305;São José do Rio Claro;1;1;2;311
5107040;Primavera do Leste;5107305;São José do Rio Claro;1;1;2;348
3549805;São José do Rio Preto;5107263;Santo Afonso;1;1;2;1089
3550308;São Paulo;5107263;Santo Afonso;1;1;2;1529
5101308;Arenápolis;5107263;Santo Afonso;1;1;2;19
5102678;Campo Verde;5107263;Santo Afonso;1;1;2;229
5105259;Lucas do Rio Verde;5107263;Santo Afonso;1;1;2;199
3304557;Rio de Janeiro;5107248;Santa Carmem;1;1;2;1807
3534401;Osasco;5107248;Santa Carmem;1;1;2;1596
3550308;São Paulo;5107248;Santa Carmem;1;1;2;1617
4117909;Palotina;5107248;Santa Carmem;1;1;2;1380
4118204;Paranaguá;5107248;Santa Carmem;1;1;2;1690
4128203;União da Vitória;5107248;Santa Carmem;1;1;2;1656
4320404;Serafina Corrêa;5107248;Santa Carmem;1;1;2;1897
3304557;Rio de Janeiro;5107206;Rio Branco;1;1;2;1838
5101258;Araputanga;5107206;Rio Branco;1;1;2;33
5105002;Jauru;5107206;Rio Branco;1;1;2;79
3304557;Rio de Janeiro;5107198;Ribeirãozinho;1;1;2;1247
3531902;Morro Agudo;5107180;Ribeirão Cascalheira;1;1;2;957
3532702;Nipoã;5107180;Ribeirão Cascalheira;1;1;2;911
3534401;Osasco;5107180;Ribeirão Cascalheira;1;1;2;1300
3549805;São José do Rio Preto;5107180;Ribeirão Cascalheira;1;1;2;913
4107256;Douradina;5107180;Ribeirão Cascalheira;1;1;2;1167
5005004;Jardim;5107180;Ribeirão Cascalheira;1;1;2;1065
5007901;Sidrolândia;5107180;Ribeirão Cascalheira;1;1;2;949
5101852;Bom Jesus do Araguaia;5107180;Ribeirão Cascalheira;1;1;2;92
5103353;Confresa;5107180;Ribeirão Cascalheira;1;1;2;256
5105002;Jauru;5107156;Reserva do Cabaçal;1;1;2;51
1302603;Manaus;5107107;São José dos Quatro Marcos;1;1;2;1396
4107256;Douradina;5107107;São José dos Quatro Marcos;1;1;2;1013
5103957;Glória d'Oeste;5107107;São José dos Quatro Marcos;1;1;2;27
5106505;Poconé;5107107;São José dos Quatro Marcos;1;1;2;178
5106752;Pontes e Lacerda;5107107;São José dos Quatro Marcos;1;1;2;131
5106828;Porto Esperidião;5107107;São José dos Quatro Marcos;1;1;2;40
1718204;Porto Nacional;5107065;Querência;1;1;2;477
3304557;Rio de Janeiro;5107065;Querência;1;1;2;1536
3531902;Morro Agudo;5107065;Querência;1;1;2;1031
3534401;Osasco;5107065;Querência;1;1;2;1374
4107256;Douradina;5107065;Querência;1;1;2;1211
4205902;Gaspar;5107065;Querência;1;1;2;1646
4316907;Santa Maria;5107065;Querência;1;1;2;1914
5002951;Chapadão do Sul;5107065;Querência;1;1;2;700
5101852;Bom Jesus do Araguaia;5107065;Querência;1;1;2;101
5103858;Gaúcha do Norte;5107065;Querência;1;1;2;114
5106257;Nova Xavantina;5107065;Querência;1;1;2;244
5106281;Novo São Joaquim;5107065;Querência;1;1;2;278
5106778;Porto Alegre do Norte;5107065;Querência;1;1;2;192
1302603;Manaus;5107040;Primavera do Leste;1;1;2;1497
1502301;Capitão Poço;5107040;Primavera do Leste;1;1;2;1705
1502939;Dom Eliseu;5107040;Primavera do Leste;1;1;2;1429
1503606;Itaituba;5107040;Primavera do Leste;1;1;2;1262
1505064;Novo Repartimento;5107040;Primavera do Leste;1;1;2;1329
1505502;Paragominas;5107040;Primavera do Leste;1;1;2;1567
1506807;Santarém;5107040;Primavera do Leste;1;1;2;1444
1507300;São Félix do Xingu;5107040;Primavera do Leste;1;1;2;1013
1702109;Araguaína;5107040;Primavera do Leste;1;1;2;1127
1707652;Figueirópolis;5107040;Primavera do Leste;1;1;2;665
2105302;Imperatriz;5107040;Primavera do Leste;1;1;2;1326
2304400;Fortaleza;5107040;Primavera do Leste;1;1;2;2111
2611101;Petrolina;5107040;Primavera do Leste;1;1;2;1617
2803609;Laranjeiras;5107040;Primavera do Leste;1;1;2;1899
2903201;Barreiras;5107040;Primavera do Leste;1;1;2;1063
2906501;Candeias;5107040;Primavera do Leste;1;1;2;1715
2909307;Correntina;5107040;Primavera do Leste;1;1;2;1064
2919553;Luís Eduardo magalhães;5107040;Primavera do Leste;1;1;2;984
3101904;Alpinópolis;5107040;Primavera do Leste;1;1;2;1048
3106200;Belo Horizonte;5107040;Primavera do Leste;1;1;2;1225
3148004;Patos de Minas;5107040;Primavera do Leste;1;1;2;913
3170206;Uberlândia;5107040;Primavera do Leste;1;1;2;756
3301702;Duque de Caxias;5107040;Primavera do Leste;1;1;2;1449
3505708;Barueri;5107040;Primavera do Leste;1;1;2;1205
3506508;Birigui;5107040;Primavera do Leste;1;1;2;774
3509502;Campinas;5107040;Primavera do Leste;1;1;2;1142
3513702;Descalvado;5107040;Primavera do Leste;1;1;2;1019
3534401;Osasco;5107040;Primavera do Leste;1;1;2;1214
3541406;Presidente Prudente;5107040;Primavera do Leste;1;1;2;799
3549805;São José do Rio Preto;5107040;Primavera do Leste;1;1;2;796
3551306;Sebastianópolis do Sul;5107040;Primavera do Leste;1;1;2;744
3552809;Taboão da Serra;5107040;Primavera do Leste;1;1;2;1220
3553856;Taquarivaí;5107040;Primavera do Leste;1;1;2;1118
4101507;Arapongas;5107040;Primavera do Leste;1;1;2;929
4102109;Astorga;5107040;Primavera do Leste;1;1;2;902
4104808;Cascavel;5107040;Primavera do Leste;1;1;2;1047
4105805;Colombo;5107040;Primavera do Leste;1;1;2;1215
4109708;Ibaiti;5107040;Primavera do Leste;1;1;2;1029
4116406;Nossa Senhora das Graças;5107040;Primavera do Leste;1;1;2;864
4119905;Ponta Grossa;5107040;Primavera do Leste;1;1;2;1156
4127700;Toledo;5107040;Primavera do Leste;1;1;2;1020
4128104;Umuarama;5107040;Primavera do Leste;1;1;2;916
4202404;Blumenau;5107040;Primavera do Leste;1;1;2;1393
4204301;Concórdia;5107040;Primavera do Leste;1;1;2;1320
4205902;Gaspar;5107040;Primavera do Leste;1;1;2;1397
4209003;Joaçaba;5107040;Primavera do Leste;1;1;2;1324
4300034;Aceguá;5107040;Primavera do Leste;1;1;2;1809
4301602;Bagé;5107040;Primavera do Leste;1;1;2;1751
4304358;Candiota;5107040;Primavera do Leste;1;1;2;1777
4306601;Dom Pedrito;5107040;Primavera do Leste;1;1;2;1710
4314902;Porto Alegre;5107040;Primavera do Leste;1;1;2;1647
5002407;Caarapó;5107040;Primavera do Leste;1;1;2;789
5002704;Campo Grande;5107040;Primavera do Leste;1;1;2;543
5100250;Alta Floresta;5107040;Primavera do Leste;1;1;2;651
5100607;Alto Taquari;5107040;Primavera do Leste;1;1;2;278
5102686;Campos de Júlio;5107040;Primavera do Leste;1;1;2;544
5103304;Comodoro;5107040;Primavera do Leste;1;1;2;617
5104526;Ipiranga do Norte;5107040;Primavera do Leste;1;1;2;411
5104609;Itiquira;5107040;Primavera do Leste;1;1;2;187
5105150;Juína;5107040;Primavera do Leste;1;1;2;654
5105903;Nobres;5107040;Primavera do Leste;1;1;2;236
5106299;Paranaíta;5107040;Primavera do Leste;1;1;2;685
5106372;Pedra Preta;5107040;Primavera do Leste;1;1;2;122
5106802;Porto dos Gaúchos;5107040;Primavera do Leste;1;1;2;547
1100205;Porto Velho;5107008;Poxoréo;1;1;2;1270
3304557;Rio de Janeiro;5107008;Poxoréo;1;1;2;1445
4115200;Maringá;5107008;Poxoréo;1;1;2;883
4118402;Paranavaí;5107008;Poxoréo;1;1;2;831
5106307;Paranatinga;5107008;Poxoréo;1;1;2;158
5106455;Planalto da Serra;5107008;Poxoréo;1;1;2;138
5101704;Barra do Bugres;5106851;Porto Estrela;1;1;2;32
5106232;Nova Olímpia;5106851;Porto Estrela;1;1;2;58
5103957;Glória d'Oeste;5106828;Porto Esperidião;1;1;2;14
5104500;Indiavaí;5106828;Porto Esperidião;1;1;2;41
5104906;Jangada;5106828;Porto Esperidião;1;1;2;221
5105150;Juína;5106802;Porto dos Gaúchos;1;1;2;150
5106273;Novo Horizonte do Norte;5106802;Porto dos Gaúchos;1;1;2;16
3301702;Duque de Caxias;5106778;Porto Alegre do Norte;1;1;2;1611
3534401;Osasco;5106778;Porto Alegre do Norte;1;1;2;1501
3550308;São Paulo;5106778;Porto Alegre do Norte;1;1;2;1519
4205902;Gaspar;5106778;Porto Alegre do Norte;1;1;2;1800
5101803;Barra do Garças;5106778;Porto Alegre do Norte;1;1;2;548
5102702;Canarana;5106778;Porto Alegre do Norte;1;1;2;300
5103403;Cuiabá;5106778;Porto Alegre do Norte;1;1;2;713
1100023;Ariquemes;5106752;Pontes e Lacerda;1;1;2;710
1100106;Guajará-Mirim;5106752;Pontes e Lacerda;1;1;2;806
1100114;Jaru;5106752;Pontes e Lacerda;1;1;2;634
1100122;Ji-Paraná;5106752;Pontes e Lacerda;1;1;2;552
1100304;Vilhena;5106752;Pontes e Lacerda;1;1;2;286
2304400;Fortaleza;5106752;Pontes e Lacerda;1;1;2;2534
3170206;Uberlândia;5106752;Pontes e Lacerda;1;1;2;1266
3301702;Duque de Caxias;5106752;Pontes e Lacerda;1;1;2;1945
3509205;Cajamar;5106752;Pontes e Lacerda;1;1;2;1637
3534401;Osasco;5106752;Pontes e Lacerda;1;1;2;1656
3541406;Presidente Prudente;5106752;Pontes e Lacerda;1;1;2;1155
3547304;Santana de Parnaíba;5106752;Pontes e Lacerda;1;1;2;1639
3556701;Vinhedo;5106752;Pontes e Lacerda;1;1;2;1607
4104808;Cascavel;5106752;Pontes e Lacerda;1;1;2;1253
4106902;Curitiba;5106752;Pontes e Lacerda;1;1;2;1582
4109708;Ibaiti;5106752;Pontes e Lacerda;1;1;2;1385
4128203;União da Vitória;5106752;Pontes e Lacerda;1;1;2;1521
4314803;Portão;5106752;Pontes e Lacerda;1;1;2;1839
5003702;Dourados;5106752;Pontes e Lacerda;1;1;2;917
5102686;Campos de Júlio;5106752;Pontes e Lacerda;1;1;2;152
5103361;Conquista D'Oeste;5106752;Pontes e Lacerda;1;1;2;83
5103502;Diamantino;5106752;Pontes e Lacerda;1;1;2;325
5105002;Jauru;5106752;Pontes e Lacerda;1;1;2;52
5105259;Lucas do Rio Verde;5106752;Pontes e Lacerda;1;1;2;440
5106109;Nossa Senhora do Livramento;5106752;Pontes e Lacerda;1;1;2;323
3550308;São Paulo;5106703;Ponte Branca;1;1;2;1025
5101209;Araguainha;5106703;Ponte Branca;1;1;2;23
5000203;Água Clara;5106653;Pontal do Araguaia;1;1;2;502
5101803;Barra do Garças;5106653;Pontal do Araguaia;1;1;2;16
5103205;Colíder;5106653;Pontal do Araguaia;1;1;2;655
1302603;Manaus;5106505;Poconé;1;1;2;1495
4107256;Douradina;5106505;Poconé;1;1;2;871
5003702;Dourados;5106505;Poconé;1;1;2;692
5100201;Água Boa;5106505;Poconé;1;1;2;533
5103007;Chapada dos Guimarães;5106505;Poconé;1;1;2;129
5104906;Jangada;5106505;Poconé;1;1;2;113
5106000;Nortelândia;5106505;Poconé;1;1;2;198
5002704;Campo Grande;5106455;Planalto da Serra;1;1;2;639
5103403;Cuiabá;5106455;Planalto da Serra;1;1;2;173
5104807;Jaciara;5106455;Planalto da Serra;1;1;2;146
5106208;Nova Brasilândia;5106455;Planalto da Serra;1;1;2;39
3506003;Bauru;5106422;Peixoto de Azevedo;1;1;2;1494
3534401;Osasco;5106422;Peixoto de Azevedo;1;1;2;1737
4107256;Douradina;5106422;Peixoto de Azevedo;1;1;2;1465
5105259;Lucas do Rio Verde;5106422;Peixoto de Azevedo;1;1;2;326
5106190;Nova Santa Helena;5106422;Peixoto de Azevedo;1;1;2;69
5106232;Nova Olímpia;5106422;Peixoto de Azevedo;1;1;2;563
3538709;Piracicaba;5106372;Pedra Preta;1;1;2;1006
3542206;Rancharia;5106372;Pedra Preta;1;1;2;732
4107256;Douradina;5106372;Pedra Preta;1;1;2;759
5002704;Campo Grande;5106372;Pedra Preta;1;1;2;421
5007935;Sonora;5106372;Pedra Preta;1;1;2;108
5100250;Alta Floresta;5106372;Pedra Preta;1;1;2;765
5100607;Alto Taquari;5106372;Pedra Preta;1;1;2;183
5102637;Campo Novo do Parecis;5106372;Pedra Preta;1;1;2;488
5103601;Dom Aquino;5106372;Pedra Preta;1;1;2;101
5104104;Guarantã do Norte;5106372;Pedra Preta;1;1;2;739
5104807;Jaciara;5106372;Pedra Preta;1;1;2;93
5105200;Juscimeira;5106372;Pedra Preta;1;1;2;78
5105903;Nobres;5106372;Pedra Preta;1;1;2;292
3304557;Rio de Janeiro;5106307;Paranatinga;1;1;2;1512
3502804;Araçatuba;5106307;Paranatinga;1;1;2;847
3534401;Osasco;5106307;Paranatinga;1;1;2;1286
4107256;Douradina;5106307;Paranatinga;1;1;2;992
4118204;Paranaguá;5106307;Paranatinga;1;1;2;1375
4118402;Paranavaí;5106307;Paranatinga;1;1;2;973
5102678;Campo Verde;5106307;Paranatinga;1;1;2;168
5104203;Guiratinga;5106307;Paranatinga;1;1;2;212
5105259;Lucas do Rio Verde;5106307;Paranatinga;1;1;2;252
5105903;Nobres;5106307;Paranatinga;1;1;2;254
1100023;Ariquemes;5106299;Paranaíta;1;1;2;716
1100205;Porto Velho;5106299;Paranaíta;1;1;2;816
3103504;Araguari;5106299;Paranaíta;1;1;2;1355
3304557;Rio de Janeiro;5106299;Paranaíta;1;1;2;2088
3534401;Osasco;5106299;Paranaíta;1;1;2;1884
3550308;São Paulo;5106299;Paranaíta;1;1;2;1905
4312203;Maximiliano de Almeida;5106299;Paranaíta;1;1;2;2058
5002704;Campo Grande;5106299;Paranaíta;1;1;2;1207
5103403;Cuiabá;5106299;Paranaíta;1;1;2;651
3534401;Osasco;5106281;Novo São Joaquim;1;1;2;1176
4126801;Tapejara;5106281;Novo São Joaquim;1;1;2;977
3170107;Uberaba;5106273;Novo Horizonte do Norte;1;1;2;1394
5105150;Juína;5106273;Novo Horizonte do Norte;1;1;2;156
3505500;Barretos;5106265;Novo Mundo;1;1;2;1388
5103205;Colíder;5106265;Novo Mundo;1;1;2;100
5103403;Cuiabá;5106265;Novo Mundo;1;1;2;628
5106224;Nova Mutum;5106265;Novo Mundo;1;1;2;441
1302603;Manaus;5106257;Nova Xavantina;1;1;2;1512
2917706;Jaguarari;5106257;Nova Xavantina;1;1;2;1393
3301702;Duque de Caxias;5106257;Nova Xavantina;1;1;2;1343
3509205;Cajamar;5106257;Nova Xavantina;1;1;2;1138
3534401;Osasco;5106257;Nova Xavantina;1;1;2;1159
3550308;São Paulo;5106257;Nova Xavantina;1;1;2;1179
4107256;Douradina;5106257;Nova Xavantina;1;1;2;968
4118204;Paranaguá;5106257;Nova Xavantina;1;1;2;1280
5102702;Canarana;5106257;Nova Xavantina;1;1;2;127
5103353;Confresa;5106257;Nova Xavantina;1;1;2;456
5103403;Cuiabá;5106257;Nova Xavantina;1;1;2;410
3304557;Rio de Janeiro;5106240;Nova Ubiratã;1;1;2;1726
3513702;Descalvado;5106240;Nova Ubiratã;1;1;2;1300
3539301;Pirassununga;5106240;Nova Ubiratã;1;1;2;1322
3540705;Porto Ferreira;5106240;Nova Ubiratã;1;1;2;1306
3547502;Santa Rita do Passa Quatro;5106240;Nova Ubiratã;1;1;2;1294
3551306;Sebastianópolis do Sul;5106240;Nova Ubiratã;1;1;2;1033
4117909;Palotina;5106240;Nova Ubiratã;1;1;2;1262
5103056;Cláudia;5106240;Nova Ubiratã;1;1;2;169
5105259;Lucas do Rio Verde;5106240;Nova Ubiratã;1;1;2;71
1100122;Ji-Paraná;5106232;Nova Olímpia;1;1;2;652
1100205;Porto Velho;5106232;Nova Olímpia;1;1;2;966
1500800;Ananindeua;5106232;Nova Olímpia;1;1;2;1758
1506807;Santarém;5106232;Nova Olímpia;1;1;2;1390
3300308;Barra do Piraí;5106232;Nova Olímpia;1;1;2;1707
3534401;Osasco;5106232;Nova Olímpia;1;1;2;1509
4107256;Douradina;5106232;Nova Olímpia;1;1;2;1047
5101407;Aripuanã;5106232;Nova Olímpia;1;1;2;556
5105259;Lucas do Rio Verde;5106232;Nova Olímpia;1;1;2;243
1302603;Manaus;5106224;Nova Mutum;1;1;2;1258
2203230;Currais;5106224;Nova Mutum;1;1;2;1360
3118601;Contagem;5106224;Nova Mutum;1;1;2;1479
3524303;Jaboticabal;5106224;Nova Mutum;1;1;2;1187
3534401;Osasco;5106224;Nova Mutum;1;1;2;1488
3551306;Sebastianópolis do Sul;5106224;Nova Mutum;1;1;2;1014
4101804;Araucária;5106224;Nova Mutum;1;1;2;1499
4119905;Ponta Grossa;5106224;Nova Mutum;1;1;2;1411
4127700;Toledo;5106224;Nova Mutum;1;1;2;1232
4128104;Umuarama;5106224;Nova Mutum;1;1;2;1138
4215406;Salto Veloso;5106224;Nova Mutum;1;1;2;1539
4219309;Videira;5106224;Nova Mutum;1;1;2;1559
5002704;Campo Grande;5106224;Nova Mutum;1;1;2;746
5100250;Alta Floresta;5106224;Nova Mutum;1;1;2;437
5101308;Arenápolis;5106224;Nova Mutum;1;1;2;106
5102504;Cáceres;5106224;Nova Mutum;1;1;2;297
5102637;Campo Novo do Parecis;5106224;Nova Mutum;1;1;2;197
5103056;Cláudia;5106224;Nova Mutum;1;1;2;288
5104203;Guiratinga;5106224;Nova Mutum;1;1;2;376
5105200;Juscimeira;5106224;Nova Mutum;1;1;2;277
5105903;Nobres;5106224;Nova Mutum;1;1;2;103
5106000;Nortelândia;5106224;Nova Mutum;1;1;2;103
3505708;Barueri;5106216;Nova Canaã do Norte;1;1;2;1739
4311403;Lajeado;5106216;Nova Canaã do Norte;1;1;2;2124
5100250;Alta Floresta;5106216;Nova Canaã do Norte;1;1;2;91
5105259;Lucas do Rio Verde;5106216;Nova Canaã do Norte;1;1;2;271
5105606;Matupá;5106216;Nova Canaã do Norte;1;1;2;96
3525706;José Bonifácio;5106208;Nova Brasilândia;1;1;2;887
5002704;Campo Grande;5106208;Nova Brasilândia;1;1;2;606
5102678;Campo Verde;5106208;Nova Brasilândia;1;1;2;65
5103403;Cuiabá;5106208;Nova Brasilândia;1;1;2;138
5105259;Lucas do Rio Verde;5106208;Nova Brasilândia;1;1;2;233
3550308;São Paulo;5106190;Nova Santa Helena;1;1;2;1712
5105606;Matupá;5106190;Nova Santa Helena;1;1;2;79
3303302;Niterói;5106182;Nova Lacerda;1;1;2;2046
3550308;São Paulo;5106182;Nova Lacerda;1;1;2;1757
5101258;Araputanga;5106182;Nova Lacerda;1;1;2;171
5103304;Comodoro;5106182;Nova Lacerda;1;1;2;92
5105002;Jauru;5106182;Nova Lacerda;1;1;2;126
5105507;Vila Bela da Santíssima Trindade;5106182;Nova Lacerda;1;1;2;65
3303302;Niterói;5106174;Nova Nazaré;1;1;2;1376
3550308;São Paulo;5106174;Nova Nazaré;1;1;2;1212
4307708;Esteio;5106174;Nova Nazaré;1;1;2;1757
5100201;Água Boa;5106174;Nova Nazaré;1;1;2;42
5103106;Cocalinho;5106174;Nova Nazaré;1;1;2;98
3505708;Barueri;5106158;Nova Bandeirantes;1;1;2;1959
4112504;Jardim Alegre;5106158;Nova Bandeirantes;1;1;2;1736
5008305;Três Lagoas;5106158;Nova Bandeirantes;1;1;2;1393
5102793;Carlinda;5106158;Nova Bandeirantes;1;1;2;225
5103205;Colíder;5106158;Nova Bandeirantes;1;1;2;286
5103403;Cuiabá;5106109;Nossa Senhora do Livramento;1;1;2;39
3509502;Campinas;5106000;Nortelândia;1;1;2;1423
3543402;Ribeirão Preto;5106000;Nortelândia;1;1;2;1234
4118204;Paranaguá;5106000;Nortelândia;1;1;2;1535
5101308;Arenápolis;5106000;Nortelândia;1;1;2;6
5103403;Cuiabá;5106000;Nortelândia;1;1;2;143
1302603;Manaus;5105903;Nobres;1;1;2;1341
3164704;São Sebastião do Paraíso;5105903;Nobres;1;1;2;1237
3509601;Campo Limpo Paulista;5105903;Nobres;1;1;2;1415
3534401;Osasco;5105903;Nobres;1;1;2;1440
3548807;São Caetano do Sul;5105903;Nobres;1;1;2;1464
4106902;Curitiba;5105903;Nobres;1;1;2;1423
4107256;Douradina;5105903;Nobres;1;1;2;1017
4202909;Brusque;5105903;Nobres;1;1;2;1604
4217303;Saudades;5105903;Nobres;1;1;2;1403
5000609;Amambaí;5105903;Nobres;1;1;2;938
5002704;Campo Grande;5105903;Nobres;1;1;2;659
5102637;Campo Novo do Parecis;5105903;Nobres;1;1;2;200
3534401;Osasco;5105622;Mirassol d'Oeste;1;1;2;1514
3543402;Ribeirão Preto;5105622;Mirassol d'Oeste;1;1;2;1274
4106902;Curitiba;5105622;Mirassol d'Oeste;1;1;2;1452
4107256;Douradina;5105622;Mirassol d'Oeste;1;1;2;1002
4109708;Ibaiti;5105622;Mirassol d'Oeste;1;1;2;1254
4208203;Itajaí;5105622;Mirassol d'Oeste;1;1;2;1621
4219309;Videira;5105622;Mirassol d'Oeste;1;1;2;1472
4310108;Igrejinha;5105622;Mirassol d'Oeste;1;1;2;1742
5101704;Barra do Bugres;5105622;Mirassol d'Oeste;1;1;2;122
5102637;Campo Novo do Parecis;5105622;Mirassol d'Oeste;1;1;2;224
5103304;Comodoro;5105622;Mirassol d'Oeste;1;1;2;287
5103957;Glória d'Oeste;5105622;Mirassol d'Oeste;1;1;2;29
5105507;Vila Bela da Santíssima Trindade;5105622;Mirassol d'Oeste;1;1;2;209
2611606;Recife;5105606;Matupá;1;1;2;2199
3534401;Osasco;5105606;Matupá;1;1;2;1741
4106902;Curitiba;5105606;Matupá;1;1;2;1806
5100250;Alta Floresta;5105606;Matupá;1;1;2;128
5102793;Carlinda;5105606;Matupá;1;1;2;100
5103403;Cuiabá;5105606;Matupá;1;1;2;608
3534401;Osasco;5105580;Marcelândia;1;1;2;1627
4107256;Douradina;5105580;Marcelândia;1;1;2;1371
4218202;Timbó;5105580;Marcelândia;1;1;2;1844
5100250;Alta Floresta;5105580;Marcelândia;1;1;2;221
5103502;Diamantino;5105580;Marcelândia;1;1;2;432
3170107;Uberaba;5105507;Vila Bela da Santíssima Trindade;1;1;2;1408
3548807;São Caetano do Sul;5105507;Vila Bela da Santíssima Trindade;1;1;2;1754
3550308;São Paulo;5105507;Vila Bela da Santíssima Trindade;1;1;2;1748
4107256;Douradina;5105507;Vila Bela da Santíssima Trindade;1;1;2;1181
5002704;Campo Grande;5105507;Vila Bela da Santíssima Trindade;1;1;2;832
5105002;Jauru;5105507;Vila Bela da Santíssima Trindade;1;1;2;120
1302603;Manaus;5105259;Lucas do Rio Verde;1;1;2;1186
1501402;Belém;5105259;Lucas do Rio Verde;1;1;2;1518
2611606;Recife;5105259;Lucas do Rio Verde;1;1;2;2322
3301702;Duque de Caxias;5105259;Lucas do Rio Verde;1;1;2;1764
3505708;Barueri;5105259;Lucas do Rio Verde;1;1;2;1533
3511003;Castilho;5105259;Lucas do Rio Verde;1;1;2;992
3517406;Guaíra;5105259;Lucas do Rio Verde;1;1;2;1160
3534401;Osasco;5105259;Lucas do Rio Verde;1;1;2;1541
3541406;Presidente Prudente;5105259;Lucas do Rio Verde;1;1;2;1122
3548500;Santos;5105259;Lucas do Rio Verde;1;1;2;1604
4101507;Arapongas;5105259;Lucas do Rio Verde;1;1;2;1249
4103453;Cafelândia;5105259;Lucas do Rio Verde;1;1;2;1311
4103800;Cambira;5105259;Lucas do Rio Verde;1;1;2;1259
4104808;Cascavel;5105259;Lucas do Rio Verde;1;1;2;1343
4106902;Curitiba;5105259;Lucas do Rio Verde;1;1;2;1557
4107256;Douradina;5105259;Lucas do Rio Verde;1;1;2;1178
4109708;Ibaiti;5105259;Lucas do Rio Verde;1;1;2;1354
4115200;Maringá;5105259;Lucas do Rio Verde;1;1;2;1230
4118105;Paranacity;5105259;Lucas do Rio Verde;1;1;2;1169
4119905;Ponta Grossa;5105259;Lucas do Rio Verde;1;1;2;1480
4128104;Umuarama;5105259;Lucas do Rio Verde;1;1;2;1217
4203600;Campos Novos;5105259;Lucas do Rio Verde;1;1;2;1675
4204202;Chapecó;5105259;Lucas do Rio Verde;1;1;2;1598
4204608;Criciúma;5105259;Lucas do Rio Verde;1;1;2;1878
4205902;Gaspar;5105259;Lucas do Rio Verde;1;1;2;1723
4208401;Itapiranga;5105259;Lucas do Rio Verde;1;1;2;1581
4307005;Erechim;5105259;Lucas do Rio Verde;1;1;2;1664
4309506;Guarani das Missões;5105259;Lucas do Rio Verde;1;1;2;1676
4314100;Passo Fundo;5105259;Lucas do Rio Verde;1;1;2;1728
4318002;São Borja;5105259;Lucas do Rio Verde;1;1;2;1727
5001904;Bataguassu;5105259;Lucas do Rio Verde;1;1;2;1032
5007695;São Gabriel do Oeste;5105259;Lucas do Rio Verde;1;1;2;717
5100201;Água Boa;5105259;Lucas do Rio Verde;1;1;2;419
5100607;Alto Taquari;5105259;Lucas do Rio Verde;1;1;2;599
5101308;Arenápolis;5105259;Lucas do Rio Verde;1;1;2;184
5101704;Barra do Bugres;5105259;Lucas do Rio Verde;1;1;2;259
5101803;Barra do Garças;5105259;Lucas do Rio Verde;1;1;2;500
5101902;Brasnorte;5105259;Lucas do Rio Verde;1;1;2;247
5103056;Cláudia;5105259;Lucas do Rio Verde;1;1;2;204
5103452;Denise;5105259;Lucas do Rio Verde;1;1;2;224
5103858;Gaúcha do Norte;5105259;Lucas do Rio Verde;1;1;2;307
5105002;Jauru;5105259;Lucas do Rio Verde;1;1;2;409
5105200;Juscimeira;5105259;Lucas do Rio Verde;1;1;2;349
3539301;Pirassununga;5105234;Lambari d'Oeste;1;1;2;1373
3543402;Ribeirão Preto;5105234;Lambari d'Oeste;1;1;2;1288
5101258;Araputanga;5105234;Lambari d'Oeste;1;1;2;39
4106902;Curitiba;5105200;Juscimeira;1;1;2;1208
4107256;Douradina;5105200;Juscimeira;1;1;2;830
5101308;Arenápolis;5105200;Juscimeira;1;1;2;273
5104609;Itiquira;5105200;Juscimeira;1;1;2;151
3534401;Osasco;5105176;Juruena;1;1;2;1960
3550308;São Paulo;5105176;Juruena;1;1;2;1981
4107256;Douradina;5105176;Juruena;1;1;2;1554
4214805;Rio do Sul;5105176;Juruena;1;1;2;2122
4314902;Porto Alegre;5105176;Juruena;1;1;2;2334
5102850;Castanheira;5105176;Juruena;1;1;2;95
5103205;Colíder;5105176;Juruena;1;1;2;323
1100049;Cacoal;5105150;Juína;1;1;2;296
1100064;Colorado do Oeste;5105150;Juína;1;1;2;270
1100114;Jaru;5105150;Juína;1;1;2;430
1302603;Manaus;5105150;Juína;1;1;2;926
3301702;Duque de Caxias;5105150;Juína;1;1;2;2139
3304557;Rio de Janeiro;5105150;Juína;1;1;2;2152
3509205;Cajamar;5105150;Juína;1;1;2;1879
3514403;Dracena;5105150;Juína;1;1;2;1379
3534401;Osasco;5105150;Juína;1;1;2;1900
4101507;Arapongas;5105150;Juína;1;1;2;1563
4106902;Curitiba;5105150;Juína;1;1;2;1886
4107256;Douradina;5105150;Juína;1;1;2;1461
4305801;Constantina;5105150;Juína;1;1;2;1924
5100805;Apiacás;5105150;Juína;1;1;2;248
5102504;Cáceres;5105150;Juína;1;1;2;526
5103205;Colíder;5105150;Juína;1;1;2;363
1100056;Cerejeiras;5105101;Juara;1;1;2;420
1302603;Manaus;5105101;Juara;1;1;2;942
2913606;Ilhéus;5105101;Juara;1;1;2;2060
3301702;Duque de Caxias;5105101;Juara;1;1;2;2038
3534401;Osasco;5105101;Juara;1;1;2;1815
3536307;Patrocínio Paulista;5105101;Juara;1;1;2;1540
3541406;Presidente Prudente;5105101;Juara;1;1;2;1384
4101507;Arapongas;5105101;Juara;1;1;2;1507
4107256;Douradina;5105101;Juara;1;1;2;1422
4115200;Maringá;5105101;Juara;1;1;2;1485
4212007;Palma Sola;5105101;Juara;1;1;2;1737
4216602;São José;5105101;Juara;1;1;2;2066
5002704;Campo Grande;5105101;Juara;1;1;2;1062
5101308;Arenápolis;5105101;Juara;1;1;2;359
5102504;Cáceres;5105101;Juara;1;1;2;527
5102850;Castanheira;5105101;Juara;1;1;2;127
5103205;Colíder;5105101;Juara;1;1;2;229
5103700;Feliz Natal;5105101;Juara;1;1;2;309
5104104;Guarantã do Norte;5105101;Juara;1;1;2;318
5104807;Jaciara;5105101;Juara;1;1;2;588
1302603;Manaus;5105002;Jauru;1;1;2;1358
4106902;Curitiba;5105002;Jauru;1;1;2;1539
5103361;Conquista D'Oeste;5105002;Jauru;1;1;2;116
5103957;Glória d'Oeste;5105002;Jauru;1;1;2;71
3520509;Indaiatuba;5104906;Jangada;1;1;2;1337
3534401;Osasco;5104906;Jangada;1;1;2;1408
3550308;São Paulo;5104906;Jangada;1;1;2;1428
4204202;Chapecó;5104906;Jangada;1;1;2;1383
5002704;Campo Grande;5104906;Jangada;1;1;2;608
5100250;Alta Floresta;5104906;Jangada;1;1;2;594
5100409;Alto Garças;5104906;Jangada;1;1;2;369
5101704;Barra do Bugres;5104906;Jangada;1;1;2;77
5103403;Cuiabá;5104906;Jangada;1;1;2;55
5103957;Glória d'Oeste;5104906;Jangada;1;1;2;209
3534401;Osasco;5104807;Jaciara;1;1;2;1230
3554102;Taubaté;5104807;Jaciara;1;1;2;1291
4106902;Curitiba;5104807;Jaciara;1;1;2;1223
4113700;Londrina;5104807;Jaciara;1;1;2;915
4115200;Maringá;5104807;Jaciara;1;1;2;893
5101803;Barra do Garças;5104807;Jaciara;1;1;2;293
5102504;Cáceres;5104807;Jaciara;1;1;2;286
5103007;Chapada dos Guimarães;5104807;Jaciara;1;1;2;97
5104104;Guarantã do Norte;5104807;Jaciara;1;1;2;663
1709500;Gurupi;5104609;Itiquira;1;1;2;810
2202901;Corrente;5104609;Itiquira;1;1;2;1203
2903201;Barreiras;5104609;Itiquira;1;1;2;1111
2913457;Igrapiúna;5104609;Itiquira;1;1;2;1628
3205010;Sooretama;5104609;Itiquira;1;1;2;1520
3505500;Barretos;5104609;Itiquira;1;1;2;703
3509502;Campinas;5104609;Itiquira;1;1;2;993
3534708;Ourinhos;5104609;Itiquira;1;1;2;788
4106902;Curitiba;5104609;Itiquira;1;1;2;1054
4107256;Douradina;5104609;Itiquira;1;1;2;690
4205407;Florianópolis;5104609;Itiquira;1;1;2;1306
4205902;Gaspar;5104609;Itiquira;1;1;2;1218
5002308;Brasilândia;5104609;Itiquira;1;1;2;500
5100201;Água Boa;5104609;Itiquira;1;1;2;407
5101803;Barra do Garças;5104609;Itiquira;1;1;2;252
5102702;Canarana;5104609;Itiquira;1;1;2;452
5104203;Guiratinga;5104609;Itiquira;1;1;2;105
3550308;São Paulo;5104559;Itaúba;1;1;2;1698
5103205;Colíder;5104559;Itaúba;1;1;2;34
5103403;Cuiabá;5104559;Itaúba;1;1;2;505
5104526;Ipiranga do Norte;5104542;Itanhangá;1;1;2;59
4204301;Concórdia;5104526;Ipiranga do Norte;1;1;2;1722
5103403;Cuiabá;5104526;Ipiranga do Norte;1;1;2;366
5103858;Gaúcha do Norte;5104526;Ipiranga do Norte;1;1;2;352
3550308;São Paulo;5104500;Indiavaí;1;1;2;1591
4106902;Curitiba;5104500;Indiavaí;1;1;2;1505
5102504;Cáceres;5104500;Indiavaí;1;1;2;113
1501402;Belém;5104203;Guiratinga;1;1;2;1746
3147709;Passa Tempo;5104203;Guiratinga;1;1;2;1109
3502804;Araçatuba;5104203;Guiratinga;1;1;2;648
3534401;Osasco;5104203;Guiratinga;1;1;2;1100
4107256;Douradina;5104203;Guiratinga;1;1;2;781
4115200;Maringá;5104203;Guiratinga;1;1;2;809
4122404;Rolândia;5104203;Guiratinga;1;1;2;814
5100300;Alto Araguaia;5104203;Guiratinga;1;1;2;121
1302603;Manaus;5104104;Guarantã do Norte;1;1;2;940
1500602;Altamira;5104104;Guarantã do Norte;1;1;2;806
1505031;Novo Progresso;5104104;Guarantã do Norte;1;1;2;316
1700400;Almas;5104104;Guarantã do Norte;1;1;2;869
3534401;Osasco;5104104;Guarantã do Norte;1;1;2;1760
3550308;São Paulo;5104104;Guarantã do Norte;1;1;2;1780
4107256;Douradina;5104104;Guarantã do Norte;1;1;2;1496
4314902;Porto Alegre;5104104;Guarantã do Norte;1;1;2;2264
5002704;Campo Grande;5104104;Guarantã do Norte;1;1;2;1158
5101704;Barra do Bugres;5104104;Guarantã do Norte;1;1;2;615
5103056;Cláudia;5104104;Guarantã do Norte;1;1;2;171
5102504;Cáceres;5103957;Glória d'Oeste;1;1;2;79
5103809;Figueirópolis d'Oeste;5103957;Glória d'Oeste;1;1;2;54
3303302;Niterói;5103908;General Carneiro;1;1;2;1325
4118204;Paranaguá;5103908;General Carneiro;1;1;2;1190
4216008;São Carlos;5103858;Gaúcha do Norte;1;1;2;1531
4104808;Cascavel;5103700;Feliz Natal;1;1;2;1400
4118204;Paranaguá;5103700;Feliz Natal;1;1;2;1627
4214706;Rio dos Cedros;5103700;Feliz Natal;1;1;2;1712
3550308;São Paulo;5103601;Dom Aquino;1;1;2;1255
5002704;Campo Grande;5103601;Dom Aquino;1;1;2;512
5101803;Barra do Garças;5103601;Dom Aquino;1;1;2;284
1302603;Manaus;5103502;Diamantino;1;1;2;1306
3170206;Uberlândia;5103502;Diamantino;1;1;2;1020
3534401;Osasco;5103502;Diamantino;1;1;2;1469
4101804;Araucária;5103502;Diamantino;1;1;2;1464
4104303;Campo Mourão;5103502;Diamantino;1;1;2;1157
4107256;Douradina;5103502;Diamantino;1;1;2;1052
4115200;Maringá;5103502;Diamantino;1;1;2;1116
4116901;Nova Esperança;5103502;Diamantino;1;1;2;1078
4118204;Paranaguá;5103502;Diamantino;1;1;2;1516
4205902;Gaspar;5103502;Diamantino;1;1;2;1619
5100508;Alto Paraguai;5103502;Diamantino;1;1;2;12
5103403;Cuiabá;5103452;Denise;1;1;2;137
3516903;General Salgado;5103437;Curvelândia;1;1;2;993
1100015;Alta Floresta d'Oeste;5103403;Cuiabá;1;1;2;745
1100056;Cerejeiras;5103403;Cuiabá;1;1;2;569
1100106;Guajará-Mirim;5103403;Cuiabá;1;1;2;1111
1100114;Jaru;5103403;Cuiabá;1;1;2;889
1100130;Machadinho d'Oeste;5103403;Cuiabá;1;1;2;923
1100155;Ouro Preto do Oeste;5103403;Cuiabá;1;1;2;847
1100452;Buritis;5103403;Cuiabá;1;1;2;1011
1101492;São Francisco do Guaporé;5103403;Cuiabá;1;1;2;884
1200013;Acrelândia;5103403;Cuiabá;1;1;2;1307
1200104;Brasiléia;5103403;Cuiabá;1;1;2;1433
1301902;Itacoatiara;5103403;Cuiabá;1;1;2;1402
1500800;Ananindeua;5103403;Cuiabá;1;1;2;1766
1501501;Benevides;5103403;Cuiabá;1;1;2;1773
1502764;Cumaru do Norte;5103403;Cuiabá;1;1;2;1024
1503606;Itaituba;5103403;Cuiabá;1;1;2;1253
1504208;Marabá;5103403;Cuiabá;1;1;2;1347
1504422;Marituba;5103403;Cuiabá;1;1;2;1769
1505502;Paragominas;5103403;Cuiabá;1;1;2;1664
1508100;Tucuruí;5103403;Cuiabá;1;1;2;1467
1702109;Araguaína;5103403;Cuiabá;1;1;2;1245
1709500;Gurupi;5103403;Cuiabá;1;1;2;861
1716109;Paraíso do Tocantins;5103403;Cuiabá;1;1;2;968
2101400;Balsas;5103403;Cuiabá;1;1;2;1385
2111201;São José de Ribamar;5103403;Cuiabá;1;1;2;1918
2207405;Palmeira do Piauí;5103403;Cuiabá;1;1;2;1465
2211001;Teresina;5103403;Cuiabá;1;1;2;1817
2303709;Caucaia;5103403;Cuiabá;1;1;2;2252
2306306;Itapagé;5103403;Cuiabá;1;1;2;2177
2600054;Abreu e Lima;5103403;Cuiabá;1;1;2;2396
2800308;Aracaju;5103403;Cuiabá;1;1;2;2084
2801504;Carmópolis;5103403;Cuiabá;1;1;2;2102
2907509;Catu;5103403;Cuiabá;1;1;2;1924
2910727;Eunápolis;5103403;Cuiabá;1;1;2;1777
2919207;Lauro de Freitas;5103403;Cuiabá;1;1;2;1920
3122306;Divinópolis;5103403;Cuiabá;1;1;2;1321
3145208;Nova Serrana;5103403;Cuiabá;1;1;2;1298
3146107;Ouro Preto;5103403;Cuiabá;1;1;2;1466
3164704;São Sebastião do Paraíso;5103403;Cuiabá;1;1;2;1157
3170404;Unaí;5103403;Cuiabá;1;1;2;991
3202405;Guarapari;5103403;Cuiabá;1;1;2;1782
3203205;Linhares;5103403;Cuiabá;1;1;2;1792
3204906;São Mateus;5103403;Cuiabá;1;1;2;1791
3301702;Duque de Caxias;5103403;Cuiabá;1;1;2;1612
3303302;Niterói;5103403;Cuiabá;1;1;2;1639
3303906;Petrópolis;5103403;Cuiabá;1;1;2;1607
3304144;Queimados;5103403;Cuiabá;1;1;2;1583
3501301;Álvares Machado;5103403;Cuiabá;1;1;2;881
3501905;Amparo;5103403;Cuiabá;1;1;2;1292
3502101;Andradina;5103403;Cuiabá;1;1;2;784
3503208;Araraquara;5103403;Cuiabá;1;1;2;1107
3503950;Aspásia;5103403;Cuiabá;1;1;2;775
3505500;Barretos;5103403;Cuiabá;1;1;2;987
3507506;Botucatu;5103403;Cuiabá;1;1;2;1166
3507605;Bragança Paulista;5103403;Cuiabá;1;1;2;1328
3508405;Cabreúva;5103403;Cuiabá;1;1;2;1305
3508702;Caconde;5103403;Cuiabá;1;1;2;1225
3509205;Cajamar;5103403;Cuiabá;1;1;2;1330
3511409;Cerqueira César;5103403;Cuiabá;1;1;2;1124
3512803;Cosmópolis;5103403;Cuiabá;1;1;2;1251
3513504;Cubatão;5103403;Cuiabá;1;1;2;1408
3514403;Dracena;5103403;Cuiabá;1;1;2;826
3518701;Guarujá;5103403;Cuiabá;1;1;2;1425
3524402;Jacareí;5103403;Cuiabá;1;1;2;1407
3525904;Jundiaí;5103403;Cuiabá;1;1;2;1315
3528403;Mairinque;5103403;Cuiabá;1;1;2;1319
3529005;Marília;5103403;Cuiabá;1;1;2;998
3530607;Moji das Cruzes;5103403;Cuiabá;1;1;2;1403
3530706;Mogi Guaçu;5103403;Cuiabá;1;1;2;1250
3534302;Orlândia;5103403;Cuiabá;1;1;2;1061
3536307;Patrocínio Paulista;5103403;Cuiabá;1;1;2;1110
3538006;Pindamonhangaba;5103403;Cuiabá;1;1;2;1423
3544004;Rio das Pedras;5103403;Cuiabá;1;1;2;1231
3549904;São José dos Campos;5103403;Cuiabá;1;1;2;1404
3551306;Sebastianópolis do Sul;5103403;Cuiabá;1;1;2;878
3552809;Taboão da Serra;5103403;Cuiabá;1;1;2;1356
3554102;Taubaté;5103403;Cuiabá;1;1;2;1417
3554508;Tietê;5103403;Cuiabá;1;1;2;1242
3556008;Urupês;5103403;Cuiabá;1;1;2;970
4103701;Cambé;5103403;Cuiabá;1;1;2;1007
4104659;Carambeí;5103403;Cuiabá;1;1;2;1230
4105508;Cianorte;5103403;Cuiabá;1;1;2;976
4105607;Cidade Gaúcha;5103403;Cuiabá;1;1;2;933
4105706;Clevelândia;5103403;Cuiabá;1;1;2;1266
4107652;Fazenda Rio Grande;5103403;Cuiabá;1;1;2;1347
4108304;Foz do Iguaçu;5103403;Cuiabá;1;1;2;1116
4108403;Francisco Beltrão;5103403;Cuiabá;1;1;2;1213
4110409;Indianópolis;5103403;Cuiabá;1;1;2;953
4110953;Itaipulândia;5103403;Cuiabá;1;1;2;1079
4114203;Mandaguari;5103403;Cuiabá;1;1;2;1009
4119905;Ponta Grossa;5103403;Cuiabá;1;1;2;1244
4120655;Quarto Centenário;5103403;Cuiabá;1;1;2;1021
4128005;Ubiratã;5103403;Cuiabá;1;1;2;1053
4128104;Umuarama;5103403;Cuiabá;1;1;2;956
4202008;Balneário Camboriú;5103403;Cuiabá;1;1;2;1510
4202909;Brusque;5103403;Cuiabá;1;1;2;1506
4204608;Criciúma;5103403;Cuiabá;1;1;2;1634
4205308;Faxinal dos Guedes;5103403;Cuiabá;1;1;2;1321
4208906;Jaraguá do Sul;5103403;Cuiabá;1;1;2;1438
4212106;Palmitos;5103403;Cuiabá;1;1;2;1316
4216008;São Carlos;5103403;Cuiabá;1;1;2;1320
4302105;Bento Gonçalves;5103403;Cuiabá;1;1;2;1592
4303004;Cachoeira do Sul;5103403;Cuiabá;1;1;2;1639
4303905;Campo Bom;5103403;Cuiabá;1;1;2;1663
4304705;Carazinho;5103403;Cuiabá;1;1;2;1458
4306403;Dois Irmãos;5103403;Cuiabá;1;1;2;1652
4307005;Erechim;5103403;Cuiabá;1;1;2;1403
4309209;Gravataí;5103403;Cuiabá;1;1;2;1693
4309308;Guaíba;5103403;Cuiabá;1;1;2;1699
4310207;Ijuí;5103403;Cuiabá;1;1;2;1442
4314100;Passo Fundo;5103403;Cuiabá;1;1;2;1466
4316907;Santa Maria;5103403;Cuiabá;1;1;2;1587
4318002;São Borja;5103403;Cuiabá;1;1;2;1451
4319505;São Sebastião do Caí;5103403;Cuiabá;1;1;2;1641
5001003;Aparecida do Taboado;5103403;Cuiabá;1;1;2;739
5003306;Coxim;5103403;Cuiabá;1;1;2;348
5004601;Itaquiraí;5103403;Cuiabá;1;1;2;901
5006002;Nova Alvorada do Sul;5103403;Cuiabá;1;1;2;680
5006309;Paranaíba;5103403;Cuiabá;1;1;2;698
5008008;Terenos;5103403;Cuiabá;1;1;2;556
5100102;Acorizal;5103403;Cuiabá;1;1;2;50
5100409;Alto Garças;5103403;Cuiabá;1;1;2;314
5100508;Alto Paraguai;5103403;Cuiabá;1;1;2;122
5100607;Alto Taquari;5103403;Cuiabá;1;1;2;392
5101308;Arenápolis;5103403;Cuiabá;1;1;2;147
5103304;Comodoro;5103403;Cuiabá;1;1;2;446
3527108;Lins;5103379;Cotriguaçu;1;1;2;1628
4107652;Fazenda Rio Grande;5103379;Cotriguaçu;1;1;2;2030
4216008;São Carlos;5103379;Cotriguaçu;1;1;2;2000
5101902;Brasnorte;5103379;Cotriguaçu;1;1;2;257
5102793;Carlinda;5103379;Cotriguaçu;1;1;2;282
5102850;Castanheira;5103379;Cotriguaçu;1;1;2;142
1506708;Santana do Araguaia;5103353;Confresa;1;1;2;196
1721000;Palmas;5103353;Confresa;1;1;2;351
2611903;Rio Formoso;5103353;Confresa;1;1;2;1802
3106200;Belo Horizonte;5103353;Confresa;1;1;2;1329
3509205;Cajamar;5103353;Confresa;1;1;2;1503
3534401;Osasco;5103353;Confresa;1;1;2;1525
3550308;São Paulo;5103353;Confresa;1;1;2;1543
4107256;Douradina;5103353;Confresa;1;1;2;1423
5100359;Alto Boa Vista;5103353;Confresa;1;1;2;116
5101852;Bom Jesus do Araguaia;5103353;Confresa;1;1;2;170
5102694;CanaBrava do Norte;5103353;Confresa;1;1;2;54
5103205;Colíder;5103353;Confresa;1;1;2;427
1100023;Ariquemes;5103304;Comodoro;1;1;2;541
1100049;Cacoal;5103304;Comodoro;1;1;2;307
1100106;Guajará-Mirim;5103304;Comodoro;1;1;2;674
1100155;Ouro Preto do Oeste;5103304;Comodoro;1;1;2;421
1100189;Pimenta Bueno;5103304;Comodoro;1;1;2;268
1100288;Rolim de Moura;5103304;Comodoro;1;1;2;292
1302603;Manaus;5103304;Comodoro;1;1;2;1167
3515004;Embu;5103304;Comodoro;1;1;2;1813
4102802;Bela Vista do Paraíso;5103304;Comodoro;1;1;2;1406
4104808;Cascavel;5103304;Comodoro;1;1;2;1435
4107256;Douradina;5103304;Comodoro;1;1;2;1295
4127700;Toledo;5103304;Comodoro;1;1;2;1397
5102637;Campo Novo do Parecis;5103304;Comodoro;1;1;2;204
1100023;Ariquemes;5103254;Colniza;1;1;2;417
1100122;Ji-Paraná;5103254;Colniza;1;1;2;336
1100130;Machadinho d'Oeste;5103254;Colniza;1;1;2;307
4107256;Douradina;5103254;Colniza;1;1;2;1681
5103205;Colíder;5103254;Colniza;1;1;2;441
1100205;Porto Velho;5103205;Colíder;1;1;2;943
1100320;São Miguel do Guaporé;5103205;Colíder;1;1;2;802
1302603;Manaus;5103205;Colíder;1;1;2;985
1505031;Novo Progresso;5103205;Colíder;1;1;2;406
2910727;Eunápolis;5103205;Colíder;1;1;2;1859
3106200;Belo Horizonte;5103205;Colíder;1;1;2;1628
3502101;Andradina;5103205;Colíder;1;1;2;1208
3505708;Barueri;5103205;Colíder;1;1;2;1706
3518800;Guarulhos;5103205;Colíder;1;1;2;1719
3524709;Jaguariúna;5103205;Colíder;1;1;2;1624
3534401;Osasco;5103205;Colíder;1;1;2;1713
4107256;Douradina;5103205;Colíder;1;1;2;1412
4204400;Coronel Freitas;5103205;Colíder;1;1;2;1808
4313037;Nova Esperança do Sul;5103205;Colíder;1;1;2;2059
5100805;Apiacás;5103205;Colíder;1;1;2;260
3167400;Silvianópolis;5103106;Cocalinho;1;1;2;1018
3304557;Rio de Janeiro;5103106;Cocalinho;1;1;2;1269
3507506;Botucatu;5103106;Cocalinho;1;1;2;980
3530508;Mococa;5103106;Cocalinho;1;1;2;895
5002605;Camapuã;5103106;Cocalinho;1;1;2;659
5100201;Água Boa;5103106;Cocalinho;1;1;2;134
5101803;Barra do Garças;5103106;Cocalinho;1;1;2;209
3534401;Osasco;5103056;Cláudia;1;1;2;1611
3550308;São Paulo;5103056;Cláudia;1;1;2;1631
4106902;Curitiba;5103056;Cláudia;1;1;2;1665
4118204;Paranaguá;5103056;Cláudia;1;1;2;1714
5002704;Campo Grande;5103056;Cláudia;1;1;2;987
1302603;Manaus;5103007;Chapada dos Guimarães;1;1;2;1438
3534401;Osasco;5103007;Chapada dos Guimarães;1;1;2;1329
4107256;Douradina;5102850;Castanheira;1;1;2;1485
5101704;Barra do Bugres;5102850;Castanheira;1;1;2;462
5002704;Campo Grande;5102793;Carlinda;1;1;2;1166
1709500;Gurupi;5102702;Canarana;1;1;2;401
3301702;Duque de Caxias;5102702;Canarana;1;1;2;1424
3516200;Franca;5102702;Canarana;1;1;2;942
3525904;Jundiaí;5102702;Canarana;1;1;2;1222
3534401;Osasco;5102702;Canarana;1;1;2;1262
3537305;Penápolis;5102702;Canarana;1;1;2;906
3551702;Sertãozinho;5102702;Canarana;1;1;2;964
4106902;Curitiba;5102702;Canarana;1;1;2;1358
4107256;Douradina;5102702;Canarana;1;1;2;1095
4205902;Gaspar;5102702;Canarana;1;1;2;1528
4316907;Santa Maria;5102702;Canarana;1;1;2;1798
5002951;Chapadão do Sul;5102702;Canarana;1;1;2;583
5100359;Alto Boa Vista;5102702;Canarana;1;1;2;227
5101803;Barra do Garças;5102694;CanaBrava do Norte;1;1;2;529
5101852;Bom Jesus do Araguaia;5102694;CanaBrava do Norte;1;1;2;129
1100049;Cacoal;5102686;Campos de Júlio;1;1;2;370
1100056;Cerejeiras;5102686;Campos de Júlio;1;1;2;198
1100205;Porto Velho;5102686;Campos de Júlio;1;1;2;759
3526704;Leme;5102686;Campos de Júlio;1;1;2;1590
4102802;Bela Vista do Paraíso;5102686;Campos de Júlio;1;1;2;1338
4121406;Realeza;5102686;Campos de Júlio;1;1;2;1456
4205902;Gaspar;5102686;Campos de Júlio;1;1;2;1840
5002902;Cassilândia;5102686;Campos de Júlio;1;1;2;996
1302603;Manaus;5102678;Campo Verde;1;1;2;1464
1506807;Santarém;5102678;Campo Verde;1;1;2;1443
3143302;Montes Claros;5102678;Campo Verde;1;1;2;1223
3170206;Uberlândia;5102678;Campo Verde;1;1;2;835
3507001;Boituva;5102678;Campo Verde;1;1;2;1189
3517703;Guará;5102678;Campo Verde;1;1;2;966
3524105;Ituverava;5102678;Campo Verde;1;1;2;960
3527405;Lucélia;5102678;Campo Verde;1;1;2;822
3534401;Osasco;5102678;Campo Verde;1;1;2;1278
3551306;Sebastianópolis do Sul;5102678;Campo Verde;1;1;2;805
4101408;Apucarana;5102678;Campo Verde;1;1;2;979
4101507;Arapongas;5102678;Campo Verde;1;1;2;965
4106902;Curitiba;5102678;Campo Verde;1;1;2;1275
4107256;Douradina;5102678;Campo Verde;1;1;2;894
4109708;Ibaiti;5102678;Campo Verde;1;1;2;1073
4115200;Maringá;5102678;Campo Verde;1;1;2;945
4128104;Umuarama;5102678;Campo Verde;1;1;2;933
4205506;Fraiburgo;5102678;Campo Verde;1;1;2;1359
4205902;Gaspar;5102678;Campo Verde;1;1;2;1439
4309605;Horizontina;5102678;Campo Verde;1;1;2;1344
4314803;Portão;5102678;Campo Verde;1;1;2;1631
4320107;Sarandi;5102678;Campo Verde;1;1;2;1398
1302603;Manaus;5102637;Campo Novo do Parecis;1;1;2;1190
2309706;Pacatuba;5102637;Campo Novo do Parecis;1;1;2;2318
3205309;Vitória;5102637;Campo Novo do Parecis;1;1;2;2069
3534401;Osasco;5102637;Campo Novo do Parecis;1;1;2;1648
3541604;Promissão;5102637;Campo Novo do Parecis;1;1;2;1243
3548708;São Bernardo do Campo;5102637;Campo Novo do Parecis;1;1;2;1679
4101804;Araucária;5102637;Campo Novo do Parecis;1;1;2;1626
4107256;Douradina;5102637;Campo Novo do Parecis;1;1;2;1190
4108403;Francisco Beltrão;5102637;Campo Novo do Parecis;1;1;2;1477
4109708;Ibaiti;5102637;Campo Novo do Parecis;1;1;2;1416
4117909;Palotina;5102637;Campo Novo do Parecis;1;1;2;1261
4118204;Paranaguá;5102637;Campo Novo do Parecis;1;1;2;1682
4127700;Toledo;5102637;Campo Novo do Parecis;1;1;2;1308
4128104;Umuarama;5102637;Campo Novo do Parecis;1;1;2;1226
4205902;Gaspar;5102637;Campo Novo do Parecis;1;1;2;1778
4306767;Eldorado do Sul;5102637;Campo Novo do Parecis;1;1;2;1952
4314100;Passo Fundo;5102637;Campo Novo do Parecis;1;1;2;1730
4314902;Porto Alegre;5102637;Campo Novo do Parecis;1;1;2;1967
5101704;Barra do Bugres;5102637;Campo Novo do Parecis;1;1;2;170
5102504;Cáceres;5102637;Campo Novo do Parecis;1;1;2;262
2611606;Recife;5102603;Campinápolis;1;1;2;2040
3534401;Osasco;5102603;Campinápolis;1;1;2;1205
4106902;Curitiba;5102603;Campinápolis;1;1;2;1273
5100201;Água Boa;5102603;Campinápolis;1;1;2;93
1100015;Alta Floresta d'Oeste;5102504;Cáceres;1;1;2;645
1501402;Belém;5102504;Cáceres;1;1;2;1886
2927408;Salvador;5102504;Cáceres;1;1;2;2070
3170206;Uberlândia;5102504;Cáceres;1;1;2;1063
3205309;Vitória;5102504;Cáceres;1;1;2;1939
3301702;Duque de Caxias;5102504;Cáceres;1;1;2;1736
3502101;Andradina;5102504;Cáceres;1;1;2;870
3506003;Bauru;5102504;Cáceres;1;1;2;1169
3518206;Guararapes;5102504;Cáceres;1;1;2;959
3518800;Guarulhos;5102504;Cáceres;1;1;2;1466
3524709;Jaguariúna;5102504;Cáceres;1;1;2;1381
3530607;Moji das Cruzes;5102504;Cáceres;1;1;2;1508
3534401;Osasco;5102504;Cáceres;1;1;2;1452
3548807;São Caetano do Sul;5102504;Cáceres;1;1;2;1477
4101507;Arapongas;5102504;Cáceres;1;1;2;1065
4114203;Mandaguari;5102504;Cáceres;1;1;2;1059
4128104;Umuarama;5102504;Cáceres;1;1;2;978
5003306;Coxim;5102504;Cáceres;1;1;2;410
5101803;Barra do Garças;5102504;Cáceres;1;1;2;579
3304557;Rio de Janeiro;5101902;Brasnorte;1;1;2;2029
4101507;Arapongas;5101902;Brasnorte;1;1;2;1445
4107256;Douradina;5101902;Brasnorte;1;1;2;1349
4118204;Paranaguá;5101902;Brasnorte;1;1;2;1827
4205902;Gaspar;5101902;Brasnorte;1;1;2;1928
4212007;Palma Sola;5101902;Brasnorte;1;1;2;1658
4309209;Gravataí;5101902;Brasnorte;1;1;2;2125
5003306;Coxim;5101902;Brasnorte;1;1;2;779
5101258;Araputanga;5101902;Brasnorte;1;1;2;365
3550308;São Paulo;5101852;Bom Jesus do Araguaia;1;1;2;1381
5100201;Água Boa;5101852;Bom Jesus do Araguaia;1;1;2;220
1302603;Manaus;5101803;Barra do Garças;1;1;2;1623
1501402;Belém;5101803;Barra do Garças;1;1;2;1646
2102804;Carolina;5101803;Barra do Garças;1;1;2;1065
2306306;Itapagé;5101803;Barra do Garças;1;1;2;1889
3143104;Monte Carmelo;5101803;Barra do Garças;1;1;2;607
3170107;Uberaba;5101803;Barra do Garças;1;1;2;641
3170206;Uberlândia;5101803;Barra do Garças;1;1;2;551
3301702;Duque de Caxias;5101803;Barra do Garças;1;1;2;1245
3507506;Botucatu;5101803;Barra do Garças;1;1;2;887
3512704;Corumbataí;5101803;Barra do Garças;1;1;2;871
3513702;Descalvado;5101803;Barra do Garças;1;1;2;843
3534401;Osasco;5101803;Barra do Garças;1;1;2;1044
3537305;Penápolis;5101803;Barra do Garças;1;1;2;666
3541406;Presidente Prudente;5101803;Barra do Garças;1;1;2;706
3548807;São Caetano do Sul;5101803;Barra do Garças;1;1;2;1066
3551504;Serrana;5101803;Barra do Garças;1;1;2;784
3557105;Votuporanga;5101803;Barra do Garças;1;1;2;569
4106902;Curitiba;5101803;Barra do Garças;1;1;2;1114
4113700;Londrina;5101803;Barra do Garças;1;1;2;837
4205902;Gaspar;5101803;Barra do Garças;1;1;2;1284
5003702;Dourados;5101803;Barra do Garças;1;1;2;761
5100250;Alta Floresta;5101803;Barra do Garças;1;1;2;770
5100409;Alto Garças;5101803;Barra do Garças;1;1;2;189
5100607;Alto Taquari;5101803;Barra do Garças;1;1;2;248
1302603;Manaus;5101704;Barra do Bugres;1;1;2;1353
2607901;Jaboatão dos Guararapes;5101704;Barra do Bugres;1;1;2;2473
2611606;Recife;5101704;Barra do Bugres;1;1;2;2483
3304557;Rio de Janeiro;5101704;Barra do Bugres;1;1;2;1759
3534401;Osasco;5101704;Barra do Bugres;1;1;2;1481
3543402;Ribeirão Preto;5101704;Barra do Bugres;1;1;2;1229
4107256;Douradina;5101704;Barra do Bugres;1;1;2;1018
4301602;Bagé;5101704;Barra do Bugres;1;1;2;1838
5100250;Alta Floresta;5101704;Barra do Bugres;1;1;2;582
5101258;Araputanga;5101704;Barra do Bugres;1;1;2;135
3536505;Paulínia;5101605;Barão de Melgaço;1;1;2;1207
1100098;Espigão d'Oeste;5101407;Aripuanã;1;1;2;232
1100304;Vilhena;5101407;Aripuanã;1;1;2;301
3505708;Barueri;5101407;Aripuanã;1;1;2;2042
3520509;Indaiatuba;5101407;Aripuanã;1;1;2;1978
3527405;Lucélia;5101407;Aripuanã;1;1;2;1584
4107256;Douradina;5101407;Aripuanã;1;1;2;1613
3534401;Osasco;5101308;Arenápolis;1;1;2;1499
4106902;Curitiba;5101308;Arenápolis;1;1;2;1479
4107256;Douradina;5101308;Arenápolis;1;1;2;1065
1302603;Manaus;5101258;Araputanga;1;1;2;1374
3506003;Bauru;5101258;Araputanga;1;1;2;1272
3534401;Osasco;5101258;Araputanga;1;1;2;1556
3550308;São Paulo;5101258;Araputanga;1;1;2;1577
4107256;Douradina;5101258;Araputanga;1;1;2;1041
3550308;São Paulo;5100805;Apiacás;1;1;2;1984
4107652;Fazenda Rio Grande;5100805;Apiacás;1;1;2;2011
4125506;São José dos Pinhais;5100805;Apiacás;1;1;2;2006
2408102;Natal;5100607;Alto Taquari;1;1;2;2292
3518206;Guararapes;5100607;Alto Taquari;1;1;2;476
3524808;Jales;5100607;Alto Taquari;1;1;2;400
3534401;Osasco;5100607;Alto Taquari;1;1;2;945
4105805;Colombo;5100607;Alto Taquari;1;1;2;934
4107256;Douradina;5100607;Alto Taquari;1;1;2;616
4118204;Paranaguá;5100607;Alto Taquari;1;1;2;1002
4205902;Gaspar;5100607;Alto Taquari;1;1;2;1115
5002951;Chapadão do Sul;5100607;Alto Taquari;1;1;2;130
5003256;Costa Rica;5100607;Alto Taquari;1;1;2;76
5008305;Três Lagoas;5100607;Alto Taquari;1;1;2;367
3304557;Rio de Janeiro;5100508;Alto Paraguai;1;1;2;1727
3170206;Uberlândia;5100409;Alto Garças;1;1;2;607
3534401;Osasco;5100409;Alto Garças;1;1;2;1035
3542206;Rancharia;5100409;Alto Garças;1;1;2;650
4107256;Douradina;5100409;Alto Garças;1;1;2;711
4205902;Gaspar;5100409;Alto Garças;1;1;2;1214
5000203;Água Clara;5100409;Alto Garças;1;1;2;392
5002704;Campo Grande;5100409;Alto Garças;1;1;2;400
3143807;Munhoz;5100359;Alto Boa Vista;1;1;2;1335
3503208;Araraquara;5100359;Alto Boa Vista;1;1;2;1175
5100201;Água Boa;5100359;Alto Boa Vista;1;1;2;277
3105905;Barroso;5100300;Alto Araguaia;1;1;2;1084
3170107;Uberaba;5100300;Alto Araguaia;1;1;2;630
3300308;Barra do Piraí;5100300;Alto Araguaia;1;1;2;1166
3301702;Duque de Caxias;5100300;Alto Araguaia;1;1;2;1231
3505708;Barueri;5100300;Alto Araguaia;1;1;2;973
3513504;Cubatão;5100300;Alto Araguaia;1;1;2;1038
3515202;Estrela d'Oeste;5100300;Alto Araguaia;1;1;2;448
3529302;Matão;5100300;Alto Araguaia;1;1;2;705
3536505;Paulínia;5100300;Alto Araguaia;1;1;2;892
3538709;Piracicaba;5100300;Alto Araguaia;1;1;2;853
3557105;Votuporanga;5100300;Alto Araguaia;1;1;2;492
4101507;Arapongas;5100300;Alto Araguaia;1;1;2;703
4106902;Curitiba;5100300;Alto Araguaia;1;1;2;997
4107256;Douradina;5100300;Alto Araguaia;1;1;2;672
4119905;Ponta Grossa;5100300;Alto Araguaia;1;1;2;925
4205902;Gaspar;5100300;Alto Araguaia;1;1;2;1164
5008305;Três Lagoas;5100300;Alto Araguaia;1;1;2;415
1302603;Manaus;5100250;Alta Floresta;1;1;2;864
1400100;Boa Vista;5100250;Alta Floresta;1;1;2;1497
1503754;Jacareacanga;5100250;Alta Floresta;1;1;2;445
1504208;Marabá;5100250;Alta Floresta;1;1;2;911
1600303;Macapá;5100250;Alta Floresta;1;1;2;1228
3127701;Governador Valadares;5100250;Alta Floresta;1;1;2;1858
3202603;Iconha;5100250;Alta Floresta;1;1;2;2096
3301702;Duque de Caxias;5100250;Alta Floresta;1;1;2;2026
3304557;Rio de Janeiro;5100250;Alta Floresta;1;1;2;2040
3509502;Campinas;5100250;Alta Floresta;1;1;2;1764
3534401;Osasco;5100250;Alta Floresta;1;1;2;1839
3543402;Ribeirão Preto;5100250;Alta Floresta;1;1;2;1556
4101507;Arapongas;5100250;Alta Floresta;1;1;2;1586
4106902;Curitiba;5100250;Alta Floresta;1;1;2;1886
4107256;Douradina;5100250;Alta Floresta;1;1;2;1526
4121703;Reserva;5100250;Alta Floresta;1;1;2;1738
4210100;Mafra;5100250;Alta Floresta;1;1;2;1934
4211306;Navegantes;5100250;Alta Floresta;1;1;2;2062
4215703;Santo Amaro da Imperatriz;5100250;Alta Floresta;1;1;2;2140
1302603;Manaus;5100201;Água Boa;1;1;2;1469
3128709;Guaxupé;5100201;Água Boa;1;1;2;1003
3301702;Duque de Caxias;5100201;Água Boa;1;1;2;1375
3501608;Americana;5100201;Água Boa;1;1;2;1101
3502804;Araçatuba;5100201;Água Boa;1;1;2;817
3516200;Franca;5100201;Água Boa;1;1;2;890
3531902;Morro Agudo;5100201;Água Boa;1;1;2;867
3534401;Osasco;5100201;Água Boa;1;1;2;1208
3537305;Penápolis;5100201;Água Boa;1;1;2;850
3548906;São Carlos;5100201;Água Boa;1;1;2;1002
4107256;Douradina;5100201;Água Boa;1;1;2;1040
4304705;Carazinho;5100201;Água Boa;1;1;2;1579
4114609;Marechal Cândido Rondon;5008404;Vicentina;1;1;2;241
4117107;Nova Londrina;5008404;Vicentina;1;1;2;155
5003454;Deodápolis;5008404;Vicentina;1;1;2;31
5003702;Dourados;5008404;Vicentina;1;1;2;42
1500503;Almeirim;5008305;Três Lagoas;1;1;2;2133
1721000;Palmas;5008305;Três Lagoas;1;1;2;1201
2105302;Imperatriz;5008305;Três Lagoas;1;1;2;1742
2304400;Fortaleza;5008305;Três Lagoas;1;1;2;2301
2602308;Bonito;5008305;Três Lagoas;1;1;2;2113
2607901;Jaboatão dos Guararapes;5008305;Três Lagoas;1;1;2;2192
2910727;Eunápolis;5008305;Três Lagoas;1;1;2;1339
2925303;Porto Seguro;5008305;Três Lagoas;1;1;2;1382
2927408;Salvador;5008305;Três Lagoas;1;1;2;1603
3103504;Araguari;5008305;Três Lagoas;1;1;2;434
3109402;Buritizeiro;5008305;Três Lagoas;1;1;2;792
3118601;Contagem;5008305;Três Lagoas;1;1;2;800
3170107;Uberaba;5008305;Três Lagoas;1;1;2;412
3202405;Guarapari;5008305;Três Lagoas;1;1;2;1163
3202504;Ibiraçu;5008305;Três Lagoas;1;1;2;1185
3204906;São Mateus;5008305;Três Lagoas;1;1;2;1247
3302908;Miguel Pereira;5008305;Três Lagoas;1;1;2;886
3500709;Agudos;5008305;Três Lagoas;1;1;2;344
3504305;Avaí;5008305;Três Lagoas;1;1;2;294
3506102;Bebedouro;5008305;Três Lagoas;1;1;2;333
3509007;Caieiras;5008305;Três Lagoas;1;1;2;598
3509205;Cajamar;5008305;Três Lagoas;1;1;2;586
3511003;Castilho;5008305;Três Lagoas;1;1;2;28
3512803;Cosmópolis;5008305;Três Lagoas;1;1;2;519
3513009;Cotia;5008305;Três Lagoas;1;1;2;596
3513504;Cubatão;5008305;Três Lagoas;1;1;2;658
3515004;Embu;5008305;Três Lagoas;1;1;2;605
3515608;Fernando Prestes;5008305;Três Lagoas;1;1;2;323
3520442;Ilha Solteira;5008305;Três Lagoas;1;1;2;55
3522307;Itapetininga;5008305;Três Lagoas;1;1;2;497
3523107;Itaquaquecetuba;5008305;Três Lagoas;1;1;2;641
3523909;Itu;5008305;Três Lagoas;1;1;2;543
3524303;Jaboticabal;5008305;Três Lagoas;1;1;2;362
3525706;José Bonifácio;5008305;Três Lagoas;1;1;2;216
3526902;Limeira;5008305;Três Lagoas;1;1;2;496
3533403;Nova Odessa;5008305;Três Lagoas;1;1;2;515
3534708;Ourinhos;5008305;Três Lagoas;1;1;2;312
3536000;Parapuã;5008305;Três Lagoas;1;1;2;150
3545803;Santa Bárbara d'Oeste;5008305;Três Lagoas;1;1;2;504
3547304;Santana de Parnaíba;5008305;Três Lagoas;1;1;2;587
3547809;Santo André;5008305;Três Lagoas;1;1;2;634
3548500;Santos;5008305;Três Lagoas;1;1;2;664
3548708;São Bernardo do Campo;5008305;Três Lagoas;1;1;2;633
3549904;São José dos Campos;5008305;Três Lagoas;1;1;2;671
3551504;Serrana;5008305;Três Lagoas;1;1;2;435
3554003;Tatuí;5008305;Três Lagoas;1;1;2;499
3556503;Várzea Paulista;5008305;Três Lagoas;1;1;2;582
3557105;Votuporanga;5008305;Três Lagoas;1;1;2;186
4101804;Araucária;5008305;Três Lagoas;1;1;2;588
4105904;Colorado;5008305;Três Lagoas;1;1;2;231
4107009;Curiúva;5008305;Três Lagoas;1;1;2;386
4113205;Lapa;5008305;Três Lagoas;1;1;2;594
4115200;Maringá;5008305;Três Lagoas;1;1;2;296
4116901;Nova Esperança;5008305;Três Lagoas;1;1;2;272
4119905;Ponta Grossa;5008305;Três Lagoas;1;1;2;508
4202107;Barra Velha;5008305;Três Lagoas;1;1;2;724
4203006;Caçador;5008305;Três Lagoas;1;1;2;672
4205407;Florianópolis;5008305;Três Lagoas;1;1;2;831
4209102;Joinville;5008305;Três Lagoas;1;1;2;683
4216602;São José;5008305;Três Lagoas;1;1;2;822
4218301;Três Barras;5008305;Três Lagoas;1;1;2;610
4301909;Barra do Ribeiro;5008305;Três Lagoas;1;1;2;1057
4301958;Barra Funda;5008305;Três Lagoas;1;1;2;805
4304606;Canoas;5008305;Três Lagoas;1;1;2;1015
4305108;Caxias do Sul;5008305;Três Lagoas;1;1;2;932
4311403;Lajeado;5008305;Três Lagoas;1;1;2;960
4314407;Pelotas;5008305;Três Lagoas;1;1;2;1216
4314506;Pinheiro Machado;5008305;Três Lagoas;1;1;2;1212
4314803;Portão;5008305;Três Lagoas;1;1;2;991
4316808;Santa Cruz do Sul;5008305;Três Lagoas;1;1;2;995
5000807;Anaurilândia;5008305;Três Lagoas;1;1;2;185
5001003;Aparecida do Taboado;5008305;Três Lagoas;1;1;2;101
5003157;Coronel Sapucaia;5008305;Três Lagoas;1;1;2;486
5003207;Corumbá;5008305;Três Lagoas;1;1;2;641
5003306;Coxim;5008305;Três Lagoas;1;1;2;407
5004502;Itaporã;5008305;Três Lagoas;1;1;2;351
5005707;Naviraí;5008305;Três Lagoas;1;1;2;360
5007109;Ribas do Rio Pardo;5008305;Três Lagoas;1;1;2;215
5007208;Rio Brilhante;5008305;Três Lagoas;1;1;2;316
1200450;Senador Guiomard;5008008;Terenos;1;1;2;1735
2607208;Ipojuca;5008008;Terenos;1;1;2;2409
3170107;Uberaba;5008008;Terenos;1;1;2;727
3516200;Franca;5008008;Terenos;1;1;2;779
3534401;Osasco;5008008;Terenos;1;1;2;918
3550308;São Paulo;5008008;Terenos;1;1;2;937
4101804;Araucária;5008008;Terenos;1;1;2;814
4103701;Cambé;5008008;Terenos;1;1;2;494
5003207;Corumbá;5008008;Terenos;1;1;2;327
5007109;Ribas do Rio Pardo;5008008;Terenos;1;1;2;114
5007406;Rio Verde de Mato Grosso;5008008;Terenos;1;1;2;167
5007505;Rochedo;5008008;Terenos;1;1;2;52
5007901;Sidrolândia;5008008;Terenos;1;1;2;55
4117107;Nova Londrina;5007976;Taquarussu;1;1;2;49
5002704;Campo Grande;5007976;Taquarussu;1;1;2;264
3541406;Presidente Prudente;5007950;Tacuru;1;1;2;406
3550308;São Paulo;5007950;Tacuru;1;1;2;856
4117909;Palotina;5007950;Tacuru;1;1;2;145
4128104;Umuarama;5007950;Tacuru;1;1;2;176
5004304;Iguatemi;5007950;Tacuru;1;1;2;48
5007703;Sete Quedas;5007950;Tacuru;1;1;2;35
2304400;Fortaleza;5007935;Sonora;1;1;2;2270
2607901;Jaboatão dos Guararapes;5007935;Sonora;1;1;2;2306
2611606;Recife;5007935;Sonora;1;1;2;2315
3557105;Votuporanga;5007935;Sonora;1;1;2;604
4107256;Douradina;5007935;Sonora;1;1;2;664
4122701;Sabáudia;5007935;Sonora;1;1;2;726
4205902;Gaspar;5007935;Sonora;1;1;2;1218
5006408;Pedro Gomes;5007935;Sonora;1;1;2;64
3509502;Campinas;5007901;Sidrolândia;1;1;2;861
3527405;Lucélia;5007901;Sidrolândia;1;1;2;425
3534401;Osasco;5007901;Sidrolândia;1;1;2;910
4101507;Arapongas;5007901;Sidrolândia;1;1;2;465
4106902;Curitiba;5007901;Sidrolândia;1;1;2;784
4107256;Douradina;5007901;Sidrolândia;1;1;2;327
4122404;Rolândia;5007901;Sidrolândia;1;1;2;464
4202404;Blumenau;5007901;Sidrolândia;1;1;2;919
4316808;Santa Cruz do Sul;5007901;Sidrolândia;1;1;2;1015
5002209;Bonito;5007901;Sidrolândia;1;1;2;160
5002308;Brasilândia;5007901;Sidrolândia;1;1;2;308
5003207;Corumbá;5007901;Sidrolândia;1;1;2;343
5004502;Itaporã;5007901;Sidrolândia;1;1;2;131
5005202;Ladário;5007901;Sidrolândia;1;1;2;341
5005608;Miranda;5007901;Sidrolândia;1;1;2;161
5006903;Porto Murtinho;5007901;Sidrolândia;1;1;2;312
3502101;Andradina;5007802;Selvíria;1;1;2;62
3506508;Birigui;5007802;Selvíria;1;1;2;153
3511003;Castilho;5007802;Selvíria;1;1;2;56
4115200;Maringá;5007802;Selvíria;1;1;2;344
5000203;Água Clara;5007802;Selvíria;1;1;2;151
5002951;Chapadão do Sul;5007802;Selvíria;1;1;2;215
5004403;Inocência;5007802;Selvíria;1;1;2;90
5006309;Paranaíba;5007802;Selvíria;1;1;2;84
3534401;Osasco;5007703;Sete Quedas;1;1;2;840
3550308;São Paulo;5007703;Sete Quedas;1;1;2;854
4106902;Curitiba;5007703;Sete Quedas;1;1;2;611
4108809;Guaíra;5007703;Sete Quedas;1;1;2;83
4115804;Medianeira;5007703;Sete Quedas;1;1;2;176
4128104;Umuarama;5007703;Sete Quedas;1;1;2;177
5000609;Amambaí;5007703;Sete Quedas;1;1;2;95
5001243;Aral Moreira;5007703;Sete Quedas;1;1;2;129
5004304;Iguatemi;5007703;Sete Quedas;1;1;2;57
3106705;Betim;5007695;São Gabriel do Oeste;1;1;2;1094
3511508;Cerquilho;5007695;São Gabriel do Oeste;1;1;2;837
3534401;Osasco;5007695;São Gabriel do Oeste;1;1;2;946
3534708;Ourinhos;5007695;São Gabriel do Oeste;1;1;2;635
3541406;Presidente Prudente;5007695;São Gabriel do Oeste;1;1;2;452
4101507;Arapongas;5007695;São Gabriel do Oeste;1;1;2;555
4104808;Cascavel;5007695;São Gabriel do Oeste;1;1;2;625
4107256;Douradina;5007695;São Gabriel do Oeste;1;1;2;461
4115200;Maringá;5007695;São Gabriel do Oeste;1;1;2;527
4204202;Chapecó;5007695;São Gabriel do Oeste;1;1;2;879
4205902;Gaspar;5007695;São Gabriel do Oeste;1;1;2;1030
4218855;União do Oeste;5007695;São Gabriel do Oeste;1;1;2;836
4321451;Teutônia;5007695;São Gabriel do Oeste;1;1;2;1153
5001003;Aparecida do Taboado;5007695;São Gabriel do Oeste;1;1;2;373
5002902;Cassilândia;5007695;São Gabriel do Oeste;1;1;2;297
5003702;Dourados;5007695;São Gabriel do Oeste;1;1;2;314
5005400;Maracaju;5007695;São Gabriel do Oeste;1;1;2;252
5006200;Nova Andradina;5007695;São Gabriel do Oeste;1;1;2;338
5006309;Paranaíba;5007695;São Gabriel do Oeste;1;1;2;356
5006606;Ponta Porã;5007695;São Gabriel do Oeste;1;1;2;365
5007406;Rio Verde de Mato Grosso;5007695;São Gabriel do Oeste;1;1;2;62
3524402;Jacareí;5007554;Santa Rita do Pardo;1;1;2;753
3536505;Paulínia;5007554;Santa Rita do Pardo;1;1;2;614
5000203;Água Clara;5007554;Santa Rita do Pardo;1;1;2;96
5000807;Anaurilândia;5007554;Santa Rita do Pardo;1;1;2;93
5002308;Brasilândia;5007554;Santa Rita do Pardo;1;1;2;80
3550308;São Paulo;5007505;Rochedo;1;1;2;965
5001508;Bandeirantes;5007505;Rochedo;1;1;2;51
5003108;Corguinho;5007505;Rochedo;1;1;2;15
5007307;Rio Negro;5007505;Rochedo;1;1;2;58
3534401;Osasco;5007406;Rio Verde de Mato Grosso;1;1;2;1004
3550308;São Paulo;5007406;Rio Verde de Mato Grosso;1;1;2;1024
3556206;Valinhos;5007406;Rio Verde de Mato Grosso;1;1;2;953
4101408;Apucarana;5007406;Rio Verde de Mato Grosso;1;1;2;631
4107256;Douradina;5007406;Rio Verde de Mato Grosso;1;1;2;522
4125506;São José dos Pinhais;5007406;Rio Verde de Mato Grosso;1;1;2;956
5001508;Bandeirantes;5007406;Rio Verde de Mato Grosso;1;1;2;123
5002951;Chapadão do Sul;5007406;Rio Verde de Mato Grosso;1;1;2;237
5003801;Fátima do Sul;5007406;Rio Verde de Mato Grosso;1;1;2;386
5006408;Pedro Gomes;5007406;Rio Verde de Mato Grosso;1;1;2;97
3550308;São Paulo;5007307;Rio Negro;1;1;2;1003
5001508;Bandeirantes;5007307;Rio Negro;1;1;2;82
1302603;Manaus;5007208;Rio Brilhante;1;1;2;2137
3205101;Viana;5007208;Rio Brilhante;1;1;2;1449
3303302;Niterói;5007208;Rio Brilhante;1;1;2;1196
3509502;Campinas;5007208;Rio Brilhante;1;1;2;788
3535507;Paraguaçu Paulista;5007208;Rio Brilhante;1;1;2;415
3541406;Presidente Prudente;5007208;Rio Brilhante;1;1;2;330
3543907;Rio Claro;5007208;Rio Brilhante;1;1;2;728
3548708;São Bernardo do Campo;5007208;Rio Brilhante;1;1;2;857
3555000;Tupã;5007208;Rio Brilhante;1;1;2;415
4101507;Arapongas;5007208;Rio Brilhante;1;1;2;370
4107256;Douradina;5007208;Rio Brilhante;1;1;2;219
4115804;Medianeira;5007208;Rio Brilhante;1;1;2;390
4312401;Montenegro;5007208;Rio Brilhante;1;1;2;931
4314902;Porto Alegre;5007208;Rio Brilhante;1;1;2;982
4316808;Santa Cruz do Sul;5007208;Rio Brilhante;1;1;2;907
5002100;Bela Vista;5007208;Rio Brilhante;1;1;2;210
5002209;Bonito;5007208;Rio Brilhante;1;1;2;215
5002407;Caarapó;5007208;Rio Brilhante;1;1;2;98
5003801;Fátima do Sul;5007208;Rio Brilhante;1;1;2;66
2103000;Caxias;5007109;Ribas do Rio Pardo;1;1;2;2020
3106705;Betim;5007109;Ribas do Rio Pardo;1;1;2;1000
3143302;Montes Claros;5007109;Ribas do Rio Pardo;1;1;2;1101
3151404;Pitangui;5007109;Ribas do Rio Pardo;1;1;2;930
3303302;Niterói;5007109;Ribas do Rio Pardo;1;1;2;1155
3500105;Adamantina;5007109;Ribas do Rio Pardo;1;1;2;313
3500709;Agudos;5007109;Ribas do Rio Pardo;1;1;2;550
3501608;Americana;5007109;Ribas do Rio Pardo;1;1;2;723
3502101;Andradina;5007109;Ribas do Rio Pardo;1;1;2;253
3503208;Araraquara;5007109;Ribas do Rio Pardo;1;1;2;606
3504503;Avaré;5007109;Ribas do Rio Pardo;1;1;2;589
3511508;Cerquilho;5007109;Ribas do Rio Pardo;1;1;2;703
3518800;Guarulhos;5007109;Ribas do Rio Pardo;1;1;2;830
3525904;Jundiaí;5007109;Ribas do Rio Pardo;1;1;2;785
3534401;Osasco;5007109;Ribas do Rio Pardo;1;1;2;812
3535408;Panorama;5007109;Ribas do Rio Pardo;1;1;2;228
4101507;Arapongas;5007109;Ribas do Rio Pardo;1;1;2;411
4104907;Castro;5007109;Ribas do Rio Pardo;1;1;2;622
4105805;Colombo;5007109;Ribas do Rio Pardo;1;1;2;718
4107256;Douradina;5007109;Ribas do Rio Pardo;1;1;2;330
4112108;Jandaia do Sul;5007109;Ribas do Rio Pardo;1;1;2;417
4115200;Maringá;5007109;Ribas do Rio Pardo;1;1;2;385
4126256;Sarandi;5007109;Ribas do Rio Pardo;1;1;2;389
4305108;Caxias do Sul;5007109;Ribas do Rio Pardo;1;1;2;1007
4317400;Santiago;5007109;Ribas do Rio Pardo;1;1;2;978
4319802;São Vicente do Sul;5007109;Ribas do Rio Pardo;1;1;2;1030
5002308;Brasilândia;5007109;Ribas do Rio Pardo;1;1;2;200
5002605;Camapuã;5007109;Ribas do Rio Pardo;1;1;2;104
5003207;Corumbá;5007109;Ribas do Rio Pardo;1;1;2;431
5004700;Ivinhema;5007109;Ribas do Rio Pardo;1;1;2;209
5005400;Maracaju;5007109;Ribas do Rio Pardo;1;1;2;197
5006200;Nova Andradina;5007109;Ribas do Rio Pardo;1;1;2;204
3534401;Osasco;5006903;Porto Murtinho;1;1;2;1172
4106902;Curitiba;5006903;Porto Murtinho;1;1;2;990
4108809;Guaíra;5006903;Porto Murtinho;1;1;2;463
4109757;Ibema;5006903;Porto Murtinho;1;1;2;633
4204806;Curitibanos;5006903;Porto Murtinho;1;1;2;985
5000203;Água Clara;5006903;Porto Murtinho;1;1;2;535
5002159;Bodoquena;5006903;Porto Murtinho;1;1;2;176
5002209;Bonito;5006903;Porto Murtinho;1;1;2;154
2513901;São Bento;5006606;Ponta Porã;1;1;2;2531
3170206;Uberlândia;5006606;Ponta Porã;1;1;2;855
3205002;Serra;5006606;Ponta Porã;1;1;2;1594
3304557;Rio de Janeiro;5006606;Ponta Porã;1;1;2;1282
3500105;Adamantina;5006606;Ponta Porã;1;1;2;481
3509502;Campinas;5006606;Ponta Porã;1;1;2;891
3516200;Franca;5006606;Ponta Porã;1;1;2;875
3516705;Garça;5006606;Ponta Porã;1;1;2;622
3534401;Osasco;5006606;Ponta Porã;1;1;2;926
3538709;Piracicaba;5006606;Ponta Porã;1;1;2;829
3541406;Presidente Prudente;5006606;Ponta Porã;1;1;2;444
3548807;São Caetano do Sul;5006606;Ponta Porã;1;1;2;951
3556206;Valinhos;5006606;Ponta Porã;1;1;2;898
4106902;Curitiba;5006606;Ponta Porã;1;1;2;740
4107256;Douradina;5006606;Ponta Porã;1;1;2;265
4108304;Foz do Iguaçu;5006606;Ponta Porã;1;1;2;354
4113700;Londrina;5006606;Ponta Porã;1;1;2;476
4115200;Maringá;5006606;Ponta Porã;1;1;2;401
4122404;Rolândia;5006606;Ponta Porã;1;1;2;455
4125506;São José dos Pinhais;5006606;Ponta Porã;1;1;2;756
4127700;Toledo;5006606;Ponta Porã;1;1;2;316
4128104;Umuarama;5006606;Ponta Porã;1;1;2;280
4202404;Blumenau;5006606;Ponta Porã;1;1;2;849
4316907;Santa Maria;5006606;Ponta Porã;1;1;2;820
5002209;Bonito;5006606;Ponta Porã;1;1;2;176
5002407;Caarapó;5006606;Ponta Porã;1;1;2;89
5002803;Caracol;5006606;Ponta Porã;1;1;2;148
5003801;Fátima do Sul;5006606;Ponta Porã;1;1;2;121
5004601;Itaquiraí;5006606;Ponta Porã;1;1;2;188
5005004;Jardim;5006606;Ponta Porã;1;1;2;124
5006200;Nova Andradina;5006408;Pedro Gomes;1;1;2;474
4128104;Umuarama;5006358;Paranhos;1;1;2;216
5002704;Campo Grande;5006358;Paranhos;1;1;2;392
5004601;Itaquiraí;5006358;Paranhos;1;1;2;135
5005707;Naviraí;5006358;Paranhos;1;1;2;158
5006200;Nova Andradina;5006358;Paranhos;1;1;2;275
3109402;Buritizeiro;5006309;Paranaíba;1;1;2;695
3134202;Ituiutaba;5006309;Paranaíba;1;1;2;196
3500105;Adamantina;5006309;Paranaíba;1;1;2;226
3502804;Araçatuba;5006309;Paranaíba;1;1;2;192
3505708;Barueri;5006309;Paranaíba;1;1;2;628
3506508;Birigui;5006309;Paranaíba;1;1;2;205
3509502;Campinas;5006309;Paranaíba;1;1;2;568
3515509;Fernandópolis;5006309;Paranaíba;1;1;2;121
3516903;General Salgado;5006309;Paranaíba;1;1;2;142
3523107;Itaquaquecetuba;5006309;Paranaíba;1;1;2;667
3528106;Macaubal;5006309;Paranaíba;1;1;2;183
3530300;Mirassol;5006309;Paranaíba;1;1;2;219
3534401;Osasco;5006309;Paranaíba;1;1;2;636
3536307;Patrocínio Paulista;5006309;Paranaíba;1;1;2;424
3541406;Presidente Prudente;5006309;Paranaíba;1;1;2;277
3548807;São Caetano do Sul;5006309;Paranaíba;1;1;2;659
3553401;Tanabi;5006309;Paranaíba;1;1;2;196
3554904;Três Fronteiras;5006309;Paranaíba;1;1;2;73
3556107;Valentim Gentil;5006309;Paranaíba;1;1;2;142
4101507;Arapongas;5006309;Paranaíba;1;1;2;418
4106902;Curitiba;5006309;Paranaíba;1;1;2;673
4107256;Douradina;5006309;Paranaíba;1;1;2;470
4112009;Jaguariaíva;5006309;Paranaíba;1;1;2;537
4311809;Marau;5006309;Paranaíba;1;1;2;982
4314902;Porto Alegre;5006309;Paranaíba;1;1;2;1153
5000203;Água Clara;5006309;Paranaíba;1;1;2;197
5001904;Bataguassu;5006309;Paranaíba;1;1;2;266
5002605;Camapuã;5006309;Paranaíba;1;1;2;300
5003702;Dourados;5006309;Paranaíba;1;1;2;477
5006200;Nova Andradina;5006309;Paranaíba;1;1;2;370
4118402;Paranavaí;5006259;Novo Horizonte do Sul;1;1;2;153
5000609;Amambaí;5006259;Novo Horizonte do Sul;1;1;2;152
5002001;Batayporã;5006259;Novo Horizonte do Sul;1;1;2;72
5003702;Dourados;5006259;Novo Horizonte do Sul;1;1;2;108
5003801;Fátima do Sul;5006259;Novo Horizonte do Sul;1;1;2;74
5004700;Ivinhema;5006259;Novo Horizonte do Sul;1;1;2;39
1702109;Araguaína;5006200;Nova Andradina;1;1;2;1743
2301109;Aracati;5006200;Nova Andradina;1;1;2;2495
3201308;Cariacica;5006200;Nova Andradina;1;1;2;1346
3500105;Adamantina;5006200;Nova Andradina;1;1;2;245
3502002;Analândia;5006200;Nova Andradina;1;1;2;591
3507902;Brotas;5006200;Nova Andradina;1;1;2;544
3514403;Dracena;5006200;Nova Andradina;1;1;2;206
3516200;Franca;5006200;Nova Andradina;1;1;2;642
3518800;Guarulhos;5006200;Nova Andradina;1;1;2;720
3530201;Mirante do Paranapanema;5006200;Nova Andradina;1;1;2;154
3534401;Osasco;5006200;Nova Andradina;1;1;2;699
3537404;Pereira Barreto;5006200;Nova Andradina;1;1;2;298
3539202;Pirapozinho;5006200;Nova Andradina;1;1;2;196
3543709;Rincão;5006200;Nova Andradina;1;1;2;553
3544251;Rosana;5006200;Nova Andradina;1;1;2;52
3545506;Sandovalina;5006200;Nova Andradina;1;1;2;171
3548500;Santos;5006200;Nova Andradina;1;1;2;754
3549805;São José do Rio Preto;5006200;Nova Andradina;1;1;2;439
4100905;Amaporã;5006200;Nova Andradina;1;1;2;114
4101507;Arapongas;5006200;Nova Andradina;1;1;2;241
4105508;Cianorte;5006200;Nova Andradina;1;1;2;178
4105904;Colorado;5006200;Nova Andradina;1;1;2;162
4107256;Douradina;5006200;Nova Andradina;1;1;2;127
4115200;Maringá;5006200;Nova Andradina;1;1;2;202
4118402;Paranavaí;5006200;Nova Andradina;1;1;2;137
4127304;Terra Rica;5006200;Nova Andradina;1;1;2;96
4127700;Toledo;5006200;Nova Andradina;1;1;2;278
4128104;Umuarama;5006200;Nova Andradina;1;1;2;167
4307609;Estância Velha;5006200;Nova Andradina;1;1;2;854
5000609;Amambaí;5006200;Nova Andradina;1;1;2;216
5000708;Anastácio;5006200;Nova Andradina;1;1;2;314
5003306;Coxim;5006200;Nova Andradina;1;1;2;445
5003454;Deodápolis;5006200;Nova Andradina;1;1;2;80
5004007;Glória de Dourados;5006200;Nova Andradina;1;1;2;91
5005004;Jardim;5006200;Nova Andradina;1;1;2;300
5005103;Jateí;5006200;Nova Andradina;1;1;2;97
5005400;Maracaju;5006200;Nova Andradina;1;1;2;197
3304557;Rio de Janeiro;5006002;Nova Alvorada do Sul;1;1;2;1170
3508405;Cabreúva;5006002;Nova Alvorada do Sul;1;1;2;784
3533403;Nova Odessa;5006002;Nova Alvorada do Sul;1;1;2;751
3534401;Osasco;5006002;Nova Alvorada do Sul;1;1;2;825
3541406;Presidente Prudente;5006002;Nova Alvorada do Sul;1;1;2;319
3547700;Santo Anastácio;5006002;Nova Alvorada do Sul;1;1;2;289
3549805;São José do Rio Preto;5006002;Nova Alvorada do Sul;1;1;2;521
3550308;São Paulo;5006002;Nova Alvorada do Sul;1;1;2;843
3552403;Sumaré;5006002;Nova Alvorada do Sul;1;1;2;756
3554300;Teodoro Sampaio;5006002;Nova Alvorada do Sul;1;1;2;257
4101507;Arapongas;5006002;Nova Alvorada do Sul;1;1;2;375
4104303;Campo Mourão;5006002;Nova Alvorada do Sul;1;1;2;354
4107256;Douradina;5006002;Nova Alvorada do Sul;1;1;2;241
4114807;Marialva;5006002;Nova Alvorada do Sul;1;1;2;351
4122404;Rolândia;5006002;Nova Alvorada do Sul;1;1;2;375
4316808;Santa Cruz do Sul;5006002;Nova Alvorada do Sul;1;1;2;938
5001508;Bandeirantes;5006002;Nova Alvorada do Sul;1;1;2;169
5004007;Glória de Dourados;5006002;Nova Alvorada do Sul;1;1;2;104
5004908;Jaraguari;5006002;Nova Alvorada do Sul;1;1;2;147
5005400;Maracaju;5006002;Nova Alvorada do Sul;1;1;2;85
5005707;Naviraí;5006002;Nova Alvorada do Sul;1;1;2;173
5000708;Anastácio;5005806;Nioaque;1;1;2;75
5003306;Coxim;5005806;Nioaque;1;1;2;322
5003702;Dourados;5005806;Nioaque;1;1;2;161
5004106;Guia Lopes da Laguna;5005806;Nioaque;1;1;2;42
5005400;Maracaju;5005806;Nioaque;1;1;2;84
3170107;Uberaba;5005707;Naviraí;1;1;2;733
3204054;Pedro Canário;5005707;Naviraí;1;1;2;1522
3500105;Adamantina;5005707;Naviraí;1;1;2;350
3502804;Araçatuba;5005707;Naviraí;1;1;2;430
3513801;Diadema;5005707;Naviraí;1;1;2;783
3516200;Franca;5005707;Naviraí;1;1;2;743
3534401;Osasco;5005707;Naviraí;1;1;2;763
3548807;São Caetano do Sul;5005707;Naviraí;1;1;2;787
3554300;Teodoro Sampaio;5005707;Naviraí;1;1;2;213
4101507;Arapongas;5005707;Naviraí;1;1;2;287
4109906;Icaraíma;5005707;Naviraí;1;1;2;61
4118402;Paranavaí;5005707;Naviraí;1;1;2;180
4122404;Rolândia;5005707;Naviraí;1;1;2;292
4122602;Rondon;5005707;Naviraí;1;1;2;154
4128807;Xambrê;5005707;Naviraí;1;1;2;108
4204806;Curitibanos;5005707;Naviraí;1;1;2;602
4305108;Caxias do Sul;5005707;Naviraí;1;1;2;751
4318309;São Gabriel;5005707;Naviraí;1;1;2;810
5002951;Chapadão do Sul;5005707;Naviraí;1;1;2;494
5003751;Eldorado;5005707;Naviraí;1;1;2;85
5003801;Fátima do Sul;5005707;Naviraí;1;1;2;77
5005152;Juti;5005707;Naviraí;1;1;2;45
5005681;Mundo Novo;5005707;Naviraí;1;1;2;102
2502805;Brejo do Cruz;5005681;Mundo Novo;1;1;2;2542
3527108;Lins;5005681;Mundo Novo;1;1;2;520
3534401;Osasco;5005681;Mundo Novo;1;1;2;764
4101507;Arapongas;5005681;Mundo Novo;1;1;2;296
4115804;Medianeira;5005681;Mundo Novo;1;1;2;151
4117222;Nova Santa Rosa;5005681;Mundo Novo;1;1;2;68
4117909;Palotina;5005681;Mundo Novo;1;1;2;64
4119608;Pitanga;5005681;Mundo Novo;1;1;2;275
4122404;Rolândia;5005681;Mundo Novo;1;1;2;305
4202909;Brusque;5005681;Mundo Novo;1;1;2;656
4207502;Indaial;5005681;Mundo Novo;1;1;2;616
4314407;Pelotas;5005681;Mundo Novo;1;1;2;887
5003702;Dourados;5005681;Mundo Novo;1;1;2;196
5003751;Eldorado;5005681;Mundo Novo;1;1;2;17
3132206;Itaguara;5005608;Miranda;1;1;2;1244
3158607;Santana do Deserto;5005608;Miranda;1;1;2;1402
3534401;Osasco;5005608;Miranda;1;1;2;1077
3548906;São Carlos;5005608;Miranda;1;1;2;913
4101507;Arapongas;5005608;Miranda;1;1;2;629
4106902;Curitiba;5005608;Miranda;1;1;2;949
5003207;Corumbá;5005608;Miranda;1;1;2;187
5003488;Dois Irmãos do Buriti;5005608;Miranda;1;1;2;123
3506805;Bocaina;5005400;Maracaju;1;1;2;695
3513504;Cubatão;5005400;Maracaju;1;1;2;950
3514106;Dois Córregos;5005400;Maracaju;1;1;2;712
4101507;Arapongas;5005400;Maracaju;1;1;2;439
4104303;Campo Mourão;5005400;Maracaju;1;1;2;398
4107256;Douradina;5005400;Maracaju;1;1;2;279
4122404;Rolândia;5005400;Maracaju;1;1;2;441
4125803;São Pedro do Ivaí;5005400;Maracaju;1;1;2;429
4205902;Gaspar;5005400;Maracaju;1;1;2;884
5002100;Bela Vista;5005400;Maracaju;1;1;2;153
5002209;Bonito;5005400;Maracaju;1;1;2;147
5003801;Fátima do Sul;5005400;Maracaju;1;1;2;111
5005152;Juti;5005400;Maracaju;1;1;2;152
4115804;Medianeira;5005251;Laguna Carapã;1;1;2;323
4117909;Palotina;5005251;Laguna Carapã;1;1;2;239
4312401;Montenegro;5005251;Laguna Carapã;1;1;2;879
5000609;Amambaí;5005251;Laguna Carapã;1;1;2;65
5002407;Caarapó;5005251;Laguna Carapã;1;1;2;34
1503606;Itaituba;5005202;Ladário;1;1;2;1646
3304557;Rio de Janeiro;5005202;Ladário;1;1;2;1589
3548500;Santos;5005202;Ladário;1;1;2;1320
4113700;Londrina;5005202;Ladário;1;1;2;836
4314902;Porto Alegre;5005202;Ladário;1;1;2;1408
5000708;Anastácio;5005202;Ladário;1;1;2;250
3550308;São Paulo;5005152;Juti;1;1;2;823
5002407;Caarapó;5005152;Juti;1;1;2;34
5003702;Dourados;5005152;Juti;1;1;2;73
5004502;Itaporã;5005152;Juti;1;1;2;89
2611606;Recife;5005103;Jateí;1;1;2;2494
3533502;Novo Horizonte;5005103;Jateí;1;1;2;533
3552908;Taciba;5005103;Jateí;1;1;2;311
4204806;Curitibanos;5005103;Jateí;1;1;2;657
5000856;Angélica;5005103;Jateí;1;1;2;66
3534401;Osasco;5005004;Jardim;1;1;2;1009
4101507;Arapongas;5005004;Jardim;1;1;2;541
4105805;Colombo;5005004;Jardim;1;1;2;841
4106902;Curitiba;5005004;Jardim;1;1;2;848
4107256;Douradina;5005004;Jardim;1;1;2;369
3547304;Santana de Parnaíba;5004908;Jaraguari;1;1;2;872
5001508;Bandeirantes;5004908;Jaraguari;1;1;2;22
5003702;Dourados;5004908;Jaraguari;1;1;2;235
5003900;Figueirão;5004908;Jaraguari;1;1;2;180
4107256;Douradina;5004809;Japorã;1;1;2;127
3502804;Araçatuba;5004700;Ivinhema;1;1;2;364
3524303;Jaboticabal;5004700;Ivinhema;1;1;2;577
3525904;Jundiaí;5004700;Ivinhema;1;1;2;720
3534401;Osasco;5004700;Ivinhema;1;1;2;738
3541406;Presidente Prudente;5004700;Ivinhema;1;1;2;249
4101507;Arapongas;5004700;Ivinhema;1;1;2;273
4106902;Curitiba;5004700;Ivinhema;1;1;2;583
4107108;Diamante do Norte;5004700;Ivinhema;1;1;2;104
4107256;Douradina;5004700;Ivinhema;1;1;2;129
4117107;Nova Londrina;5004700;Ivinhema;1;1;2;98
4118402;Paranavaí;5004700;Ivinhema;1;1;2;165
4122404;Rolândia;5004700;Ivinhema;1;1;2;275
5002001;Batayporã;5004700;Ivinhema;1;1;2;54
5004601;Itaquiraí;5004700;Ivinhema;1;1;2;134
3505807;Bastos;5004601;Itaquiraí;1;1;2;390
4104501;Capanema;5004601;Itaquiraí;1;1;2;248
4104808;Cascavel;5004601;Itaquiraí;1;1;2;179
4107256;Douradina;5004601;Itaquiraí;1;1;2;92
4108809;Guaíra;5004601;Itaquiraí;1;1;2;69
4113700;Londrina;5004601;Itaquiraí;1;1;2;310
4114609;Marechal Cândido Rondon;5004601;Itaquiraí;1;1;2;121
4117909;Palotina;5004601;Itaquiraí;1;1;2;99
4122404;Rolândia;5004601;Itaquiraí;1;1;2;288
4208906;Jaraguá do Sul;5004601;Itaquiraí;1;1;2;624
5001003;Aparecida do Taboado;5004601;Itaquiraí;1;1;2;488
5004304;Iguatemi;5004601;Itaquiraí;1;1;2;45
3527306;Louveira;5004502;Itaporã;1;1;2;819
3534401;Osasco;5004502;Itaporã;1;1;2;846
4117909;Palotina;5004502;Itaporã;1;1;2;266
5001508;Bandeirantes;5004502;Itaporã;1;1;2;240
5002407;Caarapó;5004502;Itaporã;1;1;2;62
3106200;Belo Horizonte;5004403;Inocência;1;1;2;835
3517000;Getulina;5004403;Inocência;1;1;2;313
3534401;Osasco;5004403;Inocência;1;1;2;691
3505500;Barretos;5004304;Iguatemi;1;1;2;696
3534401;Osasco;5004304;Iguatemi;1;1;2;794
4104808;Cascavel;5004304;Iguatemi;1;1;2;181
4106902;Curitiba;5004304;Iguatemi;1;1;2;576
4108809;Guaíra;5004304;Iguatemi;1;1;2;58
4109906;Icaraíma;5004304;Iguatemi;1;1;2;91
4113700;Londrina;5004304;Iguatemi;1;1;2;351
4114609;Marechal Cândido Rondon;5004304;Iguatemi;1;1;2;111
4115200;Maringá;5004304;Iguatemi;1;1;2;271
4115804;Medianeira;5004304;Iguatemi;1;1;2;185
5000609;Amambaí;5004304;Iguatemi;1;1;2;93
5002159;Bodoquena;5004304;Iguatemi;1;1;2;408
3534401;Osasco;5004106;Guia Lopes da Laguna;1;1;2;1000
3550308;São Paulo;5004106;Guia Lopes da Laguna;1;1;2;1018
5003702;Dourados;5004106;Guia Lopes da Laguna;1;1;2;161
3505807;Bastos;5004007;Glória de Dourados;1;1;2;367
3534401;Osasco;5004007;Glória de Dourados;1;1;2;783
3541406;Presidente Prudente;5004007;Glória de Dourados;1;1;2;297
3550308;São Paulo;5004007;Glória de Dourados;1;1;2;800
4117107;Nova Londrina;5004007;Glória de Dourados;1;1;2;138
4214805;Rio do Sul;5004007;Glória de Dourados;1;1;2;725
5002308;Brasilândia;5004007;Glória de Dourados;1;1;2;260
5003306;Coxim;5003900;Figueirão;1;1;2;123
1302603;Manaus;5003801;Fátima do Sul;1;1;2;2201
3534401;Osasco;5003801;Fátima do Sul;1;1;2;809
3541505;Presidente Venceslau;5003801;Fátima do Sul;1;1;2;277
4101507;Arapongas;5003801;Fátima do Sul;1;1;2;338
4104808;Cascavel;5003801;Fátima do Sul;1;1;2;304
4107256;Douradina;5003801;Fátima do Sul;1;1;2;168
4115200;Maringá;5003801;Fátima do Sul;1;1;2;292
4117909;Palotina;5003801;Fátima do Sul;1;1;2;224
4118204;Paranaguá;5003801;Fátima do Sul;1;1;2;715
4122404;Rolândia;5003801;Fátima do Sul;1;1;2;341
5001243;Aral Moreira;5003801;Fátima do Sul;1;1;2;129
5003504;Douradina;5003801;Fátima do Sul;1;1;2;40
3534401;Osasco;5003751;Eldorado;1;1;2;764
4104303;Campo Mourão;5003751;Eldorado;1;1;2;196
4104808;Cascavel;5003751;Eldorado;1;1;2;154
4106902;Curitiba;5003751;Eldorado;1;1;2;544
4113700;Londrina;5003751;Eldorado;1;1;2;323
4114609;Marechal Cândido Rondon;5003751;Eldorado;1;1;2;88
4118204;Paranaguá;5003751;Eldorado;1;1;2;621
4122602;Rondon;5003751;Eldorado;1;1;2;160
4307005;Erechim;5003751;Eldorado;1;1;2;474
5002407;Caarapó;5003751;Eldorado;1;1;2;139
1100122;Ji-Paraná;5003702;Dourados;1;1;2;1438
1302603;Manaus;5003702;Dourados;1;1;2;2177
3106200;Belo Horizonte;5003702;Dourados;1;1;2;1137
3106705;Betim;5003702;Dourados;1;1;2;1114
3122306;Divinópolis;5003702;Dourados;1;1;2;1041
3127107;Frutal;5003702;Dourados;1;1;2;640
3170206;Uberlândia;5003702;Dourados;1;1;2;761
3170701;Varginha;5003702;Dourados;1;1;2;970
3205101;Viana;5003702;Dourados;1;1;2;1473
3301702;Duque de Caxias;5003702;Dourados;1;1;2;1188
3303955;Pinheiral;5003702;Dourados;1;1;2;1115
3500105;Adamantina;5003702;Dourados;1;1;2;386
3502804;Araçatuba;5003702;Dourados;1;1;2;459
3505708;Barueri;5003702;Dourados;1;1;2;833
3506003;Bauru;5003702;Dourados;1;1;2;590
3506508;Birigui;5003702;Dourados;1;1;2;469
3506706;Boa Esperança do Sul;5003702;Dourados;1;1;2;661
3507506;Botucatu;5003702;Dourados;1;1;2;661
3513009;Cotia;5003702;Dourados;1;1;2;831
3517406;Guaíra;5003702;Dourados;1;1;2;697
3518800;Guarulhos;5003702;Dourados;1;1;2;864
3519071;Hortolândia;5003702;Dourados;1;1;2;786
3530300;Mirassol;5003702;Dourados;1;1;2;563
3534302;Orlândia;5003702;Dourados;1;1;2;728
3534609;Osvaldo Cruz;5003702;Dourados;1;1;2;406
3536505;Paulínia;5003702;Dourados;1;1;2;792
3536703;Pederneiras;5003702;Dourados;1;1;2;621
3538709;Piracicaba;5003702;Dourados;1;1;2;741
3542206;Rancharia;5003702;Dourados;1;1;2;403
3543402;Ribeirão Preto;5003702;Dourados;1;1;2;729
3543907;Rio Claro;5003702;Dourados;1;1;2;747
3547304;Santana de Parnaíba;5003702;Dourados;1;1;2;827
3549904;São José dos Campos;5003702;Dourados;1;1;2;929
3551306;Sebastianópolis do Sul;5003702;Dourados;1;1;2;529
3552809;Taboão da Serra;5003702;Dourados;1;1;2;845
3556404;Vargem Grande do Sul;5003702;Dourados;1;1;2;815
4101804;Araucária;5003702;Dourados;1;1;2;675
4107207;Dois Vizinhos;5003702;Dourados;1;1;2;429
4107256;Douradina;5003702;Dourados;1;1;2;202
4108304;Foz do Iguaçu;5003702;Dourados;1;1;2;365
4108601;Goioerê;5003702;Dourados;1;1;2;286
4109807;Ibiporã;5003702;Dourados;1;1;2;405
4118402;Paranavaí;5003702;Dourados;1;1;2;262
4124806;São João;5003702;Dourados;1;1;2;454
4204004;Catanduvas;5003702;Dourados;1;1;2;628
4205407;Florianópolis;5003702;Dourados;1;1;2;889
4205902;Gaspar;5003702;Dourados;1;1;2;804
4209102;Joinville;5003702;Dourados;1;1;2;767
4211603;Nova Veneza;5003702;Dourados;1;1;2;905
4216602;São José;5003702;Dourados;1;1;2;875
4217501;Seara;5003702;Dourados;1;1;2;605
4219705;Xaxim;5003702;Dourados;1;1;2;576
4304606;Canoas;5003702;Dourados;1;1;2;934
5000203;Água Clara;5003702;Dourados;1;1;2;280
5001102;Aquidauana;5003702;Dourados;1;1;2;223
5001904;Bataguassu;5003702;Dourados;1;1;2;248
5002100;Bela Vista;5003702;Dourados;1;1;2;182
5002209;Bonito;5003702;Dourados;1;1;2;214
5002902;Cassilândia;5003702;Dourados;1;1;2;462
5002951;Chapadão do Sul;5003702;Dourados;1;1;2;439
5003157;Coronel Sapucaia;5003702;Dourados;1;1;2;138
5002704;Campo Grande;5003504;Douradina;1;1;2;179
3109402;Buritizeiro;5003488;Dois Irmãos do Buriti;1;1;2;1126
3549805;São José do Rio Preto;5003488;Dois Irmãos do Buriti;1;1;2;615
5000708;Anastácio;5003488;Dois Irmãos do Buriti;1;1;2;57
3534401;Osasco;5003454;Deodápolis;1;1;2;777
3541406;Presidente Prudente;5003454;Deodápolis;1;1;2;287
4108809;Guaíra;5003454;Deodápolis;1;1;2;202
1302603;Manaus;5003306;Coxim;1;1;2;1777
3106200;Belo Horizonte;5003306;Coxim;1;1;2;1157
3500105;Adamantina;5003306;Coxim;1;1;2;533
3502754;Araçariguama;5003306;Coxim;1;1;2;997
3510153;Canitar;5003306;Coxim;1;1;2;737
3519071;Hortolândia;5003306;Coxim;1;1;2;946
3524303;Jaboticabal;5003306;Coxim;1;1;2;757
3530508;Mococa;5003306;Coxim;1;1;2;891
3534401;Osasco;5003306;Coxim;1;1;2;1027
3541406;Presidente Prudente;5003306;Coxim;1;1;2;547
3543907;Rio Claro;5003306;Coxim;1;1;2;888
4101507;Arapongas;5003306;Coxim;1;1;2;658
4104808;Cascavel;5003306;Coxim;1;1;2;736
4107256;Douradina;5003306;Coxim;1;1;2;571
4122404;Rolândia;5003306;Coxim;1;1;2;653
4126504;Sertanópolis;5003306;Coxim;1;1;2;651
5000252;Alcinópolis;5003306;Coxim;1;1;2;113
5003256;Costa Rica;5003306;Coxim;1;1;2;169
3134400;Iturama;5003256;Costa Rica;1;1;2;344
3138203;Lavras;5003256;Costa Rica;1;1;2;921
3304557;Rio de Janeiro;5003256;Costa Rica;1;1;2;1168
3503208;Araraquara;5003256;Costa Rica;1;1;2;646
3524402;Jacareí;5003256;Costa Rica;1;1;2;941
3534401;Osasco;5003256;Costa Rica;1;1;2;884
3538709;Piracicaba;5003256;Costa Rica;1;1;2;757
3549102;São João da Boa Vista;5003256;Costa Rica;1;1;2;781
4106902;Curitiba;5003256;Costa Rica;1;1;2;876
4107256;Douradina;5003256;Costa Rica;1;1;2;541
4314902;Porto Alegre;5003256;Costa Rica;1;1;2;1299
2111300;São Luís;5003207;Corumbá;1;1;2;2282
2408102;Natal;5003207;Corumbá;1;1;2;2721
2611606;Recife;5003207;Corumbá;1;1;2;2629
2910800;Feira de Santana;5003207;Corumbá;1;1;2;2074
3205309;Vitória;5003207;Corumbá;1;1;2;1839
3507506;Botucatu;5003207;Corumbá;1;1;2;1069
3509502;Campinas;5003207;Corumbá;1;1;2;1207
3530607;Moji das Cruzes;5003207;Corumbá;1;1;2;1322
3534401;Osasco;5003207;Corumbá;1;1;2;1262
3541406;Presidente Prudente;5003207;Corumbá;1;1;2;747
3548500;Santos;5003207;Corumbá;1;1;2;1323
3548807;São Caetano do Sul;5003207;Corumbá;1;1;2;1288
4108809;Guaíra;5003207;Corumbá;1;1;2;668
4109757;Ibema;5003207;Corumbá;1;1;2;836
4113700;Londrina;5003207;Corumbá;1;1;2;838
4118501;Pato Branco;5003207;Corumbá;1;1;2;960
4122404;Rolândia;5003207;Corumbá;1;1;2;820
4216602;São José;5003207;Corumbá;1;1;2;1356
4304606;Canoas;5003207;Corumbá;1;1;2;1396
5000203;Água Clara;5003207;Corumbá;1;1;2;529
5000708;Anastácio;5003207;Corumbá;1;1;2;251
5002159;Bodoquena;5003207;Corumbá;1;1;2;194
5002209;Bonito;5003207;Corumbá;1;1;2;260
3550308;São Paulo;5003157;Coronel Sapucaia;1;1;2;911
4115200;Maringá;5003157;Coronel Sapucaia;1;1;2;369
5000203;Água Clara;5003157;Coronel Sapucaia;1;1;2;414
5000609;Amambaí;5003157;Coronel Sapucaia;1;1;2;32
3550308;São Paulo;5003108;Corguinho;1;1;2;971
2101400;Balsas;5002951;Chapadão do Sul;1;1;2;1420
2611606;Recife;5002951;Chapadão do Sul;1;1;2;2171
3170107;Uberaba;5002951;Chapadão do Sul;1;1;2;509
3170206;Uberlândia;5002951;Chapadão do Sul;1;1;2;460
3515509;Fernandópolis;5002951;Chapadão do Sul;1;1;2;301
3516705;Garça;5002951;Chapadão do Sul;1;1;2;494
3526704;Leme;5002951;Chapadão do Sul;1;1;2;672
3533502;Novo Horizonte;5002951;Chapadão do Sul;1;1;2;468
3534401;Osasco;5002951;Chapadão do Sul;1;1;2;816
3534906;Pacaembu;5002951;Chapadão do Sul;1;1;2;339
3541406;Presidente Prudente;5002951;Chapadão do Sul;1;1;2;392
3549805;São José do Rio Preto;5002951;Chapadão do Sul;1;1;2;410
4107256;Douradina;5002951;Chapadão do Sul;1;1;2;512
4111100;Itambé;5002951;Chapadão do Sul;1;1;2;543
4113700;Londrina;5002951;Chapadão do Sul;1;1;2;523
4118204;Paranaguá;5002951;Chapadão do Sul;1;1;2;870
4120804;Quatro Barras;5002951;Chapadão do Sul;1;1;2;822
4205902;Gaspar;5002951;Chapadão do Sul;1;1;2;985
4304705;Carazinho;5002951;Chapadão do Sul;1;1;2;1052
4307559;Estação;5002951;Chapadão do Sul;1;1;2;1010
5000203;Água Clara;5002951;Chapadão do Sul;1;1;2;183
5001102;Aquidauana;5002951;Chapadão do Sul;1;1;2;379
5001508;Bandeirantes;5002951;Chapadão do Sul;1;1;2;227
3524808;Jales;5002902;Cassilândia;1;1;2;179
3534401;Osasco;5002902;Cassilândia;1;1;2;719
3546603;Santa Fé do Sul;5002902;Cassilândia;1;1;2;143
3549805;São José do Rio Preto;5002902;Cassilândia;1;1;2;311
4106902;Curitiba;5002902;Cassilândia;1;1;2;746
4107256;Douradina;5002902;Cassilândia;1;1;2;498
4314902;Porto Alegre;5002902;Cassilândia;1;1;2;1210
5000252;Alcinópolis;5002902;Cassilândia;1;1;2;224
5000906;Antônio João;5002803;Caracol;1;1;2;111
5002100;Bela Vista;5002803;Caracol;1;1;2;49
5002704;Campo Grande;5002803;Caracol;1;1;2;301
1200609;Tarauacá;5002704;Campo Grande;1;1;2;2124
1506807;Santarém;5002704;Campo Grande;1;1;2;1986
1600303;Macapá;5002704;Campo Grande;1;1;2;2296
1702109;Araguaína;5002704;Campo Grande;1;1;2;1603
2105302;Imperatriz;5002704;Campo Grande;1;1;2;1803
2201150;Baixa Grande do Ribeiro;5002704;Campo Grande;1;1;2;1688
2211001;Teresina;5002704;Campo Grande;1;1;2;2076
2503209;Cabedelo;5002704;Campo Grande;1;1;2;2491
2504009;Campina Grande;5002704;Campo Grande;1;1;2;2396
2605202;Escada;5002704;Campo Grande;1;1;2;2380
2609600;Olinda;5002704;Campo Grande;1;1;2;2428
2910800;Feira de Santana;5002704;Campo Grande;1;1;2;1838
2919553;Luís Eduardo magalhães;5002704;Campo Grande;1;1;2;1289
2923001;Nova Viçosa;5002704;Campo Grande;1;1;2;1595
2926202;Riachão das Neves;5002704;Campo Grande;1;1;2;1382
3127701;Governador Valadares;5002704;Campo Grande;1;1;2;1328
3131901;Itabirito;5002704;Campo Grande;1;1;2;1128
3133808;Itaúna;5002704;Campo Grande;1;1;2;1050
3136306;João Pinheiro;5002704;Campo Grande;1;1;2;923
3148004;Patos de Minas;5002704;Campo Grande;1;1;2;870
3157807;Santa Luzia;5002704;Campo Grande;1;1;2;1128
3200102;Afonso Cláudio;5002704;Campo Grande;1;1;2;1411
3200300;Alfredo Chaves;5002704;Campo Grande;1;1;2;1453
3200409;Anchieta;5002704;Campo Grande;1;1;2;1456
3200805;Baixo Guandu;5002704;Campo Grande;1;1;2;1423
3200904;Barra de São Francisco;5002704;Campo Grande;1;1;2;1439
3201001;Boa Esperança;5002704;Campo Grande;1;1;2;1505
3201100;Bom Jesus do Norte;5002704;Campo Grande;1;1;2;1361
3201407;Castelo;5002704;Campo Grande;1;1;2;1400
3201605;Conceição da Barra;5002704;Campo Grande;1;1;2;1556
3201902;Domingos Martins;5002704;Campo Grande;1;1;2;1461
3202108;Ecoporanga;5002704;Campo Grande;1;1;2;1452
3202306;Guaçuí;5002704;Campo Grande;1;1;2;1357
3202454;Ibatiba;5002704;Campo Grande;1;1;2;1372
3202702;Itaguaçu;5002704;Campo Grande;1;1;2;1438
3203007;Iúna;5002704;Campo Grande;1;1;2;1371
3203056;Jaguaré;5002704;Campo Grande;1;1;2;1525
3203130;João Neiva;5002704;Campo Grande;1;1;2;1487
3203320;Marataízes;5002704;Campo Grande;1;1;2;1443
3203346;Marechal Floriano;5002704;Campo Grande;1;1;2;1459
3203403;Mimoso do Sul;5002704;Campo Grande;1;1;2;1392
3203502;Montanha;5002704;Campo Grande;1;1;2;1504
3203700;Muniz Freire;5002704;Campo Grande;1;1;2;1383
3203809;Muqui;5002704;Campo Grande;1;1;2;1393
3204054;Pedro Canário;5002704;Campo Grande;1;1;2;1527
3204104;Pinheiros;5002704;Campo Grande;1;1;2;1513
3204203;Piúma;5002704;Campo Grande;1;1;2;1455
3204252;Ponto Belo;5002704;Campo Grande;1;1;2;1485
3204351;Rio Bananal;5002704;Campo Grande;1;1;2;1496
3204500;Santa Leopoldina;5002704;Campo Grande;1;1;2;1474
3204559;Santa Maria de Jetibá;5002704;Campo Grande;1;1;2;1451
3204609;Santa Teresa;5002704;Campo Grande;1;1;2;1466
3205036;Vargem Alta;5002704;Campo Grande;1;1;2;1427
3205069;Venda Nova do Imigrante;5002704;Campo Grande;1;1;2;1411
3205101;Viana;5002704;Campo Grande;1;1;2;1471
3300308;Barra do Piraí;5002704;Campo Grande;1;1;2;1160
3301702;Duque de Caxias;5002704;Campo Grande;1;1;2;1221
3304300;Rio Bonito;5002704;Campo Grande;1;1;2;1290
3305505;Saquarema;5002704;Campo Grande;1;1;2;1311
3305802;Teresópolis;5002704;Campo Grande;1;1;2;1244
3500105;Adamantina;5002704;Campo Grande;1;1;2;398
3501301;Álvares Machado;5002704;Campo Grande;1;1;2;380
3507605;Bragança Paulista;5002704;Campo Grande;1;1;2;897
3508504;Caçapava;5002704;Campo Grande;1;1;2;988
3509205;Cajamar;5002704;Campo Grande;1;1;2;882
3509601;Campo Limpo Paulista;5002704;Campo Grande;1;1;2;884
3511003;Castilho;5002704;Campo Grande;1;1;2;334
3511409;Cerqueira César;5002704;Campo Grande;1;1;2;646
3511607;Cesário Lange;5002704;Campo Grande;1;1;2;771
3513108;Cravinhos;5002704;Campo Grande;1;1;2;732
3513801;Diadema;5002704;Campo Grande;1;1;2;921
3514403;Dracena;5002704;Campo Grande;1;1;2;347
3515004;Embu;5002704;Campo Grande;1;1;2;897
3515509;Fernandópolis;5002704;Campo Grande;1;1;2;459
3518701;Guarujá;5002704;Campo Grande;1;1;2;968
3519071;Hortolândia;5002704;Campo Grande;1;1;2;827
3520442;Ilha Solteira;5002704;Campo Grande;1;1;2;345
3523404;Itatiba;5002704;Campo Grande;1;1;2;871
3524402;Jacareí;5002704;Campo Grande;1;1;2;972
3524709;Jaguariúna;5002704;Campo Grande;1;1;2;845
3526001;Junqueirópolis;5002704;Campo Grande;1;1;2;358
3526506;Lavínia;5002704;Campo Grande;1;1;2;387
3526803;Lençóis Paulista;5002704;Campo Grande;1;1;2;659
3526902;Limeira;5002704;Campo Grande;1;1;2;799
3527108;Lins;5002704;Campo Grande;1;1;2;530
3533502;Novo Horizonte;5002704;Campo Grande;1;1;2;580
3536307;Patrocínio Paulista;5002704;Campo Grande;1;1;2;768
3539202;Pirapozinho;5002704;Campo Grande;1;1;2;389
3539806;Poá;5002704;Campo Grande;1;1;2;940
3541505;Presidente Venceslau;5002704;Campo Grande;1;1;2;330
3542404;Regente Feijó;5002704;Campo Grande;1;1;2;404
3543907;Rio Claro;5002704;Campo Grande;1;1;2;776
3548054;Santo Antônio do Aracanguá;5002704;Campo Grande;1;1;2;438
3548906;São Carlos;5002704;Campo Grande;1;1;2;731
3550407;São Pedro;5002704;Campo Grande;1;1;2;746
3551702;Sertãozinho;5002704;Campo Grande;1;1;2;701
3552205;Sorocaba;5002704;Campo Grande;1;1;2;827
3552809;Taboão da Serra;5002704;Campo Grande;1;1;2;902
3554003;Tatuí;5002704;Campo Grande;1;1;2;787
3554102;Taubaté;5002704;Campo Grande;1;1;2;997
4100806;Alvorada do Sul;5002704;Campo Grande;1;1;2;444
4101408;Apucarana;5002704;Campo Grande;1;1;2;484
4102406;Bandeirantes;5002704;Campo Grande;1;1;2;540
4103453;Cafelândia;5002704;Campo Grande;1;1;2;485
4104006;Campina Grande do Sul;5002704;Campo Grande;1;1;2;803
4104204;Campo Largo;5002704;Campo Grande;1;1;2;779
4105805;Colombo;5002704;Campo Grande;1;1;2;784
4107207;Dois Vizinhos;5002704;Campo Grande;1;1;2;612
4107652;Fazenda Rio Grande;5002704;Campo Grande;1;1;2;811
4108304;Foz do Iguaçu;5002704;Campo Grande;1;1;2;564
4108320;Francisco Alves;5002704;Campo Grande;1;1;2;412
4108403;Francisco Beltrão;5002704;Campo Grande;1;1;2;649
4108601;Goioerê;5002704;Campo Grande;1;1;2;452
4111902;Jaguapitã;5002704;Campo Grande;1;1;2;443
4115705;Matinhos;5002704;Campo Grande;1;1;2;880
4118709;Paulo Frontin;5002704;Campo Grande;1;1;2;743
4120804;Quatro Barras;5002704;Campo Grande;1;1;2;806
4123402;Santa Fé;5002704;Campo Grande;1;1;2;416
4202008;Balneário Camboriú;5002704;Campo Grande;1;1;2;967
4204301;Concórdia;5002704;Campo Grande;1;1;2;803
4205902;Gaspar;5002704;Campo Grande;1;1;2;943
4212106;Palmitos;5002704;Campo Grande;1;1;2;753
4215000;Rio Negrinho;5002704;Campo Grande;1;1;2;846
4218004;Tijucas;5002704;Campo Grande;1;1;2;992
4300703;Anta Gorda;5002704;Campo Grande;1;1;2;988
4304705;Carazinho;5002704;Campo Grande;1;1;2;894
4305801;Constantina;5002704;Campo Grande;1;1;2;829
4306403;Dois Irmãos;5002704;Campo Grande;1;1;2;1085
4307609;Estância Velha;5002704;Campo Grande;1;1;2;1088
4308607;Garibaldi;5002704;Campo Grande;1;1;2;1034
4309209;Gravataí;5002704;Campo Grande;1;1;2;1126
4309308;Guaíba;5002704;Campo Grande;1;1;2;1132
4309605;Horizontina;5002704;Campo Grande;1;1;2;798
4313904;Panambi;5002704;Campo Grande;1;1;2;878
4314787;Ponte Preta;5002704;Campo Grande;1;1;2;833
4316907;Santa Maria;5002704;Campo Grande;1;1;2;1031
4318705;São Leopoldo;5002704;Campo Grande;1;1;2;1101
4319604;São Sepé;5002704;Campo Grande;1;1;2;1086
4321402;Tenente Portela;5002704;Campo Grande;1;1;2;775
5000252;Alcinópolis;5002704;Campo Grande;1;1;2;252
5000906;Antônio João;5002704;Campo Grande;1;1;2;238
5002001;Batayporã;5002704;Campo Grande;1;1;2;253
5002100;Bela Vista;5002704;Campo Grande;1;1;2;273
3534401;Osasco;5002605;Camapuã;1;1;2;890
3536505;Paulínia;5002605;Camapuã;1;1;2;815
3546603;Santa Fé do Sul;5002605;Camapuã;1;1;2;332
4101507;Arapongas;5002605;Camapuã;1;1;2;512
4107256;Douradina;5002605;Camapuã;1;1;2;434
4115200;Maringá;5002605;Camapuã;1;1;2;487
4118402;Paranavaí;5002605;Camapuã;1;1;2;430
4128534;Ventania;5002605;Camapuã;1;1;2;661
4314100;Passo Fundo;5002605;Camapuã;1;1;2;983
5000203;Água Clara;5002605;Camapuã;1;1;2;160
5000252;Alcinópolis;5002605;Camapuã;1;1;2;139
5000807;Anaurilândia;5002605;Camapuã;1;1;2;319
5001508;Bandeirantes;5002605;Camapuã;1;1;2;59
3505500;Barretos;5002407;Caarapó;1;1;2;679
3524303;Jaboticabal;5002407;Caarapó;1;1;2;685
3534401;Osasco;5002407;Caarapó;1;1;2;836
3552205;Sorocaba;5002407;Caarapó;1;1;2;762
3553955;Tarumã;5002407;Caarapó;1;1;2;438
4106902;Curitiba;5002407;Caarapó;1;1;2;654
4107256;Douradina;5002407;Caarapó;1;1;2;179
4119905;Ponta Grossa;5002407;Caarapó;1;1;2;556
4122404;Rolândia;5002407;Caarapó;1;1;2;365
5001003;Aparecida do Taboado;5002407;Caarapó;1;1;2;475
2803401;Japoatã;5002308;Brasilândia;1;1;2;1956
3143203;Monte Santo de Minas;5002308;Brasilândia;1;1;2;521
3301009;Campos dos Goytacazes;5002308;Brasilândia;1;1;2;1119
3501004;Altinópolis;5002308;Brasilândia;1;1;2;487
3509502;Campinas;5002308;Brasilândia;1;1;2;554
3518206;Guararapes;5002308;Brasilândia;1;1;2;147
3519808;Icém;5002308;Brasilândia;1;1;2;313
3526001;Junqueirópolis;5002308;Brasilândia;1;1;2;72
3534401;Osasco;5002308;Brasilândia;1;1;2;607
3539202;Pirapozinho;5002308;Brasilândia;1;1;2;129
3541307;Presidente Epitácio;5002308;Brasilândia;1;1;2;60
4113403;Leópolis;5002308;Brasilândia;1;1;2;245
4126405;Sertaneja;5002308;Brasilândia;1;1;2;236
5001904;Bataguassu;5002308;Brasilândia;1;1;2;67
2611606;Recife;5002209;Bonito;1;1;2;2607
3304557;Rio de Janeiro;5002209;Bonito;1;1;2;1400
3502804;Araçatuba;5002209;Bonito;1;1;2;630
3509502;Campinas;5002209;Bonito;1;1;2;1008
3534401;Osasco;5002209;Bonito;1;1;2;1054
4101507;Arapongas;5002209;Bonito;1;1;2;589
4107256;Douradina;5002209;Bonito;1;1;2;420
4109757;Ibema;5002209;Bonito;1;1;2;575
4115804;Medianeira;5002209;Bonito;1;1;2;527
5000708;Anastácio;5002209;Bonito;1;1;2;103
5002159;Bodoquena;5002209;Bonito;1;1;2;67
1503606;Itaituba;5002159;Bodoquena;1;1;2;1807
3525300;Jaú;5002159;Bodoquena;1;1;2;874
3170107;Uberaba;5002100;Bela Vista;1;1;2;923
3534401;Osasco;5002100;Bela Vista;1;1;2;1026
4104808;Cascavel;5002100;Bela Vista;1;1;2;452
4107256;Douradina;5002100;Bela Vista;1;1;2;368
3503208;Araraquara;5002001;Batayporã;1;1;2;528
3505500;Barretos;5002001;Batayporã;1;1;2;518
3552908;Taciba;5002001;Batayporã;1;1;2;206
4108809;Guaíra;5002001;Batayporã;1;1;2;223
4117107;Nova Londrina;5002001;Batayporã;1;1;2;60
4125902;São Pedro do Paraná;5002001;Batayporã;1;1;2;58
5000856;Angélica;5002001;Batayporã;1;1;2;53
1302603;Manaus;5001904;Bataguassu;1;1;2;2192
3306305;Volta Redonda;5001904;Bataguassu;1;1;2;871
3500105;Adamantina;5001904;Bataguassu;1;1;2;141
3504008;Assis;5001904;Bataguassu;1;1;2;233
3522208;Itapecerica da Serra;5001904;Bataguassu;1;1;2;624
3524402;Jacareí;5001904;Bataguassu;1;1;2;699
3527108;Lins;5001904;Bataguassu;1;1;2;277
3534401;Osasco;5001904;Bataguassu;1;1;2;622
3535507;Paraguaçu Paulista;5001904;Bataguassu;1;1;2;205
3537800;Piedade;5001904;Bataguassu;1;1;2;568
3539202;Pirapozinho;5001904;Bataguassu;1;1;2;116
3542206;Rancharia;5001904;Bataguassu;1;1;2;171
4103701;Cambé;5001904;Bataguassu;1;1;2;213
4115200;Maringá;5001904;Bataguassu;1;1;2;197
4121901;Ribeirão do Pinhal;5001904;Bataguassu;1;1;2;287
4122404;Rolândia;5001904;Bataguassu;1;1;2;209
5000807;Anaurilândia;5001904;Bataguassu;1;1;2;55
2201903;Bom Jesus;5001508;Bandeirantes;1;1;2;1580
3550308;São Paulo;5001508;Bandeirantes;1;1;2;920
3534401;Osasco;5001243;Aral Moreira;1;1;2;911
3550308;São Paulo;5001243;Aral Moreira;1;1;2;927
3500105;Adamantina;5001102;Aquidauana;1;1;2;510
3502705;Apiaí;5001102;Aquidauana;1;1;2;862
3516200;Franca;5001102;Aquidauana;1;1;2;874
3534401;Osasco;5001102;Aquidauana;1;1;2;1008
3534609;Osvaldo Cruz;5001102;Aquidauana;1;1;2;535
3548807;São Caetano do Sul;5001102;Aquidauana;1;1;2;1034
3549805;São José do Rio Preto;5001102;Aquidauana;1;1;2;668
4101507;Arapongas;5001102;Aquidauana;1;1;2;564
4106902;Curitiba;5001102;Aquidauana;1;1;2;884
4107256;Douradina;5001102;Aquidauana;1;1;2;419
5000203;Água Clara;5001102;Aquidauana;1;1;2;304
3127107;Frutal;5001003;Aparecida do Taboado;1;1;2;222
3502606;Aparecida d'Oeste;5001003;Aparecida do Taboado;1;1;2;45
3502804;Araçatuba;5001003;Aparecida do Taboado;1;1;2;144
3505708;Barueri;5001003;Aparecida do Taboado;1;1;2;586
3511102;Catanduva;5001003;Aparecida do Taboado;1;1;2;251
3511706;Charqueada;5001003;Aparecida do Taboado;1;1;2;441
3515509;Fernandópolis;5001003;Aparecida do Taboado;1;1;2;91
3516200;Franca;5001003;Aparecida do Taboado;1;1;2;390
3518800;Guarulhos;5001003;Aparecida do Taboado;1;1;2;607
3523404;Itatiba;5001003;Aparecida do Taboado;1;1;2;554
3526902;Limeira;5001003;Aparecida do Taboado;1;1;2;478
3527405;Lucélia;5001003;Aparecida do Taboado;1;1;2;182
3540804;Potirendaba;5001003;Aparecida do Taboado;1;1;2;210
3546405;Santa Cruz do Rio Pardo;5001003;Aparecida do Taboado;1;1;2;348
3548500;Santos;5001003;Aparecida do Taboado;1;1;2;657
3553401;Tanabi;5001003;Aparecida do Taboado;1;1;2;163
3553708;Taquaritinga;5001003;Aparecida do Taboado;1;1;2;307
3557105;Votuporanga;5001003;Aparecida do Taboado;1;1;2;123
4106902;Curitiba;5001003;Aparecida do Taboado;1;1;2;623
4107256;Douradina;5001003;Aparecida do Taboado;1;1;2;433
4305108;Caxias do Sul;5001003;Aparecida do Taboado;1;1;2;1006
4322608;Venâncio Aires;5001003;Aparecida do Taboado;1;1;2;1061
5000203;Água Clara;5001003;Aparecida do Taboado;1;1;2;189
3534401;Osasco;5000906;Antônio João;1;1;2;963
3509205;Cajamar;5000856;Angélica;1;1;2;727
3513108;Cravinhos;5000856;Angélica;1;1;2;628
3530607;Moji das Cruzes;5000856;Angélica;1;1;2;801
3534401;Osasco;5000856;Angélica;1;1;2;740
4106902;Curitiba;5000856;Angélica;1;1;2;592
5000807;Anaurilândia;5000856;Angélica;1;1;2;106
3541505;Presidente Venceslau;5000807;Anaurilândia;1;1;2;94
4101408;Apucarana;5000807;Anaurilândia;1;1;2;207
4106902;Curitiba;5000807;Anaurilândia;1;1;2;514
2931350;Teixeira de Freitas;5000708;Anastácio;1;1;2;1696
3109402;Buritizeiro;5000708;Anastácio;1;1;2;1172
3509205;Cajamar;5000708;Anastácio;1;1;2;993
3534401;Osasco;5000708;Anastácio;1;1;2;1009
3541505;Presidente Venceslau;5000708;Anastácio;1;1;2;438
4115200;Maringá;5000708;Anastácio;1;1;2;523
5000203;Água Clara;5000708;Anastácio;1;1;2;307
1302603;Manaus;5000609;Amambaí;1;1;2;2263
3304557;Rio de Janeiro;5000609;Amambaí;1;1;2;1229
3534302;Orlândia;5000609;Amambaí;1;1;2;795
3534401;Osasco;5000609;Amambaí;1;1;2;870
4101507;Arapongas;5000609;Amambaí;1;1;2;393
4104303;Campo Mourão;5000609;Amambaí;1;1;2;312
4107256;Douradina;5000609;Amambaí;1;1;2;203
4109401;Guarapuava;5000609;Amambaí;1;1;2;466
4115200;Maringá;5000609;Amambaí;1;1;2;343
4127700;Toledo;5000609;Amambaí;1;1;2;235
4203006;Caçador;5000609;Amambaí;1;1;2;594
4206900;Ibirama;5000609;Amambaí;1;1;2;739
3517802;Guaraçaí;5000252;Alcinópolis;1;1;2;401
3527108;Lins;5000252;Alcinópolis;1;1;2;561
3529302;Matão;5000252;Alcinópolis;1;1;2;673
4106902;Curitiba;5000252;Alcinópolis;1;1;2;921
4115200;Maringá;5000252;Alcinópolis;1;1;2;597
4202909;Brusque;5000252;Alcinópolis;1;1;2;1102
2611606;Recife;5000203;Água Clara;1;1;2;2272
3106200;Belo Horizonte;5000203;Água Clara;1;1;2;928
3109402;Buritizeiro;5000203;Água Clara;1;1;2;884
3502101;Andradina;5000203;Água Clara;1;1;2;162
3503406;Arealva;5000203;Água Clara;1;1;2;451
3506508;Birigui;5000203;Água Clara;1;1;2;281
3513702;Descalvado;5000203;Água Clara;1;1;2;573
3517505;Guapiaçu;5000203;Água Clara;1;1;2;383
3522901;Itapuí;5000203;Água Clara;1;1;2;478
3534401;Osasco;5000203;Água Clara;1;1;2;726
3537305;Penápolis;5000203;Água Clara;1;1;2;313
3556107;Valentim Gentil;5000203;Água Clara;1;1;2;287
4100806;Alvorada do Sul;5000203;Água Clara;1;1;2;311
4106902;Curitiba;5000203;Água Clara;1;1;2;671
4107256;Douradina;5000203;Água Clara;1;1;2;329
4119152;Pinhais;5000203;Água Clara;1;1;2;678
4205407;Florianópolis;5000203;Água Clara;1;1;2;919
2311405;Quixeramobim;4323804;Xangri-lá;1;1;2;2892
3304557;Rio de Janeiro;4323804;Xangri-lá;1;1;2;998
4113700;Londrina;4323804;Xangri-lá;1;1;2;727
4205407;Florianópolis;4323804;Xangri-lá;1;1;2;286
4300604;Alvorada;4323804;Xangri-lá;1;1;2;100
4305454;Cidreira;4323804;Xangri-lá;1;1;2;43
4307906;Farroupilha;4323804;Xangri-lá;1;1;2;138
4308201;Flores da Cunha;4323804;Xangri-lá;1;1;2;137
4308607;Garibaldi;4323804;Xangri-lá;1;1;2;153
4309209;Gravataí;4323804;Xangri-lá;1;1;2;90
4309308;Guaíba;4323804;Xangri-lá;1;1;2;127
4310108;Igrejinha;4323804;Xangri-lá;1;1;2;74
4310801;Ivoti;4323804;Xangri-lá;1;1;2;108
4313300;Nova Prata;4323804;Xangri-lá;1;1;2;186
4318408;São Jerônimo;4323804;Xangri-lá;1;1;2;161
4321436;Terra de Areia;4323804;Xangri-lá;1;1;2;23
4321451;Teutônia;4323804;Xangri-lá;1;1;2;172
4307807;Estrela;4323770;Westfália;1;1;2;21
4306932;Entre-Ijuís;4323754;Vitória das Missões;1;1;2;22
4310207;Ijuí;4323754;Vitória das Missões;1;1;2;57
4317202;Santa Rosa;4323754;Vitória das Missões;1;1;2;53
4208401;Itapiranga;4323705;Vista Gaúcha;1;1;2;14
4302105;Bento Gonçalves;4323705;Vista Gaúcha;1;1;2;301
4304002;Campo Novo;4323705;Vista Gaúcha;1;1;2;44
4306320;Derrubadas;4323705;Vista Gaúcha;1;1;2;16
4314902;Porto Alegre;4323705;Vista Gaúcha;1;1;2;396
4306809;Encantado;4323606;Vista Alegre do Prata;1;1;2;48
4203105;Caibi;4323507;Vista Alegre;1;1;2;39
4207650;Iporã do Oeste;4323507;Vista Alegre;1;1;2;41
4208401;Itapiranga;4323507;Vista Alegre;1;1;2;29
4211009;Mondaí;4323507;Vista Alegre;1;1;2;30
4314902;Porto Alegre;4323507;Vista Alegre;1;1;2;378
4315909;Rodeio Bonito;4323507;Vista Alegre;1;1;2;37
4321329;Taquaruçu do Sul;4323507;Vista Alegre;1;1;2;7
4309308;Guaíba;4323457;Vila Nova do Sul;1;1;2;246
4313375;Nova Santa Rita;4323457;Vila Nova do Sul;1;1;2;256
4314902;Porto Alegre;4323457;Vila Nova do Sul;1;1;2;259
4316907;Santa Maria;4323457;Vila Nova do Sul;1;1;2;72
4316972;Santa Margarida do Sul;4323457;Vila Nova do Sul;1;1;2;21
4318309;São Gabriel;4323457;Vila Nova do Sul;1;1;2;39
3147105;Pará de Minas;4323408;Vila Maria;1;1;2;1197
4208203;Itajaí;4323408;Vila Maria;1;1;2;375
4304408;Canela;4323408;Vila Maria;1;1;2;159
4304804;Carlos Barbosa;4323408;Vila Maria;1;1;2;106
4304903;Casca;4323408;Vila Maria;1;1;2;17
4305108;Caxias do Sul;4323408;Vila Maria;1;1;2;119
4311304;Lagoa Vermelha;4323408;Vila Maria;1;1;2;71
4311403;Lajeado;4323408;Vila Maria;1;1;2;100
4312757;Nova Alvorada;4323408;Vila Maria;1;1;2;16
4313201;Nova Petrópolis;4323408;Vila Maria;1;1;2;138
4314001;Paraí;4323408;Vila Maria;1;1;2;37
4314902;Porto Alegre;4323408;Vila Maria;1;1;2;193
4303558;Camargo;4323358;Vila Lângaro;1;1;2;54
4316600;Sananduva;4323358;Vila Lângaro;1;1;2;37
4304804;Carlos Barbosa;4323309;Vila Flores;1;1;2;48
4307906;Farroupilha;4323309;Vila Flores;1;1;2;44
4312906;Nova Bassano;4323309;Vila Flores;1;1;2;23
4313201;Nova Petrópolis;4323309;Vila Flores;1;1;2;70
4314902;Porto Alegre;4323309;Vila Flores;1;1;2;136
4307500;Espumoso;4323200;Victor Graeff;1;1;2;21
4320305;Selbach;4323200;Victor Graeff;1;1;2;21
4315909;Rodeio Bonito;4323101;Vicente Dutra;1;1;2;41
2306306;Itapagé;4323002;Viamão;1;1;2;3096
2607901;Jaboatão dos Guararapes;4323002;Viamão;1;1;2;2827
3136652;Juatuba;4323002;Viamão;1;1;2;1280
3512407;Cordeirópolis;4323002;Viamão;1;1;2;904
3513702;Descalvado;4323002;Viamão;1;1;2;959
3524709;Jaguariúna;4323002;Viamão;1;1;2;899
3548807;São Caetano do Sul;4323002;Viamão;1;1;2;829
4113700;Londrina;4323002;Viamão;1;1;2;751
4125506;São José dos Pinhais;4323002;Viamão;1;1;2;532
4201406;Araranguá;4323002;Viamão;1;1;2;192
4218806;Turvo;4323002;Viamão;1;1;2;181
4301008;Arroio do Meio;4323002;Viamão;1;1;2;117
4301636;Balneário Pinhal;4323002;Viamão;1;1;2;75
4303004;Cachoeira do Sul;4323002;Viamão;1;1;2;183
4303509;Camaquã;4323002;Viamão;1;1;2;114
4304671;Capivari do Sul;4323002;Viamão;1;1;2;49
4305454;Cidreira;4323002;Viamão;1;1;2;76
4306403;Dois Irmãos;4323002;Viamão;1;1;2;55
4307807;Estrela;4323002;Viamão;1;1;2;111
4310330;Imbé;4323002;Viamão;1;1;2;84
4311403;Lajeado;4323002;Viamão;1;1;2;121
4313300;Nova Prata;4323002;Viamão;1;1;2;154
4313508;Osório;4323002;Viamão;1;1;2;75
4314407;Pelotas;4323002;Viamão;1;1;2;226
4315602;Rio Grande;4323002;Viamão;1;1;2;250
4316907;Santa Maria;4323002;Viamão;1;1;2;273
4317608;Santo Antônio da Patrulha;4323002;Viamão;1;1;2;56
4322806;Veranópolis;4323002;Viamão;1;1;2;136
4304853;Carlos Gomes;4322905;Viadutos;1;1;2;20
4305108;Caxias do Sul;4322905;Viadutos;1;1;2;195
4311908;Marcelino Ramos;4322905;Viadutos;1;1;2;13
4320909;Tapejara;4322905;Viadutos;1;1;2;55
4302105;Bento Gonçalves;4322855;Vespasiano Correa;1;1;2;35
4305959;Cotiporã;4322855;Vespasiano Correa;1;1;2;18
4306809;Encantado;4322855;Vespasiano Correa;1;1;2;19
4312609;Muçum;4322855;Vespasiano Correa;1;1;2;8
4314902;Porto Alegre;4322855;Vespasiano Correa;1;1;2;127
4319711;São Valentim do Sul;4322855;Vespasiano Correa;1;1;2;9
2307650;Maracanaú;4322806;Veranópolis;1;1;2;3015
3170206;Uberlândia;4322806;Veranópolis;1;1;2;1153
3516200;Franca;4322806;Veranópolis;1;1;2;1008
3534401;Osasco;4322806;Veranópolis;1;1;2;751
4300604;Alvorada;4322806;Veranópolis;1;1;2;125
4303103;Cachoeirinha;4322806;Veranópolis;1;1;2;120
4304606;Canoas;4322806;Veranópolis;1;1;2;114
4305207;Cerro Largo;4322806;Veranópolis;1;1;2;321
4306403;Dois Irmãos;4322806;Veranópolis;1;1;2;85
4306809;Encantado;4322806;Veranópolis;1;1;2;48
4307609;Estância Velha;4322806;Veranópolis;1;1;2;87
4309209;Gravataí;4322806;Veranópolis;1;1;2;124
4309407;Guaporé;4322806;Veranópolis;1;1;2;37
4311304;Lagoa Vermelha;4322806;Veranópolis;1;1;2;81
4311502;Lavras do Sul;4322806;Veranópolis;1;1;2;311
4314001;Paraí;4322806;Veranópolis;1;1;2;44
4314423;Picada Café;4322806;Veranópolis;1;1;2;69
4316808;Santa Cruz do Sul;4322806;Veranópolis;1;1;2;123
3534401;Osasco;4322707;Vera Cruz;1;1;2;871
3536109;Pardinho;4322707;Vera Cruz;1;1;2;831
4207007;Içara;4322707;Vera Cruz;1;1;2;328
4213708;Pouso Redondo;4322707;Vera Cruz;1;1;2;367
4301008;Arroio do Meio;4322707;Vera Cruz;1;1;2;64
4301602;Bagé;4322707;Vera Cruz;1;1;2;237
4302451;Boqueirão do Leão;4322707;Vera Cruz;1;1;2;46
4302808;Caçapava do Sul;4322707;Vera Cruz;1;1;2;126
4303004;Cachoeira do Sul;4322707;Vera Cruz;1;1;2;50
4303103;Cachoeirinha;4322707;Vera Cruz;1;1;2;137
4304606;Canoas;4322707;Vera Cruz;1;1;2;130
4305207;Cerro Largo;4322707;Vera Cruz;1;1;2;275
4306809;Encantado;4322707;Vera Cruz;1;1;2;79
4307807;Estrela;4322707;Vera Cruz;1;1;2;57
4309902;Ibiraiaras;4322707;Vera Cruz;1;1;2;171
4310009;Ibirubá;4322707;Vera Cruz;1;1;2;133
4314027;Paraíso do Sul;4322707;Vera Cruz;1;1;2;62
4314100;Passo Fundo;4322707;Vera Cruz;1;1;2;162
4315503;Restinga Seca;4322707;Vera Cruz;1;1;2;85
4318309;São Gabriel;4322707;Vera Cruz;1;1;2;187
4318408;São Jerônimo;4322707;Vera Cruz;1;1;2;81
4320677;Sinimbu;4322707;Vera Cruz;1;1;2;20
4320701;Sobradinho;4322707;Vera Cruz;1;1;2;60
4321451;Teutônia;4322707;Vera Cruz;1;1;2;74
4321709;Três Coroas;4322707;Vera Cruz;1;1;2;168
4322004;Triunfo;4322707;Vera Cruz;1;1;2;81
1500602;Altamira;4322608;Venâncio Aires;1;1;2;2925
2304285;Eusébio;4322608;Venâncio Aires;1;1;2;3106
2304400;Fortaleza;4322608;Venâncio Aires;1;1;2;3115
2305233;Horizonte;4322608;Venâncio Aires;1;1;2;3083
2607901;Jaboatão dos Guararapes;4322608;Venâncio Aires;1;1;2;2844
2704302;Maceió;4322608;Venâncio Aires;1;1;2;2669
2927408;Salvador;4322608;Venâncio Aires;1;1;2;2227
3152402;Poté;4322608;Venâncio Aires;1;1;2;1623
3169307;Três Corações;4322608;Venâncio Aires;1;1;2;1095
3170701;Varginha;4322608;Venâncio Aires;1;1;2;1099
3301702;Duque de Caxias;4322608;Venâncio Aires;1;1;2;1127
3534401;Osasco;4322608;Venâncio Aires;1;1;2;843
4106803;Cruz Machado;4322608;Venâncio Aires;1;1;2;405
4106902;Curitiba;4322608;Venâncio Aires;1;1;2;538
4108304;Foz do Iguaçu;4322608;Venâncio Aires;1;1;2;503
4110706;Irati;4322608;Venâncio Aires;1;1;2;480
4119905;Ponta Grossa;4322608;Venâncio Aires;1;1;2;534
4120606;Prudentópolis;4322608;Venâncio Aires;1;1;2;498
4203808;Canoinhas;4322608;Venâncio Aires;1;1;2;413
4207304;Imbituba;4322608;Venâncio Aires;1;1;2;367
4208203;Itajaí;4322608;Venâncio Aires;1;1;2;442
4208500;Ituporanga;4322608;Venâncio Aires;1;1;2;347
4209607;Lauro Muller;4322608;Venâncio Aires;1;1;2;301
4210407;Maracajá;4322608;Venâncio Aires;1;1;2;277
4211900;Palhoça;4322608;Venâncio Aires;1;1;2;396
4212106;Palmitos;4322608;Venâncio Aires;1;1;2;295
4212205;Papanduva;4322608;Venâncio Aires;1;1;2;408
4213708;Pouso Redondo;4322608;Venâncio Aires;1;1;2;338
4214805;Rio do Sul;4322608;Venâncio Aires;1;1;2;360
4215679;Santa Terezinha;4322608;Venâncio Aires;1;1;2;376
4217303;Saudades;4322608;Venâncio Aires;1;1;2;307
4218756;Tunápolis;4322608;Venâncio Aires;1;1;2;323
4301107;Arroio dos Ratos;4322608;Venâncio Aires;1;1;2;69
4302006;Barros Cassal;4322608;Venâncio Aires;1;1;2;68
4302451;Boqueirão do Leão;4322608;Venâncio Aires;1;1;2;40
4302808;Caçapava do Sul;4322608;Venâncio Aires;1;1;2;157
4305207;Cerro Largo;4322608;Venâncio Aires;1;1;2;292
4306106;Cruz Alta;4322608;Venâncio Aires;1;1;2;172
4306403;Dois Irmãos;4322608;Venâncio Aires;1;1;2;107
4307708;Esteio;4322608;Venâncio Aires;1;1;2;103
4308078;Fazenda Vilanova;4322608;Venâncio Aires;1;1;2;36
4308607;Garibaldi;4322608;Venâncio Aires;1;1;2;74
4308805;General Câmara;4322608;Venâncio Aires;1;1;2;52
4311205;Júlio de Castilhos;4322608;Venâncio Aires;1;1;2;150
4312401;Montenegro;4322608;Venâncio Aires;1;1;2;68
4313003;Nova Bréscia;4322608;Venâncio Aires;1;1;2;46
4313391;Novo Cabrais;4322608;Venâncio Aires;1;1;2;78
4313953;Pantano Grande;4322608;Venâncio Aires;1;1;2;68
4315503;Restinga Seca;4322608;Venâncio Aires;1;1;2;117
4315701;Rio Pardo;4322608;Venâncio Aires;1;1;2;38
4315800;Roca Sales;4322608;Venâncio Aires;1;1;2;47
4318408;São Jerônimo;4322608;Venâncio Aires;1;1;2;61
4319711;São Valentim do Sul;4322608;Venâncio Aires;1;1;2;74
4320552;Sertão Santana;4322608;Venâncio Aires;1;1;2;111
4320800;Soledade;4322608;Venâncio Aires;1;1;2;92
4321907;Três Passos;4322608;Venâncio Aires;1;1;2;291
4322400;Uruguaiana;4322608;Venâncio Aires;1;1;2;473
4311809;Marau;4322558;Vanini;1;1;2;35
4318051;São Domingos do Sul;4322558;Vanini;1;1;2;7
4318440;São Jorge;4322558;Vanini;1;1;2;14
4300570;Alto Feliz;4322541;Vale Real;1;1;2;6
4302352;Bom Princípio;4322541;Vale Real;1;1;2;14
4307906;Farroupilha;4322541;Vale Real;1;1;2;19
4308201;Flores da Cunha;4322541;Vale Real;1;1;2;40
4312401;Montenegro;4322541;Vale Real;1;1;2;39
4314902;Porto Alegre;4322541;Vale Real;1;1;2;74
4316501;Salvador do Sul;4322541;Vale Real;1;1;2;24
3550308;São Paulo;4322533;Vale do Sol;1;1;2;871
4200309;Agronômica;4322533;Vale do Sol;1;1;2;383
4203808;Canoinhas;4322533;Vale do Sol;1;1;2;435
4218806;Turvo;4322533;Vale do Sol;1;1;2;300
4300109;Agudo;4322533;Vale do Sol;1;1;2;54
4305207;Cerro Largo;4322533;Vale do Sol;1;1;2;254
4321451;Teutônia;4322533;Vale do Sol;1;1;2;87
4208203;Itajaí;4322525;Vale Verde;1;1;2;455
4312153;Mato Leitão;4322525;Vale Verde;1;1;2;30
4321303;Taquari;4322525;Vale Verde;1;1;2;31
2304400;Fortaleza;4322509;Vacaria;1;1;2;2965
2611606;Recife;4322509;Vacaria;1;1;2;2696
2905701;Camaçari;4322509;Vacaria;1;1;2;2106
2918407;Juazeiro;4322509;Vacaria;1;1;2;2316
3118601;Contagem;4322509;Vacaria;1;1;2;1151
3301702;Duque de Caxias;4322509;Vacaria;1;1;2;967
3506003;Bauru;4322509;Vacaria;1;1;2;706
3509502;Campinas;4322509;Vacaria;1;1;2;724
3516200;Franca;4322509;Vacaria;1;1;2;944
3529302;Matão;4322509;Vacaria;1;1;2;803
3536505;Paulínia;4322509;Vacaria;1;1;2;732
4104105;Campo do Tenente;4322509;Vacaria;1;1;2;306
4120804;Quatro Barras;4322509;Vacaria;1;1;2;392
4203006;Caçador;4322509;Vacaria;1;1;2;190
4204558;Correia Pinto;4322509;Vacaria;1;1;2;117
4204806;Curitibanos;4322509;Vacaria;1;1;2;141
4205506;Fraiburgo;4322509;Vacaria;1;1;2;164
4208302;Itapema;4322509;Vacaria;1;1;2;273
4208906;Jaraguá do Sul;4322509;Vacaria;1;1;2;288
4215802;São Bento do Sul;4322509;Vacaria;1;1;2;292
4216008;São Carlos;4322509;Vacaria;1;1;2;257
4216602;São José;4322509;Vacaria;1;1;2;243
4217501;Seara;4322509;Vacaria;1;1;2;201
4217808;Taió;4322509;Vacaria;1;1;2;178
4302105;Bento Gonçalves;4322509;Vacaria;1;1;2;91
4303509;Camaquã;4322509;Vacaria;1;1;2;272
4303608;Cambará do Sul;4322509;Vacaria;1;1;2;98
4304606;Canoas;4322509;Vacaria;1;1;2;157
4306403;Dois Irmãos;4322509;Vacaria;1;1;2;120
4306767;Eldorado do Sul;4322509;Vacaria;1;1;2;187
4307005;Erechim;4322509;Vacaria;1;1;2;162
4307401;Esmeralda;4322509;Vacaria;1;1;2;56
4308201;Flores da Cunha;4322509;Vacaria;1;1;2;62
4309407;Guaporé;4322509;Vacaria;1;1;2;102
4310801;Ivoti;4322509;Vacaria;1;1;2;122
4311809;Marau;4322509;Vacaria;1;1;2;123
4313086;Nova Pádua;4322509;Vacaria;1;1;2;68
4313706;Palmeira das Missões;4322509;Vacaria;1;1;2;242
4314407;Pelotas;4322509;Vacaria;1;1;2;384
4316501;Salvador do Sul;4322509;Vacaria;1;1;2;117
4320107;Sarandi;4322509;Vacaria;1;1;2;203
4321907;Três Passos;4322509;Vacaria;1;1;2;315
1706100;Cristalândia;4322400;Uruguaiana;1;1;2;2241
3106200;Belo Horizonte;4322400;Uruguaiana;1;1;2;1637
3118601;Contagem;4322400;Uruguaiana;1;1;2;1629
3205309;Vitória;4322400;Uruguaiana;1;1;2;1885
3509502;Campinas;4322400;Uruguaiana;1;1;2;1211
3534401;Osasco;4322400;Uruguaiana;1;1;2;1190
3542602;Registro;4322400;Uruguaiana;1;1;2;1047
3548708;São Bernardo do Campo;4322400;Uruguaiana;1;1;2;1195
3552205;Sorocaba;4322400;Uruguaiana;1;1;2;1140
4101804;Araucária;4322400;Uruguaiana;1;1;2;864
4105805;Colombo;4322400;Uruguaiana;1;1;2;896
4108304;Foz do Iguaçu;4322400;Uruguaiana;1;1;2;534
4115200;Maringá;4322400;Uruguaiana;1;1;2;855
4118501;Pato Branco;4322400;Uruguaiana;1;1;2;576
4125506;São José dos Pinhais;4322400;Uruguaiana;1;1;2;884
4128104;Umuarama;4322400;Uruguaiana;1;1;2;758
4202008;Balneário Camboriú;4322400;Uruguaiana;1;1;2;859
4204301;Concórdia;4322400;Uruguaiana;1;1;2;561
4204608;Criciúma;4322400;Uruguaiana;1;1;2;750
4209102;Joinville;4322400;Uruguaiana;1;1;2;873
4219705;Xaxim;4322400;Uruguaiana;1;1;2;535
4302808;Caçapava do Sul;4322400;Uruguaiana;1;1;2;359
4303004;Cachoeira do Sul;4322400;Uruguaiana;1;1;2;403
4303509;Camaquã;4322400;Uruguaiana;1;1;2;524
4304630;Capão da Canoa;4322400;Uruguaiana;1;1;2;679
4305439;Chuí;4322400;Uruguaiana;1;1;2;559
4306106;Cruz Alta;4322400;Uruguaiana;1;1;2;358
4306601;Dom Pedrito;4322400;Uruguaiana;1;1;2;268
4306767;Eldorado do Sul;4322400;Uruguaiana;1;1;2;529
4309605;Horizontina;4322400;Uruguaiana;1;1;2;357
4314803;Portão;4322400;Uruguaiana;1;1;2;563
4317509;Santo Ângelo;4322400;Uruguaiana;1;1;2;315
4318465;São José do Herval;4322400;Uruguaiana;1;1;2;467
4318903;São Luiz Gonzaga;4322400;Uruguaiana;1;1;2;255
4321105;Tapes;4322400;Uruguaiana;1;1;2;557
4321907;Três Passos;4322400;Uruguaiana;1;1;2;396
4310207;Ijuí;4322376;Unistalda;1;1;2;140
4314902;Porto Alegre;4322376;Unistalda;1;1;2;402
4318002;São Borja;4322376;Unistalda;1;1;2;94
4104659;Carambeí;4322350;União da Serra;1;1;2;468
4306809;Encantado;4322350;União da Serra;1;1;2;50
4320321;Senador Salgado Filho;4322343;Ubiretama;1;1;2;14
4322103;Tucunduva;4322343;Ubiretama;1;1;2;49
4304663;Capão do Leão;4322327;Turuçu;1;1;2;48
4302204;Boa Vista do Buricá;4322301;Tuparendi;1;1;2;38
4303103;Cachoeirinha;4322301;Tuparendi;1;1;2;414
4306932;Entre-Ijuís;4322301;Tuparendi;1;1;2;70
4309605;Horizontina;4322301;Tuparendi;1;1;2;22
4313904;Panambi;4322301;Tuparendi;1;1;2;113
4316907;Santa Maria;4322301;Tuparendi;1;1;2;225
3170107;Uberaba;4322251;Tupandi;1;1;2;1126
3550308;São Paulo;4322251;Tupandi;1;1;2;787
4208203;Itajaí;4322251;Tupandi;1;1;2;380
4304804;Carlos Barbosa;4322251;Tupandi;1;1;2;21
4307609;Estância Velha;4322251;Tupandi;1;1;2;31
4308102;Feliz;4322251;Tupandi;1;1;2;11
4313201;Nova Petrópolis;4322251;Tupandi;1;1;2;32
4318705;São Leopoldo;4322251;Tupandi;1;1;2;41
4319752;São Vendelino;4322251;Tupandi;1;1;2;13
3534401;Osasco;4322202;Tupanciretã;1;1;2;911
4214805;Rio do Sul;4322202;Tupanciretã;1;1;2;458
4301602;Bagé;4322202;Tupanciretã;1;1;2;250
4302808;Caçapava do Sul;4322202;Tupanciretã;1;1;2;161
4303103;Cachoeirinha;4322202;Tupanciretã;1;1;2;284
4305207;Cerro Largo;4322202;Tupanciretã;1;1;2;134
4307005;Erechim;4322202;Tupanciretã;1;1;2;222
4307831;Eugênio de Castro;4322202;Tupanciretã;1;1;2;69
4307906;Farroupilha;4322202;Tupanciretã;1;1;2;246
4309605;Horizontina;4322202;Tupanciretã;1;1;2;168
4311130;Jari;4322202;Tupanciretã;1;1;2;42
4311155;Jóia;4322202;Tupanciretã;1;1;2;55
4313904;Panambi;4322202;Tupanciretã;1;1;2;96
4315321;Quevedos;4322202;Tupanciretã;1;1;2;36
4316451;Salto do Jacuí;4322202;Tupanciretã;1;1;2;62
4317400;Santiago;4322202;Tupanciretã;1;1;2;99
4317509;Santo Ângelo;4322202;Tupanciretã;1;1;2;96
4318309;São Gabriel;4322202;Tupanciretã;1;1;2;145
4318705;São Leopoldo;4322202;Tupanciretã;1;1;2;275
4319158;São Miguel das Missões;4322202;Tupanciretã;1;1;2;89
4319802;São Vicente do Sul;4322202;Tupanciretã;1;1;2;105
4321907;Três Passos;4322202;Tupanciretã;1;1;2;181
4307005;Erechim;4322186;Tupanci do Sul;1;1;2;80
4309902;Ibiraiaras;4322186;Tupanci do Sul;1;1;2;50
4311304;Lagoa Vermelha;4322186;Tupanci do Sul;1;1;2;31
4316600;Sananduva;4322186;Tupanci do Sul;1;1;2;27
4317954;Santo Expedito do Sul;4322186;Tupanci do Sul;1;1;2;11
4318606;São José do Ouro;4322186;Tupanci do Sul;1;1;2;18
4302154;Boa Vista das Missões;4322103;Tucunduva;1;1;2;109
4303103;Cachoeirinha;4322103;Tucunduva;1;1;2;418
4303707;Campina das Missões;4322103;Tucunduva;1;1;2;54
4306734;Doutor Maurício Cardoso;4322103;Tucunduva;1;1;2;18
4315107;Porto Xavier;4322103;Tucunduva;1;1;2;74
4316428;Sagrada Família;4322103;Tucunduva;1;1;2;129
4319364;São Pedro das Missões;4322103;Tucunduva;1;1;2;119
4320321;Senador Salgado Filho;4322103;Tucunduva;1;1;2;43
2408102;Natal;4322004;Triunfo;1;1;2;3053
2927408;Salvador;4322004;Triunfo;1;1;2;2228
3523404;Itatiba;4322004;Triunfo;1;1;2;891
3525904;Jundiaí;4322004;Triunfo;1;1;2;871
3530706;Mogi Guaçu;4322004;Triunfo;1;1;2;951
3534401;Osasco;4322004;Triunfo;1;1;2;844
3536208;Pariquera-Açu;4322004;Triunfo;1;1;2;679
3536505;Paulínia;4322004;Triunfo;1;1;2;899
3538006;Pindamonhangaba;4322004;Triunfo;1;1;2;970
3545803;Santa Bárbara d'Oeste;4322004;Triunfo;1;1;2;889
3547007;Santa Maria da Serra;4322004;Triunfo;1;1;2;879
3548500;Santos;4322004;Triunfo;1;1;2;835
3552809;Taboão da Serra;4322004;Triunfo;1;1;2;839
4101804;Araucária;4322004;Triunfo;1;1;2;526
4119905;Ponta Grossa;4322004;Triunfo;1;1;2;552
4128104;Umuarama;4322004;Triunfo;1;1;2;700
4202305;Biguaçu;4322004;Triunfo;1;1;2;392
4204301;Concórdia;4322004;Triunfo;1;1;2;300
4301107;Arroio dos Ratos;4322004;Triunfo;1;1;2;18
4304689;Capela de Santana;4322004;Triunfo;1;1;2;43
4307708;Esteio;4322004;Triunfo;1;1;2;52
4308201;Flores da Cunha;4322004;Triunfo;1;1;2;110
4309100;Gramado;4322004;Triunfo;1;1;2;95
4314100;Passo Fundo;4322004;Triunfo;1;1;2;195
4314423;Picada Café;4322004;Triunfo;1;1;2;75
4315701;Rio Pardo;4322004;Triunfo;1;1;2;64
4316501;Salvador do Sul;4322004;Triunfo;1;1;2;56
4321451;Teutônia;4322004;Triunfo;1;1;2;52
4218509;Treze Tílias;4321956;Trindade do Sul;1;1;2;158
4321857;Três Palmeiras;4321956;Trindade do Sul;1;1;2;12
3518800;Guarulhos;4321907;Três Passos;1;1;2;845
3534401;Osasco;4321907;Três Passos;1;1;2;820
4204301;Concórdia;4321907;Três Passos;1;1;2;192
4300406;Alegrete;4321907;Três Passos;1;1;2;316
4300604;Alvorada;4321907;Três Passos;1;1;2;401
4302402;Bom Retiro do Sul;4321907;Três Passos;1;1;2;311
4302808;Caçapava do Sul;4321907;Três Passos;1;1;2;340
4304200;Candelária;4321907;Três Passos;1;1;2;271
4304507;Canguçu;4321907;Três Passos;1;1;2;456
4305108;Caxias do Sul;4321907;Três Passos;1;1;2;334
4306106;Cruz Alta;4321907;Três Passos;1;1;2;136
4306601;Dom Pedrito;4321907;Três Passos;1;1;2;395
4306908;Encruzilhada do Sul;4321907;Três Passos;1;1;2;366
4307005;Erechim;4321907;Três Passos;1;1;2;166
4307906;Farroupilha;4321907;Três Passos;1;1;2;325
4308904;Getúlio Vargas;4321907;Três Passos;1;1;2;173
4310009;Ibirubá;4321907;Três Passos;1;1;2;155
4310603;Itaqui;4321907;Três Passos;1;1;2;320
4311007;Jaguarão;4321907;Três Passos;1;1;2;567
4311809;Marau;4321907;Três Passos;1;1;2;205
4312401;Montenegro;4321907;Três Passos;1;1;2;346
4313300;Nova Prata;4321907;Três Passos;1;1;2;275
4313706;Palmeira das Missões;4321907;Três Passos;1;1;2;79
4314050;Parobé;4321907;Três Passos;1;1;2;393
4315305;Quaraí;4321907;Três Passos;1;1;2;409
4315602;Rio Grande;4321907;Três Passos;1;1;2;542
4315701;Rio Pardo;4321907;Três Passos;1;1;2;314
4316402;Rosário do Sul;4321907;Três Passos;1;1;2;327
4316907;Santa Maria;4321907;Três Passos;1;1;2;248
4317103;Santana do Livramento;4321907;Três Passos;1;1;2;408
4317509;Santo Ângelo;4321907;Três Passos;1;1;2;99
4317806;Santo Augusto;4321907;Três Passos;1;1;2;46
4318002;São Borja;4321907;Três Passos;1;1;2;244
4318101;São Francisco de Assis;4321907;Três Passos;1;1;2;261
4318309;São Gabriel;4321907;Três Passos;1;1;2;320
4318804;São Lourenço do Sul;4321907;Três Passos;1;1;2;470
4318903;São Luiz Gonzaga;4321907;Três Passos;1;1;2;145
4319406;São Pedro do Sul;4321907;Três Passos;1;1;2;241
4319505;São Sebastião do Caí;4321907;Três Passos;1;1;2;348
4319604;São Sepé;4321907;Três Passos;1;1;2;303
4319901;Sapiranga;4321907;Três Passos;1;1;2;380
4320107;Sarandi;4321907;Três Passos;1;1;2;115
4320800;Soledade;4321907;Três Passos;1;1;2;206
4321204;Taquara;4321907;Três Passos;1;1;2;398
4321600;Tramandaí;4321907;Três Passos;1;1;2;471
4305801;Constantina;4321857;Três Palmeiras;1;1;2;20
4306957;Entre Rios do Sul;4321857;Três Palmeiras;1;1;2;14
3534401;Osasco;4321808;Três de Maio;1;1;2;860
4113700;Londrina;4321808;Três de Maio;1;1;2;577
4118204;Paranaguá;4321808;Três de Maio;1;1;2;606
4211009;Mondaí;4321808;Três de Maio;1;1;2;107
4219507;Xanxerê;4321808;Três de Maio;1;1;2;206
4301602;Bagé;4321808;Três de Maio;1;1;2;398
4301958;Barra Funda;4321808;Três de Maio;1;1;2;121
4302378;Bom Progresso;4321808;Três de Maio;1;1;2;44
4303103;Cachoeirinha;4321808;Três de Maio;1;1;2;396
4307906;Farroupilha;4321808;Três de Maio;1;1;2;332
4310413;Inhacorá;4321808;Três de Maio;1;1;2;27
4310603;Itaqui;4321808;Três de Maio;1;1;2;275
4311403;Lajeado;4321808;Três de Maio;1;1;2;289
4313011;Nova Candelária;4321808;Três de Maio;1;1;2;21
4314308;Pejuçara;4321808;Três de Maio;1;1;2;95
4317400;Santiago;4321808;Três de Maio;1;1;2;171
4318903;São Luiz Gonzaga;4321808;Três de Maio;1;1;2;101
4319901;Sapiranga;4321808;Três de Maio;1;1;2;384
4320909;Tapejara;4321808;Três de Maio;1;1;2;223
4321600;Tramandaí;4321808;Três de Maio;1;1;2;477
2304400;Fortaleza;4321709;Três Coroas;1;1;2;3058
3304557;Rio de Janeiro;4321709;Três Coroas;1;1;2;1021
3534401;Osasco;4321709;Três Coroas;1;1;2;762
3550308;São Paulo;4321709;Três Coroas;1;1;2;758
4114807;Marialva;4321709;Três Coroas;1;1;2;675
4303103;Cachoeirinha;4321709;Três Coroas;1;1;2;58
4304408;Canela;4321709;Três Coroas;1;1;2;20
4305454;Cidreira;4321709;Três Coroas;1;1;2;89
4306403;Dois Irmãos;4321709;Três Coroas;1;1;2;31
4307708;Esteio;4321709;Três Coroas;1;1;2;53
4307906;Farroupilha;4321709;Três Coroas;1;1;2;63
4311403;Lajeado;4321709;Três Coroas;1;1;2;122
4313060;Nova Hartz;4321709;Três Coroas;1;1;2;14
4314159;Paverama;4321709;Três Coroas;1;1;2;93
4318408;São Jerônimo;4321709;Três Coroas;1;1;2;104
1100023;Ariquemes;4321667;Três Cachoeiras;1;1;2;2470
3534401;Osasco;4321667;Três Cachoeiras;1;1;2;719
4208708;Jacinto Machado;4321667;Três Cachoeiras;1;1;2;52
4218707;Tubarão;4321667;Três Cachoeiras;1;1;2;137
4304408;Canela;4321667;Três Cachoeiras;1;1;2;85
4306551;Dom Pedro de Alcântara;4321667;Três Cachoeiras;1;1;2;12
4306767;Eldorado do Sul;4321667;Três Cachoeiras;1;1;2;178
4306809;Encantado;4321667;Três Cachoeiras;1;1;2;192
4310439;Ipê;4321667;Três Cachoeiras;1;1;2;150
4311809;Marau;4321667;Três Cachoeiras;1;1;2;244
4312443;Morrinhos do Sul;4321667;Três Cachoeiras;1;1;2;9
4316006;Rolante;4321667;Três Cachoeiras;1;1;2;66
4318408;São Jerônimo;4321667;Três Cachoeiras;1;1;2;183
4321436;Terra de Areia;4321667;Três Cachoeiras;1;1;2;20
4204301;Concórdia;4321634;Três Arroios;1;1;2;34
4308706;Gaurama;4321634;Três Arroios;1;1;2;11
4314902;Porto Alegre;4321634;Três Arroios;1;1;2;298
4320909;Tapejara;4321634;Três Arroios;1;1;2;64
4301008;Arroio do Meio;4321626;Travesseiro;1;1;2;18
4311403;Lajeado;4321626;Travesseiro;1;1;2;17
4312153;Mato Leitão;4321626;Travesseiro;1;1;2;26
4314050;Parobé;4321626;Travesseiro;1;1;2;127
4316808;Santa Cruz do Sul;4321626;Travesseiro;1;1;2;59
2311405;Quixeramobim;4321600;Tramandaí;1;1;2;2913
3516200;Franca;4321600;Tramandaí;1;1;2;1076
3534401;Osasco;4321600;Tramandaí;1;1;2;781
4301636;Balneário Pinhal;4321600;Tramandaí;1;1;2;31
4303509;Camaquã;4321600;Tramandaí;1;1;2;187
4304671;Capivari do Sul;4321600;Tramandaí;1;1;2;39
4305355;Charqueadas;4321600;Tramandaí;1;1;2;142
4307005;Erechim;4321600;Tramandaí;1;1;2;330
4307906;Farroupilha;4321600;Tramandaí;1;1;2;141
4308508;Frederico Westphalen;4321600;Tramandaí;1;1;2;424
4309308;Guaíba;4321600;Tramandaí;1;1;2;115
4309605;Horizontina;4321600;Tramandaí;1;1;2;475
4310405;Independência;4321600;Tramandaí;1;1;2;453
4310504;Iraí;4321600;Tramandaí;1;1;2;427
4310801;Ivoti;4321600;Tramandaí;1;1;2;106
4311403;Lajeado;4321600;Tramandaí;1;1;2;190
4313060;Nova Hartz;4321600;Tramandaí;1;1;2;84
4313656;Palmares do Sul;4321600;Tramandaí;1;1;2;46
4313805;Palmitinho;4321600;Tramandaí;1;1;2;436
4314803;Portão;4321600;Tramandaí;1;1;2;109
4316006;Rolante;4321600;Tramandaí;1;1;2;55
4318200;São Francisco de Paula;4321600;Tramandaí;1;1;2;72
4318903;São Luiz Gonzaga;4321600;Tramandaí;1;1;2;493
4320677;Sinimbu;4321600;Tramandaí;1;1;2;233
4321329;Taquaruçu do Sul;4321600;Tramandaí;1;1;2;426
4321451;Teutônia;4321600;Tramandaí;1;1;2;170
1302603;Manaus;4321501;Torres;1;1;2;3045
3106200;Belo Horizonte;4321501;Torres;1;1;2;1177
3505708;Barueri;4321501;Torres;1;1;2;700
3509502;Campinas;4321501;Torres;1;1;2;757
3518800;Guarulhos;4321501;Torres;1;1;2;720
3522208;Itapecerica da Serra;4321501;Torres;1;1;2;681
3526902;Limeira;4321501;Torres;1;1;2;782
3534401;Osasco;4321501;Torres;1;1;2;701
3543402;Ribeirão Preto;4321501;Torres;1;1;2;924
3550308;São Paulo;4321501;Torres;1;1;2;695
4125506;São José dos Pinhais;4321501;Torres;1;1;2;423
4208203;Itajaí;4321501;Torres;1;1;2;282
4209102;Joinville;4321501;Torres;1;1;2;348
4210407;Maracajá;4321501;Torres;1;1;2;62
4211256;Morro Grande;4321501;Torres;1;1;2;58
4215653;Santa Rosa do Sul;4321501;Torres;1;1;2;23
4216404;São João do Sul;4321501;Torres;1;1;2;10
4218707;Tubarão;4321501;Torres;1;1;2;118
4219002;Urussanga;4321501;Torres;1;1;2;98
4300604;Alvorada;4321501;Torres;1;1;2;145
4302303;Bom Jesus;4321501;Torres;1;1;2;93
4303509;Camaquã;4321501;Torres;1;1;2;259
4303905;Campo Bom;4321501;Torres;1;1;2;128
4304408;Canela;4321501;Torres;1;1;2;97
4305173;Cerro Grande do Sul;4321501;Torres;1;1;2;236
4305454;Cidreira;4321501;Torres;1;1;2;103
4306205;Cruzeiro do Sul;4321501;Torres;1;1;2;217
4306809;Encantado;4321501;Torres;1;1;2;204
4307708;Esteio;4321501;Torres;1;1;2;146
4307807;Estrela;4321501;Torres;1;1;2;211
4309209;Gravataí;4321501;Torres;1;1;2;134
4309407;Guaporé;4321501;Torres;1;1;2;210
4311403;Lajeado;4321501;Torres;1;1;2;216
4312401;Montenegro;4321501;Torres;1;1;2;169
4313003;Nova Bréscia;4321501;Torres;1;1;2;216
4313201;Nova Petrópolis;4321501;Torres;1;1;2;127
4314100;Passo Fundo;4321501;Torres;1;1;2;277
4315602;Rio Grande;4321501;Torres;1;1;2;386
4316006;Rolante;4321501;Torres;1;1;2;84
4317608;Santo Antônio da Patrulha;4321501;Torres;1;1;2;89
4318408;São Jerônimo;4321501;Torres;1;1;2;200
4321436;Terra de Areia;4321501;Torres;1;1;2;39
4321451;Teutônia;4321501;Torres;1;1;2;195
4316907;Santa Maria;4321493;Toropi;1;1;2;47
4305207;Cerro Largo;4321477;Tiradentes do Sul;1;1;2;106
4307807;Estrela;4321477;Tiradentes do Sul;1;1;2;315
4314902;Porto Alegre;4321477;Tiradentes do Sul;1;1;2;412
4319109;São Martinho;4321477;Tiradentes do Sul;1;1;2;36
4302303;Bom Jesus;4321469;Tio Hugo;1;1;2;213
4307054;Ernestina;4321469;Tio Hugo;1;1;2;9
4311403;Lajeado;4321469;Tio Hugo;1;1;2;110
4312674;Nicolau Vergueiro;4321469;Tio Hugo;1;1;2;14
4314100;Passo Fundo;4321469;Tio Hugo;1;1;2;41
4314902;Porto Alegre;4321469;Tio Hugo;1;1;2;214
4316501;Salvador do Sul;4321469;Tio Hugo;1;1;2;143
4320800;Soledade;4321469;Tio Hugo;1;1;2;29
1200401;Rio Branco;4321451;Teutônia;1;1;2;2603
1302603;Manaus;4321451;Teutônia;1;1;2;3008
2306306;Itapagé;4321451;Teutônia;1;1;2;3059
3528403;Mairinque;4321451;Teutônia;1;1;2;786
3534401;Osasco;4321451;Teutônia;1;1;2;809
3550308;São Paulo;4321451;Teutônia;1;1;2;806
4113700;Londrina;4321451;Teutônia;1;1;2;684
4201406;Araranguá;4321451;Teutônia;1;1;2;231
4204301;Concórdia;4321451;Teutônia;1;1;2;248
4208203;Itajaí;4321451;Teutônia;1;1;2;404
4217808;Taió;4321451;Teutônia;1;1;2;309
4300109;Agudo;4321451;Teutônia;1;1;2;141
4301404;Arvorezinha;4321451;Teutônia;1;1;2;73
4301651;Barão;4321451;Teutônia;1;1;2;31
4302105;Bento Gonçalves;4321451;Teutônia;1;1;2;43
4302253;Boa Vista do Sul;4321451;Teutônia;1;1;2;17
4302659;Brochier;4321451;Teutônia;1;1;2;21
4303509;Camaquã;4321451;Teutônia;1;1;2;154
4304630;Capão da Canoa;4321451;Teutônia;1;1;2;175
4304705;Carazinho;4321451;Teutônia;1;1;2;159
4305355;Charqueadas;4321451;Teutônia;1;1;2;59
4305587;Colinas;4321451;Teutônia;1;1;2;9
4307708;Esteio;4321451;Teutônia;1;1;2;76
4308078;Fazenda Vilanova;4321451;Teutônia;1;1;2;16
4309209;Gravataí;4321451;Teutônia;1;1;2;96
4309407;Guaporé;4321451;Teutônia;1;1;2;68
4310207;Ijuí;4321451;Teutônia;1;1;2;235
4310306;Ilópolis;4321451;Teutônia;1;1;2;65
4312054;Marques de Souza;4321451;Teutônia;1;1;2;31
4312609;Muçum;4321451;Teutônia;1;1;2;35
4313201;Nova Petrópolis;4321451;Teutônia;1;1;2;68
4313300;Nova Prata;4321451;Teutônia;1;1;2;76
4313375;Nova Santa Rita;4321451;Teutônia;1;1;2;69
4313508;Osório;4321451;Teutônia;1;1;2;157
4314001;Paraí;4321451;Teutônia;1;1;2;95
4314035;Pareci Novo;4321451;Teutônia;1;1;2;41
4314076;Passo do Sobrado;4321451;Teutônia;1;1;2;56
4315156;Progresso;4321451;Teutônia;1;1;2;54
4315206;Putinga;4321451;Teutônia;1;1;2;60
4315305;Quaraí;4321451;Teutônia;1;1;2;464
4315701;Rio Pardo;4321451;Teutônia;1;1;2;75
4316758;Santa Clara do Sul;4321451;Teutônia;1;1;2;30
4318614;São José do Sul;4321451;Teutônia;1;1;2;31
4320008;Sapucaia do Sul;4321451;Teutônia;1;1;2;78
4320404;Serafina Corrêa;4321451;Teutônia;1;1;2;83
4320800;Soledade;4321451;Teutônia;1;1;2;99
4201406;Araranguá;4321436;Terra de Areia;1;1;2;90
4301057;Arroio do Sal;4321436;Terra de Areia;1;1;2;17
4301909;Barra do Ribeiro;4321436;Terra de Areia;1;1;2;144
4305108;Caxias do Sul;4321436;Terra de Areia;1;1;2;116
4316006;Rolante;4321436;Terra de Areia;1;1;2;49
4318408;São Jerônimo;4321436;Terra de Areia;1;1;2;166
3534401;Osasco;4321402;Tenente Portela;1;1;2;801
4113700;Londrina;4321402;Tenente Portela;1;1;2;517
4117602;Palmas;4321402;Tenente Portela;1;1;2;200
4203501;Campo Erê;4321402;Tenente Portela;1;1;2;127
4302204;Boa Vista do Buricá;4321402;Tenente Portela;1;1;2;48
4303103;Cachoeirinha;4321402;Tenente Portela;1;1;2;389
4304002;Campo Novo;4321402;Tenente Portela;1;1;2;34
4305108;Caxias do Sul;4321402;Tenente Portela;1;1;2;325
4305207;Cerro Largo;4321402;Tenente Portela;1;1;2;130
4305900;Coronel Bicaco;4321402;Tenente Portela;1;1;2;39
4306007;Crissiumal;4321402;Tenente Portela;1;1;2;37
4313805;Palmitinho;4321402;Tenente Portela;1;1;2;20
4314100;Passo Fundo;4321402;Tenente Portela;1;1;2;167
4315404;Redentora;4321402;Tenente Portela;1;1;2;35
4320107;Sarandi;4321402;Tenente Portela;1;1;2;105
4306205;Cruzeiro do Sul;4321352;Tavares;1;1;2;216
4315602;Rio Grande;4321352;Tavares;1;1;2;137
4318507;São José do Norte;4321352;Tavares;1;1;2;120
4303400;Caiçara;4321329;Taquaruçu do Sul;1;1;2;14
4304630;Capão da Canoa;4321329;Taquaruçu do Sul;1;1;2;431
4305702;Condor;4321329;Taquaruçu do Sul;1;1;2;90
4314902;Porto Alegre;4321329;Taquaruçu do Sul;1;1;2;371
4315909;Rodeio Bonito;4321329;Taquaruçu do Sul;1;1;2;31
2913606;Ilhéus;4321303;Taquari;1;1;2;2031
3534401;Osasco;4321303;Taquari;1;1;2;842
4109807;Ibiporã;4321303;Taquari;1;1;2;728
4113700;Londrina;4321303;Taquari;1;1;2;723
4207304;Imbituba;4321303;Taquari;1;1;2;348
4301750;Barão do Triunfo;4321303;Taquari;1;1;2;66
4303103;Cachoeirinha;4321303;Taquari;1;1;2;74
4303509;Camaquã;4321303;Taquari;1;1;2;115
4304630;Capão da Canoa;4321303;Taquari;1;1;2;176
4306403;Dois Irmãos;4321303;Taquari;1;1;2;79
4307807;Estrela;4321303;Taquari;1;1;2;34
4307906;Farroupilha;4321303;Taquari;1;1;2;81
4308078;Fazenda Vilanova;4321303;Taquari;1;1;2;24
4312153;Mato Leitão;4321303;Taquari;1;1;2;42
4313201;Nova Petrópolis;4321303;Taquari;1;1;2;86
4314076;Passo do Sobrado;4321303;Taquari;1;1;2;40
4314159;Paverama;4321303;Taquari;1;1;2;30
4314803;Portão;4321303;Taquari;1;1;2;61
4318408;São Jerônimo;4321303;Taquari;1;1;2;22
4319752;São Vendelino;4321303;Taquari;1;1;2;67
2704302;Maceió;4321204;Taquara;1;1;2;2603
2927408;Salvador;4321204;Taquara;1;1;2;2161
3534401;Osasco;4321204;Taquara;1;1;2;775
3538709;Piracicaba;4321204;Taquara;1;1;2;819
3552809;Taboão da Serra;4321204;Taquara;1;1;2;770
4114807;Marialva;4321204;Taquara;1;1;2;690
4205407;Florianópolis;4321204;Taquara;1;1;2;315
4303103;Cachoeirinha;4321204;Taquara;1;1;2;46
4304200;Candelária;4321204;Taquara;1;1;2;198
4308052;Faxinalzinho;4321204;Taquara;1;1;2;307
4308607;Garibaldi;4321204;Taquara;1;1;2;85
4309209;Gravataí;4321204;Taquara;1;1;2;38
4311403;Lajeado;4321204;Taquara;1;1;2;123
4313201;Nova Petrópolis;4321204;Taquara;1;1;2;44
4314407;Pelotas;4321204;Taquara;1;1;2;278
4314423;Picada Café;4321204;Taquara;1;1;2;41
4316907;Santa Maria;4321204;Taquara;1;1;2;294
4318408;São Jerônimo;4321204;Taquara;1;1;2;97
4320800;Soledade;4321204;Taquara;1;1;2;193
3534401;Osasco;4321105;Tapes;1;1;2;900
4104204;Campo Largo;4321105;Tapes;1;1;2;604
4303004;Cachoeira do Sul;4321105;Tapes;1;1;2;160
4303905;Campo Bom;4321105;Tapes;1;1;2;116
4304606;Canoas;4321105;Tapes;1;1;2;87
4304630;Capão da Canoa;4321105;Tapes;1;1;2;167
4305108;Caxias do Sul;4321105;Tapes;1;1;2;169
4305173;Cerro Grande do Sul;4321105;Tapes;1;1;2;31
4309308;Guaíba;4321105;Tapes;1;1;2;62
4311403;Lajeado;4321105;Tapes;1;1;2;149
4311981;Mariana Pimentel;4321105;Tapes;1;1;2;38
4313375;Nova Santa Rita;4321105;Tapes;1;1;2;91
4313409;Novo Hamburgo;4321105;Tapes;1;1;2;113
4313508;Osório;4321105;Tapes;1;1;2;141
4314803;Portão;4321105;Tapes;1;1;2;109
4318804;São Lourenço do Sul;4321105;Tapes;1;1;2;91
3534401;Osasco;4321006;Tapera;1;1;2;810
4204301;Concórdia;4321006;Tapera;1;1;2;177
4302238;Boa vista do Incra;4321006;Tapera;1;1;2;55
4303103;Cachoeirinha;4321006;Tapera;1;1;2;227
4304101;Campos Borges;4321006;Tapera;1;1;2;31
4305108;Caxias do Sul;4321006;Tapera;1;1;2;177
4305207;Cerro Largo;4321006;Tapera;1;1;2;189
4310876;Jacuizinho;4321006;Tapera;1;1;2;49
4311403;Lajeado;4321006;Tapera;1;1;2;122
4312427;Mormaço;4321006;Tapera;1;1;2;19
4312658;Não-Me-Toque;4321006;Tapera;1;1;2;19
4313706;Palmeira das Missões;4321006;Tapera;1;1;2;91
4315800;Roca Sales;4321006;Tapera;1;1;2;122
4316451;Salto do Jacuí;4321006;Tapera;1;1;2;61
4318309;São Gabriel;4321006;Tapera;1;1;2;236
4320800;Soledade;4321006;Tapera;1;1;2;39
2605301;Exu;4320909;Tapejara;1;1;2;2540
2606002;Garanhuns;4320909;Tapejara;1;1;2;2567
2703403;Jacaré dos Homens;4320909;Tapejara;1;1;2;2461
3101201;Aiuruoca;4320909;Tapejara;1;1;2;980
3142106;Miradouro;4320909;Tapejara;1;1;2;1218
3143906;Muriaé;4320909;Tapejara;1;1;2;1207
3300407;Barra Mansa;4320909;Tapejara;1;1;2;970
3301702;Duque de Caxias;4320909;Tapejara;1;1;2;1022
3303401;Nova Friburgo;4320909;Tapejara;1;1;2;1109
3550308;São Paulo;4320909;Tapejara;1;1;2;712
4109401;Guarapuava;4320909;Tapejara;1;1;2;301
4122404;Rolândia;4320909;Tapejara;1;1;2;531
4203907;Capinzal;4320909;Tapejara;1;1;2;89
4204301;Concórdia;4320909;Tapejara;1;1;2;94
4216255;São João do Oeste;4320909;Tapejara;1;1;2;188
4216602;São José;4320909;Tapejara;1;1;2;331
4217501;Seara;4320909;Tapejara;1;1;2;106
4218509;Treze Tílias;4320909;Tapejara;1;1;2;132
4300901;Aratiba;4320909;Tapejara;1;1;2;80
4301503;Augusto Pestana;4320909;Tapejara;1;1;2;201
4301701;Barão de Cotegipe;4320909;Tapejara;1;1;2;61
4301800;Barracão;4320909;Tapejara;1;1;2;70
4302378;Bom Progresso;4320909;Tapejara;1;1;2;191
4302907;Cacequi;4320909;Tapejara;1;1;2;345
4303103;Cachoeirinha;4320909;Tapejara;1;1;2;227
4303202;Cacique Doble;4320909;Tapejara;1;1;2;48
4304630;Capão da Canoa;4320909;Tapejara;1;1;2;270
4305009;Catuípe;4320909;Tapejara;1;1;2;198
4305108;Caxias do Sul;4320909;Tapejara;1;1;2;147
4305207;Cerro Largo;4320909;Tapejara;1;1;2;268
4305504;Ciríaco;4320909;Tapejara;1;1;2;33
4306304;David Canabarro;4320909;Tapejara;1;1;2;39
4306767;Eldorado do Sul;4320909;Tapejara;1;1;2;227
4306809;Encantado;4320909;Tapejara;1;1;2;129
4307401;Esmeralda;4320909;Tapejara;1;1;2;81
4307559;Estação;4320909;Tapejara;1;1;2;30
4308078;Fazenda Vilanova;4320909;Tapejara;1;1;2;170
4309001;Giruá;4320909;Tapejara;1;1;2;229
4310801;Ivoti;4320909;Tapejara;1;1;2;189
4312609;Muçum;4320909;Tapejara;1;1;2;119
4312617;Muitos Capões;4320909;Tapejara;1;1;2;86
4312658;Não-Me-Toque;4320909;Tapejara;1;1;2;91
4313607;Paim Filho;4320909;Tapejara;1;1;2;47
4313904;Panambi;4320909;Tapejara;1;1;2;148
4314001;Paraí;4320909;Tapejara;1;1;2;62
4314464;Pinhal da Serra;4320909;Tapejara;1;1;2;86
4315313;Quatro Irmãos;4320909;Tapejara;1;1;2;50
4315602;Rio Grande;4320909;Tapejara;1;1;2;445
4316006;Rolante;4320909;Tapejara;1;1;2;226
4316105;Ronda Alta;4320909;Tapejara;1;1;2;84
4316808;Santa Cruz do Sul;4320909;Tapejara;1;1;2;188
4317509;Santo Ângelo;4320909;Tapejara;1;1;2;224
4318101;São Francisco de Assis;4320909;Tapejara;1;1;2;351
4319372;São Pedro do Butiá;4320909;Tapejara;1;1;2;283
4320305;Selbach;4320909;Tapejara;1;1;2;111
4320800;Soledade;4320909;Tapejara;1;1;2;100
3550308;São Paulo;4320859;Tabaí;1;1;2;817
4302402;Bom Retiro do Sul;4320859;Tabaí;1;1;2;23
4302907;Cacequi;4320859;Tabaí;1;1;2;304
4306403;Dois Irmãos;4320859;Tabaí;1;1;2;61
3304557;Rio de Janeiro;4320800;Soledade;1;1;2;1103
3518800;Guarulhos;4320800;Soledade;1;1;2;827
3534401;Osasco;4320800;Soledade;1;1;2;804
3550308;São Paulo;4320800;Soledade;1;1;2;804
4209300;Lages;4320800;Soledade;1;1;2;244
4217501;Seara;4320800;Soledade;1;1;2;188
4300208;Ajuricaba;4320800;Soledade;1;1;2;136
4303103;Cachoeirinha;4320800;Soledade;1;1;2;188
4303558;Camargo;4320800;Soledade;1;1;2;44
4304200;Candelária;4320800;Soledade;1;1;2;99
4304606;Canoas;4320800;Soledade;1;1;2;180
4304622;Capão Bonito do Sul;4320800;Soledade;1;1;2;137
4304903;Casca;4320800;Soledade;1;1;2;64
4305132;Cerro Branco;4320800;Soledade;1;1;2;100
4306106;Cruz Alta;4320800;Soledade;1;1;2;104
4306601;Dom Pedrito;4320800;Soledade;1;1;2;315
4307906;Farroupilha;4320800;Soledade;1;1;2;126
4308854;Gentil;4320800;Soledade;1;1;2;67
4309100;Gramado;4320800;Soledade;1;1;2;173
4309159;Gramado Xavier;4320800;Soledade;1;1;2;48
4310009;Ibirubá;4320800;Soledade;1;1;2;57
4310207;Ijuí;4320800;Soledade;1;1;2;142
4310306;Ilópolis;4320800;Soledade;1;1;2;43
4310579;Itapuca;4320800;Soledade;1;1;2;38
4310876;Jacuizinho;4320800;Soledade;1;1;2;54
4311254;Lagoão;4320800;Soledade;1;1;2;50
4312153;Mato Leitão;4320800;Soledade;1;1;2;85
4312302;Miraguaí;4320800;Soledade;1;1;2;186
4312609;Muçum;4320800;Soledade;1;1;2;73
4312658;Não-Me-Toque;4320800;Soledade;1;1;2;49
4312674;Nicolau Vergueiro;4320800;Soledade;1;1;2;34
4313904;Panambi;4320800;Soledade;1;1;2;111
4315131;Pouso Novo;4320800;Soledade;1;1;2;50
4317558;Santo Antônio do Palma;4320800;Soledade;1;1;2;64
4318408;São Jerônimo;4320800;Soledade;1;1;2;149
4318465;São José do Herval;4320800;Soledade;1;1;2;34
4320107;Sarandi;4320800;Soledade;1;1;2;105
4320305;Selbach;4320800;Soledade;1;1;2;45
3534401;Osasco;4320701;Sobradinho;1;1;2;879
3550308;São Paulo;4320701;Sobradinho;1;1;2;879
4105508;Cianorte;4320701;Sobradinho;1;1;2;639
4303004;Cachoeira do Sul;4320701;Sobradinho;1;1;2;65
4303103;Cachoeirinha;4320701;Sobradinho;1;1;2;195
4305132;Cerro Branco;4320701;Sobradinho;1;1;2;26
4305207;Cerro Largo;4320701;Sobradinho;1;1;2;216
4307500;Espumoso;4320701;Sobradinho;1;1;2;79
4307815;Estrela Velha;4320701;Sobradinho;1;1;2;30
4307906;Farroupilha;4320701;Sobradinho;1;1;2;165
4309753;Ibarama;4320701;Sobradinho;1;1;2;10
4310801;Ivoti;4320701;Sobradinho;1;1;2;182
4311254;Lagoão;4320701;Sobradinho;1;1;2;31
4316709;Santa Bárbara do Sul;4320701;Sobradinho;1;1;2;120
4316907;Santa Maria;4320701;Sobradinho;1;1;2;83
4317004;Santana da Boa Vista;4320701;Sobradinho;1;1;2;161
4318408;São Jerônimo;4320701;Sobradinho;1;1;2;140
4318903;São Luiz Gonzaga;4320701;Sobradinho;1;1;2;218
4125605;São Mateus do Sul;4320677;Sinimbu;1;1;2;458
4201257;Apiúna;4320677;Sinimbu;1;1;2;409
4211207;Morro da Fumaça;4320677;Sinimbu;1;1;2;334
4212908;Pinhalzinho;4320677;Sinimbu;1;1;2;302
4303103;Cachoeirinha;4320677;Sinimbu;1;1;2;144
4309571;Herveiras;4320677;Sinimbu;1;1;2;19
4318408;São Jerônimo;4320677;Sinimbu;1;1;2;91
4306106;Cruz Alta;4320651;Silveira Martins;1;1;2;111
4308003;Faxinal do Soturno;4320651;Silveira Martins;1;1;2;16
4300901;Aratiba;4320602;Severiano de Almeida;1;1;2;19
4305207;Cerro Largo;4320578;Sete de Setembro;1;1;2;27
4309506;Guarani das Missões;4320578;Sete de Setembro;1;1;2;9
4213203;Pomerode;4320552;Sertão Santana;1;1;2;471
4303004;Cachoeira do Sul;4320552;Sertão Santana;1;1;2;135
4305173;Cerro Grande do Sul;4320552;Sertão Santana;1;1;2;19
4306767;Eldorado do Sul;4320552;Sertão Santana;1;1;2;42
4314902;Porto Alegre;4320552;Sertão Santana;1;1;2;59
4320354;Sentinela do Sul;4320552;Sertão Santana;1;1;2;17
4209003;Joaçaba;4320503;Sertão;1;1;2;116
4306767;Eldorado do Sul;4320503;Sertão;1;1;2;242
4310462;Ipiranga do Sul;4320503;Sertão;1;1;2;17
1302603;Manaus;4320404;Serafina Corrêa;1;1;2;2928
3534401;Osasco;4320404;Serafina Corrêa;1;1;2;755
4102109;Astorga;4320404;Serafina Corrêa;1;1;2;608
4105805;Colombo;4320404;Serafina Corrêa;1;1;2;462
4106902;Curitiba;4320404;Serafina Corrêa;1;1;2;443
4115200;Maringá;4320404;Serafina Corrêa;1;1;2;585
4202305;Biguaçu;4320404;Serafina Corrêa;1;1;2;342
4202404;Blumenau;4320404;Serafina Corrêa;1;1;2;339
4203006;Caçador;4320404;Serafina Corrêa;1;1;2;227
4205407;Florianópolis;4320404;Serafina Corrêa;1;1;2;355
4303558;Camargo;4320404;Serafina Corrêa;1;1;2;30
4304606;Canoas;4320404;Serafina Corrêa;1;1;2;152
4305207;Cerro Largo;4320404;Serafina Corrêa;1;1;2;280
4307708;Esteio;4320404;Serafina Corrêa;1;1;2;146
4307906;Farroupilha;4320404;Serafina Corrêa;1;1;2;81
4310306;Ilópolis;4320404;Serafina Corrêa;1;1;2;30
4311304;Lagoa Vermelha;4320404;Serafina Corrêa;1;1;2;69
4311403;Lajeado;4320404;Serafina Corrêa;1;1;2;80
4312351;Montauri;4320404;Serafina Corrêa;1;1;2;15
4312658;Não-Me-Toque;4320404;Serafina Corrêa;1;1;2;91
4312906;Nova Bassano;4320404;Serafina Corrêa;1;1;2;23
4314001;Paraí;4320404;Serafina Corrêa;1;1;2;20
4316808;Santa Cruz do Sul;4320404;Serafina Corrêa;1;1;2;122
4318051;São Domingos do Sul;4320404;Serafina Corrêa;1;1;2;21
4303004;Cachoeira do Sul;4320354;Sentinela do Sul;1;1;2;144
4305173;Cerro Grande do Sul;4320354;Sentinela do Sul;1;1;2;16
4316808;Santa Cruz do Sul;4320354;Sentinela do Sul;1;1;2;127
4305207;Cerro Largo;4320321;Senador Salgado Filho;1;1;2;23
4309506;Guarani das Missões;4320321;Senador Salgado Filho;1;1;2;12
4317905;Santo Cristo;4320321;Senador Salgado Filho;1;1;2;26
4304101;Campos Borges;4320305;Selbach;1;1;2;29
4305207;Cerro Largo;4320305;Selbach;1;1;2;181
4310009;Ibirubá;4320305;Selbach;1;1;2;13
4311270;Lagoa dos Três Cantos;4320305;Selbach;1;1;2;11
4312658;Não-Me-Toque;4320305;Selbach;1;1;2;23
4316451;Salto do Jacuí;4320305;Selbach;1;1;2;57
4300109;Agudo;4320263;Segredo;1;1;2;47
4301206;Arroio do Tigre;4320263;Segredo;1;1;2;11
4314902;Porto Alegre;4320263;Segredo;1;1;2;197
4316451;Salto do Jacuí;4320263;Segredo;1;1;2;28
4208203;Itajaí;4320230;Sede Nova;1;1;2;517
4212908;Pinhalzinho;4320230;Sede Nova;1;1;2;128
4309704;Humaitá;4320230;Sede Nova;1;1;2;8
4314902;Porto Alegre;4320230;Sede Nova;1;1;2;383
4319109;São Martinho;4320230;Sede Nova;1;1;2;8
3534401;Osasco;4320206;Seberi;1;1;2;777
4109757;Ibema;4320206;Seberi;1;1;2;266
4201406;Araranguá;4320206;Seberi;1;1;2;422
4208401;Itapiranga;4320206;Seberi;1;1;2;46
4218707;Tubarão;4320206;Seberi;1;1;2;447
4302154;Boa Vista das Missões;4320206;Seberi;1;1;2;21
4304606;Canoas;4320206;Seberi;1;1;2;349
4304705;Carazinho;4320206;Seberi;1;1;2;109
4305207;Cerro Largo;4320206;Seberi;1;1;2;152
4306429;Dois Irmãos das Missões;4320206;Seberi;1;1;2;24
4307302;Erval Seco;4320206;Seberi;1;1;2;13
4313706;Palmeira das Missões;4320206;Seberi;1;1;2;48
4314100;Passo Fundo;4320206;Seberi;1;1;2;132
2103208;Chapadinha;4320107;Sarandi;1;1;2;2821
2611606;Recife;4320107;Sarandi;1;1;2;2758
3516200;Franca;4320107;Sarandi;1;1;2;974
3534401;Osasco;4320107;Sarandi;1;1;2;767
4204400;Coronel Freitas;4320107;Sarandi;1;1;2;116
4216008;São Carlos;4320107;Sarandi;1;1;2;97
4217501;Seara;4320107;Sarandi;1;1;2;106
4219507;Xanxerê;4320107;Sarandi;1;1;2;130
4219705;Xaxim;4320107;Sarandi;1;1;2;115
4300471;Almirante Tamandaré do Sul;4320107;Sarandi;1;1;2;19
4301602;Bagé;4320107;Sarandi;1;1;2;394
4303103;Cachoeirinha;4320107;Sarandi;1;1;2;286
4304630;Capão da Canoa;4320107;Sarandi;1;1;2;349
4305157;Cerro Grande;4320107;Sarandi;1;1;2;44
4305207;Cerro Largo;4320107;Sarandi;1;1;2;180
4306106;Cruz Alta;4320107;Sarandi;1;1;2;102
4306767;Eldorado do Sul;4320107;Sarandi;1;1;2;270
4307906;Farroupilha;4320107;Sarandi;1;1;2;211
4308508;Frederico Westphalen;4320107;Sarandi;1;1;2;79
4310009;Ibirubá;4320107;Sarandi;1;1;2;78
4311205;Júlio de Castilhos;4320107;Sarandi;1;1;2;161
4311403;Lajeado;4320107;Sarandi;1;1;2;187
4313201;Nova Petrópolis;4320107;Sarandi;1;1;2;239
4316808;Santa Cruz do Sul;4320107;Sarandi;1;1;2;203
4317202;Santa Rosa;4320107;Sarandi;1;1;2;152
4317509;Santo Ângelo;4320107;Sarandi;1;1;2;139
4318606;São José do Ouro;4320107;Sarandi;1;1;2;132
4319364;São Pedro das Missões;4320107;Sarandi;1;1;2;37
2306306;Itapagé;4320008;Sapucaia do Sul;1;1;2;3077
2607901;Jaboatão dos Guararapes;4320008;Sapucaia do Sul;1;1;2;2813
2803302;Japaratuba;4320008;Sapucaia do Sul;1;1;2;2491
2927408;Salvador;4320008;Sapucaia do Sul;1;1;2;2194
2930709;Simões Filho;4320008;Sapucaia do Sul;1;1;2;2217
3106200;Belo Horizonte;4320008;Sapucaia do Sul;1;1;2;1286
3118601;Contagem;4320008;Sapucaia do Sul;1;1;2;1279
3145901;Ouro Branco;4320008;Sapucaia do Sul;1;1;2;1243
3510609;Carapicuíba;4320008;Sapucaia do Sul;1;1;2;808
3516200;Franca;4320008;Sapucaia do Sul;1;1;2;1087
3518800;Guarulhos;4320008;Sapucaia do Sul;1;1;2;830
3524709;Jaguariúna;4320008;Sapucaia do Sul;1;1;2;881
3525904;Jundiaí;4320008;Sapucaia do Sul;1;1;2;838
3529401;Mauá;4320008;Sapucaia do Sul;1;1;2;813
3548708;São Bernardo do Campo;4320008;Sapucaia do Sul;1;1;2;802
3548807;São Caetano do Sul;4320008;Sapucaia do Sul;1;1;2;813
4113700;Londrina;4320008;Sapucaia do Sul;1;1;2;725
4119905;Ponta Grossa;4320008;Sapucaia do Sul;1;1;2;533
4202404;Blumenau;4320008;Sapucaia do Sul;1;1;2;376
4204301;Concórdia;4320008;Sapucaia do Sul;1;1;2;302
4209300;Lages;4320008;Sapucaia do Sul;1;1;2;239
4216602;São José;4320008;Sapucaia do Sul;1;1;2;343
4301057;Arroio do Sal;4320008;Sapucaia do Sul;1;1;2;124
4302105;Bento Gonçalves;4320008;Sapucaia do Sul;1;1;2;83
4302709;Butiá;4320008;Sapucaia do Sul;1;1;2;85
4304630;Capão da Canoa;4320008;Sapucaia do Sul;1;1;2;107
4305108;Caxias do Sul;4320008;Sapucaia do Sul;1;1;2;75
4305355;Charqueadas;4320008;Sapucaia do Sul;1;1;2;48
4306403;Dois Irmãos;4320008;Sapucaia do Sul;1;1;2;29
4307807;Estrela;4320008;Sapucaia do Sul;1;1;2;88
4309308;Guaíba;4320008;Sapucaia do Sul;1;1;2;36
4311627;Lindolfo Collor;4320008;Sapucaia do Sul;1;1;2;28
4311809;Marau;4320008;Sapucaia do Sul;1;1;2;184
4313201;Nova Petrópolis;4320008;Sapucaia do Sul;1;1;2;51
4313375;Nova Santa Rita;4320008;Sapucaia do Sul;1;1;2;13
4313904;Panambi;4320008;Sapucaia do Sul;1;1;2;285
4314423;Picada Café;4320008;Sapucaia do Sul;1;1;2;44
4314803;Portão;4320008;Sapucaia do Sul;1;1;2;18
4316501;Salvador do Sul;4320008;Sapucaia do Sul;1;1;2;57
4316907;Santa Maria;4320008;Sapucaia do Sul;1;1;2;259
4317608;Santo Antônio da Patrulha;4320008;Sapucaia do Sul;1;1;2;60
4318002;São Borja;4320008;Sapucaia do Sul;1;1;2;485
4319505;São Sebastião do Caí;4320008;Sapucaia do Sul;1;1;2;36
4319901;Sapiranga;4320008;Sapucaia do Sul;1;1;2;26
2304400;Fortaleza;4319901;Sapiranga;1;1;2;3078
2313559;Tururu;4319901;Sapiranga;1;1;2;3068
2611606;Recife;4319901;Sapiranga;1;1;2;2793
2912103;Ibicaraí;4319901;Sapiranga;1;1;2;1946
2927408;Salvador;4319901;Sapiranga;1;1;2;2170
3106200;Belo Horizonte;4319901;Sapiranga;1;1;2;1261
3205309;Vitória;4319901;Sapiranga;1;1;2;1441
3304557;Rio de Janeiro;4319901;Sapiranga;1;1;2;1044
3525300;Jaú;4319901;Sapiranga;1;1;2;847
3534401;Osasco;4319901;Sapiranga;1;1;2;784
3548807;São Caetano do Sul;4319901;Sapiranga;1;1;2;788
3552809;Taboão da Serra;4319901;Sapiranga;1;1;2;779
4104204;Campo Largo;4319901;Sapiranga;1;1;2;484
4201406;Araranguá;4319901;Sapiranga;1;1;2;165
4205407;Florianópolis;4319901;Sapiranga;1;1;2;329
4300604;Alvorada;4319901;Sapiranga;1;1;2;40
4304200;Candelária;4319901;Sapiranga;1;1;2;176
4304689;Capela de Santana;4319901;Sapiranga;1;1;2;32
4304705;Carazinho;4319901;Sapiranga;1;1;2;227
4305454;Cidreira;4319901;Sapiranga;1;1;2;95
4306205;Cruzeiro do Sul;4319901;Sapiranga;1;1;2;99
4308102;Feliz;4319901;Sapiranga;1;1;2;36
4310801;Ivoti;4319901;Sapiranga;1;1;2;16
4311403;Lajeado;4319901;Sapiranga;1;1;2;101
4312906;Nova Bassano;4319901;Sapiranga;1;1;2;122
4314407;Pelotas;4319901;Sapiranga;1;1;2;267
4314423;Picada Café;4319901;Sapiranga;1;1;2;25
4315602;Rio Grande;4319901;Sapiranga;1;1;2;295
4316501;Salvador do Sul;4319901;Sapiranga;1;1;2;54
4319802;São Vicente do Sul;4319901;Sapiranga;1;1;2;356
4301602;Bagé;4319802;São Vicente do Sul;1;1;2;191
4303103;Cachoeirinha;4319802;São Vicente do Sul;1;1;2;347
4305207;Cerro Largo;4319802;São Vicente do Sul;1;1;2;170
4311106;Jaguari;4319802;São Vicente do Sul;1;1;2;26
4311759;Manoel Viana;4319802;São Vicente do Sul;1;1;2;79
4318101;São Francisco de Assis;4319802;São Vicente do Sul;1;1;2;47
3518800;Guarulhos;4319752;São Vendelino;1;1;2;800
4304804;Carlos Barbosa;4319752;São Vendelino;1;1;2;15
4305108;Caxias do Sul;4319752;São Vendelino;1;1;2;30
4314902;Porto Alegre;4319752;São Vendelino;1;1;2;78
4310207;Ijuí;4319737;São Valério do Sul;1;1;2;67
3550308;São Paulo;4319711;São Valentim do Sul;1;1;2;771
4306809;Encantado;4319711;São Valentim do Sul;1;1;2;24
4308607;Garibaldi;4319711;São Valentim do Sul;1;1;2;32
4308706;Gaurama;4319711;São Valentim do Sul;1;1;2;165
4309407;Guaporé;4319711;São Valentim do Sul;1;1;2;27
4314605;Piratini;4319711;São Valentim do Sul;1;1;2;297
4301701;Barão de Cotegipe;4319703;São Valentim;1;1;2;16
4305108;Caxias do Sul;4319703;São Valentim;1;1;2;223
4306130;Cruzaltense;4319703;São Valentim;1;1;2;17
4307203;Erval Grande;4319703;São Valentim;1;1;2;19
4308706;Gaurama;4319703;São Valentim;1;1;2;43
4314902;Porto Alegre;4319703;São Valentim;1;1;2;306
4315313;Quatro Irmãos;4319703;São Valentim;1;1;2;31
3534401;Osasco;4319604;São Sepé;1;1;2;972
4106902;Curitiba;4319604;São Sepé;1;1;2;663
4208203;Itajaí;4319604;São Sepé;1;1;2;582
4303103;Cachoeirinha;4319604;São Sepé;1;1;2;240
4304606;Canoas;4319604;São Sepé;1;1;2;233
4304630;Capão da Canoa;4319604;São Sepé;1;1;2;344
4307906;Farroupilha;4319604;São Sepé;1;1;2;240
4308003;Faxinal do Soturno;4319604;São Sepé;1;1;2;68
4309308;Guaíba;4319604;São Sepé;1;1;2;218
4311403;Lajeado;4319604;São Sepé;1;1;2;171
4314001;Paraí;4319604;São Sepé;1;1;2;246
4314803;Portão;4319604;São Sepé;1;1;2;232
4318309;São Gabriel;4319604;São Sepé;1;1;2;70
4318408;São Jerônimo;4319604;São Sepé;1;1;2;182
1100809;Candeias do Jamari;4319505;São Sebastião do Caí;1;1;2;2558
2507507;João Pessoa;4319505;São Sebastião do Caí;1;1;2;2898
2607901;Jaboatão dos Guararapes;4319505;São Sebastião do Caí;1;1;2;2802
2611606;Recife;4319505;São Sebastião do Caí;1;1;2;2807
2927408;Salvador;4319505;São Sebastião do Caí;1;1;2;2184
3304557;Rio de Janeiro;4319505;São Sebastião do Caí;1;1;2;1065
3506003;Bauru;4319505;São Sebastião do Caí;1;1;2;831
3534401;Osasco;4319505;São Sebastião do Caí;1;1;2;798
4106902;Curitiba;4319505;São Sebastião do Caí;1;1;2;501
4303103;Cachoeirinha;4319505;São Sebastião do Caí;1;1;2;47
4304606;Canoas;4319505;São Sebastião do Caí;1;1;2;40
4304689;Capela de Santana;4319505;São Sebastião do Caí;1;1;2;13
4306767;Eldorado do Sul;4319505;São Sebastião do Caí;1;1;2;60
4308607;Garibaldi;4319505;São Sebastião do Caí;1;1;2;40
4310108;Igrejinha;4319505;São Sebastião do Caí;1;1;2;57
4310801;Ivoti;4319505;São Sebastião do Caí;1;1;2;21
4311403;Lajeado;4319505;São Sebastião do Caí;1;1;2;65
4313201;Nova Petrópolis;4319505;São Sebastião do Caí;1;1;2;34
4315008;Porto Lucena;4319505;São Sebastião do Caí;1;1;2;399
4315149;Presidente Lucena;4319505;São Sebastião do Caí;1;1;2;21
4316501;Salvador do Sul;4319505;São Sebastião do Caí;1;1;2;21
4316808;Santa Cruz do Sul;4319505;São Sebastião do Caí;1;1;2;103
4318408;São Jerônimo;4319505;São Sebastião do Caí;1;1;2;53
4318481;São José do Hortêncio;4319505;São Sebastião do Caí;1;1;2;12
3520509;Indaiatuba;4319406;São Pedro do Sul;1;1;2;974
3534401;Osasco;4319406;São Pedro do Sul;1;1;2;970
4300109;Agudo;4319406;São Pedro do Sul;1;1;2;91
4301602;Bagé;4319406;São Pedro do Sul;1;1;2;190
4303103;Cachoeirinha;4319406;São Pedro do Sul;1;1;2;300
4306379;Dilermando de Aguiar;4319406;São Pedro do Sul;1;1;2;10
4311403;Lajeado;4319406;São Pedro do Sul;1;1;2;209
4312104;Mata;4319406;São Pedro do Sul;1;1;2;28
4314100;Passo Fundo;4319406;São Pedro do Sul;1;1;2;229
4315305;Quaraí;4319406;São Pedro do Sul;1;1;2;236
4315321;Quevedos;4319406;São Pedro do Sul;1;1;2;31
4318309;São Gabriel;4319406;São Pedro do Sul;1;1;2;80
4318903;São Luiz Gonzaga;4319372;São Pedro do Butiá;1;1;2;32
4319307;São Paulo das Missões;4319372;São Pedro do Butiá;1;1;2;12
4312401;Montenegro;4319356;São Pedro da Serra;1;1;2;27
4314753;Poço das Antas;4319356;São Pedro da Serra;1;1;2;16
4303103;Cachoeirinha;4319307;São Paulo das Missões;1;1;2;435
4303707;Campina das Missões;4319307;São Paulo das Missões;1;1;2;10
4304309;Cândido Godói;4319307;São Paulo das Missões;1;1;2;20
4313706;Palmeira das Missões;4319307;São Paulo das Missões;1;1;2;159
4314902;Porto Alegre;4319307;São Paulo das Missões;1;1;2;434
4316303;Roque Gonzales;4319307;São Paulo das Missões;1;1;2;15
4308656;Garruchos;4319208;São Nicolau;1;1;2;37
4310207;Ijuí;4319208;São Nicolau;1;1;2;134
4317905;Santo Cristo;4319208;São Nicolau;1;1;2;71
4318903;São Luiz Gonzaga;4319208;São Nicolau;1;1;2;38
4303301;Caibaté;4319158;São Miguel das Missões;1;1;2;29
4313706;Palmeira das Missões;4319158;São Miguel das Missões;1;1;2;141
4314902;Porto Alegre;4319158;São Miguel das Missões;1;1;2;369
4318903;São Luiz Gonzaga;4319158;São Miguel das Missões;1;1;2;44
4125506;São José dos Pinhais;4319125;São Martinho da Serra;1;1;2;628
4306106;Cruz Alta;4319125;São Martinho da Serra;1;1;2;102
4311205;Júlio de Castilhos;4319125;São Martinho da Serra;1;1;2;39
4302204;Boa Vista do Buricá;4319109;São Martinho;1;1;2;15
4303103;Cachoeirinha;4319109;São Martinho;1;1;2;378
4305207;Cerro Largo;4319109;São Martinho;1;1;2;90
4305405;Chiapetta;4319109;São Martinho;1;1;2;24
4306429;Dois Irmãos das Missões;4319109;São Martinho;1;1;2;44
4306734;Doutor Maurício Cardoso;4319109;São Martinho;1;1;2;45
4307450;Esperança do Sul;4319109;São Martinho;1;1;2;39
4309704;Humaitá;4319109;São Martinho;1;1;2;16
4313011;Nova Candelária;4319109;São Martinho;1;1;2;18
4316907;Santa Maria;4319109;São Martinho;1;1;2;221
1709500;Gurupi;4319000;São Marcos;1;1;2;1920
2802106;Estância;4319000;São Marcos;1;1;2;2327
2927408;Salvador;4319000;São Marcos;1;1;2;2117
3154606;Ribeirão das Neves;4319000;São Marcos;1;1;2;1212
3513504;Cubatão;4319000;São Marcos;1;1;2;716
3516200;Franca;4319000;São Marcos;1;1;2;995
3522208;Itapecerica da Serra;4319000;São Marcos;1;1;2;707
3524600;Jacupiranga;4319000;São Marcos;1;1;2;557
3526209;Juquitiba;4319000;São Marcos;1;1;2;676
3530607;Moji das Cruzes;4319000;São Marcos;1;1;2;758
3530805;Moji-Mirim;4319000;São Marcos;1;1;2;822
3534401;Osasco;4319000;São Marcos;1;1;2;727
3538006;Pindamonhangaba;4319000;São Marcos;1;1;2;856
3548500;Santos;4319000;São Marcos;1;1;2;720
4105805;Colombo;4319000;São Marcos;1;1;2;447
4300802;Antônio Prado;4319000;São Marcos;1;1;2;24
4303103;Cachoeirinha;4319000;São Marcos;1;1;2;108
4305355;Charqueadas;4319000;São Marcos;1;1;2;122
4306403;Dois Irmãos;4319000;São Marcos;1;1;2;68
4308201;Flores da Cunha;4319000;São Marcos;1;1;2;13
4311403;Lajeado;4319000;São Marcos;1;1;2;107
4312401;Montenegro;4319000;São Marcos;1;1;2;88
4313409;Novo Hamburgo;4319000;São Marcos;1;1;2;80
4314407;Pelotas;4319000;São Marcos;1;1;2;332
4318408;São Jerônimo;4319000;São Marcos;1;1;2;127
3534401;Osasco;4318903;São Luiz Gonzaga;1;1;2;952
3550308;São Paulo;4318903;São Luiz Gonzaga;1;1;2;956
4300406;Alegrete;4318903;São Luiz Gonzaga;1;1;2;173
4301602;Bagé;4318903;São Luiz Gonzaga;1;1;2;337
4302808;Caçapava do Sul;4318903;São Luiz Gonzaga;1;1;2;276
4303103;Cachoeirinha;4318903;São Luiz Gonzaga;1;1;2;417
4304606;Canoas;4318903;São Luiz Gonzaga;1;1;2;409
4305108;Caxias do Sul;4318903;São Luiz Gonzaga;1;1;2;382
4306106;Cruz Alta;4318903;São Luiz Gonzaga;1;1;2;137
4306353;Dezesseis de Novembro;4318903;São Luiz Gonzaga;1;1;2;23
4307906;Farroupilha;4318903;São Luiz Gonzaga;1;1;2;368
4308656;Garruchos;4318903;São Luiz Gonzaga;1;1;2;70
4309209;Gravataí;4318903;São Luiz Gonzaga;1;1;2;428
4309506;Guarani das Missões;4318903;São Luiz Gonzaga;1;1;2;49
4311403;Lajeado;4318903;São Luiz Gonzaga;1;1;2;311
4314555;Pirapó;4318903;São Luiz Gonzaga;1;1;2;46
4315958;Rolador;4318903;São Luiz Gonzaga;1;1;2;21
4316709;Santa Bárbara do Sul;4318903;São Luiz Gonzaga;1;1;2;168
4316907;Santa Maria;4318903;São Luiz Gonzaga;1;1;2;183
4317905;Santo Cristo;4318903;São Luiz Gonzaga;1;1;2;70
2930709;Simões Filho;4318804;São Lourenço do Sul;1;1;2;2385
3301702;Duque de Caxias;4318804;São Lourenço do Sul;1;1;2;1238
3304557;Rio de Janeiro;4318804;São Lourenço do Sul;1;1;2;1232
3523909;Itu;4318804;São Lourenço do Sul;1;1;2;990
3534401;Osasco;4318804;São Lourenço do Sul;1;1;2;987
4125506;São José dos Pinhais;4318804;São Lourenço do Sul;1;1;2;692
4204301;Concórdia;4318804;São Lourenço do Sul;1;1;2;455
4208203;Itajaí;4318804;São Lourenço do Sul;1;1;2;573
4211751;Otacílio Costa;4318804;São Lourenço do Sul;1;1;2;461
4300638;Amaral Ferrador;4318804;São Lourenço do Sul;1;1;2;54
4301602;Bagé;4318804;São Lourenço do Sul;1;1;2;198
4303103;Cachoeirinha;4318804;São Lourenço do Sul;1;1;2;174
4305173;Cerro Grande do Sul;4318804;São Lourenço do Sul;1;1;2;85
4307906;Farroupilha;4318804;São Lourenço do Sul;1;1;2;241
4311007;Jaguarão;4318804;São Lourenço do Sul;1;1;2;184
4311403;Lajeado;4318804;São Lourenço do Sul;1;1;2;209
4312401;Montenegro;4318804;São Lourenço do Sul;1;1;2;190
4313409;Novo Hamburgo;4318804;São Lourenço do Sul;1;1;2;199
4314100;Passo Fundo;4318804;São Lourenço do Sul;1;1;2;342
4315701;Rio Pardo;4318804;São Lourenço do Sul;1;1;2;160
4316907;Santa Maria;4318804;São Lourenço do Sul;1;1;2;248
4318309;São Gabriel;4318804;São Lourenço do Sul;1;1;2;242
4318705;São Leopoldo;4318804;São Lourenço do Sul;1;1;2;191
2104552;Governador Edison Lobão;4318705;São Leopoldo;1;1;2;2679
2403251;Parnamirim;4318705;São Leopoldo;1;1;2;3005
2602902;Cabo de Santo Agostinho;4318705;São Leopoldo;1;1;2;2791
2611606;Recife;4318705;São Leopoldo;1;1;2;2810
2615706;Triunfo;4318705;São Leopoldo;1;1;2;2699
2909802;Cruz das Almas;4318705;São Leopoldo;1;1;2;2185
2910800;Feira de Santana;4318705;São Leopoldo;1;1;2;2230
2919207;Lauro de Freitas;4318705;São Leopoldo;1;1;2;2205
2925758;Presidente Tancredo Neves;4318705;São Leopoldo;1;1;2;2100
2927408;Salvador;4318705;São Leopoldo;1;1;2;2188
2930709;Simões Filho;4318705;São Leopoldo;1;1;2;2210
3106200;Belo Horizonte;4318705;São Leopoldo;1;1;2;1279
3140704;Mateus Leme;4318705;São Leopoldo;1;1;2;1250
3205002;Serra;4318705;São Leopoldo;1;1;2;1468
3302403;Macaé;4318705;São Leopoldo;1;1;2;1193
3504107;Atibaia;4318705;São Leopoldo;1;1;2;853
3513801;Diadema;4318705;São Leopoldo;1;1;2;797
3515004;Embu;4318705;São Leopoldo;1;1;2;789
3525300;Jaú;4318705;São Leopoldo;1;1;2;864
3527108;Lins;4318705;São Leopoldo;1;1;2;904
3529401;Mauá;4318705;São Leopoldo;1;1;2;806
3530607;Moji das Cruzes;4318705;São Leopoldo;1;1;2;831
3543303;Ribeirão Pires;4318705;São Leopoldo;1;1;2;805
3548708;São Bernardo do Campo;4318705;São Leopoldo;1;1;2;795
3548807;São Caetano do Sul;4318705;São Leopoldo;1;1;2;806
3549904;São José dos Campos;4318705;São Leopoldo;1;1;2;879
3552205;Sorocaba;4318705;São Leopoldo;1;1;2;775
4101804;Araucária;4318705;São Leopoldo;1;1;2;491
4104808;Cascavel;4318705;São Leopoldo;1;1;2;576
4108403;Francisco Beltrão;4318705;São Leopoldo;1;1;2;446
4113700;Londrina;4318705;São Leopoldo;1;1;2;716
4115200;Maringá;4318705;São Leopoldo;1;1;2;705
4118501;Pato Branco;4318705;São Leopoldo;1;1;2;417
4201307;Araquari;4318705;São Leopoldo;1;1;2;437
4201406;Araranguá;4318705;São Leopoldo;1;1;2;183
4202008;Balneário Camboriú;4318705;São Leopoldo;1;1;2;387
4202404;Blumenau;4318705;São Leopoldo;1;1;2;369
4202800;Braço do Norte;4318705;São Leopoldo;1;1;2;252
4205407;Florianópolis;4318705;São Leopoldo;1;1;2;348
4205704;Garopaba;4318705;São Leopoldo;1;1;2;307
4207106;Ilhota;4318705;São Leopoldo;1;1;2;387
4209300;Lages;4318705;São Leopoldo;1;1;2;230
4215109;Rodeio;4318705;São Leopoldo;1;1;2;357
4217204;São Miguel do Oeste;4318705;São Leopoldo;1;1;2;409
4300406;Alegrete;4318705;São Leopoldo;1;1;2;446
4301057;Arroio do Sal;4318705;São Leopoldo;1;1;2;123
4301305;Arroio Grande;4318705;São Leopoldo;1;1;2;331
4301909;Barra do Ribeiro;4318705;São Leopoldo;1;1;2;62
4302352;Bom Princípio;4318705;São Leopoldo;1;1;2;36
4304408;Canela;4318705;São Leopoldo;1;1;2;57
4305454;Cidreira;4318705;São Leopoldo;1;1;2;99
4306106;Cruz Alta;4318705;São Leopoldo;1;1;2;266
4306809;Encantado;4318705;São Leopoldo;1;1;2;94
4309407;Guaporé;4318705;São Leopoldo;1;1;2;125
4311205;Júlio de Castilhos;4318705;São Leopoldo;1;1;2;252
4311809;Marau;4318705;São Leopoldo;1;1;2;177
4312252;Minas do Leão;4318705;São Leopoldo;1;1;2;96
4312476;Morro Reuter;4318705;São Leopoldo;1;1;2;25
4313060;Nova Hartz;4318705;São Leopoldo;1;1;2;31
4313706;Palmeira das Missões;4318705;São Leopoldo;1;1;2;293
4315701;Rio Pardo;4318705;São Leopoldo;1;1;2;119
4316006;Rolante;4318705;São Leopoldo;1;1;2;57
4317103;Santana do Livramento;4318705;São Leopoldo;1;1;2;440
4317202;Santa Rosa;4318705;São Leopoldo;1;1;2;380
4318200;São Francisco de Paula;4318705;São Leopoldo;1;1;2;64
4318309;São Gabriel;4318705;São Leopoldo;1;1;2;312
4204608;Criciúma;4318622;São José dos Ausentes;1;1;2;67
4218806;Turvo;4318622;São José dos Ausentes;1;1;2;43
4314902;Porto Alegre;4318622;São José dos Ausentes;1;1;2;183
4311791;Maratá;4318614;São José do Sul;1;1;2;8
4314902;Porto Alegre;4318614;São José do Sul;1;1;2;65
4118204;Paranaguá;4318606;São José do Ouro;1;1;2;383
4212908;Pinhalzinho;4318606;São José do Ouro;1;1;2;171
4305108;Caxias do Sul;4318606;São José do Ouro;1;1;2;160
4307005;Erechim;4318606;São José do Ouro;1;1;2;69
4310462;Ipiranga do Sul;4318606;São José do Ouro;1;1;2;84
4314100;Passo Fundo;4318606;São José do Ouro;1;1;2;96
4317954;Santo Expedito do Sul;4318606;São José do Ouro;1;1;2;16
4318424;São João da Urtiga;4318606;São José do Ouro;1;1;2;24
3534401;Osasco;4318507;São José do Norte;1;1;2;1053
3545308;Salto de Pirapora;4318507;São José do Norte;1;1;2;1011
4209409;Laguna;4318507;São José do Norte;1;1;2;491
4304606;Canoas;4318507;São José do Norte;1;1;2;245
4306908;Encruzilhada do Sul;4318507;São José do Norte;1;1;2;172
4309209;Gravataí;4318507;São José do Norte;1;1;2;249
4313656;Palmares do Sul;4318507;São José do Norte;1;1;2;241
4314100;Passo Fundo;4318507;São José do Norte;1;1;2;417
4314407;Pelotas;4318507;São José do Norte;1;1;2;44
4314902;Porto Alegre;4318499;São José do Inhacorá;1;1;2;390
4302659;Brochier;4318481;São José do Hortêncio;1;1;2;34
4313201;Nova Petrópolis;4318481;São José do Hortêncio;1;1;2;22
4314035;Pareci Novo;4318481;São José do Hortêncio;1;1;2;19
4314050;Parobé;4318481;São José do Hortêncio;1;1;2;44
4314423;Picada Café;4318481;São José do Hortêncio;1;1;2;16
4314803;Portão;4318481;São José do Hortêncio;1;1;2;20
4316501;Salvador do Sul;4318481;São José do Hortêncio;1;1;2;25
3518305;Guararema;4318465;São José do Herval;1;1;2;861
4314902;Porto Alegre;4318465;São José do Herval;1;1;2;155
4305801;Constantina;4318457;São José das Missões;1;1;2;14
4312955;Nova Boa Vista;4318457;São José das Missões;1;1;2;28
4313490;Novo Barreiro;4318457;São José das Missões;1;1;2;14
4316428;Sagrada Família;4318457;São José das Missões;1;1;2;8
4305108;Caxias do Sul;4318440;São Jorge;1;1;2;90
4314001;Paraí;4318440;São Jorge;1;1;2;13
3550308;São Paulo;4318432;São João do Polêsine;1;1;2;920
4212908;Pinhalzinho;4318432;São João do Polêsine;1;1;2;310
4300109;Agudo;4318432;São João do Polêsine;1;1;2;20
4306700;Dona Francisca;4318432;São João do Polêsine;1;1;2;8
4308003;Faxinal do Soturno;4318432;São João do Polêsine;1;1;2;4
4206702;Herval d'Oeste;4318424;São João da Urtiga;1;1;2;77
4215505;Santa Cecília;4318424;São João da Urtiga;1;1;2;163
4311304;Lagoa Vermelha;4318424;São João da Urtiga;1;1;2;52
4313607;Paim Filho;4318424;São João da Urtiga;1;1;2;14
3301702;Duque de Caxias;4318408;São Jerônimo;1;1;2;1120
3534401;Osasco;4318408;São Jerônimo;1;1;2;849
3550308;São Paulo;4318408;São Jerônimo;1;1;2;845
4207007;Içara;4318408;São Jerônimo;1;1;2;270
4215455;Sangão;4318408;São Jerônimo;1;1;2;289
4300109;Agudo;4318408;São Jerônimo;1;1;2;150
4301008;Arroio do Meio;4318408;São Jerônimo;1;1;2;65
4301057;Arroio do Sal;4318408;São Jerônimo;1;1;2;181
4301404;Arvorezinha;4318408;São Jerônimo;1;1;2;128
4301636;Balneário Pinhal;4318408;São Jerônimo;1;1;2;145
4301909;Barra do Ribeiro;4318408;São Jerônimo;1;1;2;55
4302352;Bom Princípio;4318408;São Jerônimo;1;1;2;63
4302402;Bom Retiro do Sul;4318408;São Jerônimo;1;1;2;44
4302659;Brochier;4318408;São Jerônimo;1;1;2;47
4304507;Canguçu;4318408;São Jerônimo;1;1;2;186
4304630;Capão da Canoa;4318408;São Jerônimo;1;1;2;163
4304689;Capela de Santana;4318408;São Jerônimo;1;1;2;48
4304705;Carazinho;4318408;São Jerônimo;1;1;2;211
4304804;Carlos Barbosa;4318408;São Jerônimo;1;1;2;76
4305454;Cidreira;4318408;São Jerônimo;1;1;2;146
4306205;Cruzeiro do Sul;4318408;São Jerônimo;1;1;2;58
4306403;Dois Irmãos;4318408;São Jerônimo;1;1;2;74
4306502;Dom Feliciano;4318408;São Jerônimo;1;1;2;91
4306601;Dom Pedrito;4318408;São Jerônimo;1;1;2;306
4306809;Encantado;4318408;São Jerônimo;1;1;2;83
4306908;Encruzilhada do Sul;4318408;São Jerônimo;1;1;2;101
4307609;Estância Velha;4318408;São Jerônimo;1;1;2;63
4307807;Estrela;4318408;São Jerônimo;1;1;2;56
4308102;Feliz;4318408;São Jerônimo;1;1;2;69
4308201;Flores da Cunha;4318408;São Jerônimo;1;1;2;115
4308607;Garibaldi;4318408;São Jerônimo;1;1;2;80
4309050;Glorinha;4318408;São Jerônimo;1;1;2;93
4309100;Gramado;4318408;São Jerônimo;1;1;2;100
4310108;Igrejinha;4318408;São Jerônimo;1;1;2;99
4310330;Imbé;4318408;São Jerônimo;1;1;2;152
4310801;Ivoti;4318408;São Jerônimo;1;1;2;68
4312252;Minas do Leão;4318408;São Jerônimo;1;1;2;37
4313060;Nova Hartz;4318408;São Jerônimo;1;1;2;89
4313201;Nova Petrópolis;4318408;São Jerônimo;1;1;2;87
4313953;Pantano Grande;4318408;São Jerônimo;1;1;2;68
4314050;Parobé;4318408;São Jerônimo;1;1;2;93
4314159;Paverama;4318408;São Jerônimo;1;1;2;45
4314803;Portão;4318408;São Jerônimo;1;1;2;54
4315602;Rio Grande;4318408;São Jerônimo;1;1;2;240
4316006;Rolante;4318408;São Jerônimo;1;1;2;116
4317103;Santana do Livramento;4318408;São Jerônimo;1;1;2;379
4317608;Santo Antônio da Patrulha;4318408;São Jerônimo;1;1;2;117
4318200;São Francisco de Paula;4318408;São Jerônimo;1;1;2;123
4318309;São Gabriel;4318408;São Jerônimo;1;1;2;252
3304557;Rio de Janeiro;4318309;São Gabriel;1;1;2;1318
3534401;Osasco;4318309;São Gabriel;1;1;2;1028
3541604;Promissão;4318309;São Gabriel;1;1;2;1058
4106902;Curitiba;4318309;São Gabriel;1;1;2;718
4205902;Gaspar;4318309;São Gabriel;1;1;2;630
4303004;Cachoeira do Sul;4318309;São Gabriel;1;1;2;138
4303103;Cachoeirinha;4318309;São Gabriel;1;1;2;308
4305108;Caxias do Sul;4318309;São Gabriel;1;1;2;325
4306809;Encantado;4318309;São Gabriel;1;1;2;259
4307708;Esteio;4318309;São Gabriel;1;1;2;304
4309308;Guaíba;4318309;São Gabriel;1;1;2;285
4309605;Horizontina;4318309;São Gabriel;1;1;2;300
4310603;Itaqui;4318309;São Gabriel;1;1;2;249
4313904;Panambi;4318309;São Gabriel;1;1;2;240
4317202;Santa Rosa;4318309;São Gabriel;1;1;2;274
4317509;Santo Ângelo;4318309;São Gabriel;1;1;2;225
4318002;São Borja;4318309;São Gabriel;1;1;2;247
3534401;Osasco;4318200;São Francisco de Paula;1;1;2;747
3549102;São João da Boa Vista;4318200;São Francisco de Paula;1;1;2;902
3550308;São Paulo;4318200;São Francisco de Paula;1;1;2;742
4119905;Ponta Grossa;4318200;São Francisco de Paula;1;1;2;483
4302105;Bento Gonçalves;4318200;São Francisco de Paula;1;1;2;95
4302303;Bom Jesus;4318200;São Francisco de Paula;1;1;2;87
4303103;Cachoeirinha;4318200;São Francisco de Paula;1;1;2;76
4304630;Capão da Canoa;4318200;São Francisco de Paula;1;1;2;63
4307708;Esteio;4318200;São Francisco de Paula;1;1;2;73
4307906;Farroupilha;4318200;São Francisco de Paula;1;1;2;77
4308201;Flores da Cunha;4318200;São Francisco de Paula;1;1;2;74
4308607;Garibaldi;4318200;São Francisco de Paula;1;1;2;95
4310108;Igrejinha;4318200;São Francisco de Paula;1;1;2;24
4311403;Lajeado;4318200;São Francisco de Paula;1;1;2;140
4313201;Nova Petrópolis;4318200;São Francisco de Paula;1;1;2;52
4313409;Novo Hamburgo;4318200;São Francisco de Paula;1;1;2;59
4314050;Parobé;4318200;São Francisco de Paula;1;1;2;32
3109402;Buritizeiro;4318101;São Francisco de Assis;1;1;2;1645
3534401;Osasco;4318101;São Francisco de Assis;1;1;2;1033
4301602;Bagé;4318101;São Francisco de Assis;1;1;2;222
4303103;Cachoeirinha;4318101;São Francisco de Assis;1;1;2;393
4311403;Lajeado;4318101;São Francisco de Assis;1;1;2;302
4313037;Nova Esperança do Sul;4318101;São Francisco de Assis;1;1;2;34
4316402;Rosário do Sul;4318101;São Francisco de Assis;1;1;2;81
4318002;São Borja;4318101;São Francisco de Assis;1;1;2;130
4304903;Casca;4318051;São Domingos do Sul;1;1;2;9
4308854;Gentil;4318051;São Domingos do Sul;1;1;2;18
4314902;Porto Alegre;4318051;São Domingos do Sul;1;1;2;182
2919553;Luís Eduardo magalhães;4318002;São Borja;1;1;2;2061
3103504;Araguari;4318002;São Borja;1;1;2;1330
3125101;Extrema;4318002;São Borja;1;1;2;1126
3303500;Nova Iguaçu;4318002;São Borja;1;1;2;1363
3304557;Rio de Janeiro;4318002;São Borja;1;1;2;1375
3523206;Itararé;4318002;São Borja;1;1;2;814
3524600;Jacupiranga;4318002;São Borja;1;1;2;886
3534401;Osasco;4318002;São Borja;1;1;2;1049
3534708;Ourinhos;4318002;São Borja;1;1;2;857
3542602;Registro;4318002;São Borja;1;1;2;905
4101804;Araucária;4318002;São Borja;1;1;2;722
4102604;Barracão;4318002;São Borja;1;1;2;354
4118501;Pato Branco;4318002;São Borja;1;1;2;421
4125506;São José dos Pinhais;4318002;São Borja;1;1;2;743
4302501;Bossoroca;4318002;São Borja;1;1;2;109
4303004;Cachoeira do Sul;4318002;São Borja;1;1;2;339
4303103;Cachoeirinha;4318002;São Borja;1;1;2;502
4303509;Camaquã;4318002;São Borja;1;1;2;480
4307609;Estância Velha;4318002;São Borja;1;1;2;487
4307708;Esteio;4318002;São Borja;1;1;2;493
4307906;Farroupilha;4318002;São Borja;1;1;2;462
4308656;Garruchos;4318002;São Borja;1;1;2;64
4309605;Horizontina;4318002;São Borja;1;1;2;201
4311403;Lajeado;4318002;São Borja;1;1;2;400
4312401;Montenegro;4318002;São Borja;1;1;2;457
4316402;Rosário do Sul;4318002;São Borja;1;1;2;206
4307005;Erechim;4317954;Santo Expedito do Sul;1;1;2;69
4314902;Porto Alegre;4317954;Santo Expedito do Sul;1;1;2;242
4316600;Sananduva;4317954;Santo Expedito do Sul;1;1;2;17
4305108;Caxias do Sul;4317905;Santo Cristo;1;1;2;376
4306106;Cruz Alta;4317905;Santo Cristo;1;1;2;139
4309001;Giruá;4317905;Santo Cristo;1;1;2;39
4309506;Guarani das Missões;4317905;Santo Cristo;1;1;2;37
4309605;Horizontina;4317905;Santo Cristo;1;1;2;41
4310603;Itaqui;4317905;Santo Cristo;1;1;2;237
4311403;Lajeado;4317905;Santo Cristo;1;1;2;317
4314100;Passo Fundo;4317905;Santo Cristo;1;1;2;229
4315107;Porto Xavier;4317905;Santo Cristo;1;1;2;48
4316402;Rosário do Sul;4317905;Santo Cristo;1;1;2;272
3534401;Osasco;4317806;Santo Augusto;1;1;2;828
4125506;São José dos Pinhais;4317806;Santo Augusto;1;1;2;516
4300455;Alegria;4317806;Santo Augusto;1;1;2;28
4303103;Cachoeirinha;4317806;Santo Augusto;1;1;2;352
4305108;Caxias do Sul;4317806;Santo Augusto;1;1;2;296
4305207;Cerro Largo;4317806;Santo Augusto;1;1;2;100
4305900;Coronel Bicaco;4317806;Santo Augusto;1;1;2;17
4306007;Crissiumal;4317806;Santo Augusto;1;1;2;50
4306767;Eldorado do Sul;4317806;Santo Augusto;1;1;2;328
4309001;Giruá;4317806;Santo Augusto;1;1;2;60
4309605;Horizontina;4317806;Santo Augusto;1;1;2;58
4311403;Lajeado;4317806;Santo Augusto;1;1;2;247
4312302;Miraguaí;4317806;Santo Augusto;1;1;2;39
4313904;Panambi;4317806;Santo Augusto;1;1;2;55
4203006;Caçador;4317756;Santo Antônio do Planalto;1;1;2;236
4305306;Chapada;4317756;Santo Antônio do Planalto;1;1;2;53
4302501;Bossoroca;4317707;Santo Antônio das Missões;1;1;2;40
4303103;Cachoeirinha;4317707;Santo Antônio das Missões;1;1;2;436
4308656;Garruchos;4317707;Santo Antônio das Missões;1;1;2;54
4309506;Guarani das Missões;4317707;Santo Antônio das Missões;1;1;2;77
4310553;Itacurubi;4317707;Santo Antônio das Missões;1;1;2;31
4314100;Passo Fundo;4317707;Santo Antônio das Missões;1;1;2;278
4317202;Santa Rosa;4317707;Santo Antônio das Missões;1;1;2;103
2927408;Salvador;4317608;Santo Antônio da Patrulha;1;1;2;2163
3149903;Perdões;4317608;Santo Antônio da Patrulha;1;1;2;1091
3304557;Rio de Janeiro;4317608;Santo Antônio da Patrulha;1;1;2;1027
3534401;Osasco;4317608;Santo Antônio da Patrulha;1;1;2;779
3550308;São Paulo;4317608;Santo Antônio da Patrulha;1;1;2;774
3552205;Sorocaba;4317608;Santo Antônio da Patrulha;1;1;2;757
4210605;Massaranduba;4317608;Santo Antônio da Patrulha;1;1;2;383
4213807;Praia Grande;4317608;Santo Antônio da Patrulha;1;1;2;88
4218806;Turvo;4317608;Santo Antônio da Patrulha;1;1;2;128
4303509;Camaquã;4317608;Santo Antônio da Patrulha;1;1;2;169
4304630;Capão da Canoa;4317608;Santo Antônio da Patrulha;1;1;2;47
4307906;Farroupilha;4317608;Santo Antônio da Patrulha;1;1;2;103
4309050;Glorinha;4317608;Santo Antônio da Patrulha;1;1;2;25
4310108;Igrejinha;4317608;Santo Antônio da Patrulha;1;1;2;38
4311403;Lajeado;4317608;Santo Antônio da Patrulha;1;1;2;152
4312500;Mostardas;4317608;Santo Antônio da Patrulha;1;1;2;148
4313409;Novo Hamburgo;4317608;Santo Antônio da Patrulha;1;1;2;60
4313656;Palmares do Sul;4317608;Santo Antônio da Patrulha;1;1;2;49
4314100;Passo Fundo;4317608;Santo Antônio da Patrulha;1;1;2;250
4314407;Pelotas;4317608;Santo Antônio da Patrulha;1;1;2;278
4208203;Itajaí;4317558;Santo Antônio do Palma;1;1;2;362
4300059;Água Santa;4317558;Santo Antônio do Palma;1;1;2;35
4311809;Marau;4317558;Santo Antônio do Palma;1;1;2;18
4312674;Nicolau Vergueiro;4317558;Santo Antônio do Palma;1;1;2;43
2306306;Itapagé;4317509;Santo Ângelo;1;1;2;3042
2927408;Salvador;4317509;Santo Ângelo;1;1;2;2246
2928901;São Desidério;4317509;Santo Ângelo;1;1;2;1965
3170206;Uberlândia;4317509;Santo Ângelo;1;1;2;1186
3516200;Franca;4317509;Santo Ângelo;1;1;2;1080
3534401;Osasco;4317509;Santo Ângelo;1;1;2;892
4108304;Foz do Iguaçu;4317509;Santo Ângelo;1;1;2;310
4113700;Londrina;4317509;Santo Ângelo;1;1;2;630
4202107;Barra Velha;4317509;Santo Ângelo;1;1;2;571
4204608;Criciúma;4317509;Santo Ângelo;1;1;2;482
4300406;Alegrete;4317509;Santo Ângelo;1;1;2;221
4301503;Augusto Pestana;4317509;Santo Ângelo;1;1;2;36
4301602;Bagé;4317509;Santo Ângelo;1;1;2;336
4303004;Cachoeira do Sul;4317509;Santo Ângelo;1;1;2;231
4303509;Camaquã;4317509;Santo Ângelo;1;1;2;372
4304309;Cândido Godói;4317509;Santo Ângelo;1;1;2;61
4304705;Carazinho;4317509;Santo Ângelo;1;1;2;146
4306601;Dom Pedrito;4317509;Santo Ângelo;1;1;2;298
4306767;Eldorado do Sul;4317509;Santo Ângelo;1;1;2;328
4307708;Esteio;4317509;Santo Ângelo;1;1;2;350
4309605;Horizontina;4317509;Santo Ângelo;1;1;2;75
4310553;Itacurubi;4317509;Santo Ângelo;1;1;2;110
4310603;Itaqui;4317509;Santo Ângelo;1;1;2;242
4313706;Palmeira das Missões;4317509;Santo Ângelo;1;1;2;103
4315107;Porto Xavier;4317509;Santo Ângelo;1;1;2;96
4315305;Quaraí;4317509;Santo Ângelo;1;1;2;315
4316477;Salvador das Missões;4317509;Santo Ângelo;1;1;2;59
3534401;Osasco;4317400;Santiago;1;1;2;990
3550308;São Paulo;4317400;Santiago;1;1;2;993
4106902;Curitiba;4317400;Santiago;1;1;2;676
4303509;Camaquã;4317400;Santiago;1;1;2;350
4305108;Caxias do Sul;4317400;Santiago;1;1;2;359
4306106;Cruz Alta;4317400;Santiago;1;1;2;138
4307708;Esteio;4317400;Santiago;1;1;2;367
4310553;Itacurubi;4317400;Santiago;1;1;2;59
4311403;Lajeado;4317400;Santiago;1;1;2;277
4311759;Manoel Viana;4317400;Santiago;1;1;2;73
4317301;Santa Vitória do Palmar;4317400;Santiago;1;1;2;500
3534302;Orlândia;4317301;Santa Vitória do Palmar;1;1;2;1498
3550308;São Paulo;4317301;Santa Vitória do Palmar;1;1;2;1247
4301305;Arroio Grande;4317301;Santa Vitória do Palmar;1;1;2;147
4301602;Bagé;4317301;Santa Vitória do Palmar;1;1;2;250
4303103;Cachoeirinha;4317301;Santa Vitória do Palmar;1;1;2;448
4304507;Canguçu;4317301;Santa Vitória do Palmar;1;1;2;243
4304804;Carlos Barbosa;4317251;Santa Tereza;1;1;2;27
3304557;Rio de Janeiro;4317202;Santa Rosa;1;1;2;1214
3505708;Barueri;4317202;Santa Rosa;1;1;2;878
3509502;Campinas;4317202;Santa Rosa;1;1;2;902
3513801;Diadema;4317202;Santa Rosa;1;1;2;889
3516200;Franca;4317202;Santa Rosa;1;1;2;1056
3534401;Osasco;4317202;Santa Rosa;1;1;2;884
3548708;São Bernardo do Campo;4317202;Santa Rosa;1;1;2;890
4204202;Chapecó;4317202;Santa Rosa;1;1;2;199
4204301;Concórdia;4317202;Santa Rosa;1;1;2;250
4208203;Itajaí;4317202;Santa Rosa;1;1;2;569
4208906;Jaraguá do Sul;4317202;Santa Rosa;1;1;2;549
4213500;Porto Belo;4317202;Santa Rosa;1;1;2;583
4216909;São Lourenço do Oeste;4317202;Santa Rosa;1;1;2;226
4300406;Alegrete;4317202;Santa Rosa;1;1;2;249
4301602;Bagé;4317202;Santa Rosa;1;1;2;386
4302204;Boa Vista do Buricá;4317202;Santa Rosa;1;1;2;41
4303004;Cachoeira do Sul;4317202;Santa Rosa;1;1;2;282
4303509;Camaquã;4317202;Santa Rosa;1;1;2;422
4304408;Canela;4317202;Santa Rosa;1;1;2;397
4306007;Crissiumal;4317202;Santa Rosa;1;1;2;54
4307831;Eugênio de Castro;4317202;Santa Rosa;1;1;2;79
4308508;Frederico Westphalen;4317202;Santa Rosa;1;1;2;119
4308706;Gaurama;4317202;Santa Rosa;1;1;2;235
4309209;Gravataí;4317202;Santa Rosa;1;1;2;415
4310413;Inhacorá;4317202;Santa Rosa;1;1;2;44
4311809;Marau;4317202;Santa Rosa;1;1;2;232
4313409;Novo Hamburgo;4317202;Santa Rosa;1;1;2;388
4313706;Palmeira das Missões;4317202;Santa Rosa;1;1;2;112
4315073;Porto Vera Cruz;4317202;Santa Rosa;1;1;2;46
4315107;Porto Xavier;4317202;Santa Rosa;1;1;2;67
4315701;Rio Pardo;4317202;Santa Rosa;1;1;2;307
4316402;Rosário do Sul;4317202;Santa Rosa;1;1;2;270
4316477;Salvador das Missões;4317202;Santa Rosa;1;1;2;47
2304400;Fortaleza;4317103;Santana do Livramento;1;1;2;3359
3106200;Belo Horizonte;4317103;Santana do Livramento;1;1;2;1607
3118601;Contagem;4317103;Santana do Livramento;1;1;2;1599
3205002;Serra;4317103;Santana do Livramento;1;1;2;1829
3304557;Rio de Janeiro;4317103;Santana do Livramento;1;1;2;1434
3534401;Osasco;4317103;Santana do Livramento;1;1;2;1143
3548500;Santos;4317103;Santana do Livramento;1;1;2;1146
4109807;Ibiporã;4317103;Santana do Livramento;1;1;2;936
4118501;Pato Branco;4317103;Santana do Livramento;1;1;2;578
4202008;Balneário Camboriú;4317103;Santana do Livramento;1;1;2;770
4211603;Nova Veneza;4317103;Santana do Livramento;1;1;2;618
4300034;Aceguá;4317103;Santana do Livramento;1;1;2;170
4302907;Cacequi;4317103;Santana do Livramento;1;1;2;124
4303004;Cachoeira do Sul;4317103;Santana do Livramento;1;1;2;264
4303509;Camaquã;4317103;Santana do Livramento;1;1;2;352
4304507;Canguçu;4317103;Santana do Livramento;1;1;2;276
4305108;Caxias do Sul;4317103;Santana do Livramento;1;1;2;451
4305207;Cerro Largo;4317103;Santana do Livramento;1;1;2;309
4307708;Esteio;4317103;Santana do Livramento;1;1;2;426
4307807;Estrela;4317103;Santana do Livramento;1;1;2;367
4308607;Garibaldi;4317103;Santana do Livramento;1;1;2;415
4311007;Jaguarão;4317103;Santana do Livramento;1;1;2;281
4311403;Lajeado;4317103;Santana do Livramento;1;1;2;365
4313409;Novo Hamburgo;4317103;Santana do Livramento;1;1;2;435
4314076;Passo do Sobrado;4317103;Santana do Livramento;1;1;2;330
4306908;Encruzilhada do Sul;4317004;Santana da Boa Vista;1;1;2;67
4316907;Santa Maria;4317004;Santana da Boa Vista;1;1;2;146
4300406;Alegrete;4316972;Santa Margarida do Sul;1;1;2;170
4310009;Ibirubá;4316972;Santa Margarida do Sul;1;1;2;212
4302659;Brochier;4316956;Santa Maria do Herval;1;1;2;61
4313409;Novo Hamburgo;4316956;Santa Maria do Herval;1;1;2;25
4314423;Picada Café;4316956;Santa Maria do Herval;1;1;2;15
1400100;Boa Vista;4316907;Santa Maria;1;1;2;3656
1709500;Gurupi;4316907;Santa Maria;1;1;2;2038
2109700;Sambaíba;4316907;Santa Maria;1;1;2;2612
2306306;Itapagé;4316907;Santa Maria;1;1;2;3154
2611606;Recife;4316907;Santa Maria;1;1;2;2940
2903201;Barreiras;4316907;Santa Maria;1;1;2;2097
2927408;Salvador;4316907;Santa Maria;1;1;2;2321
3106705;Betim;4316907;Santa Maria;1;1;2;1402
3118304;Conselheiro Lafaiete;4316907;Santa Maria;1;1;2;1368
3127701;Governador Valadares;4316907;Santa Maria;1;1;2;1630
3170206;Uberlândia;4316907;Santa Maria;1;1;2;1302
3205309;Vitória;4316907;Santa Maria;1;1;2;1637
3303302;Niterói;4316907;Santa Maria;1;1;2;1259
3543907;Rio Claro;4316907;Santa Maria;1;1;2;998
3549805;São José do Rio Preto;4316907;Santa Maria;1;1;2;1066
4104808;Cascavel;4316907;Santa Maria;1;1;2;528
4105805;Colombo;4316907;Santa Maria;1;1;2;656
4108304;Foz do Iguaçu;4316907;Santa Maria;1;1;2;468
4125506;São José dos Pinhais;4316907;Santa Maria;1;1;2;637
4127700;Toledo;4316907;Santa Maria;1;1;2;551
4205902;Gaspar;4316907;Santa Maria;1;1;2;556
4207007;Içara;4316907;Santa Maria;1;1;2;449
4207700;Ipumirim;4316907;Santa Maria;1;1;2;332
4208450;Itapoá;4316907;Santa Maria;1;1;2;632
4209854;Lindóia do Sul;4316907;Santa Maria;1;1;2;338
4211603;Nova Veneza;4316907;Santa Maria;1;1;2;432
4216602;São José;4316907;Santa Maria;1;1;2;545
4216909;São Lourenço do Oeste;4316907;Santa Maria;1;1;2;379
4219507;Xanxerê;4316907;Santa Maria;1;1;2;342
4300604;Alvorada;4316907;Santa Maria;1;1;2;267
4302105;Bento Gonçalves;4316907;Santa Maria;1;1;2;231
4302303;Bom Jesus;4316907;Santa Maria;1;1;2;346
4303509;Camaquã;4316907;Santa Maria;1;1;2;233
4303905;Campo Bom;4316907;Santa Maria;1;1;2;268
4304507;Canguçu;4316907;Santa Maria;1;1;2;219
4304630;Capão da Canoa;4316907;Santa Maria;1;1;2;366
4305355;Charqueadas;4316907;Santa Maria;1;1;2;214
4306379;Dilermando de Aguiar;4316907;Santa Maria;1;1;2;38
4306809;Encantado;4316907;Santa Maria;1;1;2;192
4306908;Encruzilhada do Sul;4316907;Santa Maria;1;1;2;152
4307609;Estância Velha;4316907;Santa Maria;1;1;2;256
4308508;Frederico Westphalen;4316907;Santa Maria;1;1;2;262
4308607;Garibaldi;4316907;Santa Maria;1;1;2;226
4309209;Gravataí;4316907;Santa Maria;1;1;2;275
4310009;Ibirubá;4316907;Santa Maria;1;1;2;138
4311502;Lavras do Sul;4316907;Santa Maria;1;1;2;124
4312252;Minas do Leão;4316907;Santa Maria;1;1;2;178
4312807;Nova Araçá;4316907;Santa Maria;1;1;2;231
4314605;Piratini;4316907;Santa Maria;1;1;2;206
4314803;Portão;4316907;Santa Maria;1;1;2;249
4316451;Salto do Jacuí;4316907;Santa Maria;1;1;2;89
4316501;Salvador do Sul;4316907;Santa Maria;1;1;2;225
4316600;Sananduva;4316907;Santa Maria;1;1;2;274
4316709;Santa Bárbara do Sul;4316907;Santa Maria;1;1;2;159
2111300;São Luís;4316808;Santa Cruz do Sul;1;1;2;3099
2304400;Fortaleza;4316808;Santa Cruz do Sul;1;1;2;3136
2504009;Campina Grande;4316808;Santa Cruz do Sul;1;1;2;2908
2507507;João Pessoa;4316808;Santa Cruz do Sul;1;1;2;2960
2602902;Cabo de Santo Agostinho;4316808;Santa Cruz do Sul;1;1;2;2851
2607752;Itapissuma;4316808;Santa Cruz do Sul;1;1;2;2902
2607901;Jaboatão dos Guararapes;4316808;Santa Cruz do Sul;1;1;2;2866
2802106;Estância;4316808;Santa Cruz do Sul;1;1;2;2458
2930501;Serrinha;4316808;Santa Cruz do Sul;1;1;2;2345
2933307;Vitória da Conquista;4316808;Santa Cruz do Sul;1;1;2;1958
3136652;Juatuba;4316808;Santa Cruz do Sul;1;1;2;1318
3167202;Sete Lagoas;4316808;Santa Cruz do Sul;1;1;2;1370
3306008;Três Rios;4316808;Santa Cruz do Sul;1;1;2;1209
3507506;Botucatu;4316808;Santa Cruz do Sul;1;1;2;846
3513504;Cubatão;4316808;Santa Cruz do Sul;1;1;2;859
3513801;Diadema;4316808;Santa Cruz do Sul;1;1;2;865
3516200;Franca;4316808;Santa Cruz do Sul;1;1;2;1120
3524006;Itupeva;4316808;Santa Cruz do Sul;1;1;2;886
3528403;Mairinque;4316808;Santa Cruz do Sul;1;1;2;844
3529401;Mauá;4316808;Santa Cruz do Sul;1;1;2;875
3549953;São Lourenço da Serra;4316808;Santa Cruz do Sul;1;1;2;831
4100400;Almirante Tamandaré;4316808;Santa Cruz do Sul;1;1;2;570
4108403;Francisco Beltrão;4316808;Santa Cruz do Sul;1;1;2;408
4110102;Imbituva;4316808;Santa Cruz do Sul;1;1;2;527
4114302;Mandirituba;4316808;Santa Cruz do Sul;1;1;2;527
4115200;Maringá;4316808;Santa Cruz do Sul;1;1;2;699
4118204;Paranaguá;4316808;Santa Cruz do Sul;1;1;2;588
4125506;São José dos Pinhais;4316808;Santa Cruz do Sul;1;1;2;557
4127106;Telêmaco Borba;4316808;Santa Cruz do Sul;1;1;2;616
4201307;Araquari;4316808;Santa Cruz do Sul;1;1;2;508
4202800;Braço do Norte;4316808;Santa Cruz do Sul;1;1;2;352
4202909;Brusque;4316808;Santa Cruz do Sul;1;1;2;445
4203808;Canoinhas;4316808;Santa Cruz do Sul;1;1;2;435
4204608;Criciúma;4316808;Santa Cruz do Sul;1;1;2;316
4205407;Florianópolis;4316808;Santa Cruz do Sul;1;1;2;443
4206702;Herval d'Oeste;4316808;Santa Cruz do Sul;1;1;2;294
4207304;Imbituba;4316808;Santa Cruz do Sul;1;1;2;392
4207502;Indaial;4316808;Santa Cruz do Sul;1;1;2;437
4207700;Ipumirim;4316808;Santa Cruz do Sul;1;1;2;295
4208500;Ituporanga;4316808;Santa Cruz do Sul;1;1;2;373
4209409;Laguna;4316808;Santa Cruz do Sul;1;1;2;373
4210100;Mafra;4316808;Santa Cruz do Sul;1;1;2;467
4210407;Maracajá;4316808;Santa Cruz do Sul;1;1;2;303
4210506;Maravilha;4316808;Santa Cruz do Sul;1;1;2;336
4211207;Morro da Fumaça;4316808;Santa Cruz do Sul;1;1;2;332
4211306;Navegantes;4316808;Santa Cruz do Sul;1;1;2;477
4211603;Nova Veneza;4316808;Santa Cruz do Sul;1;1;2;307
4211751;Otacílio Costa;4316808;Santa Cruz do Sul;1;1;2;332
4212205;Papanduva;4316808;Santa Cruz do Sul;1;1;2;431
4215000;Rio Negrinho;4316808;Santa Cruz do Sul;1;1;2;474
4216909;São Lourenço do Oeste;4316808;Santa Cruz do Sul;1;1;2;374
4218301;Três Barras;4316808;Santa Cruz do Sul;1;1;2;448
4218707;Tubarão;4316808;Santa Cruz do Sul;1;1;2;354
4219002;Urussanga;4316808;Santa Cruz do Sul;1;1;2;323
4300604;Alvorada;4316808;Santa Cruz do Sul;1;1;2;134
4301107;Arroio dos Ratos;4316808;Santa Cruz do Sul;1;1;2;78
4301206;Arroio do Tigre;4316808;Santa Cruz do Sul;1;1;2;77
4301636;Balneário Pinhal;4316808;Santa Cruz do Sul;1;1;2;218
4302105;Bento Gonçalves;4316808;Santa Cruz do Sul;1;1;2;108
4302352;Bom Princípio;4316808;Santa Cruz do Sul;1;1;2;107
4304408;Canela;4316808;Santa Cruz do Sul;1;1;2;162
4304903;Casca;4316808;Santa Cruz do Sul;1;1;2;136
4305355;Charqueadas;4316808;Santa Cruz do Sul;1;1;2;82
4305454;Cidreira;4316808;Santa Cruz do Sul;1;1;2;218
4306403;Dois Irmãos;4316808;Santa Cruz do Sul;1;1;2;131
4306767;Eldorado do Sul;4316808;Santa Cruz do Sul;1;1;2;88
4308201;Flores da Cunha;4316808;Santa Cruz do Sul;1;1;2;143
4308607;Garibaldi;4316808;Santa Cruz do Sul;1;1;2;101
4308805;General Câmara;4316808;Santa Cruz do Sul;1;1;2;66
4309159;Gramado Xavier;4316808;Santa Cruz do Sul;1;1;2;53
4309571;Herveiras;4316808;Santa Cruz do Sul;1;1;2;41
4311106;Jaguari;4316808;Santa Cruz do Sul;1;1;2;227
4312807;Nova Araçá;4316808;Santa Cruz do Sul;1;1;2;135
4313300;Nova Prata;4316808;Santa Cruz do Sul;1;1;2;131
4313953;Pantano Grande;4316808;Santa Cruz do Sul;1;1;2;52
4314027;Paraíso do Sul;4316808;Santa Cruz do Sul;1;1;2;70
4314753;Poço das Antas;4316808;Santa Cruz do Sul;1;1;2;79
4315149;Presidente Lucena;4316808;Santa Cruz do Sul;1;1;2;123
4315750;Riozinho;4316808;Santa Cruz do Sul;1;1;2;191
4315800;Roca Sales;4316808;Santa Cruz do Sul;1;1;2;73
4316006;Rolante;4316808;Santa Cruz do Sul;1;1;2;179
4316758;Santa Clara do Sul;4316808;Santa Cruz do Sul;1;1;2;42
2907301;Castro Alves;4316758;Santa Clara do Sul;1;1;2;2184
4312153;Mato Leitão;4316758;Santa Clara do Sul;1;1;2;7
4313409;Novo Hamburgo;4316758;Santa Clara do Sul;1;1;2;99
4300059;Água Santa;4316733;Santa Cecília do Sul;1;1;2;11
4316600;Sananduva;4316733;Santa Cecília do Sul;1;1;2;26
2800308;Aracaju;4316709;Santa Bárbara do Sul;1;1;2;2447
4303103;Cachoeirinha;4316709;Santa Bárbara do Sul;1;1;2;275
4305108;Caxias do Sul;4316709;Santa Bárbara do Sul;1;1;2;223
4305207;Cerro Largo;4316709;Santa Bárbara do Sul;1;1;2;147
4305405;Chiapetta;4316709;Santa Bárbara do Sul;1;1;2;83
4305603;Colorado;4316709;Santa Bárbara do Sul;1;1;2;31
4305871;Coronel Barros;4316709;Santa Bárbara do Sul;1;1;2;80
4306932;Entre-Ijuís;4316709;Santa Bárbara do Sul;1;1;2;100
4307831;Eugênio de Castro;4316709;Santa Bárbara do Sul;1;1;2;90
4309605;Horizontina;4316709;Santa Bárbara do Sul;1;1;2;132
4311304;Lagoa Vermelha;4316709;Santa Bárbara do Sul;1;1;2;169
4314308;Pejuçara;4316709;Santa Bárbara do Sul;1;1;2;41
4315313;Quatro Irmãos;4316709;Santa Bárbara do Sul;1;1;2;98
3304557;Rio de Janeiro;4316600;Sananduva;1;1;2;997
3534401;Osasco;4316600;Sananduva;1;1;2;688
3550308;São Paulo;4316600;Sananduva;1;1;2;689
4204202;Chapecó;4316600;Sananduva;1;1;2;123
4204301;Concórdia;4316600;Sananduva;1;1;2;84
4300059;Água Santa;4316600;Sananduva;1;1;2;34
4301800;Barracão;4316600;Sananduva;1;1;2;46
4302105;Bento Gonçalves;4316600;Sananduva;1;1;2;137
4302303;Bom Jesus;4316600;Sananduva;1;1;2;158
4303103;Cachoeirinha;4316600;Sananduva;1;1;2;232
4303608;Cambará do Sul;4316600;Sananduva;1;1;2;205
4305207;Cerro Largo;4316600;Sananduva;1;1;2;289
4305306;Chapada;4316600;Sananduva;1;1;2;125
4305371;Charrua;4316600;Sananduva;1;1;2;20
4306767;Eldorado do Sul;4316600;Sananduva;1;1;2;237
4307005;Erechim;4316600;Sananduva;1;1;2;58
4307906;Farroupilha;4316600;Sananduva;1;1;2;149
4308904;Getúlio Vargas;4316600;Sananduva;1;1;2;45
4310108;Igrejinha;4316600;Sananduva;1;1;2;206
4310462;Ipiranga do Sul;4316600;Sananduva;1;1;2;61
4311205;Júlio de Castilhos;4316600;Sananduva;1;1;2;233
4311700;Machadinho;4316600;Sananduva;1;1;2;45
4311908;Marcelino Ramos;4316600;Sananduva;1;1;2;54
4312617;Muitos Capões;4316600;Sananduva;1;1;2;74
4312708;Nonoai;4316600;Sananduva;1;1;2;115
4314001;Paraí;4316600;Sananduva;1;1;2;71
4314464;Pinhal da Serra;4316600;Sananduva;1;1;2;63
3301702;Duque de Caxias;4316501;Salvador do Sul;1;1;2;1069
3304557;Rio de Janeiro;4316501;Salvador do Sul;1;1;2;1064
4204301;Concórdia;4316501;Salvador do Sul;1;1;2;251
4301008;Arroio do Meio;4316501;Salvador do Sul;1;1;2;42
4302402;Bom Retiro do Sul;4316501;Salvador do Sul;1;1;2;46
4302659;Brochier;4316501;Salvador do Sul;1;1;2;16
4303103;Cachoeirinha;4316501;Salvador do Sul;1;1;2;69
4303905;Campo Bom;4316501;Salvador do Sul;1;1;2;52
4304689;Capela de Santana;4316501;Salvador do Sul;1;1;2;34
4305108;Caxias do Sul;4316501;Salvador do Sul;1;1;2;45
4305355;Charqueadas;4316501;Salvador do Sul;1;1;2;58
4305959;Cotiporã;4316501;Salvador do Sul;1;1;2;52
4307609;Estância Velha;4316501;Salvador do Sul;1;1;2;40
4307708;Esteio;4316501;Salvador do Sul;1;1;2;56
4307906;Farroupilha;4316501;Salvador do Sul;1;1;2;29
4308607;Garibaldi;4316501;Salvador do Sul;1;1;2;20
4309209;Gravataí;4316501;Salvador do Sul;1;1;2;75
4310801;Ivoti;4316501;Salvador do Sul;1;1;2;38
4311791;Maratá;4316501;Salvador do Sul;1;1;2;14
4313409;Novo Hamburgo;4316501;Salvador do Sul;1;1;2;46
4314035;Pareci Novo;4316501;Salvador do Sul;1;1;2;21
4314050;Parobé;4316501;Salvador do Sul;1;1;2;69
4314407;Pelotas;4316501;Salvador do Sul;1;1;2;267
4314753;Poço das Antas;4316501;Salvador do Sul;1;1;2;16
4314803;Portão;4316501;Salvador do Sul;1;1;2;39
4315602;Rio Grande;4316501;Salvador do Sul;1;1;2;300
4315800;Roca Sales;4316501;Salvador do Sul;1;1;2;39
4303707;Campina das Missões;4316477;Salvador das Missões;1;1;2;15
4304309;Cândido Godói;4316477;Salvador das Missões;1;1;2;21
4305108;Caxias do Sul;4316477;Salvador das Missões;1;1;2;379
4316303;Roque Gonzales;4316477;Salvador das Missões;1;1;2;19
3534401;Osasco;4316451;Salto do Jacuí;1;1;2;867
4301206;Arroio do Tigre;4316451;Salto do Jacuí;1;1;2;30
4305108;Caxias do Sul;4316451;Salto do Jacuí;1;1;2;199
4305207;Cerro Largo;4316451;Salto do Jacuí;1;1;2;180
4306106;Cruz Alta;4316451;Salto do Jacuí;1;1;2;62
4311403;Lajeado;4316451;Salto do Jacuí;1;1;2;122
4314100;Passo Fundo;4316451;Salto do Jacuí;1;1;2;121
4304705;Carazinho;4316436;Saldanha Marinho;1;1;2;32
4305702;Condor;4316436;Saldanha Marinho;1;1;2;44
4306106;Cruz Alta;4316436;Saldanha Marinho;1;1;2;56
4305306;Chapada;4316428;Sagrada Família;1;1;2;39
4305801;Constantina;4316428;Sagrada Família;1;1;2;15
4307906;Farroupilha;4316428;Sagrada Família;1;1;2;245
4313466;Novo Xingu;4316428;Sagrada Família;1;1;2;9
4313706;Palmeira das Missões;4316428;Sagrada Família;1;1;2;29
4314779;Pontão;4316428;Sagrada Família;1;1;2;60
3304557;Rio de Janeiro;4316402;Rosário do Sul;1;1;2;1362
3534401;Osasco;4316402;Rosário do Sul;1;1;2;1066
3550308;São Paulo;4316402;Rosário do Sul;1;1;2;1067
4211207;Morro da Fumaça;4316402;Rosário do Sul;1;1;2;576
4303103;Cachoeirinha;4316402;Rosário do Sul;1;1;2;370
4303509;Camaquã;4316402;Rosário do Sul;1;1;2;309
4305108;Caxias do Sul;4316402;Rosário do Sul;1;1;2;382
4306767;Eldorado do Sul;4316402;Rosário do Sul;1;1;2;321
4307609;Estância Velha;4316402;Rosário do Sul;1;1;2;368
4307708;Esteio;4316402;Rosário do Sul;1;1;2;365
4307807;Estrela;4316402;Rosário do Sul;1;1;2;298
4307906;Farroupilha;4316402;Rosário do Sul;1;1;2;364
4311403;Lajeado;4316402;Rosário do Sul;1;1;2;295
4313904;Panambi;4316402;Rosário do Sul;1;1;2;260
4315305;Quaraí;4316402;Rosário do Sul;1;1;2;145
3509502;Campinas;4316303;Roque Gonzales;1;1;2;961
4205407;Florianópolis;4316303;Roque Gonzales;1;1;2;641
4208203;Itajaí;4316303;Roque Gonzales;1;1;2;627
4303103;Cachoeirinha;4316303;Roque Gonzales;1;1;2;437
4304606;Canoas;4316303;Roque Gonzales;1;1;2;429
4305108;Caxias do Sul;4316303;Roque Gonzales;1;1;2;397
4309506;Guarani das Missões;4316303;Roque Gonzales;1;1;2;46
4314902;Porto Alegre;4316303;Roque Gonzales;1;1;2;435
4315107;Porto Xavier;4316303;Roque Gonzales;1;1;2;27
3543402;Ribeirão Preto;4316204;Rondinha;1;1;2;887
4305801;Constantina;4316204;Rondinha;1;1;2;13
4311304;Lagoa Vermelha;4316204;Rondinha;1;1;2;143
4314100;Passo Fundo;4316204;Rondinha;1;1;2;69
4316105;Ronda Alta;4316204;Rondinha;1;1;2;13
3534401;Osasco;4316105;Ronda Alta;1;1;2;747
4303103;Cachoeirinha;4316105;Ronda Alta;1;1;2;294
4305207;Cerro Largo;4316105;Ronda Alta;1;1;2;195
4305801;Constantina;4316105;Ronda Alta;1;1;2;19
4306957;Entre Rios do Sul;4316105;Ronda Alta;1;1;2;27
4307005;Erechim;4316105;Ronda Alta;1;1;2;54
4313706;Palmeira das Missões;4316105;Ronda Alta;1;1;2;54
3534401;Osasco;4316006;Rolante;1;1;2;766
4303103;Cachoeirinha;4316006;Rolante;1;1;2;62
4303905;Campo Bom;4316006;Rolante;1;1;2;46
4304630;Capão da Canoa;4316006;Rolante;1;1;2;53
4305108;Caxias do Sul;4316006;Rolante;1;1;2;79
4307906;Farroupilha;4316006;Rolante;1;1;2;88
4310652;Itati;4316006;Rolante;1;1;2;46
4311403;Lajeado;4316006;Rolante;1;1;2;143
4311627;Lindolfo Collor;4316006;Rolante;1;1;2;64
4313060;Nova Hartz;4316006;Rolante;1;1;2;32
4313409;Novo Hamburgo;4316006;Rolante;1;1;2;54
4313508;Osório;4316006;Rolante;1;1;2;39
4313656;Palmares do Sul;4316006;Rolante;1;1;2;68
4302501;Bossoroca;4315958;Rolador;1;1;2;53
4104808;Cascavel;4315909;Rodeio Bonito;1;1;2;281
4203105;Caibi;4315909;Rodeio Bonito;1;1;2;46
4204707;Cunha Porã;4315909;Rodeio Bonito;1;1;2;64
4210506;Maravilha;4315909;Rodeio Bonito;1;1;2;78
4212908;Pinhalzinho;4315909;Rodeio Bonito;1;1;2;71
4216008;São Carlos;4315909;Rodeio Bonito;1;1;2;47
4300646;Ametista do Sul;4315909;Rodeio Bonito;1;1;2;12
4303400;Caiçara;4315909;Rodeio Bonito;1;1;2;34
4305108;Caxias do Sul;4315909;Rodeio Bonito;1;1;2;273
4305207;Cerro Largo;4315909;Rodeio Bonito;1;1;2;173
4310504;Iraí;4315909;Rodeio Bonito;1;1;2;32
4310850;Jaboticaba;4315909;Rodeio Bonito;1;1;2;21
4311304;Lagoa Vermelha;4315909;Rodeio Bonito;1;1;2;182
4313706;Palmeira das Missões;4315909;Rodeio Bonito;1;1;2;50
4313805;Palmitinho;4315909;Rodeio Bonito;1;1;2;40
4314100;Passo Fundo;4315909;Rodeio Bonito;1;1;2;116
4314456;Pinhal;4315909;Rodeio Bonito;1;1;2;8
4314498;Pinheirinho do Vale;4315909;Rodeio Bonito;1;1;2;52
4314704;Planalto;4315909;Rodeio Bonito;1;1;2;19
3534401;Osasco;4315800;Roca Sales;1;1;2;798
3550308;São Paulo;4315800;Roca Sales;1;1;2;796
4119509;Piraquara;4315800;Roca Sales;1;1;2;503
4205407;Florianópolis;4315800;Roca Sales;1;1;2;373
4304697;Capitão;4315800;Roca Sales;1;1;2;12
4305587;Colinas;4315800;Roca Sales;1;1;2;12
4308607;Garibaldi;4315800;Roca Sales;1;1;2;33
4311304;Lagoa Vermelha;4315800;Roca Sales;1;1;2;124
4312609;Muçum;4315800;Roca Sales;1;1;2;16
4315156;Progresso;4315800;Roca Sales;1;1;2;43
4304630;Capão da Canoa;4315750;Riozinho;1;1;2;42
3106200;Belo Horizonte;4315701;Rio Pardo;1;1;2;1354
3205200;Vila Velha;4315701;Rio Pardo;1;1;2;1538
3304557;Rio de Janeiro;4315701;Rio Pardo;1;1;2;1155
3534401;Osasco;4315701;Rio Pardo;1;1;2;879
4209607;Lauro Muller;4315701;Rio Pardo;1;1;2;331
4218707;Tubarão;4315701;Rio Pardo;1;1;2;356
4300851;Arambaré;4315701;Rio Pardo;1;1;2;138
4301602;Bagé;4315701;Rio Pardo;1;1;2;231
4302808;Caçapava do Sul;4315701;Rio Pardo;1;1;2;123
4303103;Cachoeirinha;4315701;Rio Pardo;1;1;2;121
4303509;Camaquã;4315701;Rio Pardo;1;1;2;116
4304507;Canguçu;4315701;Rio Pardo;1;1;2;169
4305207;Cerro Largo;4315701;Rio Pardo;1;1;2;298
4307500;Espumoso;4315701;Rio Pardo;1;1;2;139
4314605;Piratini;4315701;Rio Pardo;1;1;2;185
2306306;Itapagé;4315602;Rio Grande;1;1;2;3331
2611606;Recife;4315602;Rio Grande;1;1;2;3055
2800605;Barra dos Coqueiros;4315602;Rio Grande;1;1;2;2702
2905701;Camaçari;4315602;Rio Grande;1;1;2;2470
2927408;Salvador;4315602;Rio Grande;1;1;2;2436
3104007;Araxá;4315602;Rio Grande;1;1;2;1461
3205002;Serra;4315602;Rio Grande;1;1;2;1700
3205101;Viana;4315602;Rio Grande;1;1;2;1662
3205309;Vitória;4315602;Rio Grande;1;1;2;1690
3301900;Itaboraí;4315602;Rio Grande;1;1;2;1335
3303302;Niterói;4315602;Rio Grande;1;1;2;1310
3509502;Campinas;4315602;Rio Grande;1;1;2;1118
3516200;Franca;4315602;Rio Grande;1;1;2;1349
3520509;Indaiatuba;4315602;Rio Grande;1;1;2;1092
3534401;Osasco;4315602;Rio Grande;1;1;2;1066
3548807;São Caetano do Sul;4315602;Rio Grande;1;1;2;1068
3549904;São José dos Campos;4315602;Rio Grande;1;1;2;1138
3556206;Valinhos;4315602;Rio Grande;1;1;2;1114
4108809;Guaíra;4315602;Rio Grande;1;1;2;904
4113700;Londrina;4315602;Rio Grande;1;1;2;978
4118501;Pato Branco;4315602;Rio Grande;1;1;2;650
4119152;Pinhais;4315602;Rio Grande;1;1;2;785
4205407;Florianópolis;4315602;Rio Grande;1;1;2;602
4205902;Gaspar;4315602;Rio Grande;1;1;2;644
4209102;Joinville;4315602;Rio Grande;1;1;2;712
4209409;Laguna;4315602;Rio Grande;1;1;2;507
4301305;Arroio Grande;4315602;Rio Grande;1;1;2;83
4302105;Bento Gonçalves;4315602;Rio Grande;1;1;2;330
4303905;Campo Bom;4315602;Rio Grande;1;1;2;287
4304358;Candiota;4315602;Rio Grande;1;1;2;151
4304630;Capão da Canoa;4315602;Rio Grande;1;1;2;326
4304663;Capão do Leão;4315602;Rio Grande;1;1;2;45
4305355;Charqueadas;4315602;Rio Grande;1;1;2;241
4306106;Cruz Alta;4315602;Rio Grande;1;1;2;403
4307609;Estância Velha;4315602;Rio Grande;1;1;2;286
4307807;Estrela;4315602;Rio Grande;1;1;2;287
4308201;Flores da Cunha;4315602;Rio Grande;1;1;2;351
4309100;Gramado;4315602;Rio Grande;1;1;2;320
4309209;Gravataí;4315602;Rio Grande;1;1;2;262
4309308;Guaíba;4315602;Rio Grande;1;1;2;232
4309605;Horizontina;4315602;Rio Grande;1;1;2;531
4311403;Lajeado;4315602;Rio Grande;1;1;2;294
4311809;Marau;4315602;Rio Grande;1;1;2;403
4313904;Panambi;4315602;Rio Grande;1;1;2;439
3534401;Osasco;4315503;Restinga Seca;1;1;2;931
4210803;Meleiro;4315503;Restinga Seca;1;1;2;376
4303103;Cachoeirinha;4315503;Restinga Seca;1;1;2;219
4304200;Candelária;4315503;Restinga Seca;1;1;2;55
4304507;Canguçu;4315503;Restinga Seca;1;1;2;189
4304630;Capão da Canoa;4315503;Restinga Seca;1;1;2;322
4305207;Cerro Largo;4315503;Restinga Seca;1;1;2;225
4307906;Farroupilha;4315503;Restinga Seca;1;1;2;207
4309407;Guaporé;4315503;Restinga Seca;1;1;2;178
4311403;Lajeado;4315503;Restinga Seca;1;1;2;137
4313102;Nova Palma;4315503;Restinga Seca;1;1;2;39
4313391;Novo Cabrais;4315503;Restinga Seca;1;1;2;39
4313409;Novo Hamburgo;4315503;Restinga Seca;1;1;2;218
4314100;Passo Fundo;4315503;Restinga Seca;1;1;2;196
4305207;Cerro Largo;4315404;Redentora;1;1;2;121
4306429;Dois Irmãos das Missões;4315404;Redentora;1;1;2;11
4311155;Jóia;4315354;Quinze de Novembro;1;1;2;101
4306106;Cruz Alta;4315321;Quevedos;1;1;2;91
4313102;Nova Palma;4315321;Quevedos;1;1;2;60
4303806;Campinas do Sul;4315313;Quatro Irmãos;1;1;2;21
4307559;Estação;4315313;Quatro Irmãos;1;1;2;21
2933307;Vitória da Conquista;4315305;Quaraí;1;1;2;2227
3534401;Osasco;4315305;Quaraí;1;1;2;1177
4300646;Ametista do Sul;4315305;Quaraí;1;1;2;455
4301602;Bagé;4315305;Quaraí;1;1;2;250
4301875;Barra do Quaraí;4315305;Quaraí;1;1;2;108
4304507;Canguçu;4315305;Quaraí;1;1;2;381
4304606;Canoas;4315305;Quaraí;1;1;2;507
4305207;Cerro Largo;4315305;Quaraí;1;1;2;295
4307906;Farroupilha;4315305;Quaraí;1;1;2;504
4310603;Itaqui;4315305;Quaraí;1;1;2;134
4306809;Encantado;4315206;Putinga;1;1;2;35
4304804;Carlos Barbosa;4315156;Progresso;1;1;2;79
4306809;Encantado;4315156;Progresso;1;1;2;40
4304606;Canoas;4315149;Presidente Lucena;1;1;2;43
4304630;Capão da Canoa;4315149;Presidente Lucena;1;1;2;113
4307609;Estância Velha;4315149;Presidente Lucena;1;1;2;14
4307906;Farroupilha;4315149;Presidente Lucena;1;1;2;36
4312401;Montenegro;4315149;Presidente Lucena;1;1;2;35
4312476;Morro Reuter;4315149;Presidente Lucena;1;1;2;10
4313409;Novo Hamburgo;4315149;Presidente Lucena;1;1;2;19
4313508;Osório;4315149;Presidente Lucena;1;1;2;97
4314035;Pareci Novo;4315149;Presidente Lucena;1;1;2;27
4314902;Porto Alegre;4315149;Presidente Lucena;1;1;2;59
1721000;Palmas;4315107;Porto Xavier;1;1;2;2042
3534401;Osasco;4315107;Porto Xavier;1;1;2;941
4208500;Ituporanga;4315107;Porto Xavier;1;1;2;547
4303103;Cachoeirinha;4315107;Porto Xavier;1;1;2;460
4314100;Passo Fundo;4315107;Porto Xavier;1;1;2;273
4315008;Porto Lucena;4315107;Porto Xavier;1;1;2;13
4305207;Cerro Largo;4315073;Porto Vera Cruz;1;1;2;49
4315008;Porto Lucena;4315073;Porto Vera Cruz;1;1;2;17
4305207;Cerro Largo;4315057;Porto Mauá;1;1;2;65
4303103;Cachoeirinha;4315008;Porto Lucena;1;1;2;452
4305108;Caxias do Sul;4315008;Porto Lucena;1;1;2;407
1100122;Ji-Paraná;4314902;Porto Alegre;1;1;2;2328
1100288;Rolim de Moura;4314902;Porto Alegre;1;1;2;2234
1400407;Normandia;4314902;Porto Alegre;1;1;2;3829
1500503;Almeirim;4314902;Porto Alegre;1;1;2;3162
1501303;Barcarena;4314902;Porto Alegre;1;1;2;3166
1505536;Parauapebas;4314902;Porto Alegre;1;1;2;2664
1700707;Alvorada;4314902;Porto Alegre;1;1;2;1955
1709500;Gurupi;4314902;Porto Alegre;1;1;2;2040
1715259;Novo Jardim;4314902;Porto Alegre;1;1;2;2060
1716109;Paraíso do Tocantins;4314902;Porto Alegre;1;1;2;2211
1718204;Porto Nacional;4314902;Porto Alegre;1;1;2;2157
2101400;Balsas;4314902;Porto Alegre;1;1;2;2538
2206605;Monte Alegre do Piauí;4314902;Porto Alegre;1;1;2;2308
2209203;Santa Filomena;4314902;Porto Alegre;1;1;2;2366
2306900;Jaguaribe;4314902;Porto Alegre;1;1;2;2903
2311405;Quixeramobim;4314902;Porto Alegre;1;1;2;2953
2312908;Sobral;4314902;Porto Alegre;1;1;2;3079
2500601;Alhandra;4314902;Porto Alegre;1;1;2;2903
2503753;Cajazeirinhas;4314902;Porto Alegre;1;1;2;2827
2506400;Gurinhém;4314902;Porto Alegre;1;1;2;2910
2507705;Juazeirinho;4314902;Porto Alegre;1;1;2;2861
2510808;Patos;4314902;Porto Alegre;1;1;2;2842
2516201;Sousa;4314902;Porto Alegre;1;1;2;2828
2600054;Abreu e Lima;4314902;Porto Alegre;1;1;2;2860
2600104;Afogados da Ingazeira;4314902;Porto Alegre;1;1;2;2753
2600500;Águas Belas;4314902;Porto Alegre;1;1;2;2642
2601102;Araripina;4314902;Porto Alegre;1;1;2;2671
2601201;Arcoverde;4314902;Porto Alegre;1;1;2;2710
2601409;Barreiros;4314902;Porto Alegre;1;1;2;2760
2601706;Belo Jardim;4314902;Porto Alegre;1;1;2;2747
2602100;Bom Conselho;4314902;Porto Alegre;1;1;2;2655
2603009;Cabrobó;4314902;Porto Alegre;1;1;2;2622
2603454;Camaragibe;4314902;Porto Alegre;1;1;2;2843
2604007;Carpina;4314902;Porto Alegre;1;1;2;2850
2604205;Catende;4314902;Porto Alegre;1;1;2;2750
2605202;Escada;4314902;Porto Alegre;1;1;2;2802
2605459;Fernando de Noronha;4314902;Porto Alegre;1;1;2;3355
2605707;Floresta;4314902;Porto Alegre;1;1;2;2635
2606002;Garanhuns;4314902;Porto Alegre;1;1;2;2696
2606408;Gravatá;4314902;Porto Alegre;1;1;2;2801
2606804;Igarassu;4314902;Porto Alegre;1;1;2;2863
2608800;Lajedo;4314902;Porto Alegre;1;1;2;2723
2608909;Limoeiro;4314902;Porto Alegre;1;1;2;2837
2609402;Moreno;4314902;Porto Alegre;1;1;2;2830
2609501;Nazaré da Mata;4314902;Porto Alegre;1;1;2;2860
2609907;Ouricuri;4314902;Porto Alegre;1;1;2;2650
2610004;Palmares;4314902;Porto Alegre;1;1;2;2753
2610608;Paudalho;4314902;Porto Alegre;1;1;2;2847
2610707;Paulista;4314902;Porto Alegre;1;1;2;2857
2610905;Pesqueira;4314902;Porto Alegre;1;1;2;2735
2611002;Petrolândia;4314902;Porto Alegre;1;1;2;2598
2611101;Petrolina;4314902;Porto Alegre;1;1;2;2491
2611804;Ribeirão;4314902;Porto Alegre;1;1;2;2781
2611903;Rio Formoso;4314902;Porto Alegre;1;1;2;2775
2612208;Salgueiro;4314902;Porto Alegre;1;1;2;2659
2612505;Santa Cruz do Capibaribe;4314902;Porto Alegre;1;1;2;2796
2612604;Santa Maria da Boa Vista;4314902;Porto Alegre;1;1;2;2572
2613008;São Bento do Una;4314902;Porto Alegre;1;1;2;2726
2613602;São José do Egito;4314902;Porto Alegre;1;1;2;2796
2613701;São Lourenço da Mata;4314902;Porto Alegre;1;1;2;2844
2613909;Serra Talhada;4314902;Porto Alegre;1;1;2;2709
2614501;Surubim;4314902;Porto Alegre;1;1;2;2829
2615300;Timbaúba;4314902;Porto Alegre;1;1;2;2879
2616407;Vitória de Santo Antão;4314902;Porto Alegre;1;1;2;2821
2704203;Limoeiro de Anadia;4314902;Porto Alegre;1;1;2;2612
2707701;Rio Largo;4314902;Porto Alegre;1;1;2;2667
2707909;Santa Luzia do Norte;4314902;Porto Alegre;1;1;2;2657
2802304;Frei Paulo;4314902;Porto Alegre;1;1;2;2489
2803609;Laranjeiras;4314902;Porto Alegre;1;1;2;2481
2910727;Eunápolis;4314902;Porto Alegre;1;1;2;1851
2911105;Formosa do Rio Preto;4314902;Porto Alegre;1;1;2;2175
2917359;Jaborandi;4314902;Porto Alegre;1;1;2;1921
2921005;Mata de São João;4314902;Porto Alegre;1;1;2;2266
2925303;Porto Seguro;4314902;Porto Alegre;1;1;2;1870
2927705;Santa Cruz Cabrália;4314902;Porto Alegre;1;1;2;1886
2928901;São Desidério;4314902;Porto Alegre;1;1;2;2038
2930709;Simões Filho;4314902;Porto Alegre;1;1;2;2238
3101607;Alfenas;4314902;Porto Alegre;1;1;2;1075
3104007;Araxá;4314902;Porto Alegre;1;1;2;1224
3106309;Belo Oriente;4314902;Porto Alegre;1;1;2;1445
3107406;Bom Despacho;4314902;Porto Alegre;1;1;2;1268
3109006;Brumadinho;4314902;Porto Alegre;1;1;2;1275
3110004;Caeté;4314902;Porto Alegre;1;1;2;1325
3110509;Camanducaia;4314902;Porto Alegre;1;1;2;936
3110608;Cambuí;4314902;Porto Alegre;1;1;2;953
3110905;Campanha;4314902;Porto Alegre;1;1;2;1058
3111200;Campo Belo;4314902;Porto Alegre;1;1;2;1154
3113404;Caratinga;4314902;Porto Alegre;1;1;2;1407
3114550;Carneirinho;4314902;Porto Alegre;1;1;2;1148
3115508;Caxambu;4314902;Porto Alegre;1;1;2;1068
3117603;Conceição do Pará;4314902;Porto Alegre;1;1;2;1281
3117876;Confins;4314902;Porto Alegre;1;1;2;1333
3118007;Congonhas;4314902;Porto Alegre;1;1;2;1257
3120805;Cruzília;4314902;Porto Alegre;1;1;2;1087
3120904;Curvelo;4314902;Porto Alegre;1;1;2;1396
3123601;Elói Mendes;4314902;Porto Alegre;1;1;2;1072
3126109;Formiga;4314902;Porto Alegre;1;1;2;1189
3127107;Frutal;4314902;Porto Alegre;1;1;2;1120
3129806;Ibirité;4314902;Porto Alegre;1;1;2;1293
3131703;Itabira;4314902;Porto Alegre;1;1;2;1369
3131901;Itabirito;4314902;Porto Alegre;1;1;2;1279
3133006;Itamonte;4314902;Porto Alegre;1;1;2;1044
3133808;Itaúna;4314902;Porto Alegre;1;1;2;1261
3134202;Ituiutaba;4314902;Porto Alegre;1;1;2;1238
3134400;Iturama;4314902;Porto Alegre;1;1;2;1146
3136652;Juatuba;4314902;Porto Alegre;1;1;2;1286
3137601;Lagoa Santa;4314902;Porto Alegre;1;1;2;1338
3138401;Leopoldina;4314902;Porto Alegre;1;1;2;1232
3140001;Mariana;4314902;Porto Alegre;1;1;2;1292
3140704;Mateus Leme;4314902;Porto Alegre;1;1;2;1279
3143401;Monte Sião;4314902;Porto Alegre;1;1;2;948
3144300;Nanuque;4314902;Porto Alegre;1;1;2;1677
3144607;Nepomuceno;4314902;Porto Alegre;1;1;2;1123
3145604;Oliveira;4314902;Porto Alegre;1;1;2;1191
3147105;Pará de Minas;4314902;Porto Alegre;1;1;2;1283
3147303;Paraisópolis;4314902;Porto Alegre;1;1;2;973
3148103;Patrocínio;4314902;Porto Alegre;1;1;2;1290
3152105;Ponte Nova;4314902;Porto Alegre;1;1;2;1316
3154606;Ribeirão das Neves;4314902;Porto Alegre;1;1;2;1315
3157807;Santa Luzia;4314902;Porto Alegre;1;1;2;1326
3160702;Santos Dumont;4314902;Porto Alegre;1;1;2;1187
3162005;São Gonçalo do Sapucaí;4314902;Porto Alegre;1;1;2;1044
3162104;São Gotardo;4314902;Porto Alegre;1;1;2;1282
3162500;São João del Rei;4314902;Porto Alegre;1;1;2;1178
3163706;São Lourenço;4314902;Porto Alegre;1;1;2;1050
3164704;São Sebastião do Paraíso;4314902;Porto Alegre;1;1;2;1084
3168606;Teófilo Otoni;4314902;Porto Alegre;1;1;2;1618
3169307;Três Corações;4314902;Porto Alegre;1;1;2;1083
3169406;Três Pontas;4314902;Porto Alegre;1;1;2;1097
3169901;Ubá;4314902;Porto Alegre;1;1;2;1252
3171204;Vespasiano;4314902;Porto Alegre;1;1;2;1329
3201407;Castelo;4314902;Porto Alegre;1;1;2;1395
3201506;Colatina;4314902;Porto Alegre;1;1;2;1519
3202405;Guarapari;4314902;Porto Alegre;1;1;2;1436
3300209;Araruama;4314902;Porto Alegre;1;1;2;1147
3300233;Armação dos Búzios;4314902;Porto Alegre;1;1;2;1188
3302205;Itaperuna;4314902;Porto Alegre;1;1;2;1313
3302254;Itatiaia;4314902;Porto Alegre;1;1;2;1041
3302502;Magé;4314902;Porto Alegre;1;1;2;1119
3302700;Maricá;4314902;Porto Alegre;1;1;2;1113
3302908;Miguel Pereira;4314902;Porto Alegre;1;1;2;1109
3303203;Nilópolis;4314902;Porto Alegre;1;1;2;1082
3303609;Paracambi;4314902;Porto Alegre;1;1;2;1083
3303807;Parati;4314902;Porto Alegre;1;1;2;970
3304300;Rio Bonito;4314902;Porto Alegre;1;1;2;1142
3304524;Rio das Ostras;4314902;Porto Alegre;1;1;2;1205
3305505;Saquarema;4314902;Porto Alegre;1;1;2;1142
3305554;Seropédica;4314902;Porto Alegre;1;1;2;1070
3306107;Valença;4314902;Porto Alegre;1;1;2;1112
3500105;Adamantina;4314902;Porto Alegre;1;1;2;927
3500204;Adolfo;4314902;Porto Alegre;1;1;2;987
3500303;Aguaí;4314902;Porto Alegre;1;1;2;969
3500402;Águas da Prata;4314902;Porto Alegre;1;1;2;991
3500501;Águas de Lindóia;4314902;Porto Alegre;1;1;2;941
3500709;Agudos;4314902;Porto Alegre;1;1;2;863
3500907;Altair;4314902;Porto Alegre;1;1;2;1074
3501004;Altinópolis;4314902;Porto Alegre;1;1;2;1061
3501152;Alumínio;4314902;Porto Alegre;1;1;2;811
3501301;Álvares Machado;4314902;Porto Alegre;1;1;2;884
3501707;Américo Brasiliense;4314902;Porto Alegre;1;1;2;967
3501806;Américo de Campos;4314902;Porto Alegre;1;1;2;1089
3502200;Angatuba;4314902;Porto Alegre;1;1;2;773
3502309;Anhembi;4314902;Porto Alegre;1;1;2;852
3502606;Aparecida d'Oeste;4314902;Porto Alegre;1;1;2;1064
3502705;Apiaí;4314902;Porto Alegre;1;1;2;653
3503000;Aramina;4314902;Porto Alegre;1;1;2;1146
3503109;Arandu;4314902;Porto Alegre;1;1;2;792
3503505;Areias;4314902;Porto Alegre;1;1;2;1027
3503802;Artur Nogueira;4314902;Porto Alegre;1;1;2;910
3504206;Auriflama;4314902;Porto Alegre;1;1;2;1039
3504404;Avanhandava;4314902;Porto Alegre;1;1;2;959
3504602;Bady Bassitt;4314902;Porto Alegre;1;1;2;1025
3504909;Bananal;4314902;Porto Alegre;1;1;2;1039
3505203;Bariri;4314902;Porto Alegre;1;1;2;913
3505401;Barra do Turvo;4314902;Porto Alegre;1;1;2;639
3505609;Barrinha;4314902;Porto Alegre;1;1;2;1021
3506359;Bertioga;4314902;Porto Alegre;1;1;2;837
3506706;Boa Esperança do Sul;4314902;Porto Alegre;1;1;2;930
3506805;Bocaina;4314902;Porto Alegre;1;1;2;912
3506904;Bofete;4314902;Porto Alegre;1;1;2;818
3507209;Borá;4314902;Porto Alegre;1;1;2;864
3507407;Borborema;4314902;Porto Alegre;1;1;2;955
3507803;Brodowski;4314902;Porto Alegre;1;1;2;1056
3507902;Brotas;4314902;Porto Alegre;1;1;2;907
3508108;Buritama;4314902;Porto Alegre;1;1;2;1000
3508207;Buritizal;4314902;Porto Alegre;1;1;2;1139
3508603;Cachoeira Paulista;4314902;Porto Alegre;1;1;2;1002
3508702;Caconde;4314902;Porto Alegre;1;1;2;1035
3508801;Cafelândia;4314902;Porto Alegre;1;1;2;926
3508900;Caiabu;4314902;Porto Alegre;1;1;2;891
3509007;Caieiras;4314902;Porto Alegre;1;1;2;851
3509106;Caiuá;4314902;Porto Alegre;1;1;2;914
3509254;Cajati;4314902;Porto Alegre;1;1;2;658
3509403;Cajuru;4314902;Porto Alegre;1;1;2;1038
3509908;Cananéia;4314902;Porto Alegre;1;1;2;635
3509957;Canas;4314902;Porto Alegre;1;1;2;996
3510005;Cândido Mota;4314902;Porto Alegre;1;1;2;813
3510203;Capão Bonito;4314902;Porto Alegre;1;1;2;721
3510401;Capivari;4314902;Porto Alegre;1;1;2;855
3510906;Cássia dos Coqueiros;4314902;Porto Alegre;1;1;2;1041
3511201;Catiguá;4314902;Porto Alegre;1;1;2;1017
3511300;Cedral;4314902;Porto Alegre;1;1;2;1029
3511508;Cerquilho;4314902;Porto Alegre;1;1;2;829
3512001;Colina;4314902;Porto Alegre;1;1;2;1064
3512209;Conchal;4314902;Porto Alegre;1;1;2;934
3512308;Conchas;4314902;Porto Alegre;1;1;2;835
3512407;Cordeirópolis;4314902;Porto Alegre;1;1;2;909
3512803;Cosmópolis;4314902;Porto Alegre;1;1;2;902
3512902;Cosmorama;4314902;Porto Alegre;1;1;2;1069
3513108;Cravinhos;4314902;Porto Alegre;1;1;2;1018
3513207;Cristais Paulista;4314902;Porto Alegre;1;1;2;1125
3513306;Cruzália;4314902;Porto Alegre;1;1;2;812
3513603;Cunha;4314902;Porto Alegre;1;1;2;969
3513702;Descalvado;4314902;Porto Alegre;1;1;2;962
3514007;Dobrada;4314902;Porto Alegre;1;1;2;981
3514106;Dois Córregos;4314902;Porto Alegre;1;1;2;891
3514304;Dourado;4314902;Porto Alegre;1;1;2;921
3514502;Duartina;4314902;Porto Alegre;1;1;2;863
3514809;Eldorado;4314902;Porto Alegre;1;1;2;679
3515004;Embu;4314902;Porto Alegre;1;1;2;818
3515103;Embu-Guaçu;4314902;Porto Alegre;1;1;2;803
3515202;Estrela d'Oeste;4314902;Porto Alegre;1;1;2;1084
3515400;Fartura;4314902;Porto Alegre;1;1;2;755
3515806;Flora Rica;4314902;Porto Alegre;1;1;2;928
3516101;Florínia;4314902;Porto Alegre;1;1;2;795
3516309;Francisco Morato;4314902;Porto Alegre;1;1;2;862
3516507;Gabriel Monteiro;4314902;Porto Alegre;1;1;2;946
3516606;Gália;4314902;Porto Alegre;1;1;2;874
3516903;General Salgado;4314902;Porto Alegre;1;1;2;1045
3517000;Getulina;4314902;Porto Alegre;1;1;2;922
3517208;Guaiçara;4314902;Porto Alegre;1;1;2;943
3517505;Guapiaçu;4314902;Porto Alegre;1;1;2;1042
3517604;Guapiara;4314902;Porto Alegre;1;1;2;697
3517703;Guará;4314902;Porto Alegre;1;1;2;1111
3517802;Guaraçaí;4314902;Porto Alegre;1;1;2;1000
3517901;Guaraci;4314902;Porto Alegre;1;1;2;1079
3518008;Guarani d'Oeste;4314902;Porto Alegre;1;1;2;1108
3518305;Guararema;4314902;Porto Alegre;1;1;2;880
3519303;Ibaté;4314902;Porto Alegre;1;1;2;945
3519600;Ibitinga;4314902;Porto Alegre;1;1;2;945
3519709;Ibiúna;4314902;Porto Alegre;1;1;2;801
3519808;Icém;4314902;Porto Alegre;1;1;2;1092
3520004;Igaraçu do Tietê;4314902;Porto Alegre;1;1;2;871
3520202;Igaratá;4314902;Porto Alegre;1;1;2;894
3520301;Iguape;4314902;Porto Alegre;1;1;2;684
3520400;Ilhabela;4314902;Porto Alegre;1;1;2;885
3520442;Ilha Solteira;4314902;Porto Alegre;1;1;2;1066
3520707;Indiaporã;4314902;Porto Alegre;1;1;2;1119
3521002;Iperó;4314902;Porto Alegre;1;1;2;812
3521200;Iporanga;4314902;Porto Alegre;1;1;2;654
3521309;Ipuã;4314902;Porto Alegre;1;1;2;1105
3521606;Irapuru;4314902;Porto Alegre;1;1;2;940
3521705;Itaberá;4314902;Porto Alegre;1;1;2;713
3521804;Itaí;4314902;Porto Alegre;1;1;2;761
3522109;Itanhaém;4314902;Porto Alegre;1;1;2;771
3522406;Itapeva;4314902;Porto Alegre;1;1;2;707
3522901;Itapuí;4314902;Porto Alegre;1;1;2;897
3523008;Itapura;4314902;Porto Alegre;1;1;2;1042
3523206;Itararé;4314902;Porto Alegre;1;1;2;682
3523305;Itariri;4314902;Porto Alegre;1;1;2;742
3523503;Itatinga;4314902;Porto Alegre;1;1;2;807
3523602;Itirapina;4314902;Porto Alegre;1;1;2;920
3523800;Itobi;4314902;Porto Alegre;1;1;2;1002
3524006;Itupeva;4314902;Porto Alegre;1;1;2;857
3524204;Jaborandi;4314902;Porto Alegre;1;1;2;1069
3525706;José Bonifácio;4314902;Porto Alegre;1;1;2;1007
3526001;Junqueirópolis;4314902;Porto Alegre;1;1;2;946
3526100;Juquiá;4314902;Porto Alegre;1;1;2;717
3526209;Juquitiba;4314902;Porto Alegre;1;1;2;781
3526407;Laranjal Paulista;4314902;Porto Alegre;1;1;2;837
3526605;Lavrinhas;4314902;Porto Alegre;1;1;2;1016
3526803;Lençóis Paulista;4314902;Porto Alegre;1;1;2;854
3527009;Lindóia;4314902;Porto Alegre;1;1;2;937
3527405;Lucélia;4314902;Porto Alegre;1;1;2;923
3527900;Lutécia;4314902;Porto Alegre;1;1;2;858
3528007;Macatuba;4314902;Porto Alegre;1;1;2;868
3528106;Macaubal;4314902;Porto Alegre;1;1;2;1031
3528304;Magda;4314902;Porto Alegre;1;1;2;1046
3528502;Mairiporã;4314902;Porto Alegre;1;1;2;862
3528809;Maracaí;4314902;Porto Alegre;1;1;2;826
3529203;Martinópolis;4314902;Porto Alegre;1;1;2;876
3529609;Meridiano;4314902;Porto Alegre;1;1;2;1078
3529708;Miguelópolis;4314902;Porto Alegre;1;1;2;1132
3529906;Miracatu;4314902;Porto Alegre;1;1;2;730
3530003;Mira Estrela;4314902;Porto Alegre;1;1;2;1120
3530102;Mirandópolis;4314902;Porto Alegre;1;1;2;988
3530201;Mirante do Paranapanema;4314902;Porto Alegre;1;1;2;862
3530409;Mirassolândia;4314902;Porto Alegre;1;1;2;1059
3531001;Monções;4314902;Porto Alegre;1;1;2;1025
3531100;Mongaguá;4314902;Porto Alegre;1;1;2;788
3531209;Monte Alegre do Sul;4314902;Porto Alegre;1;1;2;919
3531407;Monte Aprazível;4314902;Porto Alegre;1;1;2;1037
3531605;Monte Castelo;4314902;Porto Alegre;1;1;2;970
3531902;Morro Agudo;4314902;Porto Alegre;1;1;2;1073
3532108;Murutinga do Sul;4314902;Porto Alegre;1;1;2;1004
3532207;Narandiba;4314902;Porto Alegre;1;1;2;848
3532306;Natividade da Serra;4314902;Porto Alegre;1;1;2;915
3532504;Neves Paulista;4314902;Porto Alegre;1;1;2;1030
3533007;Nova Granada;4314902;Porto Alegre;1;1;2;1069
3533304;Nova Luzitânia;4314902;Porto Alegre;1;1;2;1021
3533502;Novo Horizonte;4314902;Porto Alegre;1;1;2;969
3533809;Óleo;4314902;Porto Alegre;1;1;2;807
3534005;Onda Verde;4314902;Porto Alegre;1;1;2;1062
3534203;Orindiúva;4314902;Porto Alegre;1;1;2;1107
3534500;Oscar Bressane;4314902;Porto Alegre;1;1;2;861
3534609;Osvaldo Cruz;4314902;Porto Alegre;1;1;2;915
3534906;Pacaembu;4314902;Porto Alegre;1;1;2;941
3535002;Palestina;4314902;Porto Alegre;1;1;2;1083
3535200;Palmeira d'Oeste;4314902;Porto Alegre;1;1;2;1068
3535309;Palmital;4314902;Porto Alegre;1;1;2;810
3535408;Panorama;4314902;Porto Alegre;1;1;2;959
3535507;Paraguaçu Paulista;4314902;Porto Alegre;1;1;2;848
3535606;Paraibuna;4314902;Porto Alegre;1;1;2;903
3535804;Paranapanema;4314902;Porto Alegre;1;1;2;772
3535903;Paranapuã;4314902;Porto Alegre;1;1;2;1104
3536000;Parapuã;4314902;Porto Alegre;1;1;2;917
3536109;Pardinho;4314902;Porto Alegre;1;1;2;816
3536208;Pariquera-Açu;4314902;Porto Alegre;1;1;2;669
3536307;Patrocínio Paulista;4314902;Porto Alegre;1;1;2;1104
3536406;Paulicéia;4314902;Porto Alegre;1;1;2;969
3536604;Paulo de Faria;4314902;Porto Alegre;1;1;2;1123
3536703;Pederneiras;4314902;Porto Alegre;1;1;2;883
3536802;Pedra Bela;4314902;Porto Alegre;1;1;2;919
3536901;Pedranópolis;4314902;Porto Alegre;1;1;2;1092
3537008;Pedregulho;4314902;Porto Alegre;1;1;2;1139
3537107;Pedreira;4314902;Porto Alegre;1;1;2;904
3537404;Pereira Barreto;4314902;Porto Alegre;1;1;2;1046
3537602;Peruíbe;4314902;Porto Alegre;1;1;2;750
3537800;Piedade;4314902;Porto Alegre;1;1;2;787
3537909;Pilar do Sul;4314902;Porto Alegre;1;1;2;765
3538105;Pindorama;4314902;Porto Alegre;1;1;2;1005
3538907;Pirajuí;4314902;Porto Alegre;1;1;2;907
3539004;Pirangi;4314902;Porto Alegre;1;1;2;1020
3539103;Pirapora do Bom Jesus;4314902;Porto Alegre;1;1;2;836
3539202;Pirapozinho;4314902;Porto Alegre;1;1;2;862
3540002;Pompéia;4314902;Porto Alegre;1;1;2;885
3540200;Pontal;4314902;Porto Alegre;1;1;2;1042
3540309;Pontes Gestal;4314902;Porto Alegre;1;1;2;1103
3540408;Populina;4314902;Porto Alegre;1;1;2;1120
3540507;Porangaba;4314902;Porto Alegre;1;1;2;814
3540606;Porto Feliz;4314902;Porto Alegre;1;1;2;832
3540705;Porto Ferreira;4314902;Porto Alegre;1;1;2;972
3540754;Potim;4314902;Porto Alegre;1;1;2;974
3540804;Potirendaba;4314902;Porto Alegre;1;1;2;1012
3541109;Presidente Alves;4314902;Porto Alegre;1;1;2;896
3541307;Presidente Epitácio;4314902;Porto Alegre;1;1;2;921
3541505;Presidente Venceslau;4314902;Porto Alegre;1;1;2;911
3541604;Promissão;4314902;Porto Alegre;1;1;2;952
3541703;Quatá;4314902;Porto Alegre;1;1;2;866
3541802;Queiroz;4314902;Porto Alegre;1;1;2;919
3541901;Queluz;4314902;Porto Alegre;1;1;2;1027
3542107;Rafard;4314902;Porto Alegre;1;1;2;851
3542206;Rancharia;4314902;Porto Alegre;1;1;2;867
3542404;Regente Feijó;4314902;Porto Alegre;1;1;2;868
3542701;Restinga;4314902;Porto Alegre;1;1;2;1102
3543600;Rifaina;4314902;Porto Alegre;1;1;2;1156
3544004;Rio das Pedras;4314902;Porto Alegre;1;1;2;867
3544202;Riolândia;4314902;Porto Alegre;1;1;2;1123
3544251;Rosana;4314902;Porto Alegre;1;1;2;846
3544509;Rubinéia;4314902;Porto Alegre;1;1;2;1096
3544806;Sales;4314902;Porto Alegre;1;1;2;978
3545001;Salesópolis;4314902;Porto Alegre;1;1;2;880
3545506;Sandovalina;4314902;Porto Alegre;1;1;2;843
3545704;Santa Albertina;4314902;Porto Alegre;1;1;2;1111
3546306;Santa Cruz das Palmeiras;4314902;Porto Alegre;1;1;2;983
3546405;Santa Cruz do Rio Pardo;4314902;Porto Alegre;1;1;2;806
3546702;Santa Gertrudes;4314902;Porto Alegre;1;1;2;909
3546801;Santa Isabel;4314902;Porto Alegre;1;1;2;880
3546900;Santa Lúcia;4314902;Porto Alegre;1;1;2;971
3547007;Santa Maria da Serra;4314902;Porto Alegre;1;1;2;877
3547106;Santa Mercedes;4314902;Porto Alegre;1;1;2;965
3547205;Santana da Ponte Pensa;4314902;Porto Alegre;1;1;2;1086
3547502;Santa Rita do Passa Quatro;4314902;Porto Alegre;1;1;2;987
3547601;Santa Rosa de Viterbo;4314902;Porto Alegre;1;1;2;1015
3547700;Santo Anastácio;4314902;Porto Alegre;1;1;2;896
3547908;Santo Antônio da Alegria;4314902;Porto Alegre;1;1;2;1062
3548302;Santo Expedito;4314902;Porto Alegre;1;1;2;909
3548401;Santópolis do Aguapeí;4314902;Porto Alegre;1;1;2;934
3548609;São Bento do Sapucaí;4314902;Porto Alegre;1;1;2;963
3549201;São João das Duas Pontes;4314902;Porto Alegre;1;1;2;1073
3549953;São Lourenço da Serra;4314902;Porto Alegre;1;1;2;795
3550001;São Luís do Paraitinga;4314902;Porto Alegre;1;1;2;936
3550100;São Manuel;4314902;Porto Alegre;1;1;2;848
3550209;São Miguel Arcanjo;4314902;Porto Alegre;1;1;2;747
3550803;São Sebastião da Grama;4314902;Porto Alegre;1;1;2;1010
3551108;Sarapuí;4314902;Porto Alegre;1;1;2;778
3551306;Sebastianópolis do Sul;4314902;Porto Alegre;1;1;2;1048
3551504;Serrana;4314902;Porto Alegre;1;1;2;1035
3551603;Serra Negra;4314902;Porto Alegre;1;1;2;925
3552007;Silveiras;4314902;Porto Alegre;1;1;2;1011
3552106;Socorro;4314902;Porto Alegre;1;1;2;935
3552601;Tabapuã;4314902;Porto Alegre;1;1;2;1027
3552700;Tabatinga;4314902;Porto Alegre;1;1;2;953
3552908;Taciba;4314902;Porto Alegre;1;1;2;849
3553005;Taguaí;4314902;Porto Alegre;1;1;2;750
3553104;Taiaçu;4314902;Porto Alegre;1;1;2;1018
3553302;Tambaú;4314902;Porto Alegre;1;1;2;994
3553807;Taquarituba;4314902;Porto Alegre;1;1;2;745
3553906;Tarabai;4314902;Porto Alegre;1;1;2;857
3554201;Tejupá;4314902;Porto Alegre;1;1;2;763
3554300;Teodoro Sampaio;4314902;Porto Alegre;1;1;2;837
3554409;Terra Roxa;4314902;Porto Alegre;1;1;2;1060
3555109;Tupi Paulista;4314902;Porto Alegre;1;1;2;961
3555208;Turiúba;4314902;Porto Alegre;1;1;2;1015
3555307;Turmalina;4314902;Porto Alegre;1;1;2;1107
3555406;Ubatuba;4314902;Porto Alegre;1;1;2;931
3555604;Uchoa;4314902;Porto Alegre;1;1;2;1025
3555703;União Paulista;4314902;Porto Alegre;1;1;2;1023
3555802;Urânia;4314902;Porto Alegre;1;1;2;1087
3555901;Uru;4314902;Porto Alegre;1;1;2;933
3556008;Urupês;4314902;Porto Alegre;1;1;2;996
3556107;Valentim Gentil;4314902;Porto Alegre;1;1;2;1072
3556305;Valparaíso;4314902;Porto Alegre;1;1;2;978
3556404;Vargem Grande do Sul;4314902;Porto Alegre;1;1;2;995
3556453;Vargem Grande Paulista;4314902;Porto Alegre;1;1;2;815
3556503;Várzea Paulista;4314902;Porto Alegre;1;1;2;861
3556800;Viradouro;4314902;Porto Alegre;1;1;2;1052
3557204;Chavantes;4314902;Porto Alegre;1;1;2;790
4100400;Almirante Tamandaré;4314902;Porto Alegre;1;1;2;553
4100806;Alvorada do Sul;4314902;Porto Alegre;1;1;2;806
4101200;Antonina;4314902;Porto Alegre;1;1;2;569
4101606;Arapoti;4314902;Porto Alegre;1;1;2;666
4102604;Barracão;4314902;Porto Alegre;1;1;2;481
4103107;Bocaiúva do Sul;4314902;Porto Alegre;1;1;2;572
4105706;Clevelândia;4314902;Porto Alegre;1;1;2;423
4107652;Fazenda Rio Grande;4314902;Porto Alegre;1;1;2;519
4111803;Jacarezinho;4314902;Porto Alegre;1;1;2;772
4113205;Lapa;4314902;Porto Alegre;1;1;2;495
4113429;Lidianópolis;4314902;Porto Alegre;1;1;2;660
4114203;Mandaguari;4314902;Porto Alegre;1;1;2;721
4114302;Mandirituba;4314902;Porto Alegre;1;1;2;506
4117602;Palmas;4314902;Porto Alegre;1;1;2;400
4119954;Pontal do Paraná;4314902;Porto Alegre;1;1;2;548
4120804;Quatro Barras;4314902;Porto Alegre;1;1;2;557
4122305;Rio Negro;4314902;Porto Alegre;1;1;2;457
4124020;Santa Tereza do Oeste;4314902;Porto Alegre;1;1;2;600
4124053;Santa Terezinha de Itaipu;4314902;Porto Alegre;1;1;2;596
4124103;Santo Antônio da Platina;4314902;Porto Alegre;1;1;2;755
4125605;São Mateus do Sul;4314902;Porto Alegre;1;1;2;474
4126256;Sarandi;4314902;Porto Alegre;1;1;2;735
4127106;Telêmaco Borba;4314902;Porto Alegre;1;1;2;632
4128203;União da Vitória;4314902;Porto Alegre;1;1;2;418
4203105;Caibi;4314902;Porto Alegre;1;1;2;385
4203204;Camboriú;4314902;Porto Alegre;1;1;2;411
4204806;Curitibanos;4314902;Porto Alegre;1;1;2;313
4207502;Indaial;4314902;Porto Alegre;1;1;2;397
4208401;Itapiranga;4314902;Porto Alegre;1;1;2;399
4208807;Jaguaruna;4314902;Porto Alegre;1;1;2;262
4210308;Major Vieira;4314902;Porto Alegre;1;1;2;417
4211751;Otacílio Costa;4314902;Porto Alegre;1;1;2;303
4212254;Passo de Torres;4314902;Porto Alegre;1;1;2;167
4213104;Piratuba;4314902;Porto Alegre;1;1;2;297
4215505;Santa Cecília;4314902;Porto Alegre;1;1;2;348
4215653;Santa Rosa do Sul;4314902;Porto Alegre;1;1;2;176
4216008;São Carlos;4314902;Porto Alegre;1;1;2;373
4216057;São Cristovão do Sul;4314902;Porto Alegre;1;1;2;317
4216404;São João do Sul;4314902;Porto Alegre;1;1;2;162
4217204;São Miguel do Oeste;4314902;Porto Alegre;1;1;2;433
4217600;Siderópolis;4314902;Porto Alegre;1;1;2;233
4217709;Sombrio;4314902;Porto Alegre;1;1;2;182
4218806;Turvo;4314902;Porto Alegre;1;1;2;192
4219150;Vargem;4314902;Porto Alegre;1;1;2;285
4300034;Aceguá;4314902;Porto Alegre;1;1;2;351
4300059;Água Santa;4314902;Porto Alegre;1;1;2;223
4300554;Alto Alegre;4314902;Porto Alegre;1;1;2;222
4300851;Arambaré;4314902;Porto Alegre;1;1;2;101
4300877;Araricá;4314902;Porto Alegre;1;1;2;55
4301503;Augusto Pestana;4314902;Porto Alegre;1;1;2;317
4301552;Áurea;4314902;Porto Alegre;1;1;2;273
4301859;Barra do Guarita;4314902;Porto Alegre;1;1;2;399
4301875;Barra do Quaraí;4314902;Porto Alegre;1;1;2;614
4302253;Boa Vista do Sul;4314902;Porto Alegre;1;1;2;90
4302451;Boqueirão do Leão;4314902;Porto Alegre;1;1;2;144
4302600;Braga;4314902;Porto Alegre;1;1;2;363
4303301;Caibaté;4314902;Porto Alegre;1;1;2;382
4304101;Campos Borges;4314902;Porto Alegre;1;1;2;215
4304655;Capão do Cipó;4314902;Porto Alegre;1;1;2;358
4304952;Caseiros;4314902;Porto Alegre;1;1;2;203
4305132;Cerro Branco;4314902;Porto Alegre;1;1;2;176
4305157;Cerro Grande;4314902;Porto Alegre;1;1;2;330
4306320;Derrubadas;4314902;Porto Alegre;1;1;2;399
4306379;Dilermando de Aguiar;4314902;Porto Alegre;1;1;2;292
4306452;Dois Lajeados;4314902;Porto Alegre;1;1;2;133
4306734;Doutor Maurício Cardoso;4314902;Porto Alegre;1;1;2;413
4307054;Ernestina;4314902;Porto Alegre;1;1;2;217
4307864;Fagundes Varela;4314902;Porto Alegre;1;1;2;138
4308052;Faxinalzinho;4314902;Porto Alegre;1;1;2;325
4309555;Harmonia;4314902;Porto Alegre;1;1;2;60
4309753;Ibarama;4314902;Porto Alegre;1;1;2;199
4309803;Ibiaçá;4314902;Porto Alegre;1;1;2;230
4310363;Imigrante;4314902;Porto Alegre;1;1;2;95
4310538;Itaara;4314902;Porto Alegre;1;1;2;252
4310751;Ivorá;4314902;Porto Alegre;1;1;2;236
4310850;Jaboticaba;4314902;Porto Alegre;1;1;2;333
4311122;Jaquirana;4314902;Porto Alegre;1;1;2;153
4311155;Jóia;4314902;Porto Alegre;1;1;2;320
4311270;Lagoa dos Três Cantos;4314902;Porto Alegre;1;1;2;228
4311734;Mampituba;4314902;Porto Alegre;1;1;2;153
4311981;Mariana Pimentel;4314902;Porto Alegre;1;1;2;50
4312054;Marques de Souza;4314902;Porto Alegre;1;1;2;117
4312138;Mato Castelhano;4314902;Porto Alegre;1;1;2;218
4312351;Montauri;4314902;Porto Alegre;1;1;2;176
4312443;Morrinhos do Sul;4314902;Porto Alegre;1;1;2;144
4312450;Morro Redondo;4314902;Porto Alegre;1;1;2;220
4312617;Muitos Capões;4314902;Porto Alegre;1;1;2;193
4313391;Novo Cabrais;4314902;Porto Alegre;1;1;2;175
4313607;Paim Filho;4314902;Porto Alegre;1;1;2;265
4314035;Pareci Novo;4314902;Porto Alegre;1;1;2;53
4314175;Pedras Altas;4314902;Porto Alegre;1;1;2;297
4314423;Picada Café;4314902;Porto Alegre;1;1;2;68
4314779;Pontão;4314902;Porto Alegre;1;1;2;262
2605707;Floresta;4314803;Portão;1;1;2;2604
2918407;Juazeiro;4314803;Portão;1;1;2;2442
3104007;Araxá;4314803;Portão;1;1;2;1189
3106705;Betim;4314803;Portão;1;1;2;1263
3117504;Conceição do Mato Dentro;4314803;Portão;1;1;2;1387
3168101;Tapira;4314803;Portão;1;1;2;1159
3505708;Barueri;4314803;Portão;1;1;2;800
3509254;Cajati;4314803;Portão;1;1;2;626
3520509;Indaiatuba;4314803;Portão;1;1;2;823
3534401;Osasco;4314803;Portão;1;1;2;802
3547809;Santo André;4314803;Portão;1;1;2;804
4203006;Caçador;4314803;Portão;1;1;2;322
4203709;Canelinha;4314803;Portão;1;1;2;358
4204608;Criciúma;4314803;Portão;1;1;2;213
4214805;Rio do Sul;4314803;Portão;1;1;2;315
4300877;Araricá;4314803;Portão;1;1;2;31
4301404;Arvorezinha;4314803;Portão;1;1;2;129
4302105;Bento Gonçalves;4314803;Portão;1;1;2;65
4303509;Camaquã;4314803;Portão;1;1;2;137
4304606;Canoas;4314803;Portão;1;1;2;24
4306767;Eldorado do Sul;4314803;Portão;1;1;2;56
4307708;Esteio;4314803;Portão;1;1;2;17
4307807;Estrela;4314803;Portão;1;1;2;73
4308201;Flores da Cunha;4314803;Portão;1;1;2;75
4310207;Ijuí;4314803;Portão;1;1;2;296
4311403;Lajeado;4314803;Portão;1;1;2;82
4313201;Nova Petrópolis;4314803;Portão;1;1;2;38
4301701;Barão de Cotegipe;4314787;Ponte Preta;1;1;2;11
4312658;Não-Me-Toque;4314779;Pontão;1;1;2;47
4314100;Passo Fundo;4314779;Pontão;1;1;2;35
4302352;Bom Princípio;4314753;Poço das Antas;1;1;2;31
3534401;Osasco;4314704;Planalto;1;1;2;741
4304705;Carazinho;4314704;Planalto;1;1;2;110
4305207;Cerro Largo;4314704;Planalto;1;1;2;190
4307005;Erechim;4314704;Planalto;1;1;2;85
4308508;Frederico Westphalen;4314704;Planalto;1;1;2;33
4311304;Lagoa Vermelha;4314704;Planalto;1;1;2;181
4311601;Liberato Salzano;4314704;Planalto;1;1;2;30
4312708;Nonoai;4314704;Planalto;1;1;2;29
3534401;Osasco;4314605;Piratini;1;1;2;1051
3550308;São Paulo;4314605;Piratini;1;1;2;1047
4102901;Bituruna;4314605;Piratini;1;1;2;603
4301305;Arroio Grande;4314605;Piratini;1;1;2;86
4303103;Cachoeirinha;4314605;Piratini;1;1;2;251
4304358;Candiota;4314605;Piratini;1;1;2;55
4305108;Caxias do Sul;4314605;Piratini;1;1;2;312
4305355;Charqueadas;4314605;Piratini;1;1;2;216
4311007;Jaguarão;4314605;Piratini;1;1;2;123
4311403;Lajeado;4314605;Piratini;1;1;2;245
4312401;Montenegro;4314605;Piratini;1;1;2;249
4314100;Passo Fundo;4314605;Piratini;1;1;2;360
4314506;Pinheiro Machado;4314605;Piratini;1;1;2;30
4202404;Blumenau;4314506;Pinheiro Machado;1;1;2;650
4303103;Cachoeirinha;4314506;Pinheiro Machado;1;1;2;280
4304606;Canoas;4314506;Pinheiro Machado;1;1;2;277
4307906;Farroupilha;4314506;Pinheiro Machado;1;1;2;324
4308201;Flores da Cunha;4314506;Pinheiro Machado;1;1;2;350
4314175;Pedras Altas;4314506;Pinheiro Machado;1;1;2;26
4208401;Itapiranga;4314498;Pinheirinho do Vale;1;1;2;11
4313805;Palmitinho;4314498;Pinheirinho do Vale;1;1;2;17
3550308;São Paulo;4314472;Pinhal Grande;1;1;2;892
4305108;Caxias do Sul;4314472;Pinhal Grande;1;1;2;208
4306106;Cruz Alta;4314472;Pinhal Grande;1;1;2;83
4313102;Nova Palma;4314472;Pinhal Grande;1;1;2;21
4203600;Campos Novos;4314464;Pinhal da Serra;1;1;2;50
4301800;Barracão;4314464;Pinhal da Serra;1;1;2;36
4302105;Bento Gonçalves;4314464;Pinhal da Serra;1;1;2;147
4312203;Maximiliano de Almeida;4314464;Pinhal da Serra;1;1;2;68
4300505;Alpestre;4314456;Pinhal;1;1;2;35
4305454;Cidreira;4314456;Pinhal;1;1;2;420
2308708;Morada Nova;4314423;Picada Café;1;1;2;2930
2312700;Senador Pompeu;4314423;Picada Café;1;1;2;2849
3550308;São Paulo;4314423;Picada Café;1;1;2;769
4303905;Campo Bom;4314423;Picada Café;1;1;2;27
4306403;Dois Irmãos;4314423;Picada Café;1;1;2;16
4309100;Gramado;4314423;Picada Café;1;1;2;23
4310801;Ivoti;4314423;Picada Café;1;1;2;16
4311643;Linha Nova;4314423;Picada Café;1;1;2;7
2304285;Eusébio;4314407;Pelotas;1;1;2;3316
2306306;Itapagé;4314407;Pelotas;1;1;2;3302
2408003;Mossoró;4314407;Pelotas;1;1;2;3223
3106705;Betim;4314407;Pelotas;1;1;2;1498
3170206;Uberlândia;4314407;Pelotas;1;1;2;1468
3201209;Cachoeiro de Itapemirim;4314407;Pelotas;1;1;2;1581
3205200;Vila Velha;4314407;Pelotas;1;1;2;1663
3205309;Vitória;4314407;Pelotas;1;1;2;1674
3304201;Resende;4314407;Pelotas;1;1;2;1249
3513009;Cotia;4314407;Pelotas;1;1;2;1029
3515004;Embu;4314407;Pelotas;1;1;2;1027
3516200;Franca;4314407;Pelotas;1;1;2;1318
3524709;Jaguariúna;4314407;Pelotas;1;1;2;1113
3534302;Orlândia;4314407;Pelotas;1;1;2;1285
3543402;Ribeirão Preto;4314407;Pelotas;1;1;2;1242
3556206;Valinhos;4314407;Pelotas;1;1;2;1087
4110953;Itaipulândia;4314407;Pelotas;1;1;2;752
4118501;Pato Branco;4314407;Pelotas;1;1;2;610
4120606;Prudentópolis;4314407;Pelotas;1;1;2;732
4125506;São José dos Pinhais;4314407;Pelotas;1;1;2;746
4204202;Chapecó;4314407;Pelotas;1;1;2;512
4204608;Criciúma;4314407;Pelotas;1;1;2;439
4205407;Florianópolis;4314407;Pelotas;1;1;2;581
4211603;Nova Veneza;4314407;Pelotas;1;1;2;435
4211900;Palhoça;4314407;Pelotas;1;1;2;564
4216008;São Carlos;4314407;Pelotas;1;1;2;520
4216602;São José;4314407;Pelotas;1;1;2;573
4300034;Aceguá;4314407;Pelotas;1;1;2;170
4300604;Alvorada;4314407;Pelotas;1;1;2;227
4302105;Bento Gonçalves;4314407;Pelotas;1;1;2;296
4302253;Boa Vista do Sul;4314407;Pelotas;1;1;2;271
4304358;Candiota;4314407;Pelotas;1;1;2;125
4305447;Chuvisca;4314407;Pelotas;1;1;2;114
4306106;Cruz Alta;4314407;Pelotas;1;1;2;360
4306502;Dom Feliciano;4314407;Pelotas;1;1;2;116
4307104;Herval;4314407;Pelotas;1;1;2;103
4307807;Estrela;4314407;Pelotas;1;1;2;250
4312807;Nova Araçá;4314407;Pelotas;1;1;2;345
4313300;Nova Prata;4314407;Pelotas;1;1;2;334
4314035;Pareci Novo;4314407;Pelotas;1;1;2;250
3170404;Unaí;4314308;Pejuçara;1;1;2;1473
4305207;Cerro Largo;4314308;Pejuçara;1;1;2;109
4310207;Ijuí;4314308;Pejuçara;1;1;2;26
4310603;Itaqui;4314308;Pejuçara;1;1;2;294
4311155;Jóia;4314308;Pejuçara;1;1;2;52
3550308;São Paulo;4314209;Pedro Osório;1;1;2;1069
4301602;Bagé;4314209;Pedro Osório;1;1;2;133
4303103;Cachoeirinha;4314209;Pedro Osório;1;1;2;266
3550308;São Paulo;4314175;Pedras Altas;1;1;2;1096
4301602;Bagé;4314175;Pedras Altas;1;1;2;65
4302659;Brochier;4314159;Paverama;1;1;2;11
4308078;Fazenda Vilanova;4314159;Paverama;1;1;2;10
4312153;Mato Leitão;4314159;Paverama;1;1;2;41
4300901;Aratiba;4314134;Paulo Bento;1;1;2;36
4303806;Campinas do Sul;4314134;Paulo Bento;1;1;2;20
1100254;Presidente Médici;4314100;Passo Fundo;1;1;2;2086
1302603;Manaus;4314100;Passo Fundo;1;1;2;2869
1600279;Laranjal do Jari;4314100;Passo Fundo;1;1;2;3003
2100808;Anapurus;4314100;Passo Fundo;1;1;2;2851
2304400;Fortaleza;4314100;Passo Fundo;1;1;2;2996
2306306;Itapagé;4314100;Passo Fundo;1;1;2;2964
2309706;Pacatuba;4314100;Passo Fundo;1;1;2;2971
2903201;Barreiras;4314100;Passo Fundo;1;1;2;1905
2928901;São Desidério;4314100;Passo Fundo;1;1;2;1890
3106705;Betim;4314100;Passo Fundo;1;1;2;1205
3201209;Cachoeiro de Itapemirim;4314100;Passo Fundo;1;1;2;1356
3303807;Parati;4314100;Passo Fundo;1;1;2;925
3304201;Resende;4314100;Passo Fundo;1;1;2;992
3523107;Itaquaquecetuba;4314100;Passo Fundo;1;1;2;786
3524402;Jacareí;4314100;Passo Fundo;1;1;2;827
3529005;Marília;4314100;Passo Fundo;1;1;2;708
3543907;Rio Claro;4314100;Passo Fundo;1;1;2;796
3548005;Santo Antônio de Posse;4314100;Passo Fundo;1;1;2;817
3548807;São Caetano do Sul;4314100;Passo Fundo;1;1;2;761
3548906;São Carlos;4314100;Passo Fundo;1;1;2;814
3551306;Sebastianópolis do Sul;4314100;Passo Fundo;1;1;2;874
3556206;Valinhos;4314100;Passo Fundo;1;1;2;782
4101002;Ampére;4314100;Passo Fundo;1;1;2;280
4102604;Barracão;4314100;Passo Fundo;1;1;2;254
4103800;Cambira;4314100;Passo Fundo;1;1;2;523
4104501;Capanema;4314100;Passo Fundo;1;1;2;316
4104808;Cascavel;4314100;Passo Fundo;1;1;2;381
4105706;Clevelândia;4314100;Passo Fundo;1;1;2;206
4106506;Coronel Vivida;4314100;Passo Fundo;1;1;2;251
4107207;Dois Vizinhos;4314100;Passo Fundo;1;1;2;286
4108403;Francisco Beltrão;4314100;Passo Fundo;1;1;2;249
4110409;Indianópolis;4314100;Passo Fundo;1;1;2;530
4113304;Laranjeiras do Sul;4314100;Passo Fundo;1;1;2;312
4117602;Palmas;4314100;Passo Fundo;1;1;2;198
4117701;Palmeira;4314100;Passo Fundo;1;1;2;390
4117909;Palotina;4314100;Passo Fundo;1;1;2;459
4119152;Pinhais;4314100;Passo Fundo;1;1;2;440
4119301;Pinhão;4314100;Passo Fundo;1;1;2;293
4119400;Piraí do Sul;4314100;Passo Fundo;1;1;2;474
4120606;Prudentópolis;4314100;Passo Fundo;1;1;2;361
4121406;Realeza;4314100;Passo Fundo;1;1;2;297
4123857;Santa Maria do Oeste;4314100;Passo Fundo;1;1;2;371
4124020;Santa Tereza do Oeste;4314100;Passo Fundo;1;1;2;375
4125605;São Mateus do Sul;4314100;Passo Fundo;1;1;2;332
4200101;Abelardo Luz;4314100;Passo Fundo;1;1;2;187
4202404;Blumenau;4314100;Passo Fundo;1;1;2;355
4202909;Brusque;4314100;Passo Fundo;1;1;2;364
4203204;Camboriú;4314100;Passo Fundo;1;1;2;386
4204558;Correia Pinto;4314100;Passo Fundo;1;1;2;213
4205308;Faxinal dos Guedes;4314100;Passo Fundo;1;1;2;156
4205456;Forquilhinha;4314100;Passo Fundo;1;1;2;293
4205902;Gaspar;4314100;Passo Fundo;1;1;2;366
4207304;Imbituba;4314100;Passo Fundo;1;1;2;358
4210100;Mafra;4314100;Passo Fundo;1;1;2;342
4211603;Nova Veneza;4314100;Passo Fundo;1;1;2;288
4211751;Otacílio Costa;4314100;Passo Fundo;1;1;2;238
4211900;Palhoça;4314100;Passo Fundo;1;1;2;364
4213203;Pomerode;4314100;Passo Fundo;1;1;2;356
4213609;Porto União;4314100;Passo Fundo;1;1;2;255
4216008;São Carlos;4314100;Passo Fundo;1;1;2;145
4216107;São Domingos;4314100;Passo Fundo;1;1;2;189
4216206;São Francisco do Sul;4314100;Passo Fundo;1;1;2;427
4216503;São Joaquim;4314100;Passo Fundo;1;1;2;238
4216602;São José;4314100;Passo Fundo;1;1;2;371
4216909;São Lourenço do Oeste;4314100;Passo Fundo;1;1;2;214
4217204;São Miguel do Oeste;4314100;Passo Fundo;1;1;2;205
4219705;Xaxim;4314100;Passo Fundo;1;1;2;144
4300059;Água Santa;4314100;Passo Fundo;1;1;2;37
4300109;Agudo;4314100;Passo Fundo;1;1;2;175
4300604;Alvorada;4314100;Passo Fundo;1;1;2;232
4301404;Arvorezinha;4314100;Passo Fundo;1;1;2;72
4301958;Barra Funda;4314100;Passo Fundo;1;1;2;73
4302907;Cacequi;4314100;Passo Fundo;1;1;2;302
4304408;Canela;4314100;Passo Fundo;1;1;2;197
4305306;Chapada;4314100;Passo Fundo;1;1;2;69
4306205;Cruzeiro do Sul;4314100;Passo Fundo;1;1;2;144
4306304;David Canabarro;4314100;Passo Fundo;1;1;2;56
4306908;Encruzilhada do Sul;4314100;Passo Fundo;1;1;2;250
4307054;Ernestina;4314100;Passo Fundo;1;1;2;32
4307302;Erval Seco;4314100;Passo Fundo;1;1;2;134
4307609;Estância Velha;4314100;Passo Fundo;1;1;2;196
4308003;Faxinal do Soturno;4314100;Passo Fundo;1;1;2;179
4309803;Ibiaçá;4314100;Passo Fundo;1;1;2;58
4310801;Ivoti;4314100;Passo Fundo;1;1;2;192
4311106;Jaguari;4314100;Passo Fundo;1;1;2;269
4311908;Marcelino Ramos;4314100;Passo Fundo;1;1;2;97
4312757;Nova Alvorada;4314100;Passo Fundo;1;1;2;52
4313375;Nova Santa Rita;4314100;Passo Fundo;1;1;2;209
4313508;Osório;4314100;Passo Fundo;1;1;2;277
4314001;Paraí;4314100;Passo Fundo;1;1;2;71
2307700;Maranguape;4314076;Passo do Sobrado;1;1;2;3114
3106200;Belo Horizonte;4314076;Passo do Sobrado;1;1;2;1336
3170206;Uberlândia;4314076;Passo do Sobrado;1;1;2;1257
3518800;Guarulhos;4314076;Passo do Sobrado;1;1;2;882
4108304;Foz do Iguaçu;4314076;Passo do Sobrado;1;1;2;515
4207007;Içara;4314076;Passo do Sobrado;1;1;2;308
4208203;Itajaí;4314076;Passo do Sobrado;1;1;2;458
4213708;Pouso Redondo;4314076;Passo do Sobrado;1;1;2;355
4302451;Boqueirão do Leão;4314076;Passo do Sobrado;1;1;2;51
4305173;Cerro Grande do Sul;4314076;Passo do Sobrado;1;1;2;107
4305355;Charqueadas;4314076;Passo do Sobrado;1;1;2;67
4304200;Candelária;4314068;Passa Sete;1;1;2;30
4313391;Novo Cabrais;4314068;Passa Sete;1;1;2;31
4314027;Paraíso do Sul;4314068;Passa Sete;1;1;2;30
2305233;Horizonte;4314050;Parobé;1;1;2;3038
3506508;Birigui;4314050;Parobé;1;1;2;923
3521408;Iracemápolis;4314050;Parobé;1;1;2;841
3524006;Itupeva;4314050;Parobé;1;1;2;801
3525904;Jundiaí;4314050;Parobé;1;1;2;805
3534401;Osasco;4314050;Parobé;1;1;2;775
4209607;Lauro Muller;4314050;Parobé;1;1;2;195
4300109;Agudo;4314050;Parobé;1;1;2;233
4301008;Arroio do Meio;4314050;Parobé;1;1;2;110
4302352;Bom Princípio;4314050;Parobé;1;1;2;52
4303509;Camaquã;4314050;Parobé;1;1;2;164
4304408;Canela;4314050;Parobé;1;1;2;32
4306403;Dois Irmãos;4314050;Parobé;1;1;2;25
4307906;Farroupilha;4314050;Parobé;1;1;2;66
4310330;Imbé;4314050;Parobé;1;1;2;76
4311403;Lajeado;4314050;Parobé;1;1;2;118
4313201;Nova Petrópolis;4314050;Parobé;1;1;2;39
4313409;Novo Hamburgo;4314050;Parobé;1;1;2;29
4304689;Capela de Santana;4314035;Pareci Novo;1;1;2;14
4305108;Caxias do Sul;4314035;Pareci Novo;1;1;2;57
4309555;Harmonia;4314035;Pareci Novo;1;1;2;8
4311791;Maratá;4314035;Pareci Novo;1;1;2;16
4313375;Nova Santa Rita;4314035;Pareci Novo;1;1;2;31
3534401;Osasco;4314027;Paraíso do Sul;1;1;2;906
2910800;Feira de Santana;4314001;Paraí;1;1;2;2161
3201506;Colatina;4314001;Paraí;1;1;2;1454
4215000;Rio Negrinho;4314001;Paraí;1;1;2;340
4302105;Bento Gonçalves;4314001;Paraí;1;1;2;68
4302303;Bom Jesus;4314001;Paraí;1;1;2;133
4305207;Cerro Largo;4314001;Paraí;1;1;2;292
4307906;Farroupilha;4314001;Paraí;1;1;2;83
4308607;Garibaldi;4314001;Paraí;1;1;2;77
4309902;Ibiraiaras;4314001;Paraí;1;1;2;29
4311601;Liberato Salzano;4314001;Paraí;1;1;2;167
4312609;Muçum;4314001;Paraí;1;1;2;61
4312906;Nova Bassano;4314001;Paraí;1;1;2;16
4313300;Nova Prata;4314001;Paraí;1;1;2;27
4313409;Novo Hamburgo;4314001;Paraí;1;1;2;138
2800308;Aracaju;4313953;Pantano Grande;1;1;2;2545
3304557;Rio de Janeiro;4313953;Pantano Grande;1;1;2;1174
3550308;São Paulo;4313953;Pantano Grande;1;1;2;901
4204251;Cocal do Sul;4313953;Pantano Grande;1;1;2;340
4204608;Criciúma;4313953;Pantano Grande;1;1;2;332
4207007;Içara;4313953;Pantano Grande;1;1;2;336
4211702;Orleans;4313953;Pantano Grande;1;1;2;357
4301602;Bagé;4313953;Pantano Grande;1;1;2;210
4303103;Cachoeirinha;4313953;Pantano Grande;1;1;2;124
4307500;Espumoso;4313953;Pantano Grande;1;1;2;169
4307906;Farroupilha;4313953;Pantano Grande;1;1;2;146
4310009;Ibirubá;4313953;Pantano Grande;1;1;2;186
4311403;Lajeado;4313953;Pantano Grande;1;1;2;90
3103504;Araguari;4313904;Panambi;1;1;2;1178
3506003;Bauru;4313904;Panambi;1;1;2;782
3519600;Ibitinga;4313904;Panambi;1;1;2;849
3534401;Osasco;4313904;Panambi;1;1;2;832
3543907;Rio Claro;4313904;Panambi;1;1;2;864
3550209;São Miguel Arcanjo;4313904;Panambi;1;1;2;720
4101804;Araucária;4313904;Panambi;1;1;2;497
4106902;Curitiba;4313904;Panambi;1;1;2;515
4203204;Camboriú;4313904;Panambi;1;1;2;489
4204202;Chapecó;4313904;Panambi;1;1;2;155
4216602;São José;4313904;Panambi;1;1;2;477
4300208;Ajuricaba;4313904;Panambi;1;1;2;27
4300406;Alegrete;4313904;Panambi;1;1;2;279
4302204;Boa Vista do Buricá;4313904;Panambi;1;1;2;90
4303103;Cachoeirinha;4313904;Panambi;1;1;2;300
4303509;Camaquã;4313904;Panambi;1;1;2;330
4305009;Catuípe;4313904;Panambi;1;1;2;50
4305108;Caxias do Sul;4313904;Panambi;1;1;2;249
4305207;Cerro Largo;4313904;Panambi;1;1;2;122
4309001;Giruá;4313904;Panambi;1;1;2;88
4311403;Lajeado;4313904;Panambi;1;1;2;194
4311775;Maquiné;4313904;Panambi;1;1;2;360
4311809;Marau;4313904;Panambi;1;1;2;129
4305207;Cerro Largo;4313805;Palmitinho;1;1;2;147
3534401;Osasco;4313706;Palmeira das Missões;1;1;2;796
3550308;São Paulo;4313706;Palmeira das Missões;1;1;2;799
4115606;Matelândia;4313706;Palmeira das Missões;1;1;2;301
4204707;Cunha Porã;4313706;Palmeira das Missões;1;1;2;113
4208203;Itajaí;4313706;Palmeira das Missões;1;1;2;461
4217501;Seara;4313706;Palmeira das Missões;1;1;2;130
4219507;Xanxerê;4313706;Palmeira das Missões;1;1;2;146
4301602;Bagé;4313706;Palmeira das Missões;1;1;2;388
4302154;Boa Vista das Missões;4313706;Palmeira das Missões;1;1;2;27
4303103;Cachoeirinha;4313706;Palmeira das Missões;1;1;2;315
4303509;Camaquã;4313706;Palmeira das Missões;1;1;2;358
4304606;Canoas;4313706;Palmeira das Missões;1;1;2;307
4305108;Caxias do Sul;4313706;Palmeira das Missões;1;1;2;254
4305801;Constantina;4313706;Palmeira das Missões;1;1;2;38
4305900;Coronel Bicaco;4313706;Palmeira das Missões;1;1;2;43
4306007;Crissiumal;4313706;Palmeira das Missões;1;1;2;89
4307906;Farroupilha;4313706;Palmeira das Missões;1;1;2;245
4309605;Horizontina;4313706;Palmeira das Missões;1;1;2;102
4311403;Lajeado;4313706;Palmeira das Missões;1;1;2;212
4311809;Marau;4313706;Palmeira das Missões;1;1;2;126
3304557;Rio de Janeiro;4313656;Palmares do Sul;1;1;2;1060
3534401;Osasco;4313656;Palmares do Sul;1;1;2;822
4218707;Tubarão;4313656;Palmares do Sul;1;1;2;241
4301057;Arroio do Sal;4313656;Palmares do Sul;1;1;2;99
4303004;Cachoeira do Sul;4313656;Palmares do Sul;1;1;2;232
4304671;Capivari do Sul;4313656;Palmares do Sul;1;1;2;13
4307708;Esteio;4313656;Palmares do Sul;1;1;2;78
4309209;Gravataí;4313656;Palmares do Sul;1;1;2;58
4309308;Guaíba;4313656;Palmares do Sul;1;1;2;81
4312500;Mostardas;4313656;Palmares do Sul;1;1;2;102
4312203;Maximiliano de Almeida;4313607;Paim Filho;1;1;2;10
2905701;Camaçari;4313508;Osório;1;1;2;2191
3509502;Campinas;4313508;Osório;1;1;2;830
3516200;Franca;4313508;Osório;1;1;2;1068
3543402;Ribeirão Preto;4313508;Osório;1;1;2;994
4125506;São José dos Pinhais;4313508;Osório;1;1;2;492
4201406;Araranguá;4313508;Osório;1;1;2;128
4204608;Criciúma;4313508;Osório;1;1;2;159
4205902;Gaspar;4313508;Osório;1;1;2;350
4210803;Meleiro;4313508;Osório;1;1;2;131
4211900;Palhoça;4313508;Osório;1;1;2;287
4216206;São Francisco do Sul;4313508;Osório;1;1;2;427
4216602;São José;4313508;Osório;1;1;2;296
4217709;Sombrio;4313508;Osório;1;1;2;104
4304200;Candelária;4313508;Osório;1;1;2;247
4304671;Capivari do Sul;4313508;Osório;1;1;2;38
4306403;Dois Irmãos;4313508;Osório;1;1;2;85
4307807;Estrela;4313508;Osório;1;1;2;169
4308201;Flores da Cunha;4313508;Osório;1;1;2;129
4309100;Gramado;4313508;Osório;1;1;2;82
4313201;Nova Petrópolis;4313508;Osório;1;1;2;99
4311601;Liberato Salzano;4313466;Novo Xingu;1;1;2;16
4300646;Ametista do Sul;4313441;Novo Tiradentes;1;1;2;22
4305157;Cerro Grande;4313441;Novo Tiradentes;1;1;2;5
4305207;Cerro Largo;4313425;Novo Machado;1;1;2;68
1500800;Ananindeua;4313409;Novo Hamburgo;1;1;2;3143
1504422;Marituba;4313409;Novo Hamburgo;1;1;2;3144
2112209;Timon;4313409;Novo Hamburgo;1;1;2;2819
2302800;Canindé;4313409;Novo Hamburgo;1;1;2;3001
2306405;Itapipoca;4313409;Novo Hamburgo;1;1;2;3080
2307304;Juazeiro do Norte;4313409;Novo Hamburgo;1;1;2;2707
2307650;Maracanaú;4313409;Novo Hamburgo;1;1;2;3074
2307700;Maranguape;4313409;Novo Hamburgo;1;1;2;3069
2311801;Russas;4313409;Novo Hamburgo;1;1;2;2988
2607901;Jaboatão dos Guararapes;4313409;Novo Hamburgo;1;1;2;2799
2908507;Conceição do Jacuípe;4313409;Novo Hamburgo;1;1;2;2227
2916401;Itapetinga;4313409;Novo Hamburgo;1;1;2;1882
2933307;Vitória da Conquista;4313409;Novo Hamburgo;1;1;2;1893
3118601;Contagem;4313409;Novo Hamburgo;1;1;2;1265
3125101;Extrema;4313409;Novo Hamburgo;1;1;2;882
3133808;Itaúna;4313409;Novo Hamburgo;1;1;2;1224
3143302;Montes Claros;4313409;Novo Hamburgo;1;1;2;1583
3205002;Serra;4313409;Novo Hamburgo;1;1;2;1461
3205200;Vila Velha;4313409;Novo Hamburgo;1;1;2;1441
3205309;Vitória;4313409;Novo Hamburgo;1;1;2;1452
3301009;Campos dos Goytacazes;4313409;Novo Hamburgo;1;1;2;1268
3301702;Duque de Caxias;4313409;Novo Hamburgo;1;1;2;1062
3303302;Niterói;4313409;Novo Hamburgo;1;1;2;1067
3305109;São João de Meriti;4313409;Novo Hamburgo;1;1;2;1055
3306008;Três Rios;4313409;Novo Hamburgo;1;1;2;1122
3500709;Agudos;4313409;Novo Hamburgo;1;1;2;823
3501608;Americana;4313409;Novo Hamburgo;1;1;2;848
3501905;Amparo;4313409;Novo Hamburgo;1;1;2;876
3507308;Boracéia;4313409;Novo Hamburgo;1;1;2;859
3511102;Catanduva;4313409;Novo Hamburgo;1;1;2;967
3513009;Cotia;4313409;Novo Hamburgo;1;1;2;782
3513801;Diadema;4313409;Novo Hamburgo;1;1;2;790
3522208;Itapecerica da Serra;4313409;Novo Hamburgo;1;1;2;775
3523107;Itaquaquecetuba;4313409;Novo Hamburgo;1;1;2;822
3523404;Itatiba;4313409;Novo Hamburgo;1;1;2;843
3524709;Jaguariúna;4313409;Novo Hamburgo;1;1;2;866
3527306;Louveira;4313409;Novo Hamburgo;1;1;2;831
3529401;Mauá;4313409;Novo Hamburgo;1;1;2;799
3533403;Nova Odessa;4313409;Novo Hamburgo;1;1;2;847
3538600;Piracaia;4313409;Novo Hamburgo;1;1;2;861
3547304;Santana de Parnaíba;4313409;Novo Hamburgo;1;1;2;797
3548500;Santos;4313409;Novo Hamburgo;1;1;2;784
3548708;São Bernardo do Campo;4313409;Novo Hamburgo;1;1;2;788
3552403;Sumaré;4313409;Novo Hamburgo;1;1;2;843
4104808;Cascavel;4313409;Novo Hamburgo;1;1;2;570
4117602;Palmas;4313409;Novo Hamburgo;1;1;2;362
4118204;Paranaguá;4313409;Novo Hamburgo;1;1;2;516
4125506;São José dos Pinhais;4313409;Novo Hamburgo;1;1;2;496
4201406;Araranguá;4313409;Novo Hamburgo;1;1;2;178
4202008;Balneário Camboriú;4313409;Novo Hamburgo;1;1;2;380
4203006;Caçador;4313409;Novo Hamburgo;1;1;2;320
4211603;Nova Veneza;4313409;Novo Hamburgo;1;1;2;195
4211900;Palhoça;4313409;Novo Hamburgo;1;1;2;322
4213609;Porto União;4313409;Novo Hamburgo;1;1;2;377
4218707;Tubarão;4313409;Novo Hamburgo;1;1;2;241
4300604;Alvorada;4313409;Novo Hamburgo;1;1;2;34
4300638;Amaral Ferrador;4313409;Novo Hamburgo;1;1;2;171
4300877;Araricá;4313409;Novo Hamburgo;1;1;2;20
4301057;Arroio do Sal;4313409;Novo Hamburgo;1;1;2;120
4301909;Barra do Ribeiro;4313409;Novo Hamburgo;1;1;2;70
4303608;Cambará do Sul;4313409;Novo Hamburgo;1;1;2;118
4304408;Canela;4313409;Novo Hamburgo;1;1;2;49
4304689;Capela de Santana;4313409;Novo Hamburgo;1;1;2;19
4307005;Erechim;4313409;Novo Hamburgo;1;1;2;253
4307104;Herval;4313409;Novo Hamburgo;1;1;2;341
4307815;Estrela Velha;4313409;Novo Hamburgo;1;1;2;204
4308508;Frederico Westphalen;4313409;Novo Hamburgo;1;1;2;337
4309050;Glorinha;4313409;Novo Hamburgo;1;1;2;41
4311791;Maratá;4313409;Novo Hamburgo;1;1;2;47
4311809;Marau;4313409;Novo Hamburgo;1;1;2;172
4312443;Morrinhos do Sul;4313409;Novo Hamburgo;1;1;2;121
4312807;Nova Araçá;4313409;Novo Hamburgo;1;1;2;129
4305132;Cerro Branco;4313391;Novo Cabrais;1;1;2;9
4309753;Ibarama;4313391;Novo Cabrais;1;1;2;38
3304557;Rio de Janeiro;4313375;Nova Santa Rita;1;1;2;1078
3513504;Cubatão;4313375;Nova Santa Rita;1;1;2;803
3515004;Embu;4313375;Nova Santa Rita;1;1;2;804
3522208;Itapecerica da Serra;4313375;Nova Santa Rita;1;1;2;797
3522505;Itapevi;4313375;Nova Santa Rita;1;1;2;809
3525904;Jundiaí;4313375;Nova Santa Rita;1;1;2;846
3548708;São Bernardo do Campo;4313375;Nova Santa Rita;1;1;2;811
3556701;Vinhedo;4313375;Nova Santa Rita;1;1;2;857
4106902;Curitiba;4313375;Nova Santa Rita;1;1;2;525
4205407;Florianópolis;4313375;Nova Santa Rita;1;1;2;364
4304671;Capivari do Sul;4313375;Nova Santa Rita;1;1;2;80
4305108;Caxias do Sul;4313375;Nova Santa Rita;1;1;2;78
4306767;Eldorado do Sul;4313375;Nova Santa Rita;1;1;2;42
4309605;Horizontina;4313375;Nova Santa Rita;1;1;2;381
4310207;Ijuí;4313375;Nova Santa Rita;1;1;2;301
4310801;Ivoti;4313375;Nova Santa Rita;1;1;2;31
4120804;Quatro Barras;4313359;Nova Roma do Sul;1;1;2;460
4307906;Farroupilha;4313359;Nova Roma do Sul;1;1;2;27
4310207;Ijuí;4313334;Nova Ramada;1;1;2;43
2408003;Mossoró;4313300;Nova Prata;1;1;2;2920
2910800;Feira de Santana;4313300;Nova Prata;1;1;2;2168
3118601;Contagem;4313300;Nova Prata;1;1;2;1211
3125101;Extrema;4313300;Nova Prata;1;1;2;828
3201209;Cachoeiro de Itapemirim;4313300;Nova Prata;1;1;2;1329
3513801;Diadema;4313300;Nova Prata;1;1;2;739
3534401;Osasco;4313300;Nova Prata;1;1;2;741
3548708;São Bernardo do Campo;4313300;Nova Prata;1;1;2;739
4211900;Palhoça;4313300;Nova Prata;1;1;2;306
4215802;São Bento do Sul;4313300;Nova Prata;1;1;2;353
4303103;Cachoeirinha;4313300;Nova Prata;1;1;2;138
4304408;Canela;4313300;Nova Prata;1;1;2;100
4304606;Canoas;4313300;Nova Prata;1;1;2;132
4304630;Capão da Canoa;4313300;Nova Prata;1;1;2;188
4304705;Carazinho;4313300;Nova Prata;1;1;2;126
4305207;Cerro Largo;4313300;Nova Prata;1;1;2;312
4305959;Cotiporã;4313300;Nova Prata;1;1;2;25
4306403;Dois Irmãos;4313300;Nova Prata;1;1;2;102
4306809;Encantado;4313300;Nova Prata;1;1;2;57
4307005;Erechim;4313300;Nova Prata;1;1;2;143
4307708;Esteio;4313300;Nova Prata;1;1;2;125
4309407;Guaporé;4313300;Nova Prata;1;1;2;30
4311403;Lajeado;4313300;Nova Prata;1;1;2;83
4311809;Marau;4313300;Nova Prata;1;1;2;68
4312807;Nova Araçá;4313300;Nova Prata;1;1;2;19
2307700;Maranguape;4313201;Nova Petrópolis;1;1;2;3038
2311801;Russas;4313201;Nova Petrópolis;1;1;2;2957
3106200;Belo Horizonte;4313201;Nova Petrópolis;1;1;2;1243
3304557;Rio de Janeiro;4313201;Nova Petrópolis;1;1;2;1033
3513009;Cotia;4313201;Nova Petrópolis;1;1;2;753
3516200;Franca;4313201;Nova Petrópolis;1;1;2;1038
3534401;Osasco;4313201;Nova Petrópolis;1;1;2;766
3543402;Ribeirão Preto;4313201;Nova Petrópolis;1;1;2;963
3548807;São Caetano do Sul;4313201;Nova Petrópolis;1;1;2;770
4113700;Londrina;4313201;Nova Petrópolis;1;1;2;673
4125506;São José dos Pinhais;4313201;Nova Petrópolis;1;1;2;463
4208302;Itapema;4313201;Nova Petrópolis;1;1;2;347
4300570;Alto Feliz;4313201;Nova Petrópolis;1;1;2;21
4303103;Cachoeirinha;4313201;Nova Petrópolis;1;1;2;63
4304606;Canoas;4313201;Nova Petrópolis;1;1;2;60
4306908;Encruzilhada do Sul;4313201;Nova Petrópolis;1;1;2;189
4308201;Flores da Cunha;4313201;Nova Petrópolis;1;1;2;39
4308607;Garibaldi;4313201;Nova Petrópolis;1;1;2;43
4311403;Lajeado;4313201;Nova Petrópolis;1;1;2;89
4311643;Linha Nova;4313201;Nova Petrópolis;1;1;2;13
4312658;Não-Me-Toque;4313201;Nova Petrópolis;1;1;2;194
4300109;Agudo;4313102;Nova Palma;1;1;2;29
4309209;Gravataí;4313102;Nova Palma;1;1;2;247
4310538;Itaara;4313102;Nova Palma;1;1;2;33
4302055;Benjamin Constant do Sul;4313086;Nova Pádua;1;1;2;210
4304804;Carlos Barbosa;4313086;Nova Pádua;1;1;2;35
4305108;Caxias do Sul;4313086;Nova Pádua;1;1;2;20
3534401;Osasco;4313060;Nova Hartz;1;1;2;774
4303103;Cachoeirinha;4313060;Nova Hartz;1;1;2;45
4304606;Canoas;4313060;Nova Hartz;1;1;2;46
4306908;Encruzilhada do Sul;4313060;Nova Hartz;1;1;2;191
4307609;Estância Velha;4313060;Nova Hartz;1;1;2;27
4307906;Farroupilha;4313060;Nova Hartz;1;1;2;58
4311403;Lajeado;4313060;Nova Hartz;1;1;2;110
4305207;Cerro Largo;4313037;Nova Esperança do Sul;1;1;2;139
4311106;Jaguari;4313037;Nova Esperança do Sul;1;1;2;9
4306007;Crissiumal;4313011;Nova Candelária;1;1;2;12
4309704;Humaitá;4313011;Nova Candelária;1;1;2;14
3125101;Extrema;4312906;Nova Bassano;1;1;2;828
3512803;Cosmópolis;4312906;Nova Bassano;1;1;2;799
3515004;Embu;4312906;Nova Bassano;1;1;2;729
3547809;Santo André;4312906;Nova Bassano;1;1;2;749
3548708;São Bernardo do Campo;4312906;Nova Bassano;1;1;2;740
4303103;Cachoeirinha;4312906;Nova Bassano;1;1;2;148
4304630;Capão da Canoa;4312906;Nova Bassano;1;1;2;199
4304903;Casca;4312906;Nova Bassano;1;1;2;32
4307906;Farroupilha;4312906;Nova Bassano;1;1;2;66
4311403;Lajeado;4312906;Nova Bassano;1;1;2;85
4312807;Nova Araçá;4312906;Nova Bassano;1;1;2;8
4302105;Bento Gonçalves;4312807;Nova Araçá;1;1;2;60
4309407;Guaporé;4312807;Nova Araçá;1;1;2;26
4309902;Ibiraiaras;4312807;Nova Araçá;1;1;2;34
4311304;Lagoa Vermelha;4312807;Nova Araçá;1;1;2;54
4311403;Lajeado;4312807;Nova Araçá;1;1;2;90
4312757;Nova Alvorada;4312807;Nova Araçá;1;1;2;41
4311809;Marau;4312757;Nova Alvorada;1;1;2;26
3534401;Osasco;4312708;Nonoai;1;1;2;720
4104808;Cascavel;4312708;Nonoai;1;1;2;276
4217501;Seara;4312708;Nonoai;1;1;2;51
4219507;Xanxerê;4312708;Nonoai;1;1;2;66
4300646;Ametista do Sul;4312708;Nonoai;1;1;2;41
4303103;Cachoeirinha;4312708;Nonoai;1;1;2;331
4304804;Carlos Barbosa;4312708;Nonoai;1;1;2;249
4305108;Caxias do Sul;4312708;Nonoai;1;1;2;255
4305801;Constantina;4312708;Nonoai;1;1;2;47
4308052;Faxinalzinho;4312708;Nonoai;1;1;2;11
4311304;Lagoa Vermelha;4312708;Nonoai;1;1;2;155
4304804;Carlos Barbosa;4312674;Nicolau Vergueiro;1;1;2;127
4312658;Não-Me-Toque;4312674;Nicolau Vergueiro;1;1;2;36
2919553;Luís Eduardo magalhães;4312658;Não-Me-Toque;1;1;2;1924
3148004;Patos de Minas;4312658;Não-Me-Toque;1;1;2;1246
3534401;Osasco;4312658;Não-Me-Toque;1;1;2;795
4109401;Guarapuava;4312658;Não-Me-Toque;1;1;2;364
4114401;Mangueirinha;4312658;Não-Me-Toque;1;1;2;286
4301404;Arvorezinha;4312658;Não-Me-Toque;1;1;2;78
4303103;Cachoeirinha;4312658;Não-Me-Toque;1;1;2;236
4305108;Caxias do Sul;4312658;Não-Me-Toque;1;1;2;180
4305207;Cerro Largo;4312658;Não-Me-Toque;1;1;2;190
4311304;Lagoa Vermelha;4312658;Não-Me-Toque;1;1;2;130
4311403;Lajeado;4312658;Não-Me-Toque;1;1;2;133
4312138;Mato Castelhano;4312658;Não-Me-Toque;1;1;2;65
4305504;Ciríaco;4312625;Muliterno;1;1;2;11
4305108;Caxias do Sul;4312617;Muitos Capões;1;1;2;94
4309902;Ibiraiaras;4312617;Muitos Capões;1;1;2;45
4302105;Bento Gonçalves;4312609;Muçum;1;1;2;37
4306908;Encruzilhada do Sul;4312609;Muçum;1;1;2;165
4307807;Estrela;4312609;Muçum;1;1;2;41
4308805;General Câmara;4312609;Muçum;1;1;2;86
4311304;Lagoa Vermelha;4312609;Muçum;1;1;2;109
4311403;Lajeado;4312609;Muçum;1;1;2;35
4312385;Monte Belo do Sul;4312609;Muçum;1;1;2;23
3522307;Itapetininga;4312500;Mostardas;1;1;2;875
4308607;Garibaldi;4312500;Mostardas;1;1;2;213
3550308;São Paulo;4312476;Morro Reuter;1;1;2;775
4310108;Igrejinha;4312476;Morro Reuter;1;1;2;28
4218806;Turvo;4312443;Morrinhos do Sul;1;1;2;55
4301057;Arroio do Sal;4312443;Morrinhos do Sul;1;1;2;19
4308300;Fontoura Xavier;4312427;Mormaço;1;1;2;47
2611606;Recife;4312401;Montenegro;1;1;2;2819
3106200;Belo Horizonte;4312401;Montenegro;1;1;2;1288
3205200;Vila Velha;4312401;Montenegro;1;1;2;1464
3513009;Cotia;4312401;Montenegro;1;1;2;798
3529401;Mauá;4312401;Montenegro;1;1;2;817
3543303;Ribeirão Pires;4312401;Montenegro;1;1;2;816
4119152;Pinhais;4312401;Montenegro;1;1;2;517
4119905;Ponta Grossa;4312401;Montenegro;1;1;2;521
4213104;Piratuba;4312401;Montenegro;1;1;2;250
4215000;Rio Negrinho;4312401;Montenegro;1;1;2;423
4300604;Alvorada;4312401;Montenegro;1;1;2;54
4300661;André da Rocha;4312401;Montenegro;1;1;2;115
4301057;Arroio do Sal;4312401;Montenegro;1;1;2;155
4302352;Bom Princípio;4312401;Montenegro;1;1;2;24
4302402;Bom Retiro do Sul;4312401;Montenegro;1;1;2;44
4303004;Cachoeira do Sul;4312401;Montenegro;1;1;2;142
4303905;Campo Bom;4312401;Montenegro;1;1;2;43
4304630;Capão da Canoa;4312401;Montenegro;1;1;2;141
4304705;Carazinho;4312401;Montenegro;1;1;2;196
4305355;Charqueadas;4312401;Montenegro;1;1;2;34
4306205;Cruzeiro do Sul;4312401;Montenegro;1;1;2;54
4306403;Dois Irmãos;4312401;Montenegro;1;1;2;41
4306809;Encantado;4312401;Montenegro;1;1;2;62
4306908;Encruzilhada do Sul;4312401;Montenegro;1;1;2;139
4307708;Esteio;4312401;Montenegro;1;1;2;37
4309407;Guaporé;4312401;Montenegro;1;1;2;100
4309555;Harmonia;4312401;Montenegro;1;1;2;15
4311304;Lagoa Vermelha;4312401;Montenegro;1;1;2;162
4304804;Carlos Barbosa;4312385;Monte Belo do Sul;1;1;2;22
4307401;Esmeralda;4312385;Monte Belo do Sul;1;1;2;129
4308607;Garibaldi;4312385;Monte Belo do Sul;1;1;2;17
4308508;Frederico Westphalen;4312351;Montauri;1;1;2;192
4311809;Marau;4312351;Montauri;1;1;2;26
4204202;Chapecó;4312302;Miraguaí;1;1;2;116
4304002;Campo Novo;4312302;Miraguaí;1;1;2;21
4127106;Telêmaco Borba;4312252;Minas do Leão;1;1;2;651
4204608;Criciúma;4312252;Minas do Leão;1;1;2;302
4301107;Arroio dos Ratos;4312252;Minas do Leão;1;1;2;31
4303103;Cachoeirinha;4312252;Minas do Leão;1;1;2;92
4305355;Charqueadas;4312252;Minas do Leão;1;1;2;45
4306767;Eldorado do Sul;4312252;Minas do Leão;1;1;2;42
4309001;Giruá;4312252;Minas do Leão;1;1;2;320
4310009;Ibirubá;4312252;Minas do Leão;1;1;2;194
1100205;Porto Velho;4312203;Maximiliano de Almeida;1;1;2;2371
1100304;Vilhena;4312203;Maximiliano de Almeida;1;1;2;1819
4200507;Águas de Chapecó;4312203;Maximiliano de Almeida;1;1;2;132
4305108;Caxias do Sul;4312203;Maximiliano de Almeida;1;1;2;181
4305207;Cerro Largo;4312203;Maximiliano de Almeida;1;1;2;296
4311908;Marcelino Ramos;4312203;Maximiliano de Almeida;1;1;2;22
4303301;Caibaté;4312179;Mato Queimado;1;1;2;7
4305207;Cerro Largo;4312179;Mato Queimado;1;1;2;16
3106200;Belo Horizonte;4312153;Mato Leitão;1;1;2;1310
3504008;Assis;4312153;Mato Leitão;1;1;2;776
4304663;Capão do Leão;4312153;Mato Leitão;1;1;2;251
4311403;Lajeado;4312153;Mato Leitão;1;1;2;16
4300059;Água Santa;4312138;Mato Castelhano;1;1;2;19
4311809;Marau;4312138;Mato Castelhano;1;1;2;19
4302907;Cacequi;4312104;Mata;1;1;2;51
4304200;Candelária;4312104;Mata;1;1;2;160
4204301;Concórdia;4312005;Mariano Moro;1;1;2;20
4301750;Barão do Triunfo;4311981;Mariana Pimentel;1;1;2;15
4303004;Cachoeira do Sul;4311981;Mariana Pimentel;1;1;2;133
4115309;Mariópolis;4311908;Marcelino Ramos;1;1;2;138
1100122;Ji-Paraná;4311809;Marau;1;1;2;2137
2604106;Caruaru;4311809;Marau;1;1;2;2687
2802908;Itabaiana;4311809;Marau;1;1;2;2400
3534401;Osasco;4311809;Marau;1;1;2;752
4101804;Araucária;4311809;Marau;1;1;2;417
4106902;Curitiba;4311809;Marau;1;1;2;436
4118501;Pato Branco;4311809;Marau;1;1;2;250
4119905;Ponta Grossa;4311809;Marau;1;1;2;419
4202305;Biguaçu;4311809;Marau;1;1;2;357
4202909;Brusque;4311809;Marau;1;1;2;354
4204301;Concórdia;4311809;Marau;1;1;2;137
4204806;Curitibanos;4311809;Marau;1;1;2;203
4205407;Florianópolis;4311809;Marau;1;1;2;372
4209102;Joinville;4311809;Marau;1;1;2;403
4217204;São Miguel do Oeste;4311809;Marau;1;1;2;233
4217501;Seara;4311809;Marau;1;1;2;144
4219309;Videira;4311809;Marau;1;1;2;189
4300703;Anta Gorda;4311809;Marau;1;1;2;61
4301602;Bagé;4311809;Marau;1;1;2;371
4303103;Cachoeirinha;4311809;Marau;1;1;2;198
4303509;Camaquã;4311809;Marau;1;1;2;267
4303806;Campinas do Sul;4311809;Marau;1;1;2;91
4304630;Capão da Canoa;4311809;Marau;1;1;2;257
4304804;Carlos Barbosa;4311809;Marau;1;1;2;116
4305207;Cerro Largo;4311809;Marau;1;1;2;250
4306106;Cruz Alta;4311809;Marau;1;1;2;138
4306403;Dois Irmãos;4311809;Marau;1;1;2;167
4307559;Estação;4311809;Marau;1;1;2;60
4307906;Farroupilha;4311809;Marau;1;1;2;121
4308904;Getúlio Vargas;4311809;Marau;1;1;2;63
4309050;Glorinha;4311809;Marau;1;1;2;213
4309100;Gramado;4311809;Marau;1;1;2;165
4309407;Guaporé;4311809;Marau;1;1;2;52
4309951;Ibirapuitã;4311809;Marau;1;1;2;36
4311403;Lajeado;4311809;Marau;1;1;2;110
4303103;Cachoeirinha;4311791;Maratá;1;1;2;64
2104057;Estreito;4311775;Maquiné;1;1;2;2569
4304630;Capão da Canoa;4311775;Maquiné;1;1;2;18
4305108;Caxias do Sul;4311759;Manoel Viana;1;1;2;419
4305207;Cerro Largo;4311759;Manoel Viana;1;1;2;172
4217709;Sombrio;4311734;Mampituba;1;1;2;29
3550308;São Paulo;4311718;Maçambara;1;1;2;1080
4310553;Itacurubi;4311718;Maçambara;1;1;2;87
4204004;Catanduvas;4311700;Machadinho;1;1;2;55
4209300;Lages;4311700;Machadinho;1;1;2;134
4219853;Zortéa;4311700;Machadinho;1;1;2;17
4301701;Barão de Cotegipe;4311700;Machadinho;1;1;2;71
4301800;Barracão;4311700;Machadinho;1;1;2;24
4305108;Caxias do Sul;4311700;Machadinho;1;1;2;183
4305207;Cerro Largo;4311700;Machadinho;1;1;2;310
4306767;Eldorado do Sul;4311700;Machadinho;1;1;2;279
4307005;Erechim;4311700;Machadinho;1;1;2;61
4311304;Lagoa Vermelha;4311700;Machadinho;1;1;2;72
2306306;Itapagé;4311643;Linha Nova;1;1;2;3041
4302808;Caçapava do Sul;4311627;Lindolfo Collor;1;1;2;238
4304606;Canoas;4311627;Lindolfo Collor;1;1;2;35
4307609;Estância Velha;4311627;Lindolfo Collor;1;1;2;8
4308102;Feliz;4311627;Lindolfo Collor;1;1;2;17
4211009;Mondaí;4311601;Liberato Salzano;1;1;2;67
4300505;Alpestre;4311601;Liberato Salzano;1;1;2;39
4304358;Candiota;4311502;Lavras do Sul;1;1;2;85
4305207;Cerro Largo;4311502;Lavras do Sul;1;1;2;305
4309100;Gramado;4311502;Lavras do Sul;1;1;2;324
1505536;Parauapebas;4311403;Lajeado;1;1;2;2600
1507151;São Domingos do Araguaia;4311403;Lajeado;1;1;2;2661
2611606;Recife;4311403;Lajeado;1;1;2;2827
2919553;Luís Eduardo magalhães;4311403;Lajeado;1;1;2;2001
3170206;Uberlândia;4311403;Lajeado;1;1;2;1218
3304557;Rio de Janeiro;4311403;Lajeado;1;1;2;1100
3505708;Barueri;4311403;Lajeado;1;1;2;817
3509502;Campinas;4311403;Lajeado;1;1;2;862
3515004;Embu;4311403;Lajeado;1;1;2;806
3525904;Jundiaí;4311403;Lajeado;1;1;2;845
3534401;Osasco;4311403;Lajeado;1;1;2;820
4107207;Dois Vizinhos;4311403;Lajeado;1;1;2;421
4108403;Francisco Beltrão;4311403;Lajeado;1;1;2;384
4118501;Pato Branco;4311403;Lajeado;1;1;2;360
4121406;Realeza;4311403;Lajeado;1;1;2;430
4125506;São José dos Pinhais;4311403;Lajeado;1;1;2;510
4128203;União da Vitória;4311403;Lajeado;1;1;2;359
4201505;Armazém;4311403;Lajeado;1;1;2;318
4202800;Braço do Norte;4311403;Lajeado;1;1;2;305
4203006;Caçador;4311403;Lajeado;1;1;2;305
4203600;Campos Novos;4311403;Lajeado;1;1;2;236
4203956;Capivari de Baixo;4311403;Lajeado;1;1;2;316
4204251;Cocal do Sul;4311403;Lajeado;1;1;2;277
4204806;Curitibanos;4311403;Lajeado;1;1;2;276
4205456;Forquilhinha;4311403;Lajeado;1;1;2;259
4205506;Fraiburgo;4311403;Lajeado;1;1;2;287
4206207;Gravatal;4311403;Lajeado;1;1;2;314
4208807;Jaguaruna;4311403;Lajeado;1;1;2;304
4209409;Laguna;4311403;Lajeado;1;1;2;327
4210506;Maravilha;4311403;Lajeado;1;1;2;315
4211207;Morro da Fumaça;4311403;Lajeado;1;1;2;286
4211702;Orleans;4311403;Lajeado;1;1;2;289
4212106;Palmitos;4311403;Lajeado;1;1;2;283
4216008;São Carlos;4311403;Lajeado;1;1;2;278
4216909;São Lourenço do Oeste;4311403;Lajeado;1;1;2;348
4217006;São Ludgero;4311403;Lajeado;1;1;2;301
4217204;São Miguel do Oeste;4311403;Lajeado;1;1;2;336
4217709;Sombrio;4311403;Lajeado;1;1;2;232
4219002;Urussanga;4311403;Lajeado;1;1;2;276
4219309;Videira;4311403;Lajeado;1;1;2;282
4219507;Xanxerê;4311403;Lajeado;1;1;2;288
4219705;Xaxim;4311403;Lajeado;1;1;2;278
4300109;Agudo;4311403;Lajeado;1;1;2;120
4300406;Alegrete;4311403;Lajeado;1;1;2;365
4300604;Alvorada;4311403;Lajeado;1;1;2;111
4300802;Antônio Prado;4311403;Lajeado;1;1;2;96
4301057;Arroio do Sal;4311403;Lajeado;1;1;2;207
4301206;Arroio do Tigre;4311403;Lajeado;1;1;2;104
4301305;Arroio Grande;4311403;Lajeado;1;1;2;326
4302352;Bom Princípio;4311403;Lajeado;1;1;2;66
4302451;Boqueirão do Leão;4311403;Lajeado;1;1;2;41
4302808;Caçapava do Sul;4311403;Lajeado;1;1;2;182
4303905;Campo Bom;4311403;Lajeado;1;1;2;99
4304408;Canela;4311403;Lajeado;1;1;2;119
4304507;Canguçu;4311403;Lajeado;1;1;2;228
4304614;Canudos do Vale;4311403;Lajeado;1;1;2;23
4304853;Carlos Gomes;4311403;Lajeado;1;1;2;190
4304903;Casca;4311403;Lajeado;1;1;2;97
4306007;Crissiumal;4311403;Lajeado;1;1;2;293
4306452;Dois Lajeados;4311403;Lajeado;1;1;2;53
4306601;Dom Pedrito;4311403;Lajeado;1;1;2;308
4306767;Eldorado do Sul;4311403;Lajeado;1;1;2;83
4306908;Encruzilhada do Sul;4311403;Lajeado;1;1;2;130
4307500;Espumoso;4311403;Lajeado;1;1;2;112
4308003;Faxinal do Soturno;4311403;Lajeado;1;1;2;138
4308078;Fazenda Vilanova;4311403;Lajeado;1;1;2;26
4308102;Feliz;4311403;Lajeado;1;1;2;70
4308201;Flores da Cunha;4311403;Lajeado;1;1;2;93
4308433;Forquetinha;4311403;Lajeado;1;1;2;8
4308508;Frederico Westphalen;4311403;Lajeado;1;1;2;264
4308805;General Câmara;4311403;Lajeado;1;1;2;58
4308904;Getúlio Vargas;4311403;Lajeado;1;1;2;174
4309209;Gravataí;4311403;Lajeado;1;1;2;116
4309605;Horizontina;4311403;Lajeado;1;1;2;297
4310009;Ibirubá;4311403;Lajeado;1;1;2;136
4310108;Igrejinha;4311403;Lajeado;1;1;2;121
4310306;Ilópolis;4311403;Lajeado;1;1;2;57
4310439;Ipê;4311403;Lajeado;1;1;2;99
4310603;Itaqui;4311403;Lajeado;1;1;2;437
4310801;Ivoti;4311403;Lajeado;1;1;2;86
4311007;Jaguarão;4311403;Lajeado;1;1;2;367
4311106;Jaguari;4311403;Lajeado;1;1;2;265
4311205;Júlio de Castilhos;4311403;Lajeado;1;1;2;162
4311304;Lagoa Vermelha;4311403;Lajeado;1;1;2;144
3106200;Belo Horizonte;4311304;Lagoa Vermelha;1;1;2;1166
3304557;Rio de Janeiro;4311304;Lagoa Vermelha;1;1;2;989
3518800;Guarulhos;4311304;Lagoa Vermelha;1;1;2;712
3534401;Osasco;4311304;Lagoa Vermelha;1;1;2;690
3550308;São Paulo;4311304;Lagoa Vermelha;1;1;2;689
4201000;Anita Garibaldi;4311304;Lagoa Vermelha;1;1;2;69
4202008;Balneário Camboriú;4311304;Lagoa Vermelha;1;1;2;309
4202404;Blumenau;4311304;Lagoa Vermelha;1;1;2;277
4202909;Brusque;4311304;Lagoa Vermelha;1;1;2;284
4203204;Camboriú;4311304;Lagoa Vermelha;1;1;2;306
4203600;Campos Novos;4311304;Lagoa Vermelha;1;1;2;92
4203907;Capinzal;4311304;Lagoa Vermelha;1;1;2;96
4204558;Correia Pinto;4311304;Lagoa Vermelha;1;1;2;133
4205506;Fraiburgo;4311304;Lagoa Vermelha;1;1;2;144
4207502;Indaial;4311304;Lagoa Vermelha;1;1;2;267
4208302;Itapema;4311304;Lagoa Vermelha;1;1;2;308
4209003;Joaçaba;4311304;Lagoa Vermelha;1;1;2;117
4210506;Maravilha;4311304;Lagoa Vermelha;1;1;2;227
4211306;Navegantes;4311304;Lagoa Vermelha;1;1;2;315
4211751;Otacílio Costa;4311304;Lagoa Vermelha;1;1;2;159
4214805;Rio do Sul;4311304;Lagoa Vermelha;1;1;2;216
4216503;São Joaquim;4311304;Lagoa Vermelha;1;1;2;153
4217501;Seara;4311304;Lagoa Vermelha;1;1;2;140
4218202;Timbó;4311304;Lagoa Vermelha;1;1;2;267
4219309;Videira;4311304;Lagoa Vermelha;1;1;2;138
4219705;Xaxim;4311304;Lagoa Vermelha;1;1;2;169
4300505;Alpestre;4311304;Lagoa Vermelha;1;1;2;182
4300661;André da Rocha;4311304;Lagoa Vermelha;1;1;2;47
4301701;Barão de Cotegipe;4311304;Lagoa Vermelha;1;1;2;106
4301800;Barracão;4311304;Lagoa Vermelha;1;1;2;60
4302006;Barros Cassal;4311304;Lagoa Vermelha;1;1;2;143
4302105;Bento Gonçalves;4311304;Lagoa Vermelha;1;1;2;106
4302303;Bom Jesus;4311304;Lagoa Vermelha;1;1;2;120
4303103;Cachoeirinha;4311304;Lagoa Vermelha;1;1;2;197
4303806;Campinas do Sul;4311304;Lagoa Vermelha;1;1;2;121
4304804;Carlos Barbosa;4311304;Lagoa Vermelha;1;1;2;121
4304952;Caseiros;4311304;Lagoa Vermelha;1;1;2;17
4305207;Cerro Largo;4311304;Lagoa Vermelha;1;1;2;315
4305801;Constantina;4311304;Lagoa Vermelha;1;1;2;153
4306106;Cruz Alta;4311304;Lagoa Vermelha;1;1;2;209
4306304;David Canabarro;4311304;Lagoa Vermelha;1;1;2;37
4306767;Eldorado do Sul;4311304;Lagoa Vermelha;1;1;2;208
4306809;Encantado;4311304;Lagoa Vermelha;1;1;2;119
4307302;Erval Seco;4311304;Lagoa Vermelha;1;1;2;207
4307401;Esmeralda;4311304;Lagoa Vermelha;1;1;2;37
4307906;Farroupilha;4311304;Lagoa Vermelha;1;1;2;114
4308201;Flores da Cunha;4311304;Lagoa Vermelha;1;1;2;97
4308300;Fontoura Xavier;4311304;Lagoa Vermelha;1;1;2;118
4308508;Frederico Westphalen;4311304;Lagoa Vermelha;1;1;2;205
4309803;Ibiaçá;4311304;Lagoa Vermelha;1;1;2;36
4310439;Ipê;4311304;Lagoa Vermelha;1;1;2;70
4305603;Colorado;4311270;Lagoa dos Três Cantos;1;1;2;14
4300109;Agudo;4311254;Lagoão;1;1;2;63
1503606;Itaituba;4311205;Júlio de Castilhos;1;1;2;2773
3534401;Osasco;4311205;Júlio de Castilhos;1;1;2;908
3550308;São Paulo;4311205;Júlio de Castilhos;1;1;2;909
4301602;Bagé;4311205;Júlio de Castilhos;1;1;2;238
4303103;Cachoeirinha;4311205;Júlio de Castilhos;1;1;2;263
4305108;Caxias do Sul;4311205;Júlio de Castilhos;1;1;2;244
4306767;Eldorado do Sul;4311205;Júlio de Castilhos;1;1;2;223
4307906;Farroupilha;4311205;Júlio de Castilhos;1;1;2;228
4308458;Fortaleza dos Valos;4311205;Júlio de Castilhos;1;1;2;65
4310538;Itaara;4311205;Júlio de Castilhos;1;1;2;44
4302220;Boa Vista do Cadeado;4311155;Jóia;1;1;2;30
4305108;Caxias do Sul;4311155;Jóia;1;1;2;295
4305207;Cerro Largo;4311155;Jóia;1;1;2;81
4305871;Coronel Barros;4311155;Jóia;1;1;2;30
4306932;Entre-Ijuís;4311155;Jóia;1;1;2;35
4306106;Cruz Alta;4311130;Jari;1;1;2;94
4311106;Jaguari;4311130;Jari;1;1;2;56
4211900;Palhoça;4311122;Jaquirana;1;1;2;208
3534401;Osasco;4311106;Jaguari;1;1;2;1000
4301602;Bagé;4311106;Jaguari;1;1;2;217
4302907;Cacequi;4311106;Jaguari;1;1;2;48
4303103;Cachoeirinha;4311106;Jaguari;1;1;2;359
4305207;Cerro Largo;4311106;Jaguari;1;1;2;145
3534401;Osasco;4311007;Jaguarão;1;1;2;1158
4210001;Luiz Alves;4311007;Jaguarão;1;1;2;759
4300034;Aceguá;4311007;Jaguarão;1;1;2;109
4303103;Cachoeirinha;4311007;Jaguarão;1;1;2;353
4304606;Canoas;4311007;Jaguarão;1;1;2;352
4306908;Encruzilhada do Sul;4311007;Jaguarão;1;1;2;236
4310009;Ibirubá;4311007;Jaguarão;1;1;2;435
4208203;Itajaí;4310900;Jacutinga;1;1;2;382
4305108;Caxias do Sul;4310900;Jacutinga;1;1;2;208
4304101;Campos Borges;4310876;Jacuizinho;1;1;2;17
4304705;Carazinho;4310876;Jacuizinho;1;1;2;86
4307500;Espumoso;4310876;Jacuizinho;1;1;2;40
2610707;Paulista;4310801;Ivoti;1;1;2;2817
3515152;Engenheiro Coelho;4310801;Ivoti;1;1;2;870
3516200;Franca;4310801;Ivoti;1;1;2;1062
3525300;Jaú;4310801;Ivoti;1;1;2;846
3534401;Osasco;4310801;Ivoti;1;1;2;788
4104006;Campina Grande do Sul;4310801;Ivoti;1;1;2;515
4216255;São João do Oeste;4310801;Ivoti;1;1;2;361
4301206;Arroio do Tigre;4310801;Ivoti;1;1;2;189
4307708;Esteio;4310801;Ivoti;1;1;2;29
4306106;Cruz Alta;4310751;Ivorá;1;1;2;97
4307203;Erval Grande;4310702;Itatiba do Sul;1;1;2;10
4203808;Canoinhas;4310652;Itati;1;1;2;366
4304630;Capão da Canoa;4310652;Itati;1;1;2;30
3534401;Osasco;4310603;Itaqui;1;1;2;1116
4204202;Chapecó;4310603;Itaqui;1;1;2;440
4301602;Bagé;4310603;Itaqui;1;1;2;339
4302501;Bossoroca;4310603;Itaqui;1;1;2;165
4303509;Camaquã;4310603;Itaqui;1;1;2;498
4306767;Eldorado do Sul;4310603;Itaqui;1;1;2;490
4306809;Encantado;4310603;Itaqui;1;1;2;450
4307906;Farroupilha;4310603;Itaqui;1;1;2;505
4310009;Ibirubá;4310603;Itaqui;1;1;2;339
4307807;Estrela;4310538;Itaara;1;1;2;175
4305207;Cerro Largo;4310504;Iraí;1;1;2;182
4308904;Getúlio Vargas;4310462;Ipiranga do Sul;1;1;2;18
3106200;Belo Horizonte;4310439;Ipê;1;1;2;1203
4305405;Chiapetta;4310413;Inhacorá;1;1;2;9
4309605;Horizontina;4310405;Independência;1;1;2;26
4310207;Ijuí;4310405;Independência;1;1;2;67
3534401;Osasco;4310363;Imigrante;1;1;2;799
4218301;Três Barras;4310363;Imigrante;1;1;2;386
4306809;Encantado;4310363;Imigrante;1;1;2;19
3523107;Itaquaquecetuba;4310330;Imbé;1;1;2;802
3529401;Mauá;4310330;Imbé;1;1;2;779
4301404;Arvorezinha;4310330;Imbé;1;1;2;229
4302659;Brochier;4310330;Imbé;1;1;2;149
4303103;Cachoeirinha;4310330;Imbé;1;1;2;93
4304408;Canela;4310330;Imbé;1;1;2;94
4305108;Caxias do Sul;4310330;Imbé;1;1;2;133
4309100;Gramado;4310330;Imbé;1;1;2;97
4300703;Anta Gorda;4310306;Ilópolis;1;1;2;13
4305108;Caxias do Sul;4310306;Ilópolis;1;1;2;96
4307005;Erechim;4310306;Ilópolis;1;1;2;144
2306306;Itapagé;4310207;Ijuí;1;1;2;3036
3162500;São João del Rei;4310207;Ijuí;1;1;2;1219
3205200;Vila Velha;4310207;Ijuí;1;1;2;1566
3509502;Campinas;4310207;Ijuí;1;1;2;896
3512803;Cosmópolis;4310207;Ijuí;1;1;2;905
3516200;Franca;4310207;Ijuí;1;1;2;1067
3522208;Itapecerica da Serra;4310207;Ijuí;1;1;2;854
3534401;Osasco;4310207;Ijuí;1;1;2;871
3538709;Piracicaba;4310207;Ijuí;1;1;2;867
3554003;Tatuí;4310207;Ijuí;1;1;2;807
4102604;Barracão;4310207;Ijuí;1;1;2;241
4104808;Cascavel;4310207;Ijuí;1;1;2;384
4106803;Cruz Machado;4310207;Ijuí;1;1;2;363
4106902;Curitiba;4310207;Ijuí;1;1;2;555
4120655;Quarto Centenário;4310207;Ijuí;1;1;2;463
4200556;Águas Frias;4310207;Ijuí;1;1;2;197
4202008;Balneário Camboriú;4310207;Ijuí;1;1;2;533
4203006;Caçador;4310207;Ijuí;1;1;2;327
4204301;Concórdia;4310207;Ijuí;1;1;2;227
4214805;Rio do Sul;4310207;Ijuí;1;1;2;439
4216909;São Lourenço do Oeste;4310207;Ijuí;1;1;2;245
4302204;Boa Vista do Buricá;4310207;Ijuí;1;1;2;82
4302501;Bossoroca;4310207;Ijuí;1;1;2;103
4303509;Camaquã;4310207;Ijuí;1;1;2;342
4304655;Capão do Cipó;4310207;Ijuí;1;1;2;97
4304903;Casca;4310207;Ijuí;1;1;2;192
4306320;Derrubadas;4310207;Ijuí;1;1;2;125
4306403;Dois Irmãos;4310207;Ijuí;1;1;2;309
4306429;Dois Irmãos das Missões;4310207;Ijuí;1;1;2;90
4307708;Esteio;4310207;Ijuí;1;1;2;315
4307906;Farroupilha;4310207;Ijuí;1;1;2;270
2918001;Jequié;4310108;Igrejinha;1;1;2;2003
3505708;Barueri;4310108;Igrejinha;1;1;2;767
3530607;Moji das Cruzes;4310108;Igrejinha;1;1;2;795
3534401;Osasco;4310108;Igrejinha;1;1;2;768
3554508;Tietê;4310108;Igrejinha;1;1;2;773
4303103;Cachoeirinha;4310108;Igrejinha;1;1;2;52
4303905;Campo Bom;4310108;Igrejinha;1;1;2;28
4307906;Farroupilha;4310108;Igrejinha;1;1;2;66
3518800;Guarulhos;4310009;Ibirubá;1;1;2;849
3523909;Itu;4310009;Ibirubá;1;1;2;811
3534401;Osasco;4310009;Ibirubá;1;1;2;826
3554003;Tatuí;4310009;Ibirubá;1;1;2;770
4300406;Alegrete;4310009;Ibirubá;1;1;2;292
4301602;Bagé;4310009;Ibirubá;1;1;2;316
4302220;Boa Vista do Cadeado;4310009;Ibirubá;1;1;2;71
4302709;Butiá;4310009;Ibirubá;1;1;2;198
4303103;Cachoeirinha;4310009;Ibirubá;1;1;2;243
4303673;Campestre da Serra;4310009;Ibirubá;1;1;2;196
4305108;Caxias do Sul;4310009;Ibirubá;1;1;2;197
4305207;Cerro Largo;4310009;Ibirubá;1;1;2;169
4305306;Chapada;4310009;Ibirubá;1;1;2;64
4305603;Colorado;4310009;Ibirubá;1;1;2;15
4306908;Encruzilhada do Sul;4310009;Ibirubá;1;1;2;215
4307609;Estância Velha;4310009;Ibirubá;1;1;2;220
4307906;Farroupilha;4310009;Ibirubá;1;1;2;184
4308508;Frederico Westphalen;4310009;Ibirubá;1;1;2;144
4309605;Horizontina;4310009;Ibirubá;1;1;2;162
3526902;Limeira;4309902;Ibiraiaras;1;1;2;760
4300661;André da Rocha;4309902;Ibiraiaras;1;1;2;30
4300802;Antônio Prado;4309902;Ibiraiaras;1;1;2;64
4303673;Campestre da Serra;4309902;Ibiraiaras;1;1;2;71
4305207;Cerro Largo;4309902;Ibiraiaras;1;1;2;304
4307401;Esmeralda;4309902;Ibiraiaras;1;1;2;56
4202909;Brusque;4309803;Ibiaçá;1;1;2;307
4300059;Água Santa;4309803;Ibiaçá;1;1;2;22
4303103;Cachoeirinha;4309704;Humaitá;1;1;2;389
4305207;Cerro Largo;4309704;Humaitá;1;1;2;100
4305405;Chiapetta;4309704;Humaitá;1;1;2;40
4306007;Crissiumal;4309704;Humaitá;1;1;2;14
4306734;Doutor Maurício Cardoso;4309704;Humaitá;1;1;2;39
4307609;Estância Velha;4309704;Humaitá;1;1;2;362
3304557;Rio de Janeiro;4309654;Hulha Negra;1;1;2;1355
3507605;Bragança Paulista;4309654;Hulha Negra;1;1;2;1152
4301958;Barra Funda;4309654;Hulha Negra;1;1;2;394
4302808;Caçapava do Sul;4309654;Hulha Negra;1;1;2;108
2109502;Riachão;4309605;Horizontina;1;1;2;2353
3106705;Betim;4309605;Horizontina;1;1;2;1289
3168705;Timóteo;4309605;Horizontina;1;1;2;1428
3509502;Campinas;4309605;Horizontina;1;1;2;876
3513504;Cubatão;4309605;Horizontina;1;1;2;870
3515004;Embu;4309605;Horizontina;1;1;2;847
3520509;Indaiatuba;4309605;Horizontina;1;1;2;849
3534401;Osasco;4309605;Horizontina;1;1;2;859
3543402;Ribeirão Preto;4309605;Horizontina;1;1;2;952
3550308;São Paulo;4309605;Horizontina;1;1;2;864
4106902;Curitiba;4309605;Horizontina;1;1;2;547
4118501;Pato Branco;4309605;Horizontina;1;1;2;224
4208302;Itapema;4309605;Horizontina;1;1;2;561
4302204;Boa Vista do Buricá;4309605;Horizontina;1;1;2;20
4303103;Cachoeirinha;4309605;Horizontina;1;1;2;410
4304630;Capão da Canoa;4309605;Horizontina;1;1;2;486
4305207;Cerro Largo;4309605;Horizontina;1;1;2;72
4307609;Estância Velha;4309605;Horizontina;1;1;2;384
4307906;Farroupilha;4309605;Horizontina;1;1;2;344
4309159;Gramado Xavier;4309571;Herveiras;1;1;2;17
3525300;Jaú;4309555;Harmonia;1;1;2;849
4300604;Alvorada;4309555;Harmonia;1;1;2;59
4307708;Esteio;4309555;Harmonia;1;1;2;41
2928901;São Desidério;4309506;Guarani das Missões;1;1;2;1962
4208203;Itajaí;4309506;Guarani das Missões;1;1;2;583
4303103;Cachoeirinha;4309506;Guarani das Missões;1;1;2;396
3509502;Campinas;4309407;Guaporé;1;1;2;804
3513801;Diadema;4309407;Guaporé;1;1;2;763
3534401;Osasco;4309407;Guaporé;1;1;2;764
4118501;Pato Branco;4309407;Guaporé;1;1;2;298
4300703;Anta Gorda;4309407;Guaporé;1;1;2;17
4303103;Cachoeirinha;4309407;Guaporé;1;1;2;145
4303558;Camargo;4309407;Guaporé;1;1;2;40
4304408;Canela;4309407;Guaporé;1;1;2;121
4304705;Carazinho;4309407;Guaporé;1;1;2;105
4305207;Cerro Largo;4309407;Guaporé;1;1;2;285
4306908;Encruzilhada do Sul;4309407;Guaporé;1;1;2;196
4307609;Estância Velha;4309407;Guaporé;1;1;2;115
4308607;Garibaldi;4309407;Guaporé;1;1;2;59
1100205;Porto Velho;4309308;Guaíba;1;1;2;2619
1200401;Rio Branco;4309308;Guaíba;1;1;2;2681
1302603;Manaus;4309308;Guaíba;1;1;2;3089
1501402;Belém;4309308;Guaíba;1;1;2;3189
1600303;Macapá;4309308;Guaíba;1;1;2;3340
2111300;São Luís;4309308;Guaíba;1;1;2;3118
2211001;Teresina;4309308;Guaíba;1;1;2;2874
2304400;Fortaleza;4309308;Guaíba;1;1;2;3135
2408102;Natal;4309308;Guaíba;1;1;2;3055
2507507;João Pessoa;4309308;Guaíba;1;1;2;2940
2611606;Recife;4309308;Guaíba;1;1;2;2849
2704302;Maceió;4309308;Guaíba;1;1;2;2669
2800308;Aracaju;4309308;Guaíba;1;1;2;2488
2903409;Belmonte;4309308;Guaíba;1;1;2;1938
2910503;Entre Rios;4309308;Guaíba;1;1;2;2345
2927408;Salvador;4309308;Guaíba;1;1;2;2227
2931350;Teixeira de Freitas;4309308;Guaíba;1;1;2;1753
3106200;Belo Horizonte;4309308;Guaíba;1;1;2;1320
3109402;Buritizeiro;4309308;Guaíba;1;1;2;1528
3120904;Curvelo;4309308;Guaíba;1;1;2;1407
3136702;Juiz de Fora;4309308;Guaíba;1;1;2;1188
3144805;Nova Lima;4309308;Guaíba;1;1;2;1315
3161700;São Gonçalo do Abaeté;4309308;Guaíba;1;1;2;1399
3170206;Uberlândia;4309308;Guaíba;1;1;2;1274
3303302;Niterói;4309308;Guaíba;1;1;2;1111
3509502;Campinas;4309308;Guaíba;1;1;2;893
3513009;Cotia;4309308;Guaíba;1;1;2;831
3513504;Cubatão;4309308;Guaíba;1;1;2;829
3516200;Franca;4309308;Guaíba;1;1;2;1121
3524402;Jacareí;4309308;Guaíba;1;1;2;906
3530607;Moji das Cruzes;4309308;Guaíba;1;1;2;872
3534401;Osasco;4309308;Guaíba;1;1;2;844
3543402;Ribeirão Preto;4309308;Guaíba;1;1;2;1046
3547809;Santo André;4309308;Guaíba;1;1;2;846
3548500;Santos;4309308;Guaíba;1;1;2;832
3548807;São Caetano do Sul;4309308;Guaíba;1;1;2;848
3552205;Sorocaba;4309308;Guaíba;1;1;2;818
3552502;Suzano;4309308;Guaíba;1;1;2;867
3556701;Vinhedo;4309308;Guaíba;1;1;2;884
4100400;Almirante Tamandaré;4309308;Guaíba;1;1;2;564
4104808;Cascavel;4309308;Guaíba;1;1;2;607
4108304;Foz do Iguaçu;4309308;Guaíba;1;1;2;591
4110078;Imbaú;4309308;Guaíba;1;1;2;630
4115200;Maringá;4309308;Guaíba;1;1;2;743
4118501;Pato Branco;4309308;Guaíba;1;1;2;448
4125506;São José dos Pinhais;4309308;Guaíba;1;1;2;546
4127106;Telêmaco Borba;4309308;Guaíba;1;1;2;640
4202008;Balneário Camboriú;4309308;Guaíba;1;1;2;428
4209300;Lages;4309308;Guaíba;1;1;2;273
4212304;Paulo Lopes;4309308;Guaíba;1;1;2;348
4216602;São José;4309308;Guaíba;1;1;2;377
4218301;Três Barras;4309308;Guaíba;1;1;2;454
4300604;Alvorada;4309308;Guaíba;1;1;2;28
4301305;Arroio Grande;4309308;Guaíba;1;1;2;288
4302105;Bento Gonçalves;4309308;Guaíba;1;1;2;107
4302709;Butiá;4309308;Guaíba;1;1;2;61
4302808;Caçapava do Sul;4309308;Guaíba;1;1;2;209
4305454;Cidreira;4309308;Guaíba;1;1;2;106
4306403;Dois Irmãos;4309308;Guaíba;1;1;2;64
4306502;Dom Feliciano;4309308;Guaíba;1;1;2;99
4306601;Dom Pedrito;4309308;Guaíba;1;1;2;335
4306809;Encantado;4309308;Guaíba;1;1;2;112
4307005;Erechim;4309308;Guaíba;1;1;2;289
4307708;Esteio;4309308;Guaíba;1;1;2;33
4309209;Gravataí;4309308;Guaíba;1;1;2;38
1721000;Palmas;4309258;Guabiju;1;1;2;2036
1100205;Porto Velho;4309209;Gravataí;1;1;2;2617
1302603;Manaus;4309209;Gravataí;1;1;2;3079
1501402;Belém;4309209;Gravataí;1;1;2;3168
1721000;Palmas;4309209;Gravataí;1;1;2;2180
2304400;Fortaleza;4309209;Gravataí;1;1;2;3107
2607901;Jaboatão dos Guararapes;4309209;Gravataí;1;1;2;2814
2611606;Recife;4309209;Gravataí;1;1;2;2818
2908507;Conceição do Jacuípe;4309209;Gravataí;1;1;2;2243
2927408;Salvador;4309209;Gravataí;1;1;2;2196
3136652;Juatuba;4309209;Gravataí;1;1;2;1266
3138203;Lavras;4309209;Gravataí;1;1;2;1114
3160405;Santo Antônio do Monte;4309209;Gravataí;1;1;2;1212
3201308;Cariacica;4309209;Gravataí;1;1;2;1452
3202603;Iconha;4309209;Gravataí;1;1;2;1386
3205002;Serra;4309209;Gravataí;1;1;2;1471
3205200;Vila Velha;4309209;Gravataí;1;1;2;1450
3205309;Vitória;4309209;Gravataí;1;1;2;1461
3300407;Barra Mansa;4309209;Gravataí;1;1;2;1038
3303302;Niterói;4309209;Gravataí;1;1;2;1076
3304110;Porto Real;4309209;Gravataí;1;1;2;1042
3506003;Bauru;4309209;Gravataí;1;1;2;861
3508504;Caçapava;4309209;Gravataí;1;1;2;905
3509502;Campinas;4309209;Gravataí;1;1;2;863
3515004;Embu;4309209;Gravataí;1;1;2;798
3524006;Itupeva;4309209;Gravataí;1;1;2;837
3524402;Jacareí;4309209;Gravataí;1;1;2;873
3530607;Moji das Cruzes;4309209;Gravataí;1;1;2;838
3543402;Ribeirão Preto;4309209;Gravataí;1;1;2;1018
3547007;Santa Maria da Serra;4309209;Gravataí;1;1;2;859
3548500;Santos;4309209;Gravataí;1;1;2;799
3554003;Tatuí;4309209;Gravataí;1;1;2;788
3554102;Taubaté;4309209;Gravataí;1;1;2;921
4100400;Almirante Tamandaré;4309209;Gravataí;1;1;2;536
4104808;Cascavel;4309209;Gravataí;1;1;2;601
4105904;Colorado;4309209;Gravataí;1;1;2;792
4109807;Ibiporã;4309209;Gravataí;1;1;2;739
4113700;Londrina;4309209;Gravataí;1;1;2;736
4114302;Mandirituba;4309209;Gravataí;1;1;2;487
4114807;Marialva;4309209;Gravataí;1;1;2;719
4120804;Quatro Barras;4309209;Gravataí;1;1;2;538
4127700;Toledo;4309209;Gravataí;1;1;2;634
4201406;Araranguá;4309209;Gravataí;1;1;2;181
4202305;Biguaçu;4309209;Gravataí;1;1;2;348
4202404;Blumenau;4309209;Gravataí;1;1;2;378
4204608;Criciúma;4309209;Gravataí;1;1;2;209
4205704;Garopaba;4309209;Gravataí;1;1;2;308
4205803;Garuva;4309209;Gravataí;1;1;2;479
4207304;Imbituba;4309209;Gravataí;1;1;2;290
4208203;Itajaí;4309209;Gravataí;1;1;2;395
4208906;Jaraguá do Sul;4309209;Gravataí;1;1;2;424
4210407;Maracajá;4309209;Gravataí;1;1;2;191
4211207;Morro da Fumaça;4309209;Gravataí;1;1;2;223
4301636;Balneário Pinhal;4309209;Gravataí;1;1;2;78
4302105;Bento Gonçalves;4309209;Gravataí;1;1;2;100
4303905;Campo Bom;4309209;Gravataí;1;1;2;30
4306403;Dois Irmãos;4309209;Gravataí;1;1;2;41
4307609;Estância Velha;4309209;Gravataí;1;1;2;37
4307807;Estrela;4309209;Gravataí;1;1;2;106
4308508;Frederico Westphalen;4309209;Gravataí;1;1;2;367
4309100;Gramado;4309209;Gravataí;1;1;2;61
2306306;Itapagé;4309100;Gramado;1;1;2;3025
3304557;Rio de Janeiro;4309100;Gramado;1;1;2;1021
3509700;Campos do Jordão;4309100;Gramado;1;1;2;895
4125506;São José dos Pinhais;4309100;Gramado;1;1;2;458
4202008;Balneário Camboriú;4309100;Gramado;1;1;2;342
4202404;Blumenau;4309100;Gramado;1;1;2;323
4204608;Criciúma;4309100;Gramado;1;1;2;168
4207007;Içara;4309100;Gramado;1;1;2;173
4209102;Joinville;4309100;Gramado;1;1;2;397
4300877;Araricá;4309100;Gramado;1;1;2;23
4303608;Cambará do Sul;4309100;Gramado;1;1;2;84
4306403;Dois Irmãos;4309100;Gramado;1;1;2;26
4306908;Encruzilhada do Sul;4309100;Gramado;1;1;2;202
4307005;Erechim;4309100;Gramado;1;1;2;236
4307807;Estrela;4309100;Gramado;1;1;2;103
4308607;Garibaldi;4309100;Gramado;1;1;2;63
4211603;Nova Veneza;4309050;Glorinha;1;1;2;184
4304606;Canoas;4309050;Glorinha;1;1;2;41
4306205;Cruzeiro do Sul;4309050;Glorinha;1;1;2;128
3534401;Osasco;4309001;Giruá;1;1;2;883
3550308;São Paulo;4309001;Giruá;1;1;2;887
4208203;Itajaí;4309001;Giruá;1;1;2;561
4208302;Itapema;4309001;Giruá;1;1;2;569
4302204;Boa Vista do Buricá;4309001;Giruá;1;1;2;46
4302352;Bom Princípio;4309001;Giruá;1;1;2;338
4303103;Cachoeirinha;4309001;Giruá;1;1;2;385
4304309;Cândido Godói;4309001;Giruá;1;1;2;41
4304606;Canoas;4309001;Giruá;1;1;2;377
4305108;Caxias do Sul;4309001;Giruá;1;1;2;338
4305405;Chiapetta;4309001;Giruá;1;1;2;42
4306767;Eldorado do Sul;4309001;Giruá;1;1;2;354
4307807;Estrela;4309001;Giruá;1;1;2;287
4307906;Farroupilha;4309001;Giruá;1;1;2;326
1302603;Manaus;4308904;Getúlio Vargas;1;1;2;2833
1501402;Belém;4308904;Getúlio Vargas;1;1;2;2953
3170206;Uberlândia;4308904;Getúlio Vargas;1;1;2;1064
3505708;Barueri;4308904;Getúlio Vargas;1;1;2;711
3534401;Osasco;4308904;Getúlio Vargas;1;1;2;715
3550308;São Paulo;4308904;Getúlio Vargas;1;1;2;717
4106902;Curitiba;4308904;Getúlio Vargas;1;1;2;396
4202008;Balneário Camboriú;4308904;Getúlio Vargas;1;1;2;364
4204806;Curitibanos;4308904;Getúlio Vargas;1;1;2;176
4208005;Itá;4308904;Getúlio Vargas;1;1;2;67
4217501;Seara;4308904;Getúlio Vargas;1;1;2;81
4301057;Arroio do Sal;4308904;Getúlio Vargas;1;1;2;297
4301552;Áurea;4308904;Getúlio Vargas;1;1;2;29
4301958;Barra Funda;4308904;Getúlio Vargas;1;1;2;77
4303103;Cachoeirinha;4308904;Getúlio Vargas;1;1;2;256
4304606;Canoas;4308904;Getúlio Vargas;1;1;2;249
4304705;Carazinho;4308904;Getúlio Vargas;1;1;2;69
4307906;Farroupilha;4308904;Getúlio Vargas;1;1;2;175
4308250;Floriano Peixoto;4308904;Getúlio Vargas;1;1;2;17
4308706;Gaurama;4308904;Getúlio Vargas;1;1;2;37
4304952;Caseiros;4308854;Gentil;1;1;2;38
4302709;Butiá;4308805;General Câmara;1;1;2;29
4304606;Canoas;4308805;General Câmara;1;1;2;57
4305355;Charqueadas;4308805;General Câmara;1;1;2;16
4204202;Chapecó;4308706;Gaurama;1;1;2;74
4204301;Concórdia;4308706;Gaurama;1;1;2;41
4301701;Barão de Cotegipe;4308706;Gaurama;1;1;2;29
4305207;Cerro Largo;4308706;Gaurama;1;1;2;269
3303302;Niterói;4308656;Garruchos;1;1;2;1341
3534401;Osasco;4308656;Garruchos;1;1;2;996
2501807;Bayeux;4308607;Garibaldi;1;1;2;2880
2611101;Petrolina;4308607;Garibaldi;1;1;2;2426
2611606;Recife;4308607;Garibaldi;1;1;2;2787
2930709;Simões Filho;4308607;Garibaldi;1;1;2;2187
3106705;Betim;4308607;Garibaldi;1;1;2;1238
3118601;Contagem;4308607;Garibaldi;1;1;2;1247
3201308;Cariacica;4308607;Garibaldi;1;1;2;1440
3203205;Linhares;4308607;Garibaldi;1;1;2;1535
3301009;Campos dos Goytacazes;4308607;Garibaldi;1;1;2;1269
3515004;Embu;4308607;Garibaldi;1;1;2;764
3530607;Moji das Cruzes;4308607;Garibaldi;1;1;2;809
3534401;Osasco;4308607;Garibaldi;1;1;2;777
3548708;São Bernardo do Campo;4308607;Garibaldi;1;1;2;773
3552205;Sorocaba;4308607;Garibaldi;1;1;2;745
4101507;Arapongas;4308607;Garibaldi;1;1;2;647
4101804;Araucária;4308607;Garibaldi;1;1;2;455
4106902;Curitiba;4308607;Garibaldi;1;1;2;474
4118204;Paranaguá;4308607;Garibaldi;1;1;2;497
4125506;São José dos Pinhais;4308607;Garibaldi;1;1;2;469
4202008;Balneário Camboriú;4308607;Garibaldi;1;1;2;372
4202305;Biguaçu;4308607;Garibaldi;1;1;2;336
4204301;Concórdia;4308607;Garibaldi;1;1;2;231
4208203;Itajaí;4308607;Garibaldi;1;1;2;371
4301875;Barra do Quaraí;4308607;Garibaldi;1;1;2;598
4303004;Cachoeira do Sul;4308607;Garibaldi;1;1;2;158
4303103;Cachoeirinha;4308607;Garibaldi;1;1;2;87
4303509;Camaquã;4308607;Garibaldi;1;1;2;177
4304408;Canela;4308607;Garibaldi;1;1;2;71
4304630;Capão da Canoa;4308607;Garibaldi;1;1;2;155
4304705;Carazinho;4308607;Garibaldi;1;1;2;161
4305934;Coronel Pilar;4308607;Garibaldi;1;1;2;15
4306403;Dois Irmãos;4308607;Garibaldi;1;1;2;57
4307708;Esteio;4308607;Garibaldi;1;1;2;74
3504107;Atibaia;4308508;Frederico Westphalen;1;1;2;815
3516200;Franca;4308508;Frederico Westphalen;1;1;2;950
3518800;Guarulhos;4308508;Frederico Westphalen;1;1;2;794
3534401;Osasco;4308508;Frederico Westphalen;1;1;2;770
4123808;Santa Izabel do Oeste;4308508;Frederico Westphalen;1;1;2;171
4203006;Caçador;4308508;Frederico Westphalen;1;1;2;235
4203105;Caibi;4308508;Frederico Westphalen;1;1;2;34
4203808;Canoinhas;4308508;Frederico Westphalen;1;1;2;320
4204202;Chapecó;4308508;Frederico Westphalen;1;1;2;81
4204301;Concórdia;4308508;Frederico Westphalen;1;1;2;137
4204707;Cunha Porã;4308508;Frederico Westphalen;1;1;2;56
4204806;Curitibanos;4308508;Frederico Westphalen;1;1;2;276
4208203;Itajaí;4308508;Frederico Westphalen;1;1;2;461
4209300;Lages;4308508;Frederico Westphalen;1;1;2;307
4213104;Piratuba;4308508;Frederico Westphalen;1;1;2;161
4216008;São Carlos;4308508;Frederico Westphalen;1;1;2;49
4216909;São Lourenço do Oeste;4308508;Frederico Westphalen;1;1;2;120
4217204;São Miguel do Oeste;4308508;Frederico Westphalen;1;1;2;74
4217501;Seara;4308508;Frederico Westphalen;1;1;2;109
4303103;Cachoeirinha;4308508;Frederico Westphalen;1;1;2;367
4303400;Caiçara;4308508;Frederico Westphalen;1;1;2;10
4303509;Camaquã;4308508;Frederico Westphalen;1;1;2;417
4304903;Casca;4308508;Frederico Westphalen;1;1;2;194
4305207;Cerro Largo;4308508;Frederico Westphalen;1;1;2;160
4306007;Crissiumal;4308508;Frederico Westphalen;1;1;2;72
4208203;Itajaí;4308433;Forquetinha;1;1;2;419
4304614;Canudos do Vale;4308433;Forquetinha;1;1;2;15
4211306;Navegantes;4308409;Formigueiro;1;1;2;574
4304507;Canguçu;4308409;Formigueiro;1;1;2;175
4305207;Cerro Largo;4308409;Formigueiro;1;1;2;236
3534401;Osasco;4308300;Fontoura Xavier;1;1;2;802
4208203;Itajaí;4308300;Fontoura Xavier;1;1;2;414
4302006;Barros Cassal;4308300;Fontoura Xavier;1;1;2;26
4304705;Carazinho;4308300;Fontoura Xavier;1;1;2;87
4305207;Cerro Largo;4308300;Fontoura Xavier;1;1;2;249
3509502;Campinas;4308250;Floriano Peixoto;1;1;2;733
4305371;Charrua;4308250;Floriano Peixoto;1;1;2;12
1500800;Ananindeua;4308201;Flores da Cunha;1;1;2;3071
2607901;Jaboatão dos Guararapes;4308201;Flores da Cunha;1;1;2;2747
2901106;Amélia Rodrigues;4308201;Flores da Cunha;1;1;2;2167
2927408;Salvador;4308201;Flores da Cunha;1;1;2;2128
3205101;Viana;4308201;Flores da Cunha;1;1;2;1382
3301009;Campos dos Goytacazes;4308201;Flores da Cunha;1;1;2;1229
3304557;Rio de Janeiro;4308201;Flores da Cunha;1;1;2;1014
3305802;Teresópolis;4308201;Flores da Cunha;1;1;2;1065
3515004;Embu;4308201;Flores da Cunha;1;1;2;725
3516200;Franca;4308201;Flores da Cunha;1;1;2;1005
3525904;Jundiaí;4308201;Flores da Cunha;1;1;2;765
3534401;Osasco;4308201;Flores da Cunha;1;1;2;738
4120804;Quatro Barras;4308201;Flores da Cunha;1;1;2;453
4205308;Faxinal dos Guedes;4308201;Flores da Cunha;1;1;2;263
4208203;Itajaí;4308201;Flores da Cunha;1;1;2;329
4208302;Itapema;4308201;Flores da Cunha;1;1;2;326
4303103;Cachoeirinha;4308201;Flores da Cunha;1;1;2;102
4303608;Cambará do Sul;4308201;Flores da Cunha;1;1;2;101
4303673;Campestre da Serra;4308201;Flores da Cunha;1;1;2;27
4304630;Capão da Canoa;4308201;Flores da Cunha;1;1;2;137
4306403;Dois Irmãos;4308201;Flores da Cunha;1;1;2;62
4306767;Eldorado do Sul;4308201;Flores da Cunha;1;1;2;124
4307708;Esteio;4308201;Flores da Cunha;1;1;2;91
1500800;Ananindeua;4308102;Feliz;1;1;2;3118
3534401;Osasco;4308102;Feliz;1;1;2;782
3550308;São Paulo;4308102;Feliz;1;1;2;779
4304804;Carlos Barbosa;4308102;Feliz;1;1;2;26
4306403;Dois Irmãos;4308102;Feliz;1;1;2;26
3143906;Muriaé;4308078;Fazenda Vilanova;1;1;2;1295
4106902;Curitiba;4308078;Fazenda Vilanova;1;1;2;519
4204202;Chapecó;4308078;Fazenda Vilanova;1;1;2;285
4209102;Joinville;4308078;Fazenda Vilanova;1;1;2;463
4302055;Benjamin Constant do Sul;4308052;Faxinalzinho;1;1;2;13
4307203;Erval Grande;4308052;Faxinalzinho;1;1;2;10
3304557;Rio de Janeiro;4308003;Faxinal do Soturno;1;1;2;1212
3534401;Osasco;4308003;Faxinal do Soturno;1;1;2;918
4304200;Candelária;4308003;Faxinal do Soturno;1;1;2;62
4305207;Cerro Largo;4308003;Faxinal do Soturno;1;1;2;200
4306700;Dona Francisca;4308003;Faxinal do Soturno;1;1;2;9
4306767;Eldorado do Sul;4308003;Faxinal do Soturno;1;1;2;186
1100205;Porto Velho;4307906;Farroupilha;1;1;2;2536
1500800;Ananindeua;4307906;Farroupilha;1;1;2;3093
2304285;Eusébio;4307906;Farroupilha;1;1;2;3039
2305233;Horizonte;4307906;Farroupilha;1;1;2;3016
2307650;Maracanaú;4307906;Farroupilha;1;1;2;3036
2608909;Limoeiro;4307906;Farroupilha;1;1;2;2773
2611606;Recife;4307906;Farroupilha;1;1;2;2775
2929503;São Sebastião do Passé;4307906;Farroupilha;1;1;2;2195
3106200;Belo Horizonte;4307906;Farroupilha;1;1;2;1242
3110509;Camanducaia;4307906;Farroupilha;1;1;2;869
3132404;Itajubá;4307906;Farroupilha;1;1;2;936
3135100;Janaúba;4307906;Farroupilha;1;1;2;1661
3138203;Lavras;4307906;Farroupilha;1;1;2;1067
3140852;Matias Cardoso;4307906;Farroupilha;1;1;2;1734
3143401;Monte Sião;4307906;Farroupilha;1;1;2;877
3169307;Três Corações;4307906;Farroupilha;1;1;2;1016
3500105;Adamantina;4307906;Farroupilha;1;1;2;836
3501707;Américo Brasiliense;4307906;Farroupilha;1;1;2;885
3502804;Araçatuba;4307906;Farroupilha;1;1;2;890
3503208;Araraquara;4307906;Farroupilha;1;1;2;877
3503307;Araras;4307906;Farroupilha;1;1;2;848
3504008;Assis;4307906;Farroupilha;1;1;2;732
3504107;Atibaia;4307906;Farroupilha;1;1;2;815
3505203;Bariri;4307906;Farroupilha;1;1;2;829
3505807;Bastos;4307906;Farroupilha;1;1;2;811
3506508;Birigui;4307906;Farroupilha;1;1;2;882
3507605;Bragança Paulista;4307906;Farroupilha;1;1;2;830
3507902;Brotas;4307906;Farroupilha;1;1;2;827
3510401;Capivari;4307906;Farroupilha;1;1;2;780
3510500;Caraguatatuba;4307906;Farroupilha;1;1;2;836
3513009;Cotia;4307906;Farroupilha;1;1;2;751
3513405;Cruzeiro;4307906;Farroupilha;1;1;2;952
3513702;Descalvado;4307906;Farroupilha;1;1;2;884
3514403;Dracena;4307906;Farroupilha;1;1;2;853
3515004;Embu;4307906;Farroupilha;1;1;2;750
3515509;Fernandópolis;4307906;Farroupilha;1;1;2;996
3519303;Ibaté;4307906;Farroupilha;1;1;2;865
3519600;Ibitinga;4307906;Farroupilha;1;1;2;860
3520509;Indaiatuba;4307906;Farroupilha;1;1;2;782
3522307;Itapetininga;4307906;Farroupilha;1;1;2;699
3522703;Itápolis;4307906;Farroupilha;1;1;2;878
3523909;Itu;4307906;Farroupilha;1;1;2;762
3526704;Leme;4307906;Farroupilha;1;1;2;864
3526803;Lençóis Paulista;4307906;Farroupilha;1;1;2;771
3526902;Limeira;4307906;Farroupilha;1;1;2;827
3530508;Mococa;4307906;Farroupilha;1;1;2;950
3530607;Moji das Cruzes;4307906;Farroupilha;1;1;2;795
3530706;Mogi Guaçu;4307906;Farroupilha;1;1;2;869
3530805;Moji-Mirim;4307906;Farroupilha;1;1;2;858
3531308;Monte Alto;4307906;Farroupilha;1;1;2;919
3531803;Monte Mor;4307906;Farroupilha;1;1;2;793
3533908;Olímpia;4307906;Farroupilha;1;1;2;966
3534401;Osasco;4307906;Farroupilha;1;1;2;764
3534609;Osvaldo Cruz;4307906;Farroupilha;1;1;2;824
3534708;Ourinhos;4307906;Farroupilha;1;1;2;705
3537107;Pedreira;4307906;Farroupilha;1;1;2;832
3537305;Penápolis;4307906;Farroupilha;1;1;2;872
3538006;Pindamonhangaba;4307906;Farroupilha;1;1;2;893
3538709;Piracicaba;4307906;Farroupilha;1;1;2;798
3539301;Pirassununga;4307906;Farroupilha;1;1;2;880
3541406;Presidente Prudente;4307906;Farroupilha;1;1;2;786
3543402;Ribeirão Preto;4307906;Farroupilha;1;1;2;954
3543907;Rio Claro;4307906;Farroupilha;1;1;2;835
3545803;Santa Bárbara d'Oeste;4307906;Farroupilha;1;1;2;807
3546405;Santa Cruz do Rio Pardo;4307906;Farroupilha;1;1;2;719
3547502;Santa Rita do Passa Quatro;4307906;Farroupilha;1;1;2;908
3548906;São Carlos;4307906;Farroupilha;1;1;2;861
3549409;São Joaquim da Barra;4307906;Farroupilha;1;1;2;1009
3549706;São José do Rio Pardo;4307906;Farroupilha;1;1;2;943
3550407;São Pedro;4307906;Farroupilha;1;1;2;807
3550704;São Sebastião;4307906;Farroupilha;1;1;2;825
3553708;Taquaritinga;4307906;Farroupilha;1;1;2;901
3554102;Taubaté;4307906;Farroupilha;1;1;2;879
3554508;Tietê;4307906;Farroupilha;1;1;2;760
3555406;Ubatuba;4307906;Farroupilha;1;1;2;874
3556206;Valinhos;4307906;Farroupilha;1;1;2;806
3556701;Vinhedo;4307906;Farroupilha;1;1;2;801
3557105;Votuporanga;4307906;Farroupilha;1;1;2;981
4101408;Apucarana;4307906;Farroupilha;1;1;2;628
4101507;Arapongas;4307906;Farroupilha;1;1;2;644
4101606;Arapoti;4307906;Farroupilha;1;1;2;580
4101804;Araucária;4307906;Farroupilha;1;1;2;444
4102000;Assis Chateaubriand;4307906;Farroupilha;1;1;2;570
4102109;Astorga;4307906;Farroupilha;1;1;2;665
4102406;Bandeirantes;4307906;Farroupilha;1;1;2;684
4104204;Campo Largo;4307906;Farroupilha;1;1;2;452
4104907;Castro;4307906;Farroupilha;1;1;2;507
4106407;Cornélio Procópio;4307906;Farroupilha;1;1;2;673
4107207;Dois Vizinhos;4307906;Farroupilha;1;1;2;420
4107603;Faxinal;4307906;Farroupilha;1;1;2;578
4108601;Goioerê;4307906;Farroupilha;1;1;2;579
4108809;Guaíra;4307906;Farroupilha;1;1;2;631
4109609;Guaratuba;4307906;Farroupilha;1;1;2;445
4111506;Ivaiporã;4307906;Farroupilha;1;1;2;553
4113205;Lapa;4307906;Farroupilha;1;1;2;413
4113304;Laranjeiras do Sul;4307906;Farroupilha;1;1;2;434
4113502;Loanda;4307906;Farroupilha;1;1;2;718
4114203;Mandaguari;4307906;Farroupilha;1;1;2;629
4114302;Mandirituba;4307906;Farroupilha;1;1;2;428
4114609;Marechal Cândido Rondon;4307906;Farroupilha;1;1;2;578
4115606;Matelândia;4307906;Farroupilha;1;1;2;508
4115804;Medianeira;4307906;Farroupilha;1;1;2;509
4117107;Nova Londrina;4307906;Farroupilha;1;1;2;732
4117602;Palmas;4307906;Farroupilha;1;1;2;308
4117909;Palotina;4307906;Farroupilha;1;1;2;594
4118402;Paranavaí;4307906;Farroupilha;1;1;2;687
4119509;Piraquara;4307906;Farroupilha;1;1;2;472
4119608;Pitanga;4307906;Farroupilha;1;1;2;495
4120804;Quatro Barras;4307906;Farroupilha;1;1;2;479
4122206;Rio Branco do Sul;4307906;Farroupilha;1;1;2;487
4122305;Rio Negro;4307906;Farroupilha;1;1;2;376
4122404;Rolândia;4307906;Farroupilha;1;1;2;655
4127106;Telêmaco Borba;4307906;Farroupilha;1;1;2;542
4127700;Toledo;4307906;Farroupilha;1;1;2;550
4128203;União da Vitória;4307906;Farroupilha;1;1;2;327
4203808;Canoinhas;4307906;Farroupilha;1;1;2;347
4203907;Capinzal;4307906;Farroupilha;1;1;2;210
4204251;Cocal do Sul;4307906;Farroupilha;1;1;2;207
4204558;Correia Pinto;4307906;Farroupilha;1;1;2;205
4204806;Curitibanos;4307906;Farroupilha;1;1;2;228
4205506;Fraiburgo;4307906;Farroupilha;1;1;2;247
4205902;Gaspar;4307906;Farroupilha;1;1;2;342
4207007;Içara;4307906;Farroupilha;1;1;2;206
4209409;Laguna;4307906;Farroupilha;1;1;2;257
4210100;Mafra;4307906;Farroupilha;1;1;2;371
4211306;Navegantes;4307906;Farroupilha;1;1;2;365
4211751;Otacílio Costa;4307906;Farroupilha;1;1;2;226
4213203;Pomerode;4307906;Farroupilha;1;1;2;345
4215000;Rio Negrinho;4307906;Farroupilha;1;1;2;373
4218202;Timbó;4307906;Farroupilha;1;1;2;330
4219002;Urussanga;4307906;Farroupilha;1;1;2;206
4219309;Videira;4307906;Farroupilha;1;1;2;246
4219507;Xanxerê;4307906;Farroupilha;1;1;2;282
4301651;Barão;4307906;Farroupilha;1;1;2;23
4302253;Boa Vista do Sul;4307906;Farroupilha;1;1;2;36
4302303;Bom Jesus;4307906;Farroupilha;1;1;2;108
4302808;Caçapava do Sul;4307906;Farroupilha;1;1;2;250
4303004;Cachoeira do Sul;4307906;Farroupilha;1;1;2;176
4304200;Candelária;4307906;Farroupilha;1;1;2;153
4304507;Canguçu;4307906;Farroupilha;1;1;2;276
4304705;Carazinho;4307906;Farroupilha;1;1;2;174
4305355;Charqueadas;4307906;Farroupilha;1;1;2;86
4306403;Dois Irmãos;4307906;Farroupilha;1;1;2;47
4306601;Dom Pedrito;4307906;Farroupilha;1;1;2;379
4306908;Encruzilhada do Sul;4307906;Farroupilha;1;1;2;185
4307500;Espumoso;4307906;Farroupilha;1;1;2;157
4301503;Augusto Pestana;4307831;Eugênio de Castro;1;1;2;15
4306932;Entre-Ijuís;4307831;Eugênio de Castro;1;1;2;22
4300109;Agudo;4307815;Estrela Velha;1;1;2;52
4304101;Campos Borges;4307815;Estrela Velha;1;1;2;36
2308005;Massapê;4307807;Estrela;1;1;2;3062
2308708;Morada Nova;4307807;Estrela;1;1;2;2966
2310704;Pentecoste;4307807;Estrela;1;1;2;3069
2919553;Luís Eduardo magalhães;4307807;Estrela;1;1;2;2007
3165537;Sarzedo;4307807;Estrela;1;1;2;1277
3505401;Barra do Turvo;4307807;Estrela;1;1;2;620
3515004;Embu;4307807;Estrela;1;1;2;809
3516309;Francisco Morato;4307807;Estrela;1;1;2;851
3518800;Guarulhos;4307807;Estrela;1;1;2;844
3527207;Lorena;4307807;Estrela;1;1;2;991
3534401;Osasco;4307807;Estrela;1;1;2;822
3552809;Taboão da Serra;4307807;Estrela;1;1;2;818
3557105;Votuporanga;4307807;Estrela;1;1;2;1021
4104808;Cascavel;4307807;Estrela;1;1;2;524
4216602;São José;4307807;Estrela;1;1;2;380
4303103;Cachoeirinha;4307807;Estrela;1;1;2;96
4304200;Candelária;4307807;Estrela;1;1;2;86
4304630;Capão da Canoa;4307807;Estrela;1;1;2;189
4305871;Coronel Barros;4307807;Estrela;1;1;2;237
4306767;Eldorado do Sul;4307807;Estrela;1;1;2;73
2306306;Itapagé;4307708;Esteio;1;1;2;3078
2905701;Camaçari;4307708;Esteio;1;1;2;2231
2919207;Lauro de Freitas;4307708;Esteio;1;1;2;2214
2919553;Luís Eduardo magalhães;4307708;Esteio;1;1;2;2024
3136652;Juatuba;4307708;Esteio;1;1;2;1266
3205002;Serra;4307708;Esteio;1;1;2;1476
3303500;Nova Iguaçu;4307708;Esteio;1;1;2;1067
3305752;Tanguá;4307708;Esteio;1;1;2;1117
3505708;Barueri;4307708;Esteio;1;1;2;810
3510005;Cândido Mota;4307708;Esteio;1;1;2;790
3512803;Cosmópolis;4307708;Esteio;1;1;2;881
3516200;Franca;4307708;Esteio;1;1;2;1089
3518800;Guarulhos;4307708;Esteio;1;1;2;832
3520004;Igaraçu do Tietê;4307708;Esteio;1;1;2;849
3528502;Mairiporã;4307708;Esteio;1;1;2;842
3539806;Poá;4307708;Esteio;1;1;2;835
3548708;São Bernardo do Campo;4307708;Esteio;1;1;2;805
3548807;São Caetano do Sul;4307708;Esteio;1;1;2;816
4105805;Colombo;4307708;Esteio;1;1;2;541
4119905;Ponta Grossa;4307708;Esteio;1;1;2;534
4120655;Quarto Centenário;4307708;Esteio;1;1;2;643
4202404;Blumenau;4307708;Esteio;1;1;2;378
4204202;Chapecó;4307708;Esteio;1;1;2;333
4204608;Criciúma;4307708;Esteio;1;1;2;216
4205456;Forquilhinha;4307708;Esteio;1;1;2;204
4207007;Içara;4307708;Esteio;1;1;2;220
4211900;Palhoça;4307708;Esteio;1;1;2;337
4300406;Alegrete;4307708;Esteio;1;1;2;443
4301636;Balneário Pinhal;4307708;Esteio;1;1;2;99
4303509;Camaquã;4307708;Esteio;1;1;2;126
4305355;Charqueadas;4307708;Esteio;1;1;2;45
4307005;Erechim;4307708;Esteio;1;1;2;267
1501402;Belém;4307609;Estância Velha;1;1;2;3137
3513009;Cotia;4307609;Estância Velha;1;1;2;781
3513801;Diadema;4307609;Estância Velha;1;1;2;788
3516200;Franca;4307609;Estância Velha;1;1;2;1068
3518206;Guararapes;4307609;Estância Velha;1;1;2;930
3530607;Moji das Cruzes;4307609;Estância Velha;1;1;2;822
3534401;Osasco;4307609;Estância Velha;1;1;2;793
3548906;São Carlos;4307609;Estância Velha;1;1;2;899
4101507;Arapongas;4307609;Estância Velha;1;1;2;691
4207007;Içara;4307609;Estância Velha;1;1;2;208
4208203;Itajaí;4307609;Estância Velha;1;1;2;379
4216305;São João Batista;4307609;Estância Velha;1;1;2;344
4216602;São José;4307609;Estância Velha;1;1;2;331
4300604;Alvorada;4307609;Estância Velha;1;1;2;39
4302204;Boa Vista do Buricá;4307609;Estância Velha;1;1;2;357
4303509;Camaquã;4307609;Estância Velha;1;1;2;146
4303608;Cambará do Sul;4307609;Estância Velha;1;1;2;120
4304804;Carlos Barbosa;4307609;Estância Velha;1;1;2;50
4305108;Caxias do Sul;4307609;Estância Velha;1;1;2;54
1500800;Ananindeua;4307559;Estação;1;1;2;2958
3525201;Jarinu;4307559;Estação;1;1;2;754
3550308;São Paulo;4307559;Estação;1;1;2;719
4214805;Rio do Sul;4307559;Estação;1;1;2;271
4304804;Carlos Barbosa;4307559;Estação;1;1;2;171
3534401;Osasco;4307500;Espumoso;1;1;2;816
4301206;Arroio do Tigre;4307500;Espumoso;1;1;2;71
4303103;Cachoeirinha;4307500;Espumoso;1;1;2;218
4304606;Canoas;4307500;Espumoso;1;1;2;210
4305207;Cerro Largo;4307500;Espumoso;1;1;2;194
4305355;Charqueadas;4307500;Espumoso;1;1;2;182
4305603;Colorado;4307500;Espumoso;1;1;2;26
4306106;Cruz Alta;4307500;Espumoso;1;1;2;73
4306767;Eldorado do Sul;4307500;Espumoso;1;1;2;193
4307005;Erechim;4307500;Espumoso;1;1;2;133
4304002;Campo Novo;4307450;Esperança do Sul;1;1;2;40
4301800;Barracão;4307401;Esmeralda;1;1;2;50
4302105;Bento Gonçalves;4307401;Esmeralda;1;1;2;127
4305108;Caxias do Sul;4307401;Esmeralda;1;1;2;123
4202404;Blumenau;4307302;Erval Seco;1;1;2;441
4207502;Indaial;4307302;Erval Seco;1;1;2;427
4303400;Caiçara;4307302;Erval Seco;1;1;2;31
4305207;Cerro Largo;4307302;Erval Seco;1;1;2;139
4204202;Chapecó;4307203;Erval Grande;1;1;2;32
4302055;Benjamin Constant do Sul;4307203;Erval Grande;1;1;2;13
3550308;São Paulo;4307104;Herval;1;1;2;1112
4208500;Ituporanga;4307104;Herval;1;1;2;620
4301305;Arroio Grande;4307104;Herval;1;1;2;39
4304507;Canguçu;4307104;Herval;1;1;2;96
1721000;Palmas;4307005;Erechim;1;1;2;1946
2704302;Maceió;4307005;Erechim;1;1;2;2521
2704708;Marechal Deodoro;4307005;Erechim;1;1;2;2506
3106200;Belo Horizonte;4307005;Erechim;1;1;2;1168
3170206;Uberlândia;4307005;Erechim;1;1;2;1040
3301900;Itaboraí;4307005;Erechim;1;1;2;1060
3509502;Campinas;4307005;Erechim;1;1;2;728
3516200;Franca;4307005;Erechim;1;1;2;914
3548807;São Caetano do Sul;4307005;Erechim;1;1;2;711
4101804;Araucária;4307005;Erechim;1;1;2;361
4103701;Cambé;4307005;Erechim;1;1;2;490
4104808;Cascavel;4307005;Erechim;1;1;2;319
4107405;Enéas Marques;4307005;Erechim;1;1;2;206
4117602;Palmas;4307005;Erechim;1;1;2;128
4119152;Pinhais;4307005;Erechim;1;1;2;387
4125506;São José dos Pinhais;4307005;Erechim;1;1;2;381
4125605;São Mateus do Sul;4307005;Erechim;1;1;2;272
4202404;Blumenau;4307005;Erechim;1;1;2;324
4203204;Camboriú;4307005;Erechim;1;1;2;359
4203907;Capinzal;4307005;Erechim;1;1;2;73
4205407;Florianópolis;4307005;Erechim;1;1;2;371
4206504;Guaramirim;4307005;Erechim;1;1;2;346
4207502;Indaial;4307005;Erechim;1;1;2;310
4208005;Itá;4307005;Erechim;1;1;2;40
4208302;Itapema;4307005;Erechim;1;1;2;363
4209102;Joinville;4307005;Erechim;1;1;2;367
4209854;Lindóia do Sul;4307005;Erechim;1;1;2;67
4210506;Maravilha;4307005;Erechim;1;1;2;130
4211306;Navegantes;4307005;Erechim;1;1;2;364
4211801;Ouro;4307005;Erechim;1;1;2;71
4211900;Palhoça;4307005;Erechim;1;1;2;349
4213104;Piratuba;4307005;Erechim;1;1;2;55
4213153;Planalto Alegre;4307005;Erechim;1;1;2;87
4216602;São José;4307005;Erechim;1;1;2;354
4301602;Bagé;4307005;Erechim;1;1;2;449
4302055;Benjamin Constant do Sul;4307005;Erechim;1;1;2;34
4303202;Cacique Doble;4307005;Erechim;1;1;2;63
4303509;Camaquã;4307005;Erechim;1;1;2;358
4304853;Carlos Gomes;4307005;Erechim;1;1;2;37
4306106;Cruz Alta;4307005;Erechim;1;1;2;172
4306130;Cruzaltense;4307005;Erechim;1;1;2;37
4306403;Dois Irmãos;4307005;Erechim;1;1;2;246
4306767;Eldorado do Sul;4307005;Erechim;1;1;2;280
4205407;Florianópolis;4306957;Entre Rios do Sul;1;1;2;417
4303806;Campinas do Sul;4306957;Entre Rios do Sul;1;1;2;23
4303301;Caibaté;4306932;Entre-Ijuís;1;1;2;38
4305801;Constantina;4306924;Engenho Velho;1;1;2;8
3534401;Osasco;4306908;Encruzilhada do Sul;1;1;2;941
4106902;Curitiba;4306908;Encruzilhada do Sul;1;1;2;640
4209409;Laguna;4306908;Encruzilhada do Sul;1;1;2;420
4213203;Pomerode;4306908;Encruzilhada do Sul;1;1;2;525
4301107;Arroio dos Ratos;4306908;Encruzilhada do Sul;1;1;2;92
4301305;Arroio Grande;4306908;Encruzilhada do Sul;1;1;2;196
4301602;Bagé;4306908;Encruzilhada do Sul;1;1;2;175
4302105;Bento Gonçalves;4306908;Encruzilhada do Sul;1;1;2;180
4303004;Cachoeira do Sul;4306908;Encruzilhada do Sul;1;1;2;66
4303103;Cachoeirinha;4306908;Encruzilhada do Sul;1;1;2;151
4306767;Eldorado do Sul;4306908;Encruzilhada do Sul;1;1;2;101
2927408;Salvador;4306809;Encantado;1;1;2;2181
3304557;Rio de Janeiro;4306809;Encantado;1;1;2;1079
3522208;Itapecerica da Serra;4306809;Encantado;1;1;2;777
3523107;Itaquaquecetuba;4306809;Encantado;1;1;2;827
3534401;Osasco;4306809;Encantado;1;1;2;796
3550308;São Paulo;4306809;Encantado;1;1;2;794
4109807;Ibiporã;4306809;Encantado;1;1;2;665
4120606;Prudentópolis;4306809;Encantado;1;1;2;452
4125605;São Mateus do Sul;4306809;Encantado;1;1;2;403
4203808;Canoinhas;4306809;Encantado;1;1;2;365
4205407;Florianópolis;4306809;Encantado;1;1;2;374
4205803;Garuva;4306809;Encantado;1;1;2;460
4208203;Itajaí;4306809;Encantado;1;1;2;395
4304358;Candiota;4306809;Encantado;1;1;2;311
4304705;Carazinho;4306809;Encantado;1;1;2;134
4305207;Cerro Largo;4306809;Encantado;1;1;2;298
4305835;Coqueiro Baixo;4306809;Encantado;1;1;2;19
4306106;Cruz Alta;4306809;Encantado;1;1;2;176
4306452;Dois Lajeados;4306809;Encantado;1;1;2;28
2910800;Feira de Santana;4306767;Eldorado do Sul;1;1;2;2280
3304557;Rio de Janeiro;4306767;Eldorado do Sul;1;1;2;1116
3519071;Hortolândia;4306767;Eldorado do Sul;1;1;2;900
3534401;Osasco;4306767;Eldorado do Sul;1;1;2;855
3547007;Santa Maria da Serra;4306767;Eldorado do Sul;1;1;2;893
3552809;Taboão da Serra;4306767;Eldorado do Sul;1;1;2;850
4105706;Clevelândia;4306767;Eldorado do Sul;1;1;2;417
4107850;Flor da Serra do Sul;4306767;Eldorado do Sul;1;1;2;457
4113700;Londrina;4306767;Eldorado do Sul;1;1;2;753
4114807;Marialva;4306767;Eldorado do Sul;1;1;2;731
4118501;Pato Branco;4306767;Eldorado do Sul;1;1;2;438
4203501;Campo Erê;4306767;Eldorado do Sul;1;1;2;432
4203600;Campos Novos;4306767;Eldorado do Sul;1;1;2;297
4206603;Guarujá do Sul;4306767;Eldorado do Sul;1;1;2;448
4208203;Itajaí;4306767;Eldorado do Sul;1;1;2;442
4208500;Ituporanga;4306767;Eldorado do Sul;1;1;2;353
4208708;Jacinto Machado;4306767;Eldorado do Sul;1;1;2;215
4212908;Pinhalzinho;4306767;Eldorado do Sul;1;1;2;382
4216107;São Domingos;4306767;Eldorado do Sul;1;1;2;400
4218707;Tubarão;4306767;Eldorado do Sul;1;1;2;303
4219507;Xanxerê;4306767;Eldorado do Sul;1;1;2;365
4300406;Alegrete;4306767;Eldorado do Sul;1;1;2;400
4301305;Arroio Grande;4306767;Eldorado do Sul;1;1;2;276
4301602;Bagé;4306767;Eldorado do Sul;1;1;2;278
4301750;Barão do Triunfo;4306767;Eldorado do Sul;1;1;2;36
4302709;Butiá;4306767;Eldorado do Sul;1;1;2;34
4303509;Camaquã;4306767;Eldorado do Sul;1;1;2;86
4304507;Canguçu;4306767;Eldorado do Sul;1;1;2;179
4304671;Capivari do Sul;4306767;Eldorado do Sul;1;1;2;106
4304705;Carazinho;4306767;Eldorado do Sul;1;1;2;228
4305108;Caxias do Sul;4306767;Eldorado do Sul;1;1;2;111
4306106;Cruz Alta;4306767;Eldorado do Sul;1;1;2;248
4306601;Dom Pedrito;4306767;Eldorado do Sul;1;1;2;310
4208005;Itá;4306759;Doutor Ricardo;1;1;2;203
4300703;Anta Gorda;4306759;Doutor Ricardo;1;1;2;13
4305587;Colinas;4306759;Doutor Ricardo;1;1;2;36
3534401;Osasco;4306734;Doutor Maurício Cardoso;1;1;2;857
4303103;Cachoeirinha;4306734;Doutor Maurício Cardoso;1;1;2;423
4305207;Cerro Largo;4306734;Doutor Maurício Cardoso;1;1;2;81
4306007;Crissiumal;4306734;Doutor Maurício Cardoso;1;1;2;26
3534401;Osasco;4306601;Dom Pedrito;1;1;2;1099
4300034;Aceguá;4306601;Dom Pedrito;1;1;2;110
4300406;Alegrete;4306601;Dom Pedrito;1;1;2;167
4301305;Arroio Grande;4306601;Dom Pedrito;1;1;2;208
4303004;Cachoeira do Sul;4306601;Dom Pedrito;1;1;2;198
4303103;Cachoeirinha;4306601;Dom Pedrito;1;1;2;355
3304557;Rio de Janeiro;4306551;Dom Pedro de Alcântara;1;1;2;951
4217709;Sombrio;4306551;Dom Pedro de Alcântara;1;1;2;35
4303103;Cachoeirinha;4306551;Dom Pedro de Alcântara;1;1;2;139
3534401;Osasco;4306502;Dom Feliciano;1;1;2;935
4300604;Alvorada;4306502;Dom Feliciano;1;1;2;126
4300638;Amaral Ferrador;4306502;Dom Feliciano;1;1;2;24
4303004;Cachoeira do Sul;4306502;Dom Feliciano;1;1;2;109
4305207;Cerro Largo;4306502;Dom Feliciano;1;1;2;376
1505031;Novo Progresso;4306452;Dois Lajeados;1;1;2;2438
4106902;Curitiba;4306452;Dois Lajeados;1;1;2;463
1501402;Belém;4306403;Dois Irmãos;1;1;2;3129
2408102;Natal;4306403;Dois Irmãos;1;1;2;2997
2507507;João Pessoa;4306403;Dois Irmãos;1;1;2;2883
2927200;Ruy Barbosa;4306403;Dois Irmãos;1;1;2;2144
3304557;Rio de Janeiro;4306403;Dois Irmãos;1;1;2;1045
3505708;Barueri;4306403;Dois Irmãos;1;1;2;781
3534401;Osasco;4306403;Dois Irmãos;1;1;2;783
3538709;Piracicaba;4306403;Dois Irmãos;1;1;2;823
3548807;São Caetano do Sul;4306403;Dois Irmãos;1;1;2;787
4106902;Curitiba;4306403;Dois Irmãos;1;1;2;490
4201406;Araranguá;4306403;Dois Irmãos;1;1;2;169
4205704;Garopaba;4306403;Dois Irmãos;1;1;2;290
4208203;Itajaí;4306403;Dois Irmãos;1;1;2;368
4209102;Joinville;4306403;Dois Irmãos;1;1;2;423
4216602;São José;4306403;Dois Irmãos;1;1;2;320
4300109;Agudo;4306403;Dois Irmãos;1;1;2;209
4302105;Bento Gonçalves;4306403;Dois Irmãos;1;1;2;62
4303004;Cachoeira do Sul;4306403;Dois Irmãos;1;1;2;183
4303509;Camaquã;4306403;Dois Irmãos;1;1;2;156
4304200;Candelária;4306403;Dois Irmãos;1;1;2;169
4304705;Carazinho;4306403;Dois Irmãos;1;1;2;217
4305306;Chapada;4306403;Dois Irmãos;1;1;2;255
4306106;Cruz Alta;4306403;Dois Irmãos;1;1;2;263
4305207;Cerro Largo;4306353;Dezesseis de Novembro;1;1;2;34
4304002;Campo Novo;4306320;Derrubadas;1;1;2;46
4304952;Caseiros;4306304;David Canabarro;1;1;2;20
4305207;Cerro Largo;4306304;David Canabarro;1;1;2;284
3534401;Osasco;4306205;Cruzeiro do Sul;1;1;2;826
4301008;Arroio do Meio;4306205;Cruzeiro do Sul;1;1;2;14
4302402;Bom Retiro do Sul;4306205;Cruzeiro do Sul;1;1;2;14
4303103;Cachoeirinha;4306205;Cruzeiro do Sul;1;1;2;101
4303806;Campinas do Sul;4306130;Cruzaltense;1;1;2;6
1302603;Manaus;4306106;Cruz Alta;1;1;2;2886
1500800;Ananindeua;4306106;Cruz Alta;1;1;2;3055
2408102;Natal;4306106;Cruz Alta;1;1;2;3037
2927408;Salvador;4306106;Cruz Alta;1;1;2;2229
3106200;Belo Horizonte;4306106;Cruz Alta;1;1;2;1327
3505708;Barueri;4306106;Cruz Alta;1;1;2;858
3516200;Franca;4306106;Cruz Alta;1;1;2;1072
3518800;Guarulhos;4306106;Cruz Alta;1;1;2;886
3534401;Osasco;4306106;Cruz Alta;1;1;2;862
4105805;Colombo;4306106;Cruz Alta;1;1;2;563
4110409;Indianópolis;4306106;Cruz Alta;1;1;2;579
4113700;Londrina;4306106;Cruz Alta;1;1;2;636
4117909;Palotina;4306106;Cruz Alta;1;1;2;482
4205902;Gaspar;4306106;Cruz Alta;1;1;2;488
4208203;Itajaí;4306106;Cruz Alta;1;1;2;506
4209102;Joinville;4306106;Cruz Alta;1;1;2;527
4219507;Xanxerê;4306106;Cruz Alta;1;1;2;229
4300406;Alegrete;4306106;Cruz Alta;1;1;2;248
4301602;Bagé;4306106;Cruz Alta;1;1;2;302
4302238;Boa vista do Incra;4306106;Cruz Alta;1;1;2;28
4302584;Bozano;4306106;Cruz Alta;1;1;2;35
4303004;Cachoeira do Sul;4306106;Cruz Alta;1;1;2;165
4303509;Camaquã;4306106;Cruz Alta;1;1;2;300
4304705;Carazinho;4306106;Cruz Alta;1;1;2;88
4305306;Chapada;4306106;Cruz Alta;1;1;2;83
4305603;Colorado;4306106;Cruz Alta;1;1;2;60
3541406;Presidente Prudente;4306007;Crissiumal;1;1;2;649
4208203;Itajaí;4306007;Crissiumal;1;1;2;531
4302204;Boa Vista do Buricá;4306007;Crissiumal;1;1;2;19
4303103;Cachoeirinha;4306007;Crissiumal;1;1;2;403
4305108;Caxias do Sul;4306007;Crissiumal;1;1;2;345
4305207;Cerro Largo;4306007;Crissiumal;1;1;2;96
3505708;Barueri;4305975;Coxilha;1;1;2;731
3550308;São Paulo;4305975;Coxilha;1;1;2;736
4106902;Curitiba;4305959;Cotiporã;1;1;2;457
3550308;São Paulo;4305934;Coronel Pilar;1;1;2;785
4304804;Carlos Barbosa;4305934;Coronel Pilar;1;1;2;18
4212908;Pinhalzinho;4305900;Coronel Bicaco;1;1;2;119
4305207;Cerro Largo;4305900;Coronel Bicaco;1;1;2;113
4301503;Augusto Pestana;4305871;Coronel Barros;1;1;2;17
4305306;Chapada;4305850;Coqueiros do Sul;1;1;2;29
4104808;Cascavel;4305801;Constantina;1;1;2;312
4208302;Itapema;4305801;Constantina;1;1;2;434
4303103;Cachoeirinha;4305801;Constantina;1;1;2;309
4305108;Caxias do Sul;4305801;Constantina;1;1;2;240
4305207;Cerro Largo;4305801;Constantina;1;1;2;178
4305306;Chapada;4305801;Constantina;1;1;2;36
4217204;São Miguel do Oeste;4305702;Condor;1;1;2;167
4305207;Cerro Largo;4305702;Condor;1;1;2;122
3515004;Embu;4305587;Colinas;1;1;2;794
4211900;Palhoça;4305587;Colinas;1;1;2;358
4305108;Caxias do Sul;4305504;Ciríaco;1;1;2;114
4303103;Cachoeirinha;4305447;Chuvisca;1;1;2;122
4303509;Camaquã;4305447;Chuvisca;1;1;2;18
3548708;São Bernardo do Campo;4305439;Chuí;1;1;2;1260
4304606;Canoas;4305439;Chuí;1;1;2;465
4300455;Alegria;4305405;Chiapetta;1;1;2;16
4302204;Boa Vista do Buricá;4305405;Chiapetta;1;1;2;33
3145901;Ouro Branco;4305355;Charqueadas;1;1;2;1278
3534401;Osasco;4305355;Charqueadas;1;1;2;844
3548708;São Bernardo do Campo;4305355;Charqueadas;1;1;2;838
4101804;Araucária;4305355;Charqueadas;1;1;2;528
4216602;São José;4305355;Charqueadas;1;1;2;385
4300604;Alvorada;4305355;Charqueadas;1;1;2;52
4303004;Cachoeira do Sul;4305355;Charqueadas;1;1;2;124
4303103;Cachoeirinha;4305355;Charqueadas;1;1;2;49
4304606;Canoas;4305355;Charqueadas;1;1;2;43
4304630;Capão da Canoa;4305355;Charqueadas;1;1;2;154
2303709;Caucaia;4305306;Chapada;1;1;2;3003
2602100;Bom Conselho;4305306;Chapada;1;1;2;2582
2910800;Feira de Santana;4305306;Chapada;1;1;2;2186
3304144;Queimados;4305306;Chapada;1;1;2;1087
3509502;Campinas;4305306;Chapada;1;1;2;813
4125506;São José dos Pinhais;4305306;Chapada;1;1;2;470
4204301;Concórdia;4305306;Chapada;1;1;2;138
4208203;Itajaí;4305306;Chapada;1;1;2;440
4305108;Caxias do Sul;4305306;Chapada;1;1;2;224
4305207;Cerro Largo;4305306;Chapada;1;1;2;164
3534401;Osasco;4305207;Cerro Largo;1;1;2;921
3550308;São Paulo;4305207;Cerro Largo;1;1;2;925
4102901;Bituruna;4305207;Cerro Largo;1;1;2;380
4204202;Chapecó;4305207;Cerro Largo;1;1;2;237
4204301;Concórdia;4305207;Cerro Largo;1;1;2;285
4204400;Coronel Freitas;4305207;Cerro Largo;1;1;2;242
4204707;Cunha Porã;4305207;Cerro Largo;1;1;2;207
4206405;Guaraciaba;4305207;Cerro Largo;1;1;2;209
4207650;Iporã do Oeste;4305207;Cerro Largo;1;1;2;175
4208203;Itajaí;4305207;Cerro Largo;1;1;2;600
4210506;Maravilha;4305207;Cerro Largo;1;1;2;217
4211009;Mondaí;4305207;Cerro Largo;1;1;2;172
4212106;Palmitos;4305207;Cerro Largo;1;1;2;196
4212908;Pinhalzinho;4305207;Cerro Largo;1;1;2;223
4216008;São Carlos;4305207;Cerro Largo;1;1;2;206
4216701;São José do Cedro;4305207;Cerro Largo;1;1;2;222
4216909;São Lourenço do Oeste;4305207;Cerro Largo;1;1;2;267
4217204;São Miguel do Oeste;4305207;Cerro Largo;1;1;2;198
4219705;Xaxim;4305207;Cerro Largo;1;1;2;252
4300109;Agudo;4305207;Cerro Largo;1;1;2;221
4300208;Ajuricaba;4305207;Cerro Largo;1;1;2;95
4300406;Alegrete;4305207;Cerro Largo;1;1;2;208
4301206;Arroio do Tigre;4305207;Cerro Largo;1;1;2;208
4301503;Augusto Pestana;4305207;Cerro Largo;1;1;2;83
4302006;Barros Cassal;4305207;Cerro Largo;1;1;2;236
4302105;Bento Gonçalves;4305207;Cerro Largo;1;1;2;337
4302204;Boa Vista do Buricá;4305207;Cerro Largo;1;1;2;81
4303004;Cachoeira do Sul;4305207;Cerro Largo;1;1;2;273
4303103;Cachoeirinha;4305207;Cerro Largo;1;1;2;410
4303509;Camaquã;4305207;Cerro Largo;1;1;2;416
4303806;Campinas do Sul;4305207;Cerro Largo;1;1;2;212
4304002;Campo Novo;4305207;Cerro Largo;1;1;2;106
4304200;Candelária;4305207;Cerro Largo;1;1;2;254
4304507;Canguçu;4305207;Cerro Largo;1;1;2;414
4304705;Carazinho;4305207;Cerro Largo;1;1;2;192
4305108;Caxias do Sul;4305207;Cerro Largo;1;1;2;369
3534401;Osasco;4305173;Cerro Grande do Sul;1;1;2;907
4300851;Arambaré;4305173;Cerro Grande do Sul;1;1;2;42
4303004;Cachoeira do Sul;4305173;Cerro Grande do Sul;1;1;2;130
4303509;Camaquã;4305173;Cerro Grande do Sul;1;1;2;28
4300505;Alpestre;4305157;Cerro Grande;1;1;2;42
4300109;Agudo;4305132;Cerro Branco;1;1;2;26
4300901;Aratiba;4305116;Centenário;1;1;2;50
1100106;Guajará-Mirim;4305108;Caxias do Sul;1;1;2;2413
1400100;Boa Vista;4305108;Caxias do Sul;1;1;2;3648
1600303;Macapá;4305108;Caxias do Sul;1;1;2;3234
2105302;Imperatriz;4305108;Caxias do Sul;1;1;2;2639
2304202;Crato;4305108;Caxias do Sul;1;1;2;2656
2304285;Eusébio;4305108;Caxias do Sul;1;1;2;3027
2307304;Juazeiro do Norte;4305108;Caxias do Sul;1;1;2;2658
2312908;Sobral;4305108;Caxias do Sul;1;1;2;2988
2408102;Natal;4305108;Caxias do Sul;1;1;2;2964
2412005;São Gonçalo do Amarante;4305108;Caxias do Sul;1;1;2;2963
2501302;Aroeiras;4305108;Caxias do Sul;1;1;2;2778
2602902;Cabo de Santo Agostinho;4305108;Caxias do Sul;1;1;2;2742
2604106;Caruaru;4305108;Caxias do Sul;1;1;2;2696
2609600;Olinda;4305108;Caxias do Sul;1;1;2;2775
2610707;Paulista;4305108;Caxias do Sul;1;1;2;2781
2611101;Petrolina;4305108;Caxias do Sul;1;1;2;2404
2704302;Maceió;4305108;Caxias do Sul;1;1;2;2582
2901106;Amélia Rodrigues;4305108;Caxias do Sul;1;1;2;2178
2905701;Camaçari;4305108;Caxias do Sul;1;1;2;2172
2910057;Dias d'Ávila;4305108;Caxias do Sul;1;1;2;2181
2919207;Lauro de Freitas;4305108;Caxias do Sul;1;1;2;2156
2919553;Luís Eduardo magalhães;4305108;Caxias do Sul;1;1;2;1952
2925204;Pojuca;4305108;Caxias do Sul;1;1;2;2197
2930709;Simões Filho;4305108;Caxias do Sul;1;1;2;2160
2931350;Teixeira de Freitas;4305108;Caxias do Sul;1;1;2;1670
3102605;Andradas;4305108;Caxias do Sul;1;1;2;898
3131307;Ipatinga;4305108;Caxias do Sul;1;1;2;1343
3137106;Lagamar;4305108;Caxias do Sul;1;1;2;1282
3147907;Passos;4305108;Caxias do Sul;1;1;2;1029
3152501;Pouso Alegre;4305108;Caxias do Sul;1;1;2;914
3167202;Sete Lagoas;4305108;Caxias do Sul;1;1;2;1257
3168705;Timóteo;4305108;Caxias do Sul;1;1;2;1328
3170107;Uberaba;4305108;Caxias do Sul;1;1;2;1087
3201308;Cariacica;4305108;Caxias do Sul;1;1;2;1409
3205200;Vila Velha;4305108;Caxias do Sul;1;1;2;1408
3205309;Vitória;4305108;Caxias do Sul;1;1;2;1419
3300407;Barra Mansa;4305108;Caxias do Sul;1;1;2;987
3301850;Guapimirim;4305108;Caxias do Sul;1;1;2;1067
3302403;Macaé;4305108;Caxias do Sul;1;1;2;1156
3303500;Nova Iguaçu;4305108;Caxias do Sul;1;1;2;1017
3304524;Rio das Ostras;4305108;Caxias do Sul;1;1;2;1145
3304904;São Gonçalo;4305108;Caxias do Sul;1;1;2;1043
3305109;São João de Meriti;4305108;Caxias do Sul;1;1;2;1021
3306305;Volta Redonda;4305108;Caxias do Sul;1;1;2;996
3501905;Amparo;4305108;Caxias do Sul;1;1;2;828
3503901;Arujá;4305108;Caxias do Sul;1;1;2;788
3506003;Bauru;4305108;Caxias do Sul;1;1;2;781
3506508;Birigui;4305108;Caxias do Sul;1;1;2;874
3507001;Boituva;4305108;Caxias do Sul;1;1;2;731
3507506;Botucatu;4305108;Caxias do Sul;1;1;2;742
3508504;Caçapava;4305108;Caxias do Sul;1;1;2;848
3509205;Cajamar;4305108;Caxias do Sul;1;1;2;761
3509601;Campo Limpo Paulista;4305108;Caxias do Sul;1;1;2;780
3510401;Capivari;4305108;Caxias do Sul;1;1;2;766
3511409;Cerqueira César;4305108;Caxias do Sul;1;1;2;705
3513504;Cubatão;4305108;Caxias do Sul;1;1;2;738
3521002;Iperó;4305108;Caxias do Sul;1;1;2;724
3522208;Itapecerica da Serra;4305108;Caxias do Sul;1;1;2;730
3522406;Itapeva;4305108;Caxias do Sul;1;1;2;614
3523107;Itaquaquecetuba;4305108;Caxias do Sul;1;1;2;778
3523909;Itu;4305108;Caxias do Sul;1;1;2;748
3524006;Itupeva;4305108;Caxias do Sul;1;1;2;771
3529401;Mauá;4305108;Caxias do Sul;1;1;2;755
3530607;Moji das Cruzes;4305108;Caxias do Sul;1;1;2;780
3530706;Mogi Guaçu;4305108;Caxias do Sul;1;1;2;856
3533403;Nova Odessa;4305108;Caxias do Sul;1;1;2;798
3536208;Pariquera-Açu;4305108;Caxias do Sul;1;1;2;584
3537602;Peruíbe;4305108;Caxias do Sul;1;1;2;669
3538006;Pindamonhangaba;4305108;Caxias do Sul;1;1;2;877
3539806;Poá;4305108;Caxias do Sul;1;1;2;775
3541406;Presidente Prudente;4305108;Caxias do Sul;1;1;2;779
3543303;Ribeirão Pires;4305108;Caxias do Sul;1;1;2;755
3543907;Rio Claro;4305108;Caxias do Sul;1;1;2;822
3547304;Santana de Parnaíba;4305108;Caxias do Sul;1;1;2;751
3548500;Santos;4305108;Caxias do Sul;1;1;2;742
3548906;São Carlos;4305108;Caxias do Sul;1;1;2;849
3549805;São José do Rio Preto;4305108;Caxias do Sul;1;1;2;938
3554102;Taubaté;4305108;Caxias do Sul;1;1;2;864
3557006;Votorantim;4305108;Caxias do Sul;1;1;2;720
4101408;Apucarana;4305108;Caxias do Sul;1;1;2;621
4101507;Arapongas;4305108;Caxias do Sul;1;1;2;637
4104204;Campo Largo;4305108;Caxias do Sul;1;1;2;439
4108304;Foz do Iguaçu;4305108;Caxias do Sul;1;1;2;514
4110003;Iguaraçu;4305108;Caxias do Sul;1;1;2;664
4118402;Paranavaí;4305108;Caxias do Sul;1;1;2;682
4118501;Pato Branco;4305108;Caxias do Sul;1;1;2;355
4201307;Araquari;4305108;Caxias do Sul;1;1;2;385
4201406;Araranguá;4305108;Caxias do Sul;1;1;2;165
4202107;Barra Velha;4305108;Caxias do Sul;1;1;2;366
4202305;Biguaçu;4305108;Caxias do Sul;1;1;2;302
4204301;Concórdia;4305108;Caxias do Sul;1;1;2;230
4205704;Garopaba;4305108;Caxias do Sul;1;1;2;274
4205803;Garuva;4305108;Caxias do Sul;1;1;2;412
4207007;Içara;4305108;Caxias do Sul;1;1;2;189
4207106;Ilhota;4305108;Caxias do Sul;1;1;2;337
4207502;Indaial;4305108;Caxias do Sul;1;1;2;313
4208302;Itapema;4305108;Caxias do Sul;1;1;2;335
4208906;Jaraguá do Sul;4305108;Caxias do Sul;1;1;2;359
4209003;Joaçaba;4305108;Caxias do Sul;1;1;2;226
4211603;Nova Veneza;4305108;Caxias do Sul;1;1;2;173
4213203;Pomerode;4305108;Caxias do Sul;1;1;2;330
4215000;Rio Negrinho;4305108;Caxias do Sul;1;1;2;359
4215802;São Bento do Sul;4305108;Caxias do Sul;1;1;2;365
4217204;São Miguel do Oeste;4305108;Caxias do Sul;1;1;2;355
4217402;Schroeder;4305108;Caxias do Sul;1;1;2;365
4218202;Timbó;4305108;Caxias do Sul;1;1;2;315
4219309;Videira;4305108;Caxias do Sul;1;1;2;239
4300406;Alegrete;4305108;Caxias do Sul;1;1;2;453
4300604;Alvorada;4305108;Caxias do Sul;1;1;2;92
4300638;Amaral Ferrador;4305108;Caxias do Sul;1;1;2;218
4300901;Aratiba;4305108;Caxias do Sul;1;1;2;224
4301503;Augusto Pestana;4305108;Caxias do Sul;1;1;2;283
4303509;Camaquã;4305108;Caxias do Sul;1;1;2;196
4304002;Campo Novo;4305108;Caxias do Sul;1;1;2;303
4304663;Capão do Leão;4305108;Caxias do Sul;1;1;2;316
4304671;Capivari do Sul;4305108;Caxias do Sul;1;1;2;127
4304903;Casca;4305108;Caxias do Sul;1;1;2;103
4301503;Augusto Pestana;4305009;Catuípe;1;1;2;30
4303103;Cachoeirinha;4305009;Catuípe;1;1;2;343
4300059;Água Santa;4304952;Caseiros;1;1;2;35
3518800;Guarulhos;4304903;Casca;1;1;2;769
4208203;Itajaí;4304903;Casca;1;1;2;361
4219309;Videira;4304903;Casca;1;1;2;190
4302105;Bento Gonçalves;4304903;Casca;1;1;2;81
2111532;São Pedro da Água Branca;4304804;Carlos Barbosa;1;1;2;2691
2312908;Sobral;4304804;Carlos Barbosa;1;1;2;3012
3505708;Barueri;4304804;Carlos Barbosa;1;1;2;777
3534401;Osasco;4304804;Carlos Barbosa;1;1;2;779
3543402;Ribeirão Preto;4304804;Carlos Barbosa;1;1;2;967
3548708;São Bernardo do Campo;4304804;Carlos Barbosa;1;1;2;774
3552809;Taboão da Serra;4304804;Carlos Barbosa;1;1;2;775
4115200;Maringá;4304804;Carlos Barbosa;1;1;2;651
4118501;Pato Branco;4304804;Carlos Barbosa;1;1;2;358
4203204;Camboriú;4304804;Carlos Barbosa;1;1;2;369
4300703;Anta Gorda;4304804;Carlos Barbosa;1;1;2;61
4301602;Bagé;4304804;Carlos Barbosa;1;1;2;340
4302352;Bom Princípio;4304804;Carlos Barbosa;1;1;2;26
4304606;Canoas;4304804;Carlos Barbosa;1;1;2;75
4304630;Capão da Canoa;4304804;Carlos Barbosa;1;1;2;151
4301636;Balneário Pinhal;4304713;Caraá;1;1;2;53
1506138;Redenção;4304705;Carazinho;1;1;2;2260
1714203;Natividade;4304705;Carazinho;1;1;2;1891
1718907;Santa Rosa do Tocantins;4304705;Carazinho;1;1;2;1914
2101400;Balsas;4304705;Carazinho;1;1;2;2383
3170206;Uberlândia;4304705;Carazinho;1;1;2;1124
3509502;Campinas;4304705;Carazinho;1;1;2;811
3515004;Embu;4304705;Carazinho;1;1;2;768
3516200;Franca;4304705;Carazinho;1;1;2;999
3536505;Paulínia;4304705;Carazinho;1;1;2;817
3549805;São José do Rio Preto;4304705;Carazinho;1;1;2;888
3552205;Sorocaba;4304705;Carazinho;1;1;2;736
4104303;Campo Mourão;4304705;Carazinho;1;1;2;472
4104808;Cascavel;4304705;Carazinho;1;1;2;377
4113700;Londrina;4304705;Carazinho;1;1;2;575
4128104;Umuarama;4304705;Carazinho;1;1;2;507
4202909;Brusque;4304705;Carazinho;1;1;2;401
4203600;Campos Novos;4304705;Carazinho;1;1;2;181
4204301;Concórdia;4304705;Carazinho;1;1;2;141
4204707;Cunha Porã;4304705;Carazinho;1;1;2;160
4204806;Curitibanos;4304705;Carazinho;1;1;2;241
4210506;Maravilha;4304705;Carazinho;1;1;2;174
4217303;Saudades;4304705;Carazinho;1;1;2;153
4218707;Tubarão;4304705;Carazinho;1;1;2;368
4300471;Almirante Tamandaré do Sul;4304705;Carazinho;1;1;2;24
4301602;Bagé;4304705;Carazinho;1;1;2;362
4301958;Barra Funda;4304705;Carazinho;1;1;2;48
4302238;Boa vista do Incra;4304705;Carazinho;1;1;2;83
4303004;Cachoeira do Sul;4304705;Carazinho;1;1;2;190
4303103;Cachoeirinha;4304705;Carazinho;1;1;2;247
4303509;Camaquã;4304705;Carazinho;1;1;2;298
4208203;Itajaí;4304697;Capitão;1;1;2;404
3303500;Nova Iguaçu;4304689;Capela de Santana;1;1;2;1066
3547809;Santo André;4304689;Capela de Santana;1;1;2;808
4304606;Canoas;4304689;Capela de Santana;1;1;2;27
4304630;Capão da Canoa;4304671;Capivari do Sul;1;1;2;63
3534401;Osasco;4304663;Capão do Leão;1;1;2;1049
4301602;Bagé;4304663;Capão do Leão;1;1;2;160
2311405;Quixeramobim;4304630;Capão da Canoa;1;1;2;2887
3505708;Barueri;4304630;Capão da Canoa;1;1;2;753
3516200;Franca;4304630;Capão da Canoa;1;1;2;1050
3534401;Osasco;4304630;Capão da Canoa;1;1;2;754
3548807;São Caetano do Sul;4304630;Capão da Canoa;1;1;2;755
4106902;Curitiba;4304630;Capão da Canoa;1;1;2;484
4201406;Araranguá;4304630;Capão da Canoa;1;1;2;104
4202008;Balneário Camboriú;4304630;Capão da Canoa;1;1;2;333
4204608;Criciúma;4304630;Capão da Canoa;1;1;2;137
4211900;Palhoça;4304630;Capão da Canoa;1;1;2;265
4212254;Passo de Torres;4304630;Capão da Canoa;1;1;2;63
4300604;Alvorada;4304630;Capão da Canoa;1;1;2;104
4301057;Arroio do Sal;4304630;Capão da Canoa;1;1;2;28
4303004;Cachoeira do Sul;4304630;Capão da Canoa;1;1;2;279
4303509;Camaquã;4304630;Capão da Canoa;1;1;2;210
4303905;Campo Bom;4304630;Capão da Canoa;1;1;2;98
4302451;Boqueirão do Leão;4304614;Canudos do Vale;1;1;2;19
1100122;Ji-Paraná;4304606;Canoas;1;1;2;2315
1100304;Vilhena;4304606;Canoas;1;1;2;2062
1200401;Rio Branco;4304606;Canoas;1;1;2;2672
1400100;Boa Vista;4304606;Canoas;1;1;2;3727
1501402;Belém;4304606;Canoas;1;1;2;3166
1506807;Santarém;4304606;Canoas;1;1;2;3052
1600303;Macapá;4304606;Canoas;1;1;2;3317
2105302;Imperatriz;4304606;Canoas;1;1;2;2721
2111300;São Luís;4304606;Canoas;1;1;2;3093
2211001;Teresina;4304606;Canoas;1;1;2;2849
2304285;Eusébio;4304606;Canoas;1;1;2;3101
2310704;Pentecoste;4304606;Canoas;1;1;2;3084
2311405;Quixeramobim;4304606;Canoas;1;1;2;2939
2602902;Cabo de Santo Agostinho;4304606;Canoas;1;1;2;2806
2609600;Olinda;4304606;Canoas;1;1;2;2838
2611606;Recife;4304606;Canoas;1;1;2;2825
2704708;Marechal Deodoro;4304606;Canoas;1;1;2;2631
2905701;Camaçari;4304606;Canoas;1;1;2;2237
3143302;Montes Claros;4304606;Canoas;1;1;2;1606
3151800;Poços de Caldas;4304606;Canoas;1;1;2;1000
3152501;Pouso Alegre;4304606;Canoas;1;1;2;983
3157807;Santa Luzia;4304606;Canoas;1;1;2;1313
3159605;Santa Rita do Sapucaí;4304606;Canoas;1;1;2;991
3169307;Três Corações;4304606;Canoas;1;1;2;1069
3170107;Uberaba;4304606;Canoas;1;1;2;1166
3205309;Vitória;4304606;Canoas;1;1;2;1471
3300803;Cachoeiras de Macacu;4304606;Canoas;1;1;2;1148
3302403;Macaé;4304606;Canoas;1;1;2;1206
3303500;Nova Iguaçu;4304606;Canoas;1;1;2;1072
3503307;Araras;4304606;Canoas;1;1;2;909
3506003;Bauru;4304606;Canoas;1;1;2;861
3506508;Birigui;4304606;Canoas;1;1;2;957
3509007;Caieiras;4304606;Canoas;1;1;2;837
3510609;Carapicuíba;4304606;Canoas;1;1;2;817
3513504;Cubatão;4304606;Canoas;1;1;2;803
3513702;Descalvado;4304606;Canoas;1;1;2;947
3524709;Jaguariúna;4304606;Canoas;1;1;2;890
3525003;Jandira;4304606;Canoas;1;1;2;814
3525904;Jundiaí;4304606;Canoas;1;1;2;847
3526803;Lençóis Paulista;4304606;Canoas;1;1;2;839
3534708;Ourinhos;4304606;Canoas;1;1;2;777
3536703;Pederneiras;4304606;Canoas;1;1;2;867
3538006;Pindamonhangaba;4304606;Canoas;1;1;2;942
3539806;Poá;4304606;Canoas;1;1;2;841
3545209;Salto;4304606;Canoas;1;1;2;828
3545803;Santa Bárbara d'Oeste;4304606;Canoas;1;1;2;868
3548708;São Bernardo do Campo;4304606;Canoas;1;1;2;811
3552205;Sorocaba;4304606;Canoas;1;1;2;792
3552403;Sumaré;4304606;Canoas;1;1;2;867
3556206;Valinhos;4304606;Canoas;1;1;2;863
3556701;Vinhedo;4304606;Canoas;1;1;2;858
4103701;Cambé;4304606;Canoas;1;1;2;733
4104006;Campina Grande do Sul;4304606;Canoas;1;1;2;549
4104303;Campo Mourão;4304606;Canoas;1;1;2;660
4104659;Carambeí;4304606;Canoas;1;1;2;563
4108304;Foz do Iguaçu;4304606;Canoas;1;1;2;579
4109401;Guarapuava;4304606;Canoas;1;1;2;501
4115804;Medianeira;4304606;Canoas;1;1;2;581
4117909;Palotina;4304606;Canoas;1;1;2;669
4118501;Pato Branco;4304606;Canoas;1;1;2;431
4120804;Quatro Barras;4304606;Canoas;1;1;2;542
4120903;Quedas do Iguaçu;4304606;Canoas;1;1;2;520
4126256;Sarandi;4304606;Canoas;1;1;2;719
4128104;Umuarama;4304606;Canoas;1;1;2;712
4200200;Agrolândia;4304606;Canoas;1;1;2;306
4201406;Araranguá;4304606;Canoas;1;1;2;195
4202701;Botuverá;4304606;Canoas;1;1;2;362
4204301;Concórdia;4304606;Canoas;1;1;2;309
4204509;Corupá;4304606;Canoas;1;1;2;428
4205308;Faxinal dos Guedes;4304606;Canoas;1;1;2;354
4206009;Governador Celso Ramos;4304606;Canoas;1;1;2;380
4206306;Guabiruba;4304606;Canoas;1;1;2;376
4206504;Guaramirim;4304606;Canoas;1;1;2;434
4206900;Ibirama;4304606;Canoas;1;1;2;354
4208906;Jaraguá do Sul;4304606;Canoas;1;1;2;430
4210407;Maracajá;4304606;Canoas;1;1;2;204
4211504;Nova Trento;4304606;Canoas;1;1;2;362
4212502;Penha;4304606;Canoas;1;1;2;420
4213500;Porto Belo;4304606;Canoas;1;1;2;393
4214003;Presidente Getúlio;4304606;Canoas;1;1;2;350
4215109;Rodeio;4304606;Canoas;1;1;2;374
4216206;São Francisco do Sul;4304606;Canoas;1;1;2;469
4216305;São João Batista;4304606;Canoas;1;1;2;367
4217808;Taió;4304606;Canoas;1;1;2;329
4218707;Tubarão;4304606;Canoas;1;1;2;259
4302253;Boa Vista do Sul;4304606;Canoas;1;1;2;78
4302352;Bom Princípio;4304606;Canoas;1;1;2;49
4302402;Bom Retiro do Sul;4304606;Canoas;1;1;2;80
4302709;Butiá;4304606;Canoas;1;1;2;79
4302808;Caçapava do Sul;4304606;Canoas;1;1;2;229
3518800;Guarulhos;4304507;Canguçu;1;1;2;1046
3534401;Osasco;4304507;Canguçu;1;1;2;1026
3550308;São Paulo;4304507;Canguçu;1;1;2;1022
4303509;Camaquã;4304507;Canguçu;1;1;2;104
3304557;Rio de Janeiro;4304408;Canela;1;1;2;1010
3516200;Franca;4304408;Canela;1;1;2;1025
3534401;Osasco;4304408;Canela;1;1;2;747
4106902;Curitiba;4304408;Canela;1;1;2;456
4300802;Antônio Prado;4304408;Canela;1;1;2;70
4302105;Bento Gonçalves;4304408;Canela;1;1;2;71
4303103;Cachoeirinha;4304408;Canela;1;1;2;74
3503901;Arujá;4304358;Candiota;1;1;2;1127
4101804;Araucária;4304358;Candiota;1;1;2;770
4203006;Caçador;4304358;Candiota;1;1;2;579
4302105;Bento Gonçalves;4304358;Candiota;1;1;2;334
4302808;Caçapava do Sul;4304358;Candiota;1;1;2;120
4303103;Cachoeirinha;4304309;Cândido Godói;1;1;2;424
4303707;Campina das Missões;4304309;Cândido Godói;1;1;2;9
3534401;Osasco;4304200;Candelária;1;1;2;888
3550308;São Paulo;4304200;Candelária;1;1;2;886
4107256;Douradina;4304200;Candelária;1;1;2;701
4301206;Arroio do Tigre;4304200;Candelária;1;1;2;48
4302808;Caçapava do Sul;4304200;Candelária;1;1;2;108
4303103;Cachoeirinha;4304200;Candelária;1;1;2;168
4300554;Alto Alegre;4304101;Campos Borges;1;1;2;13
3106200;Belo Horizonte;4304002;Campo Novo;1;1;2;1275
4207650;Iporã do Oeste;4304002;Campo Novo;1;1;2;81
4211009;Mondaí;4304002;Campo Novo;1;1;2;73
4217204;São Miguel do Oeste;4304002;Campo Novo;1;1;2;111
4301859;Barra do Guarita;4304002;Campo Novo;1;1;2;54
1501402;Belém;4303905;Campo Bom;1;1;2;3140
2306108;Irauçuba;4303905;Campo Bom;1;1;2;3046
2306405;Itapipoca;4303905;Campo Bom;1;1;2;3077
2312908;Sobral;4303905;Campo Bom;1;1;2;3037
2408102;Natal;4303905;Campo Bom;1;1;2;3004
2507507;João Pessoa;4303905;Campo Bom;1;1;2;2890
2910057;Dias d'Ávila;4303905;Campo Bom;1;1;2;2220
2910800;Feira de Santana;4303905;Campo Bom;1;1;2;2219
2930501;Serrinha;4303905;Campo Bom;1;1;2;2278
2930709;Simões Filho;4303905;Campo Bom;1;1;2;2199
3205200;Vila Velha;4303905;Campo Bom;1;1;2;1436
3502804;Araçatuba;4303905;Campo Bom;1;1;2;938
3507308;Boracéia;4303905;Campo Bom;1;1;2;856
3513801;Diadema;4303905;Campo Bom;1;1;2;785
3525904;Jundiaí;4303905;Campo Bom;1;1;2;819
3534401;Osasco;4303905;Campo Bom;1;1;2;790
3547304;Santana de Parnaíba;4303905;Campo Bom;1;1;2;793
3548708;São Bernardo do Campo;4303905;Campo Bom;1;1;2;783
3554003;Tatuí;4303905;Campo Bom;1;1;2;764
4106407;Cornélio Procópio;4303905;Campo Bom;1;1;2;721
4113700;Londrina;4303905;Campo Bom;1;1;2;707
4115200;Maringá;4303905;Campo Bom;1;1;2;697
4122404;Rolândia;4303905;Campo Bom;1;1;2;706
4205407;Florianópolis;4303905;Campo Bom;1;1;2;335
4303103;Cachoeirinha;4303905;Campo Bom;1;1;2;30
4303103;Cachoeirinha;4303707;Campina das Missões;1;1;2;429
4106902;Curitiba;4303673;Campestre da Serra;1;1;2;411
4300802;Antônio Prado;4303673;Campestre da Serra;1;1;2;20
3550308;São Paulo;4303608;Cambará do Sul;1;1;2;684
4104659;Carambeí;4303558;Camargo;1;1;2;454
4119400;Piraí do Sul;4303558;Camargo;1;1;2;497
2607901;Jaboatão dos Guararapes;4303509;Camaquã;1;1;2;2928
2919553;Luís Eduardo magalhães;4303509;Camaquã;1;1;2;2143
2927408;Salvador;4303509;Camaquã;1;1;2;2311
3170206;Uberlândia;4303509;Camaquã;1;1;2;1361
3516200;Franca;4303509;Camaquã;1;1;2;1210
3534401;Osasco;4303509;Camaquã;1;1;2;933
3548807;São Caetano do Sul;4303509;Camaquã;1;1;2;936
4106902;Curitiba;4303509;Camaquã;1;1;2;643
4207007;Içara;4303509;Camaquã;1;1;2;334
4217709;Sombrio;4303509;Camaquã;1;1;2;280
4300406;Alegrete;4303509;Camaquã;1;1;2;393
4302105;Bento Gonçalves;4303509;Camaquã;1;1;2;188
4303004;Cachoeira do Sul;4303509;Camaquã;1;1;2;140
4218855;União do Oeste;4303202;Cacique Doble;1;1;2;162
1302603;Manaus;4303103;Cachoeirinha;1;1;2;3076
2607901;Jaboatão dos Guararapes;4303103;Cachoeirinha;1;1;2;2820
2704708;Marechal Deodoro;4303103;Cachoeirinha;1;1;2;2631
2905701;Camaçari;4303103;Cachoeirinha;1;1;2;2237
3118601;Contagem;4303103;Cachoeirinha;1;1;2;1288
3137601;Lagoa Santa;4303103;Cachoeirinha;1;1;2;1324
3170206;Uberlândia;4303103;Cachoeirinha;1;1;2;1251
3205101;Viana;4303103;Cachoeirinha;1;1;2;1440
3501608;Americana;4303103;Cachoeirinha;1;1;2;873
3509254;Cajati;4303103;Cachoeirinha;1;1;2;644
3510401;Capivari;4303103;Cachoeirinha;1;1;2;841
3513009;Cotia;4303103;Cachoeirinha;1;1;2;806
3515707;Ferraz de Vasconcelos;4303103;Cachoeirinha;1;1;2;838
3516200;Franca;4303103;Cachoeirinha;1;1;2;1097
3518305;Guararema;4303103;Cachoeirinha;1;1;2;866
3524006;Itupeva;4303103;Cachoeirinha;1;1;2;843
3525904;Jundiaí;4303103;Cachoeirinha;1;1;2;847
3529005;Marília;4303103;Cachoeirinha;1;1;2;863
3543402;Ribeirão Preto;4303103;Cachoeirinha;1;1;2;1022
3547304;Santana de Parnaíba;4303103;Cachoeirinha;1;1;2;821
3549805;São José do Rio Preto;4303103;Cachoeirinha;1;1;2;1023
3551702;Sertãozinho;4303103;Cachoeirinha;1;1;2;1018
3552205;Sorocaba;4303103;Cachoeirinha;1;1;2;792
3552502;Suzano;4303103;Cachoeirinha;1;1;2;841
4101002;Ampére;4303103;Cachoeirinha;1;1;2;500
4101804;Araucária;4303103;Cachoeirinha;1;1;2;510
4104501;Capanema;4303103;Cachoeirinha;1;1;2;537
4104808;Cascavel;4303103;Cachoeirinha;1;1;2;597
4106506;Coronel Vivida;4303103;Cachoeirinha;1;1;2;459
4109401;Guarapuava;4303103;Cachoeirinha;1;1;2;506
4119152;Pinhais;4303103;Cachoeirinha;1;1;2;531
4119509;Piraquara;4303103;Cachoeirinha;1;1;2;536
4119905;Ponta Grossa;4303103;Cachoeirinha;1;1;2;544
4120903;Quedas do Iguaçu;4303103;Cachoeirinha;1;1;2;527
4127700;Toledo;4303103;Cachoeirinha;1;1;2;630
4128203;União da Vitória;4303103;Cachoeirinha;1;1;2;407
4202008;Balneário Camboriú;4303103;Cachoeirinha;1;1;2;401
4202305;Biguaçu;4303103;Cachoeirinha;1;1;2;356
4202404;Blumenau;4303103;Cachoeirinha;1;1;2;385
4203600;Campos Novos;4303103;Cachoeirinha;1;1;2;280
4203808;Canoinhas;4303103;Cachoeirinha;1;1;2;420
4204301;Concórdia;4303103;Cachoeirinha;1;1;2;315
4205407;Florianópolis;4303103;Cachoeirinha;1;1;2;360
4205506;Fraiburgo;4303103;Cachoeirinha;1;1;2;324
4209003;Joaçaba;4303103;Cachoeirinha;1;1;2;313
4210100;Mafra;4303103;Cachoeirinha;1;1;2;439
4210506;Maravilha;4303103;Cachoeirinha;1;1;2;404
4211207;Morro da Fumaça;4303103;Cachoeirinha;1;1;2;232
4211306;Navegantes;4303103;Cachoeirinha;1;1;2;412
4211751;Otacílio Costa;4303103;Cachoeirinha;1;1;2;289
4211900;Palhoça;4303103;Cachoeirinha;1;1;2;341
4212908;Pinhalzinho;4303103;Cachoeirinha;1;1;2;387
4213807;Praia Grande;4303103;Cachoeirinha;1;1;2;139
4216503;São Joaquim;4303103;Cachoeirinha;1;1;2;216
4219507;Xanxerê;4303103;Cachoeirinha;1;1;2;364
4300109;Agudo;4303103;Cachoeirinha;1;1;2;208
4300208;Ajuricaba;4303103;Cachoeirinha;1;1;2;317
4301008;Arroio do Meio;4303103;Cachoeirinha;1;1;2;100
4301107;Arroio dos Ratos;4303103;Cachoeirinha;1;1;2;61
4301206;Arroio do Tigre;4303103;Cachoeirinha;1;1;2;202
4301503;Augusto Pestana;4303103;Cachoeirinha;1;1;2;318
4302204;Boa Vista do Buricá;4303103;Cachoeirinha;1;1;2;382
4302402;Bom Retiro do Sul;4303103;Cachoeirinha;1;1;2;88
4302501;Bossoroca;4303103;Cachoeirinha;1;1;2;388
4302808;Caçapava do Sul;4303103;Cachoeirinha;1;1;2;234
4302907;Cacequi;4303103;Cachoeirinha;1;1;2;359
2910800;Feira de Santana;4303004;Cachoeira do Sul;1;1;2;2335
3303500;Nova Iguaçu;4303004;Cachoeira do Sul;1;1;2;1193
3518800;Guarulhos;4303004;Cachoeira do Sul;1;1;2;940
3534401;Osasco;4303004;Cachoeira do Sul;1;1;2;918
3534906;Pacaembu;4303004;Cachoeira do Sul;1;1;2;947
3543402;Ribeirão Preto;4303004;Cachoeira do Sul;1;1;2;1089
4106902;Curitiba;4303004;Cachoeira do Sul;1;1;2;611
4115200;Maringá;4303004;Cachoeira do Sul;1;1;2;734
4301750;Barão do Triunfo;4303004;Cachoeira do Sul;1;1;2;122
4302105;Bento Gonçalves;4303004;Cachoeira do Sul;1;1;2;164
4302808;Caçapava do Sul;4303004;Cachoeira do Sul;1;1;2;76
3534401;Osasco;4302907;Cacequi;1;1;2;1033
4106902;Curitiba;4302907;Cacequi;1;1;2;720
4300406;Alegrete;4302907;Cacequi;1;1;2;90
3534401;Osasco;4302808;Caçapava do Sul;1;1;2;989
3534401;Osasco;4302709;Butiá;1;1;2;875
4204608;Criciúma;4302709;Butiá;1;1;2;295
4207007;Içara;4302709;Butiá;1;1;2;299
4217600;Siderópolis;4302709;Butiá;1;1;2;294
4301651;Barão;4302659;Brochier;1;1;2;22
4302378;Bom Progresso;4302600;Braga;1;1;2;15
3509502;Campinas;4302584;Bozano;1;1;2;884
4300208;Ajuricaba;4302584;Bozano;1;1;2;14
4301503;Augusto Pestana;4302584;Bozano;1;1;2;27
3534401;Osasco;4302402;Bom Retiro do Sul;1;1;2;830
4208203;Itajaí;4302402;Bom Retiro do Sul;1;1;2;425
4301008;Arroio do Meio;4302402;Bom Retiro do Sul;1;1;2;23
3534401;Osasco;4302352;Bom Princípio;1;1;2;788
3550308;São Paulo;4302352;Bom Princípio;1;1;2;785
3552403;Sumaré;4302352;Bom Princípio;1;1;2;833
3552809;Taboão da Serra;4302352;Bom Princípio;1;1;2;783
4114609;Marechal Cândido Rondon;4302352;Bom Princípio;1;1;2;604
4204608;Criciúma;4302352;Bom Princípio;1;1;2;211
4302105;Bento Gonçalves;4302352;Bom Princípio;1;1;2;39
3534401;Osasco;4302303;Bom Jesus;1;1;2;667
4201406;Araranguá;4302303;Bom Jesus;1;1;2;97
4202602;Bom Retiro;4302303;Bom Jesus;1;1;2;133
4211256;Morro Grande;4302303;Bom Jesus;1;1;2;71
4216503;São Joaquim;4302303;Bom Jesus;1;1;2;63
4301008;Arroio do Meio;4302253;Boa Vista do Sul;1;1;2;27
4114609;Marechal Cândido Rondon;4302204;Boa Vista do Buricá;1;1;2;345
4200408;Água Doce;4302204;Boa Vista do Buricá;1;1;2;262
4218509;Treze Tílias;4302204;Boa Vista do Buricá;1;1;2;276
4302105;Bento Gonçalves;4302204;Boa Vista do Buricá;1;1;2;307
1100205;Porto Velho;4302105;Bento Gonçalves;1;1;2;2523
1302603;Manaus;4302105;Bento Gonçalves;1;1;2;2985
2211001;Teresina;4302105;Bento Gonçalves;1;1;2;2779
2304400;Fortaleza;4302105;Bento Gonçalves;1;1;2;3049
2602902;Cabo de Santo Agostinho;4302105;Bento Gonçalves;1;1;2;2759
2800308;Aracaju;4302105;Bento Gonçalves;1;1;2;2417
2804805;Nossa Senhora do Socorro;4302105;Bento Gonçalves;1;1;2;2418
2905701;Camaçari;4302105;Bento Gonçalves;1;1;2;2190
3169901;Ubá;4302105;Bento Gonçalves;1;1;2;1201
3203205;Linhares;4302105;Bento Gonçalves;1;1;2;1527
3503307;Araras;4302105;Bento Gonçalves;1;1;2;849
3505708;Barueri;4302105;Bento Gonçalves;1;1;2;765
3512803;Cosmópolis;4302105;Bento Gonçalves;1;1;2;829
3525904;Jundiaí;4302105;Bento Gonçalves;1;1;2;794
3526100;Juquiá;4302105;Bento Gonçalves;1;1;2;650
4101804;Araucária;4302105;Bento Gonçalves;1;1;2;444
4104006;Campina Grande do Sul;4302105;Bento Gonçalves;1;1;2;487
4104808;Cascavel;4302105;Bento Gonçalves;1;1;2;503
4115200;Maringá;4302105;Bento Gonçalves;1;1;2;636
4118501;Pato Branco;4302105;Bento Gonçalves;1;1;2;343
4119905;Ponta Grossa;4302105;Bento Gonçalves;1;1;2;467
4201406;Araranguá;4302105;Bento Gonçalves;1;1;2;198
4202305;Biguaçu;4302105;Bento Gonçalves;1;1;2;328
4202404;Blumenau;4302105;Bento Gonçalves;1;1;2;339
4205407;Florianópolis;4302105;Bento Gonçalves;1;1;2;337
4207502;Indaial;4302105;Bento Gonçalves;1;1;2;333
4208203;Itajaí;4302105;Bento Gonçalves;1;1;2;362
4211207;Morro da Fumaça;4302105;Bento Gonçalves;1;1;2;230
4300059;Água Santa;4302105;Bento Gonçalves;1;1;2;120
4300802;Antônio Prado;4302105;Bento Gonçalves;1;1;2;40
4301107;Arroio dos Ratos;4302105;Bento Gonçalves;1;1;2;104
4301602;Bagé;4302105;Bento Gonçalves;1;1;2;351
2932606;Urandi;4301909;Barra do Ribeiro;1;1;2;1891
3143302;Montes Claros;4301909;Barra do Ribeiro;1;1;2;1649
3530706;Mogi Guaçu;4301909;Barra do Ribeiro;1;1;2;972
3534401;Osasco;4301909;Barra do Ribeiro;1;1;2;860
4207205;Imaruí;4301909;Barra do Ribeiro;1;1;2;321
4208401;Itapiranga;4301859;Barra do Guarita;1;1;2;4
3106200;Belo Horizonte;4301800;Barracão;1;1;2;1120
3505708;Barueri;4301800;Barracão;1;1;2;640
4204152;Celso Ramos;4301800;Barracão;1;1;2;13
4205308;Faxinal dos Guedes;4301800;Barracão;1;1;2;120
4213203;Pomerode;4301750;Barão do Triunfo;1;1;2;471
4301107;Arroio dos Ratos;4301750;Barão do Triunfo;1;1;2;34
4300901;Aratiba;4301701;Barão de Cotegipe;1;1;2;26
4105508;Cianorte;4301651;Barão;1;1;2;642
4115200;Maringá;4301651;Barão;1;1;2;660
4207502;Indaial;4301651;Barão;1;1;2;350
3534401;Osasco;4301636;Balneário Pinhal;1;1;2;811
4300604;Alvorada;4301636;Balneário Pinhal;1;1;2;84
2704302;Maceió;4301602;Bagé;1;1;2;2903
2930709;Simões Filho;4301602;Bagé;1;1;2;2486
3106200;Belo Horizonte;4301602;Bagé;1;1;2;1564
3201209;Cachoeiro de Itapemirim;4301602;Bagé;1;1;2;1660
3534401;Osasco;4301602;Bagé;1;1;2;1094
3541604;Promissão;4301602;Bagé;1;1;2;1152
3548807;São Caetano do Sul;4301602;Bagé;1;1;2;1101
3554003;Tatuí;4301602;Bagé;1;1;2;1055
4113700;Londrina;4301602;Bagé;1;1;2;931
4204202;Chapecó;4301602;Bagé;1;1;2;488
4208203;Itajaí;4301602;Bagé;1;1;2;697
4212106;Palmitos;4301602;Bagé;1;1;2;481
4300802;Antônio Prado;4301602;Bagé;1;1;2;381
4300901;Aratiba;4301552;Áurea;1;1;2;42
4300208;Ajuricaba;4301503;Augusto Pestana;1;1;2;38
2919553;Luís Eduardo magalhães;4301404;Arvorezinha;1;1;2;1947
3534401;Osasco;4301404;Arvorezinha;1;1;2;783
3550308;São Paulo;4301404;Arvorezinha;1;1;2;782
4204905;Descanso;4301404;Arvorezinha;1;1;2;260
2930709;Simões Filho;4301305;Arroio Grande;1;1;2;2509
3534401;Osasco;4301305;Arroio Grande;1;1;2;1117
3550308;São Paulo;4301305;Arroio Grande;1;1;2;1113
4300109;Agudo;4301206;Arroio do Tigre;1;1;2;37
4300604;Alvorada;4301057;Arroio do Sal;1;1;2;125
3534401;Osasco;4301008;Arroio do Meio;1;1;2;813
4201273;Arabutã;4301008;Arroio do Meio;1;1;2;249
4204202;Chapecó;4300901;Aratiba;1;1;2;45
4205407;Florianópolis;4300901;Aratiba;1;1;2;375
4208005;Itá;4300901;Aratiba;1;1;2;14
4217501;Seara;4300901;Aratiba;1;1;2;27
3525201;Jarinu;4300802;Antônio Prado;1;1;2;771
3534401;Osasco;4300802;Antônio Prado;1;1;2;729
4119152;Pinhais;4300802;Antônio Prado;1;1;2;428
4202404;Blumenau;4300802;Antônio Prado;1;1;2;300
3550308;São Paulo;4300646;Ametista do Sul;1;1;2;757
3552809;Taboão da Serra;4300646;Ametista do Sul;1;1;2;751
4204202;Chapecó;4300646;Ametista do Sul;1;1;2;62
4213104;Piratuba;4300646;Ametista do Sul;1;1;2;140
1100049;Cacoal;4300604;Alvorada;1;1;2;2261
2105302;Imperatriz;4300604;Alvorada;1;1;2;2728
2304400;Fortaleza;4300604;Alvorada;1;1;2;3115
2611606;Recife;4300604;Alvorada;1;1;2;2827
2910800;Feira de Santana;4300604;Alvorada;1;1;2;2248
3118601;Contagem;4300604;Alvorada;1;1;2;1290
3516200;Franca;4300604;Alvorada;1;1;2;1101
3529401;Mauá;4300604;Alvorada;1;1;2;824
3534401;Osasco;4300604;Alvorada;1;1;2;821
3547809;Santo André;4300604;Alvorada;1;1;2;822
3548807;São Caetano do Sul;4300604;Alvorada;1;1;2;824
3552502;Suzano;4300604;Alvorada;1;1;2;843
4104204;Campo Largo;4300604;Alvorada;1;1;2;523
4106902;Curitiba;4300604;Alvorada;1;1;2;532
4108403;Francisco Beltrão;4300604;Alvorada;1;1;2;471
4215653;Santa Rosa do Sul;4300604;Alvorada;1;1;2;163
4217709;Sombrio;4300604;Alvorada;1;1;2;168
4120606;Prudentópolis;4300505;Alpestre;1;1;2;299
4212106;Palmitos;4300505;Alpestre;1;1;2;23
3550308;São Paulo;4300471;Almirante Tamandaré do Sul;1;1;2;780
3106200;Belo Horizonte;4300406;Alegrete;1;1;2;1548
3118601;Contagem;4300406;Alegrete;1;1;2;1540
3301900;Itaboraí;4300406;Alegrete;1;1;2;1440
3534401;Osasco;4300406;Alegrete;1;1;2;1092
3541604;Promissão;4300406;Alegrete;1;1;2;1067
3549102;São João da Boa Vista;4300406;Alegrete;1;1;2;1205
3549805;São José do Rio Preto;4300406;Alegrete;1;1;2;1156
3554003;Tatuí;4300406;Alegrete;1;1;2;1031
4204301;Concórdia;4300406;Alegrete;1;1;2;457
4205407;Florianópolis;4300406;Alegrete;1;1;2;734
4208203;Itajaí;4300406;Alegrete;1;1;2;739
4118501;Pato Branco;4300307;Alecrim;1;1;2;260
3534401;Osasco;4300109;Agudo;1;1;2;910
4127700;Toledo;4300109;Agudo;1;1;2;548
3304557;Rio de Janeiro;4300034;Aceguá;1;1;2;1404
3550308;São Paulo;4300034;Aceguá;1;1;2;1138
4127601;Tijucas do Sul;4300034;Aceguá;1;1;2;800
4203907;Capinzal;4219853;Zortéa;1;1;2;13
4211801;Ouro;4219853;Zortéa;1;1;2;17
4213104;Piratuba;4219853;Zortéa;1;1;2;22
1600303;Macapá;4219705;Xaxim;1;1;2;2994
1703867;Cariri do Tocantins;4219705;Xaxim;1;1;2;1699
2611606;Recife;4219705;Xaxim;1;1;2;2663
3306008;Três Rios;4219705;Xaxim;1;1;2;1055
3509502;Campinas;4219705;Xaxim;1;1;2;699
3516200;Franca;4219705;Xaxim;1;1;2;867
3523404;Itatiba;4219705;Xaxim;1;1;2;708
3534401;Osasco;4219705;Xaxim;1;1;2;678
4101200;Antonina;4219705;Xaxim;1;1;2;415
4105706;Clevelândia;4219705;Xaxim;1;1;2;63
4106506;Coronel Vivida;4219705;Xaxim;1;1;2;108
4106902;Curitiba;4219705;Xaxim;1;1;2;361
4108403;Francisco Beltrão;4219705;Xaxim;1;1;2;111
4116950;Nova Esperança do Sudoeste;4219705;Xaxim;1;1;2;138
4119806;Planalto;4219705;Xaxim;1;1;2;185
4121406;Realeza;4219705;Xaxim;1;1;2;166
4200101;Abelardo Luz;4219705;Xaxim;1;1;2;49
4203956;Capivari de Baixo;4219705;Xaxim;1;1;2;393
4204004;Catanduvas;4219705;Xaxim;1;1;2;85
4204301;Concórdia;4219705;Xaxim;1;1;2;58
4204806;Curitibanos;4219705;Xaxim;1;1;2;195
4205308;Faxinal dos Guedes;4219705;Xaxim;1;1;2;30
4205407;Florianópolis;4219705;Xaxim;1;1;2;406
4206652;Guatambú;4219705;Xaxim;1;1;2;32
4207684;Ipuaçu;4219705;Xaxim;1;1;2;38
4208203;Itajaí;4219705;Xaxim;1;1;2;375
4209003;Joaçaba;4219705;Xaxim;1;1;2;100
4209102;Joinville;4219705;Xaxim;1;1;2;371
4210555;Marema;4219705;Xaxim;1;1;2;20
4214201;Quilombo;4219705;Xaxim;1;1;2;33
4217501;Seara;4219705;Xaxim;1;1;2;30
3550308;São Paulo;4219606;Xavantina;1;1;2;673
4201653;Arvoredo;4219606;Xavantina;1;1;2;11
4204202;Chapecó;4219606;Xavantina;1;1;2;28
4204301;Concórdia;4219606;Xavantina;1;1;2;36
4205407;Florianópolis;4219606;Xavantina;1;1;2;385
1503606;Itaituba;4219507;Xanxerê;1;1;2;2526
3106200;Belo Horizonte;4219507;Xanxerê;1;1;2;1122
3516200;Franca;4219507;Xanxerê;1;1;2;852
3522406;Itapeva;4219507;Xanxerê;1;1;2;471
3534401;Osasco;4219507;Xanxerê;1;1;2;663
3536505;Paulínia;4219507;Xanxerê;1;1;2;686
4104105;Campo do Tenente;4219507;Xanxerê;1;1;2;287
4107207;Dois Vizinhos;4219507;Xanxerê;1;1;2;140
4109401;Guarapuava;4219507;Xanxerê;1;1;2;188
4115606;Matelândia;4219507;Xanxerê;1;1;2;237
4115804;Medianeira;4219507;Xanxerê;1;1;2;241
4116950;Nova Esperança do Sudoeste;4219507;Xanxerê;1;1;2;135
4117909;Palotina;4219507;Xanxerê;1;1;2;315
4118204;Paranaguá;4219507;Xanxerê;1;1;2;406
4202404;Blumenau;4219507;Xanxerê;1;1;2;332
4202537;Bom Jesus;4219507;Xanxerê;1;1;2;14
4203006;Caçador;4219507;Xanxerê;1;1;2;131
4203907;Capinzal;4219507;Xanxerê;1;1;2;96
4204004;Catanduvas;4219507;Xanxerê;1;1;2;76
4204806;Curitibanos;4219507;Xanxerê;1;1;2;186
4205001;Dionísio Cerqueira;4219507;Xanxerê;1;1;2;137
4205506;Fraiburgo;4219507;Xanxerê;1;1;2;149
4206801;Ibicaré;4219507;Xanxerê;1;1;2;107
4209102;Joinville;4219507;Xanxerê;1;1;2;358
4211405;Nova Erechim;4219507;Xanxerê;1;1;2;49
4212908;Pinhalzinho;4219507;Xanxerê;1;1;2;58
4214151;Princesa;4219507;Xanxerê;1;1;2;126
4214201;Quilombo;4219507;Xanxerê;1;1;2;34
4216008;São Carlos;4219507;Xanxerê;1;1;2;65
4216107;São Domingos;4219507;Xanxerê;1;1;2;35
4216701;São José do Cedro;4219507;Xanxerê;1;1;2;119
4218509;Treze Tílias;4219507;Xanxerê;1;1;2;101
4219101;Vargeão;4219507;Xanxerê;1;1;2;24
4205407;Florianópolis;4219408;Witmarsum;1;1;2;147
4206900;Ibirama;4219408;Witmarsum;1;1;2;31
4209151;José Boiteux;4219408;Witmarsum;1;1;2;17
4214805;Rio do Sul;4219408;Witmarsum;1;1;2;39
4205407;Florianópolis;4219358;Vitor Meireles;1;1;2;153
4206900;Ibirama;4219358;Vitor Meireles;1;1;2;37
4209151;José Boiteux;4219358;Vitor Meireles;1;1;2;22
4214805;Rio do Sul;4219358;Vitor Meireles;1;1;2;45
4215307;Salete;4219358;Vitor Meireles;1;1;2;20
1702109;Araguaína;4219309;Videira;1;1;2;2210
2929305;São Gonçalo dos Campos;4219309;Videira;1;1;2;1983
3147907;Passos;4219309;Videira;1;1;2;824
3148103;Patrocínio;4219309;Videira;1;1;2;979
3170107;Uberaba;4219309;Videira;1;1;2;863
3172004;Visconde do Rio Branco;4219309;Videira;1;1;2;1044
3301702;Duque de Caxias;4219309;Videira;1;1;2;898
3306008;Três Rios;4219309;Videira;1;1;2;945
3505500;Barretos;4219309;Videira;1;1;2;757
3510609;Carapicuíba;4219309;Videira;1;1;2;572
3516200;Franca;4219309;Videira;1;1;2;803
3522307;Itapetininga;4219309;Videira;1;1;2;486
3524709;Jaguariúna;4219309;Videira;1;1;2;626
3533601;Nuporanga;4219309;Videira;1;1;2;770
3534401;Osasco;4219309;Videira;1;1;2;575
3547304;Santana de Parnaíba;4219309;Videira;1;1;2;572
4101804;Araucária;4219309;Videira;1;1;2;234
4102901;Bituruna;4219309;Videira;1;1;2;102
4104659;Carambeí;4219309;Videira;1;1;2;254
4106456;Coronel Domingos Soares;4219309;Videira;1;1;2;123
4107652;Fazenda Rio Grande;4219309;Videira;1;1;2;236
4108403;Francisco Beltrão;4219309;Videira;1;1;2;214
4109807;Ibiporã;4219309;Videira;1;1;2;414
4111902;Jaguapitã;4219309;Videira;1;1;2;433
4112801;Joaquim Távora;4219309;Videira;1;1;2;407
4113700;Londrina;4219309;Videira;1;1;2;411
4115200;Maringá;4219309;Videira;1;1;2;403
4115408;Marmeleiro;4219309;Videira;1;1;2;208
4118402;Paranavaí;4219309;Videira;1;1;2;451
4118501;Pato Branco;4219309;Videira;1;1;2;172
4119905;Ponta Grossa;4219309;Videira;1;1;2;232
4122404;Rolândia;4219309;Videira;1;1;2;410
4201604;Arroio Trinta;4219309;Videira;1;1;2;20
4202909;Brusque;4219309;Videira;1;1;2;223
4205456;Forquilhinha;4219309;Videira;1;1;2;256
4206702;Herval d'Oeste;4219309;Videira;1;1;2;40
4206801;Ibicaré;4219309;Videira;1;1;2;23
4207007;Içara;4219309;Videira;1;1;2;265
4207502;Indaial;4219309;Videira;1;1;2;191
4208302;Itapema;4219309;Videira;1;1;2;250
4208500;Ituporanga;4219309;Videira;1;1;2;160
4208906;Jaraguá do Sul;4219309;Videira;1;1;2;213
4210506;Maravilha;4219309;Videira;1;1;2;202
4210852;Mirim Doce;4219309;Videira;1;1;2;109
4212205;Papanduva;4219309;Videira;1;1;2;122
4213609;Porto União;4219309;Videira;1;1;2;81
4215406;Salto Veloso;4219309;Videira;1;1;2;28
4216503;São Joaquim;4219309;Videira;1;1;2;183
4216602;São José;4219309;Videira;1;1;2;254
4218202;Timbó;4219309;Videira;1;1;2;188
4218707;Tubarão;4219309;Videira;1;1;2;267
4218954;Urupema;4219309;Videira;1;1;2;163
3550308;São Paulo;4219200;Vidal Ramos;1;1;2;491
4204608;Criciúma;4219200;Vidal Ramos;1;1;2;141
4204806;Curitibanos;4219200;Vidal Ramos;1;1;2;124
4205407;Florianópolis;4219200;Vidal Ramos;1;1;2;86
4208500;Ituporanga;4219200;Vidal Ramos;1;1;2;25
4209102;Joinville;4219200;Vidal Ramos;1;1;2;132
4211504;Nova Trento;4219200;Vidal Ramos;1;1;2;44
4218608;Trombudo Central;4219200;Vidal Ramos;1;1;2;47
4114302;Mandirituba;4219176;Vargem Bonita;1;1;2;276
4115200;Maringá;4219176;Vargem Bonita;1;1;2;396
4115309;Mariópolis;4219176;Vargem Bonita;1;1;2;107
4200408;Água Doce;4219176;Vargem Bonita;1;1;2;20
4204004;Catanduvas;4219176;Vargem Bonita;1;1;2;10
4204301;Concórdia;4219176;Vargem Bonita;1;1;2;35
4204400;Coronel Freitas;4219176;Vargem Bonita;1;1;2;94
4204608;Criciúma;4219176;Vargem Bonita;1;1;2;300
4207809;Irani;4219176;Vargem Bonita;1;1;2;15
4209003;Joaçaba;4219176;Vargem Bonita;1;1;2;26
4213401;Ponte Serrada;4219176;Vargem Bonita;1;1;2;30
4200051;Abdon Batista;4219150;Vargem;1;1;2;14
4203600;Campos Novos;4219150;Vargem;1;1;2;25
4204806;Curitibanos;4219150;Vargem;1;1;2;44
4209300;Lages;4219150;Vargem;1;1;2;72
3509254;Cajati;4219101;Vargeão;1;1;2;464
4125506;São José dos Pinhais;4219101;Vargeão;1;1;2;330
4205308;Faxinal dos Guedes;4219101;Vargeão;1;1;2;9
4205407;Florianópolis;4219101;Vargeão;1;1;2;373
4212270;Passos Maia;4219101;Vargeão;1;1;2;15
3205002;Serra;4219002;Urussanga;1;1;2;1264
3516200;Franca;4219002;Urussanga;1;1;2;902
3534401;Osasco;4219002;Urussanga;1;1;2;604
4202800;Braço do Norte;4219002;Urussanga;1;1;2;33
4205407;Florianópolis;4219002;Urussanga;1;1;2;132
4205704;Garopaba;4219002;Urussanga;1;1;2;89
4209409;Laguna;4219002;Urussanga;1;1;2;53
4209607;Lauro Muller;4219002;Urussanga;1;1;2;13
4212304;Paulo Lopes;4219002;Urussanga;1;1;2;91
4212403;Pedras Grandes;4219002;Urussanga;1;1;2;20
4215455;Sangão;4219002;Urussanga;1;1;2;28
4216503;São Joaquim;4219002;Urussanga;1;1;2;64
4218103;Timbé do Sul;4219002;Urussanga;1;1;2;58
4218350;Treviso;4219002;Urussanga;1;1;2;8
4218400;Treze de Maio;4219002;Urussanga;1;1;2;23
4205407;Florianópolis;4218954;Urupema;1;1;2;141
4216503;São Joaquim;4218954;Urupema;1;1;2;36
3534401;Osasco;4218905;Urubici;1;1;2;565
4202800;Braço do Norte;4218905;Urubici;1;1;2;51
4207304;Imbituba;4218905;Urubici;1;1;2;85
4215059;Rio Rufino;4218905;Urubici;1;1;2;25
4216602;São José;4218905;Urubici;1;1;2;101
4101002;Ampére;4218855;União do Oeste;1;1;2;112
4205407;Florianópolis;4218855;União do Oeste;1;1;2;443
1504208;Marabá;4218806;Turvo;1;1;2;2607
2304285;Eusébio;4218806;Turvo;1;1;2;2954
2615607;Trindade;4218806;Turvo;1;1;2;2492
2802106;Estância;4218806;Turvo;1;1;2;2257
2929305;São Gonçalo dos Campos;4218806;Turvo;1;1;2;2076
2930105;Senhor do Bonfim;4218806;Turvo;1;1;2;2224
3138203;Lavras;4218806;Turvo;1;1;2;960
3534401;Osasco;4218806;Turvo;1;1;2;658
4204806;Curitibanos;4218806;Turvo;1;1;2;204
4205407;Florianópolis;4218806;Turvo;1;1;2;186
4207502;Indaial;4218806;Turvo;1;1;2;229
4211256;Morro Grande;4218806;Turvo;1;1;2;14
4211702;Orleans;4218806;Turvo;1;1;2;75
4215455;Sangão;4218806;Turvo;1;1;2;62
4217600;Siderópolis;4218806;Turvo;1;1;2;43
4202156;Belmonte;4218756;Tunápolis;1;1;2;15
4211009;Mondaí;4218756;Tunápolis;1;1;2;23
2302206;Beberibe;4218707;Tubarão;1;1;2;2870
2304400;Fortaleza;4218707;Tubarão;1;1;2;2901
2611101;Petrolina;4218707;Tubarão;1;1;2;2264
2612505;Santa Cruz do Capibaribe;4218707;Tubarão;1;1;2;2562
2615607;Trindade;4218707;Tubarão;1;1;2;2428
2927408;Salvador;4218707;Tubarão;1;1;2;1977
2930709;Simões Filho;4218707;Tubarão;1;1;2;1999
3129509;Ibiá;4218707;Tubarão;1;1;2;1029
3151800;Poços de Caldas;4218707;Tubarão;1;1;2;781
3163706;São Lourenço;4218707;Tubarão;1;1;2;802
3301702;Duque de Caxias;4218707;Tubarão;1;1;2;837
3502804;Araçatuba;4218707;Tubarão;1;1;2;816
3505708;Barueri;4218707;Tubarão;1;1;2;589
3509205;Cajamar;4218707;Tubarão;1;1;2;605
3509502;Campinas;4218707;Tubarão;1;1;2;647
3516200;Franca;4218707;Tubarão;1;1;2;894
3546702;Santa Gertrudes;4218707;Tubarão;1;1;2;683
3548807;São Caetano do Sul;4218707;Tubarão;1;1;2;590
4103701;Cambé;4218707;Tubarão;1;1;2;614
4104808;Cascavel;4218707;Tubarão;1;1;2;579
4110706;Irati;4218707;Tubarão;1;1;2;367
4113700;Londrina;4218707;Tubarão;1;1;2;609
4118501;Pato Branco;4218707;Tubarão;1;1;2;431
4119905;Ponta Grossa;4218707;Tubarão;1;1;2;390
4122206;Rio Branco do Sul;4218707;Tubarão;1;1;2;366
4202503;Bom Jardim da Serra;4218707;Tubarão;1;1;2;60
4203600;Campos Novos;4218707;Tubarão;1;1;2;243
4203907;Capinzal;4218707;Tubarão;1;1;2;281
4204251;Cocal do Sul;4218707;Tubarão;1;1;2;31
4204806;Curitibanos;4218707;Tubarão;1;1;2;203
4206108;Grão Pará;4218707;Tubarão;1;1;2;39
4206504;Guaramirim;4218707;Tubarão;1;1;2;223
4207502;Indaial;4218707;Tubarão;1;1;2;177
4208302;Itapema;4218707;Tubarão;1;1;2;160
4208500;Ituporanga;4218707;Tubarão;1;1;2;131
4209003;Joaçaba;4218707;Tubarão;1;1;2;285
4210407;Maracajá;4218707;Tubarão;1;1;2;57
4211306;Navegantes;4218707;Tubarão;1;1;2;182
4211504;Nova Trento;4218707;Tubarão;1;1;2;134
4211603;Nova Veneza;4218707;Tubarão;1;1;2;48
4214300;Rancho Queimado;4218707;Tubarão;1;1;2;90
4215455;Sangão;4218707;Tubarão;1;1;2;19
4215653;Santa Rosa do Sul;4218707;Tubarão;1;1;2;97
4216008;São Carlos;4218707;Tubarão;1;1;2;418
4216503;São Joaquim;4218707;Tubarão;1;1;2;94
4217105;São Martinho;4218707;Tubarão;1;1;2;36
4218004;Tijucas;4218707;Tubarão;1;1;2;144
4218400;Treze de Maio;4218707;Tubarão;1;1;2;13
3550308;São Paulo;4218608;Trombudo Central;1;1;2;508
4106902;Curitiba;4218608;Trombudo Central;1;1;2;213
4202404;Blumenau;4218608;Trombudo Central;1;1;2;83
4204806;Curitibanos;4218608;Trombudo Central;1;1;2;78
4205407;Florianópolis;4218608;Trombudo Central;1;1;2;133
4207502;Indaial;4218608;Trombudo Central;1;1;2;73
4209102;Joinville;4218608;Trombudo Central;1;1;2;147
4209508;Laurentino;4218608;Trombudo Central;1;1;2;12
4214607;Rio do Oeste;4218608;Trombudo Central;1;1;2;12
4217808;Taió;4218608;Trombudo Central;1;1;2;30
3522208;Itapecerica da Serra;4218509;Treze Tílias;1;1;2;576
3523206;Itararé;4218509;Treze Tílias;1;1;2;380
3534401;Osasco;4218509;Treze Tílias;1;1;2;593
3550308;São Paulo;4218509;Treze Tílias;1;1;2;595
4106902;Curitiba;4218509;Treze Tílias;1;1;2;271
4107207;Dois Vizinhos;4218509;Treze Tílias;1;1;2;215
4115309;Mariópolis;4218509;Treze Tílias;1;1;2;135
4119905;Ponta Grossa;4218509;Treze Tílias;1;1;2;243
4200101;Abelardo Luz;4218509;Treze Tílias;1;1;2;103
4200408;Água Doce;4218509;Treze Tílias;1;1;2;15
4201604;Arroio Trinta;4218509;Treze Tílias;1;1;2;10
4203006;Caçador;4218509;Treze Tílias;1;1;2;38
4203105;Caibi;4218509;Treze Tílias;1;1;2;186
4203600;Campos Novos;4218509;Treze Tílias;1;1;2;50
4204202;Chapecó;4218509;Treze Tílias;1;1;2;122
4204301;Concórdia;4218509;Treze Tílias;1;1;2;65
4204806;Curitibanos;4218509;Treze Tílias;1;1;2;85
4204905;Descanso;4218509;Treze Tílias;1;1;2;209
4205407;Florianópolis;4218509;Treze Tílias;1;1;2;295
4206702;Herval d'Oeste;4218509;Treze Tílias;1;1;2;23
4207577;Iomerê;4218509;Treze Tílias;1;1;2;16
4211058;Monte Carlo;4218509;Treze Tílias;1;1;2;49
4214409;Rio das Antas;4218509;Treze Tílias;1;1;2;35
4214805;Rio do Sul;4218509;Treze Tílias;1;1;2;180
4215208;Romelândia;4218509;Treze Tílias;1;1;2;194
4216008;São Carlos;4218509;Treze Tílias;1;1;2;160
4216107;São Domingos;4218509;Treze Tílias;1;1;2;122
4216255;São João do Oeste;4218509;Treze Tílias;1;1;2;218
3516705;Garça;4218400;Treze de Maio;1;1;2;704
3550308;São Paulo;4218400;Treze de Maio;1;1;2;594
4205407;Florianópolis;4218400;Treze de Maio;1;1;2;123
4205456;Forquilhinha;4218400;Treze de Maio;1;1;2;38
4208708;Jacinto Machado;4218400;Treze de Maio;1;1;2;77
4208807;Jaguaruna;4218400;Treze de Maio;1;1;2;13
4209607;Lauro Muller;4218400;Treze de Maio;1;1;2;31
4215455;Sangão;4218400;Treze de Maio;1;1;2;9
4217709;Sombrio;4218400;Treze de Maio;1;1;2;78
4209607;Lauro Muller;4218350;Treviso;1;1;2;15
3304557;Rio de Janeiro;4218301;Três Barras;1;1;2;783
3512209;Conchal;4218301;Três Barras;1;1;2;521
3523206;Itararé;4218301;Três Barras;1;1;2;242
3534401;Osasco;4218301;Três Barras;1;1;2;451
3556206;Valinhos;4218301;Três Barras;1;1;2;478
4101309;Antônio Olinto;4218301;Três Barras;1;1;2;18
4101507;Arapongas;4218301;Três Barras;1;1;2;318
4125605;São Mateus do Sul;4218301;Três Barras;1;1;2;30
4203006;Caçador;4218301;Três Barras;1;1;2;109
4204806;Curitibanos;4218301;Três Barras;1;1;2;132
4205407;Florianópolis;4218301;Três Barras;1;1;2;245
4208203;Itajaí;4218301;Três Barras;1;1;2;183
4212205;Papanduva;4218301;Três Barras;1;1;2;34
4213104;Piratuba;4218301;Três Barras;1;1;2;206
4213351;Ponte Alta do Norte;4218301;Três Barras;1;1;2;117
4218004;Tijucas;4218301;Três Barras;1;1;2;211
4202131;Bela Vista do Toldo;4218251;Timbó Grande;1;1;2;43
4203154;Calmon;4218251;Timbó Grande;1;1;2;42
4204400;Coronel Freitas;4218251;Timbó Grande;1;1;2;205
4204558;Correia Pinto;4218251;Timbó Grande;1;1;2;112
4205407;Florianópolis;4218251;Timbó Grande;1;1;2;241
4205506;Fraiburgo;4218251;Timbó Grande;1;1;2;52
4209706;Lebon Régis;4218251;Timbó Grande;1;1;2;35
4210506;Maravilha;4218251;Timbó Grande;1;1;2;250
2611606;Recife;4218202;Timbó;1;1;2;2473
3159605;Santa Rita do Sapucaí;4218202;Timbó;1;1;2;616
3304557;Rio de Janeiro;4218202;Timbó;1;1;2;733
3518800;Guarulhos;4218202;Timbó;1;1;2;461
3522208;Itapecerica da Serra;4218202;Timbó;1;1;2;420
3534401;Osasco;4218202;Timbó;1;1;2;440
3546801;Santa Isabel;4218202;Timbó;1;1;2;492
4104204;Campo Largo;4218202;Timbó;1;1;2;156
4115200;Maringá;4218202;Timbó;1;1;2;459
4118501;Pato Branco;4218202;Timbó;1;1;2;343
4119905;Ponta Grossa;4218202;Timbó;1;1;2;212
4200200;Agrolândia;4218202;Timbó;1;1;2;84
4201257;Apiúna;4218202;Timbó;1;1;2;24
4202701;Botuverá;4218202;Timbó;1;1;2;44
4204806;Curitibanos;4218202;Timbó;1;1;2;141
4205159;Doutor Pedrinho;4218202;Timbó;1;1;2;27
4205407;Florianópolis;4218202;Timbó;1;1;2;112
4205902;Gaspar;4218202;Timbó;1;1;2;32
4206900;Ibirama;4218202;Timbó;1;1;2;34
4208203;Itajaí;4218202;Timbó;1;1;2;52
4208302;Itapema;4218202;Timbó;1;1;2;68
4209300;Lages;4218202;Timbó;1;1;2;150
4209706;Lebon Régis;4218202;Timbó;1;1;2;142
4211306;Navegantes;4218202;Timbó;1;1;2;59
4212809;Piçarras;4218202;Timbó;1;1;2;55
4216206;São Francisco do Sul;4218202;Timbó;1;1;2;89
4217808;Taió;4218202;Timbó;1;1;2;82
4201406;Araranguá;4218103;Timbé do Sul;1;1;2;37
4202800;Braço do Norte;4218103;Timbé do Sul;1;1;2;90
4204608;Criciúma;4218103;Timbé do Sul;1;1;2;49
4205456;Forquilhinha;4218103;Timbé do Sul;1;1;2;38
4207007;Içara;4218103;Timbé do Sul;1;1;2;55
4207304;Imbituba;4218103;Timbé do Sul;1;1;2;128
4208708;Jacinto Machado;4218103;Timbé do Sul;1;1;2;20
4211207;Morro da Fumaça;4218103;Timbé do Sul;1;1;2;65
4211702;Orleans;4218103;Timbé do Sul;1;1;2;76
4217006;São Ludgero;4218103;Timbé do Sul;1;1;2;86
2610707;Paulista;4218004;Tijucas;1;1;2;2495
2611606;Recife;4218004;Tijucas;1;1;2;2475
3157005;Salinas;4218004;Tijucas;1;1;2;1365
3205309;Vitória;4218004;Tijucas;1;1;2;1115
3509502;Campinas;4218004;Tijucas;1;1;2;505
3515004;Embu;4218004;Tijucas;1;1;2;434
3516200;Franca;4218004;Tijucas;1;1;2;751
3518800;Guarulhos;4218004;Tijucas;1;1;2;467
3522406;Itapeva;4218004;Tijucas;1;1;2;363
3530706;Mogi Guaçu;4218004;Tijucas;1;1;2;568
3534401;Osasco;4218004;Tijucas;1;1;2;448
3546702;Santa Gertrudes;4218004;Tijucas;1;1;2;541
3547809;Santo André;4218004;Tijucas;1;1;2;448
3548500;Santos;4218004;Tijucas;1;1;2;433
3548708;São Bernardo do Campo;4218004;Tijucas;1;1;2;439
3548807;São Caetano do Sul;4218004;Tijucas;1;1;2;450
3549805;São José do Rio Preto;4218004;Tijucas;1;1;2;714
4113700;Londrina;4218004;Tijucas;1;1;2;501
4119400;Piraí do Sul;4218004;Tijucas;1;1;2;324
4125506;São José dos Pinhais;4218004;Tijucas;1;1;2;196
4128104;Umuarama;4218004;Tijucas;1;1;2;599
4201406;Araranguá;4218004;Tijucas;1;1;2;207
4202206;Benedito Novo;4218004;Tijucas;1;1;2;89
4202404;Blumenau;4218004;Tijucas;1;1;2;54
4202453;Bombinhas;4218004;Tijucas;1;1;2;15
4202602;Bom Retiro;4218004;Tijucas;1;1;2;105
4203303;Campo Alegre;4218004;Tijucas;1;1;2;132
4203808;Canoinhas;4218004;Tijucas;1;1;2;210
4203956;Capivari de Baixo;4218004;Tijucas;1;1;2;137
4204806;Curitibanos;4218004;Tijucas;1;1;2;195
4205159;Doutor Pedrinho;4218004;Tijucas;1;1;2;103
4207007;Içara;4218004;Tijucas;1;1;2;177
4208500;Ituporanga;4218004;Tijucas;1;1;2;98
4209300;Lages;4218004;Tijucas;1;1;2;180
4212304;Paulo Lopes;4218004;Tijucas;1;1;2;80
4212809;Piçarras;4218004;Tijucas;1;1;2;54
3534401;Osasco;4217907;Tangará;1;1;2;588
3550308;São Paulo;4217907;Tangará;1;1;2;590
4106902;Curitiba;4217907;Tangará;1;1;2;267
4117602;Palmas;4217907;Tangará;1;1;2;98
4120804;Quatro Barras;4217907;Tangará;1;1;2;288
4200408;Água Doce;4217907;Tangará;1;1;2;33
4203600;Campos Novos;4217907;Tangará;1;1;2;35
4203907;Capinzal;4217907;Tangará;1;1;2;45
4205407;Florianópolis;4217907;Tangará;1;1;2;277
4205902;Gaspar;4217907;Tangará;1;1;2;228
4206801;Ibicaré;4217907;Tangará;1;1;2;12
4209003;Joaçaba;4217907;Tangará;1;1;2;30
4209300;Lages;4217907;Tangará;1;1;2;119
4210035;Luzerna;4217907;Tangará;1;1;2;24
4211058;Monte Carlo;4217907;Tangará;1;1;2;30
4214409;Rio das Antas;4217907;Tangará;1;1;2;29
3534401;Osasco;4217808;Taió;1;1;2;508
4104006;Campina Grande do Sul;4217808;Taió;1;1;2;223
4115358;Maripá;4217808;Taió;1;1;2;477
4202008;Balneário Camboriú;4217808;Taió;1;1;2;135
4202206;Benedito Novo;4217808;Taió;1;1;2;75
4202404;Blumenau;4217808;Taió;1;1;2;97
4202602;Bom Retiro;4217808;Taió;1;1;2;93
4203006;Caçador;4217808;Taió;1;1;2;110
4203204;Camboriú;4217808;Taió;1;1;2;133
4205407;Florianópolis;4217808;Taió;1;1;2;160
4205902;Gaspar;4217808;Taió;1;1;2;109
4206504;Guaramirim;4217808;Taió;1;1;2;124
4208500;Ituporanga;4217808;Taió;1;1;2;54
4208906;Jaraguá do Sul;4217808;Taió;1;1;2;118
4209151;José Boiteux;4217808;Taió;1;1;2;44
4209508;Laurentino;4217808;Taió;1;1;2;32
4210852;Mirim Doce;4217808;Taió;1;1;2;10
4212809;Piçarras;4217808;Taió;1;1;2;136
4215109;Rodeio;4217808;Taió;1;1;2;70
4216602;São José;4217808;Taió;1;1;2;144
4202578;Bom Jesus do Oeste;4217758;Sul Brasil;1;1;2;14
3516200;Franca;4217709;Sombrio;1;1;2;971
3534401;Osasco;4217709;Sombrio;1;1;2;674
3550308;São Paulo;4217709;Sombrio;1;1;2;668
4113700;Londrina;4217709;Sombrio;1;1;2;658
4201950;Balneário Arroio do Silva;4217709;Sombrio;1;1;2;28
4202701;Botuverá;4217709;Sombrio;1;1;2;218
4202800;Braço do Norte;4217709;Sombrio;1;1;2;103
4204806;Curitibanos;4217709;Sombrio;1;1;2;222
4205407;Florianópolis;4217709;Sombrio;1;1;2;200
4205902;Gaspar;4217709;Sombrio;1;1;2;250
4209102;Joinville;4217709;Sombrio;1;1;2;322
4210803;Meleiro;4217709;Sombrio;1;1;2;30
4211207;Morro da Fumaça;4217709;Sombrio;1;1;2;66
4211256;Morro Grande;4217709;Sombrio;1;1;2;34
4211702;Orleans;4217709;Sombrio;1;1;2;92
4216602;São José;4217709;Sombrio;1;1;2;193
3117876;Confins;4217600;Siderópolis;1;1;2;1118
3145901;Ouro Branco;4217600;Siderópolis;1;1;2;1047
3205002;Serra;4217600;Siderópolis;1;1;2;1275
3304557;Rio de Janeiro;4217600;Siderópolis;1;1;2;866
3304904;São Gonçalo;4217600;Siderópolis;1;1;2;886
3306305;Volta Redonda;4217600;Siderópolis;1;1;2;846
3501608;Americana;4217600;Siderópolis;1;1;2;680
3504107;Atibaia;4217600;Siderópolis;1;1;2;667
3512407;Cordeirópolis;4217600;Siderópolis;1;1;2;704
3513504;Cubatão;4217600;Siderópolis;1;1;2;596
3522406;Itapeva;4217600;Siderópolis;1;1;2;515
3534401;Osasco;4217600;Siderópolis;1;1;2;616
3548906;São Carlos;4217600;Siderópolis;1;1;2;743
4204806;Curitibanos;4217600;Siderópolis;1;1;2;185
4209607;Lauro Muller;4217600;Siderópolis;1;1;2;23
4211207;Morro da Fumaça;4217600;Siderópolis;1;1;2;24
4216602;São José;4217600;Siderópolis;1;1;2;135
4210506;Maravilha;4217550;Serra Alta;1;1;2;14
4215356;Saltinho;4217550;Serra Alta;1;1;2;13
3534401;Osasco;4217501;Seara;1;1;2;671
4102604;Barracão;4217501;Seara;1;1;2;165
4118501;Pato Branco;4217501;Seara;1;1;2;108
4128203;União da Vitória;4217501;Seara;1;1;2;150
4200101;Abelardo Luz;4217501;Seara;1;1;2;65
4203006;Caçador;4217501;Seara;1;1;2;127
4203600;Campos Novos;4217501;Seara;1;1;2;113
4203808;Canoinhas;4217501;Seara;1;1;2;214
4203907;Capinzal;4217501;Seara;1;1;2;73
4204400;Coronel Freitas;4217501;Seara;1;1;2;47
4204558;Correia Pinto;4217501;Seara;1;1;2;200
4204707;Cunha Porã;4217501;Seara;1;1;2;89
4204905;Descanso;4217501;Seara;1;1;2;123
4205308;Faxinal dos Guedes;4217501;Seara;1;1;2;33
4205407;Florianópolis;4217501;Seara;1;1;2;380
4205506;Fraiburgo;4217501;Seara;1;1;2;138
4207650;Iporã do Oeste;4217501;Seara;1;1;2;123
4207700;Ipumirim;4217501;Seara;1;1;2;19
4208401;Itapiranga;4217501;Seara;1;1;2;139
4209003;Joaçaba;4217501;Seara;1;1;2;76
4209102;Joinville;4217501;Seara;1;1;2;354
4209854;Lindóia do Sul;4217501;Seara;1;1;2;26
4210506;Maravilha;4217501;Seara;1;1;2;95
4211009;Mondaí;4217501;Seara;1;1;2;113
4211751;Otacílio Costa;4217501;Seara;1;1;2;220
4211876;Paial;4217501;Seara;1;1;2;22
4212106;Palmitos;4217501;Seara;1;1;2;84
4212908;Pinhalzinho;4217501;Seara;1;1;2;75
4214201;Quilombo;4217501;Seara;1;1;2;62
4216008;São Carlos;4217501;Seara;1;1;2;71
4216107;São Domingos;4217501;Seara;1;1;2;69
4216701;São José do Cedro;4217501;Seara;1;1;2;143
4216909;São Lourenço do Oeste;4217501;Seara;1;1;2;103
4217204;São Miguel do Oeste;4217501;Seara;1;1;2;132
4217303;Saudades;4217501;Seara;1;1;2;73
3534401;Osasco;4217402;Schroeder;1;1;2;390
4202909;Brusque;4217402;Schroeder;1;1;2;77
4210605;Massaranduba;4217402;Schroeder;1;1;2;23
4211207;Morro da Fumaça;4217402;Schroeder;1;1;2;248
4213203;Pomerode;4217402;Schroeder;1;1;2;38
2306405;Itapipoca;4217303;Saudades;1;1;2;2881
2914703;Itaberaba;4217303;Saudades;1;1;2;1994
2928802;Santo Estêvão;4217303;Saudades;1;1;2;2067
3548500;Santos;4217303;Saudades;1;1;2;734
4106902;Curitiba;4217303;Saudades;1;1;2;402
4204756;Cunhataí;4217303;Saudades;1;1;2;10
4210506;Maravilha;4217303;Saudades;1;1;2;24
4211405;Nova Erechim;4217303;Saudades;1;1;2;10
3550308;São Paulo;4217253;São Pedro de Alcântara;1;1;2;481
4201208;Antônio Carlos;4217253;São Pedro de Alcântara;1;1;2;6
4205407;Florianópolis;4217253;São Pedro de Alcântara;1;1;2;29
3509502;Campinas;4217204;São Miguel do Oeste;1;1;2;763
3516200;Franca;4217204;São Miguel do Oeste;1;1;2;906
3518800;Guarulhos;4217204;São Miguel do Oeste;1;1;2;775
3534401;Osasco;4217204;São Miguel do Oeste;1;1;2;751
3545209;Salto;4217204;São Miguel do Oeste;1;1;2;726
4102604;Barracão;4217204;São Miguel do Oeste;1;1;2;52
4106902;Curitiba;4217204;São Miguel do Oeste;1;1;2;444
4107207;Dois Vizinhos;4217204;São Miguel do Oeste;1;1;2;117
4109401;Guarapuava;4217204;São Miguel do Oeste;1;1;2;252
4115200;Maringá;4217204;São Miguel do Oeste;1;1;2;396
4115408;Marmeleiro;4217204;São Miguel do Oeste;1;1;2;80
4116950;Nova Esperança do Sudoeste;4217204;São Miguel do Oeste;1;1;2;92
4117057;Nova Laranjeiras;4217204;São Miguel do Oeste;1;1;2;184
4119905;Ponta Grossa;4217204;São Miguel do Oeste;1;1;2;378
4200804;Anchieta;4217204;São Miguel do Oeste;1;1;2;28
4202156;Belmonte;4217204;São Miguel do Oeste;1;1;2;16
4202404;Blumenau;4217204;São Miguel do Oeste;1;1;2;446
4202909;Brusque;4217204;São Miguel do Oeste;1;1;2;464
4203501;Campo Erê;4217204;São Miguel do Oeste;1;1;2;58
4204806;Curitibanos;4217204;São Miguel do Oeste;1;1;2;300
4208906;Jaraguá do Sul;4217204;São Miguel do Oeste;1;1;2;445
4209003;Joaçaba;4217204;São Miguel do Oeste;1;1;2;205
4209102;Joinville;4217204;São Miguel do Oeste;1;1;2;467
4209300;Lages;4217204;São Miguel do Oeste;1;1;2;343
4216255;São João do Oeste;4217204;São Miguel do Oeste;1;1;2;44
4204707;Cunha Porã;4217154;São Miguel da Boa Vista;1;1;2;24
4210506;Maravilha;4217154;São Miguel da Boa Vista;1;1;2;11
4202404;Blumenau;4217105;São Martinho;1;1;2;135
4203956;Capivari de Baixo;4217105;São Martinho;1;1;2;31
4205407;Florianópolis;4217105;São Martinho;1;1;2;78
4207205;Imaruí;4217105;São Martinho;1;1;2;21
2507507;João Pessoa;4217006;São Ludgero;1;1;2;2687
3114501;Carmópolis de Minas;4217006;São Ludgero;1;1;2;964
3534401;Osasco;4217006;São Ludgero;1;1;2;578
4114807;Marialva;4217006;São Ludgero;1;1;2;592
4202404;Blumenau;4217006;São Ludgero;1;1;2;153
4202503;Bom Jardim da Serra;4217006;São Ludgero;1;1;2;44
4212403;Pedras Grandes;4217006;São Ludgero;1;1;2;12
4214904;Rio Fortuna;4217006;São Ludgero;1;1;2;23
2933307;Vitória da Conquista;4216909;São Lourenço do Oeste;1;1;2;1720
3304557;Rio de Janeiro;4216909;São Lourenço do Oeste;1;1;2;1023
3534401;Osasco;4216909;São Lourenço do Oeste;1;1;2;678
3546405;Santa Cruz do Rio Pardo;4216909;São Lourenço do Oeste;1;1;2;501
3549953;São Lourenço da Serra;4216909;São Lourenço do Oeste;1;1;2;650
3550308;São Paulo;4216909;São Lourenço do Oeste;1;1;2;685
4109401;Guarapuava;4216909;São Lourenço do Oeste;1;1;2;179
4110706;Irati;4216909;São Lourenço do Oeste;1;1;2;244
4115309;Mariópolis;4216909;São Lourenço do Oeste;1;1;2;32
4115408;Marmeleiro;4216909;São Lourenço do Oeste;1;1;2;29
4116950;Nova Esperança do Sudoeste;4216909;São Lourenço do Oeste;1;1;2;64
4117602;Palmas;4216909;São Lourenço do Oeste;1;1;2;92
4119905;Ponta Grossa;4216909;São Lourenço do Oeste;1;1;2;304
4124806;São João;4216909;São Lourenço do Oeste;1;1;2;63
4202008;Balneário Camboriú;4216909;São Lourenço do Oeste;1;1;2;426
4202453;Bombinhas;4216909;São Lourenço do Oeste;1;1;2;443
4204301;Concórdia;4216909;São Lourenço do Oeste;1;1;2;127
4204707;Cunha Porã;4216909;São Lourenço do Oeste;1;1;2;64
4204806;Curitibanos;4216909;São Lourenço do Oeste;1;1;2;249
4205001;Dionísio Cerqueira;4216909;São Lourenço do Oeste;1;1;2;76
4210902;Modelo;4216909;São Lourenço do Oeste;1;1;2;48
4211009;Mondaí;4216909;São Lourenço do Oeste;1;1;2;98
4213609;Porto União;4216909;São Lourenço do Oeste;1;1;2;184
4215752;São Bernardino;4216909;São Lourenço do Oeste;1;1;2;13
4215802;São Bento do Sul;4216909;São Lourenço do Oeste;1;1;2;350
4202602;Bom Retiro;4216800;São José do Cerrito;1;1;2;109
4203402;Campo Belo do Sul;4216800;São José do Cerrito;1;1;2;32
4204301;Concórdia;4216800;São José do Cerrito;1;1;2;150
4204806;Curitibanos;4216800;São José do Cerrito;1;1;2;43
4205407;Florianópolis;4216800;São José do Cerrito;1;1;2;204
4209003;Joaçaba;4216800;São José do Cerrito;1;1;2;111
3534401;Osasco;4216701;São José do Cedro;1;1;2;739
4102604;Barracão;4216701;São José do Cedro;1;1;2;27
4104501;Capanema;4216701;São José do Cedro;1;1;2;90
4108403;Francisco Beltrão;4216701;São José do Cedro;1;1;2;63
4204301;Concórdia;4216701;São José do Cedro;1;1;2;173
4204400;Coronel Freitas;4216701;São José do Cedro;1;1;2;96
4205407;Florianópolis;4216701;São José do Cedro;1;1;2;518
4207650;Iporã do Oeste;4216701;São José do Cedro;1;1;2;59
4210506;Maravilha;4216701;São José do Cedro;1;1;2;49
4212007;Palma Sola;4216701;São José do Cedro;1;1;2;28
2408003;Mossoró;4216602;São José;1;1;2;2693
2607901;Jaboatão dos Guararapes;4216602;São José;1;1;2;2503
2611606;Recife;4216602;São José;1;1;2;2507
3159605;Santa Rita do Sapucaí;4216602;São José;1;1;2;657
3201209;Cachoeiro de Itapemirim;4216602;São José;1;1;2;1045
3205309;Vitória;4216602;São José;1;1;2;1143
3301702;Duque de Caxias;4216602;São José;1;1;2;745
3305109;São João de Meriti;4216602;São José;1;1;2;738
3501905;Amparo;4216602;São José;1;1;2;572
3503307;Araras;4216602;São José;1;1;2;592
3510401;Capivari;4216602;São José;1;1;2;521
3513009;Cotia;4216602;São José;1;1;2;473
3513801;Diadema;4216602;São José;1;1;2;476
3518800;Guarulhos;4216602;São José;1;1;2;503
3522208;Itapecerica da Serra;4216602;São José;1;1;2;464
3525904;Jundiaí;4216602;São José;1;1;2;517
3529401;Mauá;4216602;São José;1;1;2;484
3531308;Monte Alto;4216602;São José;1;1;2;697
3538006;Pindamonhangaba;4216602;São José;1;1;2;603
3538709;Piracicaba;4216602;São José;1;1;2;544
3540705;Porto Ferreira;4216602;São José;1;1;2;645
3542602;Registro;4216602;São José;1;1;2;348
3547304;Santana de Parnaíba;4216602;São José;1;1;2;489
3547809;Santo André;4216602;São José;1;1;2;483
3549805;São José do Rio Preto;4216602;São José;1;1;2;751
3552205;Sorocaba;4216602;São José;1;1;2;468
4104204;Campo Largo;4216602;São José;1;1;2;249
4104808;Cascavel;4216602;São José;1;1;2;550
4107652;Fazenda Rio Grande;4216602;São José;1;1;2;222
4108304;Foz do Iguaçu;4216602;São José;1;1;2;613
4119152;Pinhais;4216602;São José;1;1;2;242
4122404;Rolândia;4216602;São José;1;1;2;540
4127700;Toledo;4216602;São José;1;1;2;588
4200606;Águas Mornas;4216602;São José;1;1;2;21
4201109;Anitápolis;4216602;São José;1;1;2;57
4201703;Ascurra;4216602;São José;1;1;2;99
4203006;Caçador;4216602;São José;1;1;2;252
4203709;Canelinha;4216602;São José;1;1;2;36
4204301;Concórdia;4216602;São José;1;1;2;331
4204806;Curitibanos;4216602;São José;1;1;2;192
4205506;Fraiburgo;4216602;São José;1;1;2;229
4205704;Garopaba;4216602;São José;1;1;2;49
4205902;Gaspar;4216602;São José;1;1;2;77
4207106;Ilhota;4216602;São José;1;1;2;77
4207205;Imaruí;4216602;São José;1;1;2;84
4208104;Itaiópolis;4216602;São José;1;1;2;183
4208500;Ituporanga;4216602;São José;1;1;2;93
4210100;Mafra;4216602;São José;1;1;2;195
4210506;Maravilha;4216602;São José;1;1;2;451
4211702;Orleans;4216602;São José;1;1;2;104
4212106;Palmitos;4216602;São José;1;1;2;444
4213500;Porto Belo;4216602;São José;1;1;2;48
4214300;Rancho Queimado;4216602;São José;1;1;2;35
4215000;Rio Negrinho;4216602;São José;1;1;2;168
4215059;Rio Rufino;4216602;São José;1;1;2;113
4216008;São Carlos;4216602;São José;1;1;2;431
4216503;São Joaquim;4216602;São José;1;1;2;148
3516200;Franca;4216503;São Joaquim;1;1;2;890
3534401;Osasco;4216503;São Joaquim;1;1;2;607
3548708;São Bernardo do Campo;4216503;São Joaquim;1;1;2;600
4202404;Blumenau;4216503;São Joaquim;1;1;2;170
4202800;Braço do Norte;4216503;São Joaquim;1;1;2;79
4203600;Campos Novos;4216503;São Joaquim;1;1;2;154
4203907;Capinzal;4216503;São Joaquim;1;1;2;190
4204806;Curitibanos;4216503;São Joaquim;1;1;2;127
4205506;Fraiburgo;4216503;São Joaquim;1;1;2;166
4207007;Içara;4216503;São Joaquim;1;1;2;83
4207502;Indaial;4216503;São Joaquim;1;1;2;168
4208906;Jaraguá do Sul;4216503;São Joaquim;1;1;2;216
4211751;Otacílio Costa;4216503;São Joaquim;1;1;2;88
4205407;Florianópolis;4216404;São João do Sul;1;1;2;220
4208807;Jaguaruna;4216404;São João do Sul;1;1;2;102
4208906;Jaraguá do Sul;4216404;São João do Sul;1;1;2;312
4215653;Santa Rosa do Sul;4216404;São João do Sul;1;1;2;14
4205407;Florianópolis;4216354;São João do Itaperiú;1;1;2;112
4205803;Garuva;4216354;São João do Itaperiú;1;1;2;66
4205902;Gaspar;4216354;São João do Itaperiú;1;1;2;38
4209102;Joinville;4216354;São João do Itaperiú;1;1;2;38
3145208;Nova Serrana;4216305;São João Batista;1;1;2;900
3516200;Franca;4216305;São João Batista;1;1;2;759
3534401;Osasco;4216305;São João Batista;1;1;2;460
4119152;Pinhais;4216305;São João Batista;1;1;2;206
4200903;Angelina;4216305;São João Batista;1;1;2;35
4202701;Botuverá;4216305;São João Batista;1;1;2;24
4203006;Caçador;4216305;São João Batista;1;1;2;228
4204608;Criciúma;4216305;São João Batista;1;1;2;163
4204806;Curitibanos;4216305;São João Batista;1;1;2;174
4208203;Itajaí;4216305;São João Batista;1;1;2;38
4213500;Porto Belo;4216305;São João Batista;1;1;2;30
4204905;Descanso;4216255;São João do Oeste;1;1;2;31
4211009;Mondaí;4216255;São João do Oeste;1;1;2;14
2111300;São Luís;4216206;São Francisco do Sul;1;1;2;2661
2408003;Mossoró;4216206;São Francisco do Sul;1;1;2;2567
3106200;Belo Horizonte;4216206;São Francisco do Sul;1;1;2;840
3118601;Contagem;4216206;São Francisco do Sul;1;1;2;833
3131307;Ipatinga;4216206;São Francisco do Sul;1;1;2;960
3141108;Matozinhos;4216206;São Francisco do Sul;1;1;2;867
3147402;Paraopeba;4216206;São Francisco do Sul;1;1;2;880
3205002;Serra;4216206;São Francisco do Sul;1;1;2;1060
3205200;Vila Velha;4216206;São Francisco do Sul;1;1;2;1041
3302007;Itaguaí;4216206;São Francisco do Sul;1;1;2;611
3306305;Volta Redonda;4216206;São Francisco do Sul;1;1;2;612
3516200;Franca;4216206;São Francisco do Sul;1;1;2;648
3518701;Guarujá;4216206;São Francisco do Sul;1;1;2;348
3527108;Lins;4216206;São Francisco do Sul;1;1;2;523
3534401;Osasco;4216206;São Francisco do Sul;1;1;2;355
3545803;Santa Bárbara d'Oeste;4216206;São Francisco do Sul;1;1;2;410
4101804;Araucária;4216206;São Francisco do Sul;1;1;2;110
4104303;Campo Mourão;4216206;São Francisco do Sul;1;1;2;448
4105805;Colombo;4216206;São Francisco do Sul;1;1;2;131
4108809;Guaíra;4216206;São Francisco do Sul;1;1;2;607
4109401;Guarapuava;4216206;São Francisco do Sul;1;1;2;300
4115200;Maringá;4216206;São Francisco do Sul;1;1;2;455
4118402;Paranavaí;4216206;São Francisco do Sul;1;1;2;517
4119152;Pinhais;4216206;São Francisco do Sul;1;1;2;110
4125605;São Mateus do Sul;4216206;São Francisco do Sul;1;1;2;183
4126504;Sertanópolis;4216206;São Francisco do Sul;1;1;2;430
4202057;Balneário Barra do Sul;4216206;São Francisco do Sul;1;1;2;20
4202107;Barra Velha;4216206;São Francisco do Sul;1;1;2;39
4202909;Brusque;4216206;São Francisco do Sul;1;1;2;93
4204202;Chapecó;4216206;São Francisco do Sul;1;1;2;411
4204350;Cordilheira Alta;4216206;São Francisco do Sul;1;1;2;410
4204806;Curitibanos;4216206;São Francisco do Sul;1;1;2;227
4205001;Dionísio Cerqueira;4216206;São Francisco do Sul;1;1;2;501
4205902;Gaspar;4216206;São Francisco do Sul;1;1;2;78
4207304;Imbituba;4216206;São Francisco do Sul;1;1;2;210
4208302;Itapema;4216206;São Francisco do Sul;1;1;2;88
4210001;Luiz Alves;4216206;São Francisco do Sul;1;1;2;57
4210100;Mafra;4216206;São Francisco do Sul;1;1;2;123
4211306;Navegantes;4216206;São Francisco do Sul;1;1;2;65
4211900;Palhoça;4216206;São Francisco do Sul;1;1;2;151
4215802;São Bento do Sul;4216206;São Francisco do Sul;1;1;2;75
3304557;Rio de Janeiro;4216107;São Domingos;1;1;2;997
3534401;Osasco;4216107;São Domingos;1;1;2;657
4104808;Cascavel;4216107;São Domingos;1;1;2;201
4105706;Clevelândia;4216107;São Domingos;1;1;2;19
4106902;Curitiba;4216107;São Domingos;1;1;2;344
4117602;Palmas;4216107;São Domingos;1;1;2;56
4204806;Curitibanos;4216107;São Domingos;1;1;2;208
4205407;Florianópolis;4216107;São Domingos;1;1;2;418
4205605;Galvão;4216107;São Domingos;1;1;2;19
4207684;Ipuaçu;4216107;São Domingos;1;1;2;11
4209177;Jupiá;4216107;São Domingos;1;1;2;26
4211850;Ouro Verde;4216107;São Domingos;1;1;2;27
3304557;Rio de Janeiro;4216057;São Cristovão do Sul;1;1;2;851
4106902;Curitiba;4216057;São Cristovão do Sul;1;1;2;232
4200705;Alfredo Wagner;4216057;São Cristovão do Sul;1;1;2;120
4204202;Chapecó;4216057;São Cristovão do Sul;1;1;2;217
4205407;Florianópolis;4216057;São Cristovão do Sul;1;1;2;194
4207403;Imbuia;4216057;São Cristovão do Sul;1;1;2;104
4208500;Ituporanga;4216057;São Cristovão do Sul;1;1;2;84
4213708;Pouso Redondo;4216057;São Cristovão do Sul;1;1;2;50
3205002;Serra;4216008;São Carlos;1;1;2;1449
3534401;Osasco;4216008;São Carlos;1;1;2;724
3548708;São Bernardo do Campo;4216008;São Carlos;1;1;2;731
4119905;Ponta Grossa;4216008;São Carlos;1;1;2;355
4125506;São José dos Pinhais;4216008;São Carlos;1;1;2;415
4202404;Blumenau;4216008;São Carlos;1;1;2;391
4203006;Caçador;4216008;São Carlos;1;1;2;194
4203105;Caibi;4216008;São Carlos;1;1;2;26
4203501;Campo Erê;4216008;São Carlos;1;1;2;75
4204608;Criciúma;4216008;São Carlos;1;1;2;404
4209003;Joaçaba;4216008;São Carlos;1;1;2;147
4209300;Lages;4216008;São Carlos;1;1;2;279
4210506;Maravilha;4216008;São Carlos;1;1;2;37
4210902;Modelo;4216008;São Carlos;1;1;2;33
4212908;Pinhalzinho;4216008;São Carlos;1;1;2;25
4214805;Rio do Sul;4216008;São Carlos;1;1;2;339
4215075;Riqueza;4216008;São Carlos;1;1;2;35
4202800;Braço do Norte;4215901;São Bonifácio;1;1;2;48
4211900;Palhoça;4215901;São Bonifácio;1;1;2;33
4215703;Santo Amaro da Imperatriz;4215901;São Bonifácio;1;1;2;28
2403251;Parnamirim;4215802;São Bento do Sul;1;1;2;2617
2919207;Lauro de Freitas;4215802;São Bento do Sul;1;1;2;1819
2927408;Salvador;4215802;São Bento do Sul;1;1;2;1801
3106200;Belo Horizonte;4215802;São Bento do Sul;1;1;2;879
3118601;Contagem;4215802;São Bento do Sul;1;1;2;871
3170206;Uberlândia;4215802;São Bento do Sul;1;1;2;822
3203205;Linhares;4215802;São Bento do Sul;1;1;2;1188
3505708;Barueri;4215802;São Bento do Sul;1;1;2;392
3506003;Bauru;4215802;São Bento do Sul;1;1;2;435
3507001;Boituva;4215802;São Bento do Sul;1;1;2;370
3509205;Cajamar;4215802;São Bento do Sul;1;1;2;405
3515004;Embu;4215802;São Bento do Sul;1;1;2;382
3518305;Guararema;4215802;São Bento do Sul;1;1;2;455
3526209;Juquitiba;4215802;São Bento do Sul;1;1;2;344
3530300;Mirassol;4215802;São Bento do Sul;1;1;2;603
3531803;Monte Mor;4215802;São Bento do Sul;1;1;2;419
3534708;Ourinhos;4215802;São Bento do Sul;1;1;2;366
3543907;Rio Claro;4215802;São Bento do Sul;1;1;2;462
3548708;São Bernardo do Campo;4215802;São Bento do Sul;1;1;2;394
3548906;São Carlos;4215802;São Bento do Sul;1;1;2;491
4101507;Arapongas;4215802;São Bento do Sul;1;1;2;376
4104303;Campo Mourão;4215802;São Bento do Sul;1;1;2;386
4105805;Colombo;4215802;São Bento do Sul;1;1;2;112
4107652;Fazenda Rio Grande;4215802;São Bento do Sul;1;1;2;67
4113700;Londrina;4215802;São Bento do Sul;1;1;2;372
4117701;Palmeira;4215802;São Bento do Sul;1;1;2;111
4119905;Ponta Grossa;4215802;São Bento do Sul;1;1;2;150
4120804;Quatro Barras;4215802;São Bento do Sul;1;1;2;103
4128203;União da Vitória;4215802;São Bento do Sul;1;1;2;177
4200051;Abdon Batista;4215802;São Bento do Sul;1;1;2;223
4202008;Balneário Camboriú;4215802;São Bento do Sul;1;1;2;106
4202107;Barra Velha;4215802;São Bento do Sul;1;1;2;77
4205803;Garuva;4215802;São Bento do Sul;1;1;2;58
4206504;Guaramirim;4215802;São Bento do Sul;1;1;2;44
4206900;Ibirama;4215802;São Bento do Sul;1;1;2;90
4208104;Itaiópolis;4215802;São Bento do Sul;1;1;2;54
4209003;Joaçaba;4215802;São Bento do Sul;1;1;2;239
4210035;Luzerna;4215802;São Bento do Sul;1;1;2;233
4211306;Navegantes;4215802;São Bento do Sul;1;1;2;98
4211900;Palhoça;4215802;São Bento do Sul;1;1;2;167
4212502;Penha;4215802;São Bento do Sul;1;1;2;93
4214706;Rio dos Cedros;4215802;São Bento do Sul;1;1;2;54
4204202;Chapecó;4215752;São Bernardino;1;1;2;79
4204400;Coronel Freitas;4215752;São Bernardino;1;1;2;55
3301702;Duque de Caxias;4215703;Santo Amaro da Imperatriz;1;1;2;759
3516200;Franca;4215703;Santo Amaro da Imperatriz;1;1;2;802
3534401;Osasco;4215703;Santo Amaro da Imperatriz;1;1;2;499
4106902;Curitiba;4215703;Santo Amaro da Imperatriz;1;1;2;255
4202305;Biguaçu;4215703;Santo Amaro da Imperatriz;1;1;2;23
4204202;Chapecó;4215703;Santo Amaro da Imperatriz;1;1;2;384
4204806;Curitibanos;4215703;Santo Amaro da Imperatriz;1;1;2;185
4204202;Chapecó;4215695;Santiago do Sul;1;1;2;53
4202578;Bom Jesus do Oeste;4215687;Santa Terezinha do Progresso;1;1;2;13
4210506;Maravilha;4215687;Santa Terezinha do Progresso;1;1;2;16
4202206;Benedito Novo;4215679;Santa Terezinha;1;1;2;63
4203808;Canoinhas;4215679;Santa Terezinha;1;1;2;76
4204301;Concórdia;4215679;Santa Terezinha;1;1;2;206
4204806;Curitibanos;4215679;Santa Terezinha;1;1;2;81
4209003;Joaçaba;4215679;Santa Terezinha;1;1;2;158
4209508;Laurentino;4215679;Santa Terezinha;1;1;2;56
4212205;Papanduva;4215679;Santa Terezinha;1;1;2;47
4213708;Pouso Redondo;4215679;Santa Terezinha;1;1;2;54
4215307;Salete;4215679;Santa Terezinha;1;1;2;22
3534401;Osasco;4215653;Santa Rosa do Sul;1;1;2;679
3550308;São Paulo;4215653;Santa Rosa do Sul;1;1;2;672
4204806;Curitibanos;4215653;Santa Rosa do Sul;1;1;2;222
4211207;Morro da Fumaça;4215653;Santa Rosa do Sul;1;1;2;72
4201109;Anitápolis;4215604;Santa Rosa de Lima;1;1;2;15
4202800;Braço do Norte;4215604;Santa Rosa de Lima;1;1;2;26
4206108;Grão Pará;4215604;Santa Rosa de Lima;1;1;2;20
4208401;Itapiranga;4215554;Santa Helena;1;1;2;27
4212106;Palmitos;4215554;Santa Helena;1;1;2;49
3534401;Osasco;4215505;Santa Cecília;1;1;2;524
4119905;Ponta Grossa;4215505;Santa Cecília;1;1;2;209
4127106;Telêmaco Borba;4215505;Santa Cecília;1;1;2;290
4202701;Botuverá;4215505;Santa Cecília;1;1;2;141
4203600;Campos Novos;4215505;Santa Cecília;1;1;2;89
4204202;Chapecó;4215505;Santa Cecília;1;1;2;215
4205407;Florianópolis;4215505;Santa Cecília;1;1;2;206
4205506;Fraiburgo;4215505;Santa Cecília;1;1;2;45
4205555;Frei Rogério;4215505;Santa Cecília;1;1;2;40
4208203;Itajaí;4215505;Santa Cecília;1;1;2;171
4209102;Joinville;4215505;Santa Cecília;1;1;2;177
4209300;Lages;4215505;Santa Cecília;1;1;2;93
4209706;Lebon Régis;4215505;Santa Cecília;1;1;2;23
4212205;Papanduva;4215505;Santa Cecília;1;1;2;74
4104303;Campo Mourão;4215455;Sangão;1;1;2;597
4202800;Braço do Norte;4215455;Sangão;1;1;2;40
4204608;Criciúma;4215455;Sangão;1;1;2;25
4207007;Içara;4215455;Sangão;1;1;2;19
4208807;Jaguaruna;4215455;Sangão;1;1;2;10
4211207;Morro da Fumaça;4215455;Sangão;1;1;2;8
3543907;Rio Claro;4215406;Salto Veloso;1;1;2;623
3550308;São Paulo;4215406;Salto Veloso;1;1;2;589
4106902;Curitiba;4215406;Salto Veloso;1;1;2;265
4108304;Foz do Iguaçu;4215406;Salto Veloso;1;1;2;342
4118501;Pato Branco;4215406;Salto Veloso;1;1;2;145
4203600;Campos Novos;4215406;Salto Veloso;1;1;2;61
4205407;Florianópolis;4215406;Salto Veloso;1;1;2;298
4207809;Irani;4215406;Salto Veloso;1;1;2;51
4209003;Joaçaba;4215406;Salto Veloso;1;1;2;30
4204202;Chapecó;4215356;Saltinho;1;1;2;70
4206603;Guarujá do Sul;4215356;Saltinho;1;1;2;53
4211405;Nova Erechim;4215356;Saltinho;1;1;2;36
4212908;Pinhalzinho;4215356;Saltinho;1;1;2;27
3550308;São Paulo;4215307;Salete;1;1;2;493
4202909;Brusque;4215307;Salete;1;1;2;109
4204806;Curitibanos;4215307;Salete;1;1;2;68
4205407;Florianópolis;4215307;Salete;1;1;2;163
4205902;Gaspar;4215307;Salete;1;1;2;103
4214508;Rio do Campo;4215307;Salete;1;1;2;14
4202099;Barra Bonita;4215208;Romelândia;1;1;2;11
4205407;Florianópolis;4215208;Romelândia;1;1;2;492
4210506;Maravilha;4215208;Romelândia;1;1;2;19
3543402;Ribeirão Preto;4215109;Rodeio;1;1;2;657
4106902;Curitiba;4215109;Rodeio;1;1;2;165
4202206;Benedito Novo;4215109;Rodeio;1;1;2;16
4204806;Curitibanos;4215109;Rodeio;1;1;2;129
4205407;Florianópolis;4215109;Rodeio;1;1;2;113
4213203;Pomerode;4215109;Rodeio;1;1;2;28
4214706;Rio dos Cedros;4215109;Rodeio;1;1;2;22
4203105;Caibi;4215075;Riqueza;1;1;2;9
4205407;Florianópolis;4215075;Riqueza;1;1;2;486
4212106;Palmitos;4215075;Riqueza;1;1;2;22
4200705;Alfredo Wagner;4215059;Rio Rufino;1;1;2;47
4209300;Lages;4215059;Rio Rufino;1;1;2;55
2607901;Jaboatão dos Guararapes;4215000;Rio Negrinho;1;1;2;2433
3168705;Timóteo;4215000;Rio Negrinho;1;1;2;997
3169901;Ubá;4215000;Rio Negrinho;1;1;2;858
3513504;Cubatão;4215000;Rio Negrinho;1;1;2;402
3522208;Itapecerica da Serra;4215000;Rio Negrinho;1;1;2;386
3526209;Juquitiba;4215000;Rio Negrinho;1;1;2;353
3534401;Osasco;4215000;Rio Negrinho;1;1;2;404
4114302;Mandirituba;4215000;Rio Negrinho;1;1;2;56
4128203;União da Vitória;4215000;Rio Negrinho;1;1;2;163
4202008;Balneário Camboriú;4215000;Rio Negrinho;1;1;2;117
4202404;Blumenau;4215000;Rio Negrinho;1;1;2;89
4204202;Chapecó;4215000;Rio Negrinho;1;1;2;326
4204806;Curitibanos;4215000;Rio Negrinho;1;1;2;157
4205308;Faxinal dos Guedes;4215000;Rio Negrinho;1;1;2;283
4205506;Fraiburgo;4215000;Rio Negrinho;1;1;2;165
4208104;Itaiópolis;4215000;Rio Negrinho;1;1;2;40
4208203;Itajaí;4215000;Rio Negrinho;1;1;2;108
4214003;Presidente Getúlio;4215000;Rio Negrinho;1;1;2;89
3550308;São Paulo;4214904;Rio Fortuna;1;1;2;550
4201109;Anitápolis;4214904;Rio Fortuna;1;1;2;25
4204608;Criciúma;4214904;Rio Fortuna;1;1;2;65
4205407;Florianópolis;4214904;Rio Fortuna;1;1;2;83
3106200;Belo Horizonte;4214805;Rio do Sul;1;1;2;977
3505708;Barueri;4214805;Rio do Sul;1;1;2;491
3509502;Campinas;4214805;Rio do Sul;1;1;2;541
3522208;Itapecerica da Serra;4214805;Rio do Sul;1;1;2;474
3534401;Osasco;4214805;Rio do Sul;1;1;2;494
3543402;Ribeirão Preto;4214805;Rio do Sul;1;1;2;696
3548807;São Caetano do Sul;4214805;Rio do Sul;1;1;2;500
4107538;Entre Rios do Oeste;4214805;Rio do Sul;1;1;2;533
4110706;Irati;4214805;Rio do Sul;1;1;2;219
4115200;Maringá;4214805;Rio do Sul;1;1;2;478
4115358;Maripá;4214805;Rio do Sul;1;1;2;518
4118204;Paranaguá;4214805;Rio do Sul;1;1;2;210
4118402;Paranavaí;4214805;Rio do Sul;1;1;2;535
4200705;Alfredo Wagner;4214805;Rio do Sul;1;1;2;58
4202602;Bom Retiro;4214805;Rio do Sul;1;1;2;63
4202800;Braço do Norte;4214805;Rio do Sul;1;1;2;123
4202859;Braço do Trombudo;4214805;Rio do Sul;1;1;2;33
4203204;Camboriú;4214805;Rio do Sul;1;1;2;93
4203600;Campos Novos;4214805;Rio do Sul;1;1;2;161
4203907;Capinzal;4214805;Rio do Sul;1;1;2;199
4204301;Concórdia;4214805;Rio do Sul;1;1;2;239
4205100;Dona Emma;4214805;Rio do Sul;1;1;2;30
4205506;Fraiburgo;4214805;Rio do Sul;1;1;2;132
4209003;Joaçaba;4214805;Rio do Sul;1;1;2;192
4209805;Leoberto Leal;4214805;Rio do Sul;1;1;2;44
4210852;Mirim Doce;4214805;Rio do Sul;1;1;2;46
4211108;Monte Castelo;4214805;Rio do Sul;1;1;2;106
4211751;Otacílio Costa;4214805;Rio do Sul;1;1;2;58
4211900;Palhoça;4214805;Rio do Sul;1;1;2;97
4212809;Piçarras;4214805;Rio do Sul;1;1;2;103
4212908;Pinhalzinho;4214805;Rio do Sul;1;1;2;337
4214102;Presidente Nereu;4214805;Rio do Sul;1;1;2;22
4214706;Rio dos Cedros;4214805;Rio do Sul;1;1;2;65
3534401;Osasco;4214706;Rio dos Cedros;1;1;2;431
4201307;Araquari;4214706;Rio dos Cedros;1;1;2;63
4205407;Florianópolis;4214706;Rio dos Cedros;1;1;2;121
4206900;Ibirama;4214706;Rio dos Cedros;1;1;2;43
4204806;Curitibanos;4214607;Rio do Oeste;1;1;2;80
4205407;Florianópolis;4214607;Rio do Oeste;1;1;2;135
4208500;Ituporanga;4214607;Rio do Oeste;1;1;2;31
4210001;Luiz Alves;4214607;Rio do Oeste;1;1;2;100
4202859;Braço do Trombudo;4214508;Rio do Campo;1;1;2;50
4204806;Curitibanos;4214508;Rio do Campo;1;1;2;58
4205407;Florianópolis;4214508;Rio do Campo;1;1;2;177
4206900;Ibirama;4214508;Rio do Campo;1;1;2;63
4210100;Mafra;4214508;Rio do Campo;1;1;2;94
4213708;Pouso Redondo;4214508;Rio do Campo;1;1;2;40
4203006;Caçador;4214409;Rio das Antas;1;1;2;11
4204202;Chapecó;4214409;Rio das Antas;1;1;2;156
4205407;Florianópolis;4214409;Rio das Antas;1;1;2;266
4205506;Fraiburgo;4214409;Rio das Antas;1;1;2;21
4208203;Itajaí;4214409;Rio das Antas;1;1;2;231
4213005;Pinheiro Preto;4214409;Rio das Antas;1;1;2;23
3304557;Rio de Janeiro;4214300;Rancho Queimado;1;1;2;769
3550308;São Paulo;4214300;Rancho Queimado;1;1;2;501
4200606;Águas Mornas;4214300;Rancho Queimado;1;1;2;17
4200705;Alfredo Wagner;4214300;Rancho Queimado;1;1;2;31
4200903;Angelina;4214300;Rancho Queimado;1;1;2;12
4204608;Criciúma;4214300;Rancho Queimado;1;1;2;116
4207007;Içara;4214300;Rancho Queimado;1;1;2;119
4211702;Orleans;4214300;Rancho Queimado;1;1;2;78
3534401;Osasco;4214201;Quilombo;1;1;2;681
4109807;Ibiporã;4214201;Quilombo;1;1;2;417
4202305;Biguaçu;4214201;Quilombo;1;1;2;410
4204806;Curitibanos;4214201;Quilombo;1;1;2;220
4205407;Florianópolis;4214201;Quilombo;1;1;2;431
4205605;Galvão;4214201;Quilombo;1;1;2;30
3534401;Osasco;4214003;Presidente Getúlio;1;1;2;478
3550308;São Paulo;4214003;Presidente Getúlio;1;1;2;476
4104501;Capanema;4214003;Presidente Getúlio;1;1;2;439
4106902;Curitiba;4214003;Presidente Getúlio;1;1;2;182
4200200;Agrolândia;4214003;Presidente Getúlio;1;1;2;45
4202602;Bom Retiro;4214003;Presidente Getúlio;1;1;2;84
4202909;Brusque;4214003;Presidente Getúlio;1;1;2;71
4203907;Capinzal;4214003;Presidente Getúlio;1;1;2;200
4204350;Cordilheira Alta;4214003;Presidente Getúlio;1;1;2;299
4205407;Florianópolis;4214003;Presidente Getúlio;1;1;2;125
4205902;Gaspar;4214003;Presidente Getúlio;1;1;2;67
4208500;Ituporanga;4214003;Presidente Getúlio;1;1;2;40
4208906;Jaraguá do Sul;4214003;Presidente Getúlio;1;1;2;83
4209151;José Boiteux;4214003;Presidente Getúlio;1;1;2;10
4204301;Concórdia;4213906;Presidente Castelo Branco;1;1;2;21
4205407;Florianópolis;4213906;Presidente Castelo Branco;1;1;2;329
3507506;Botucatu;4213807;Praia Grande;1;1;2;714
3516606;Gália;4213807;Praia Grande;1;1;2;766
4202073;Balneário Gaivota;4213807;Praia Grande;1;1;2;32
4204608;Criciúma;4213807;Praia Grande;1;1;2;81
4205407;Florianópolis;4213807;Praia Grande;1;1;2;225
3534401;Osasco;4213708;Pouso Redondo;1;1;2;514
4106308;Corbélia;4213708;Pouso Redondo;1;1;2;428
4202404;Blumenau;4213708;Pouso Redondo;1;1;2;91
4206900;Ibirama;4213708;Pouso Redondo;1;1;2;47
4209003;Joaçaba;4213708;Pouso Redondo;1;1;2;160
4209508;Laurentino;4213708;Pouso Redondo;1;1;2;20
4209904;Lontras;4213708;Pouso Redondo;1;1;2;40
4211603;Nova Veneza;4213708;Pouso Redondo;1;1;2;159
4211751;Otacílio Costa;4213708;Pouso Redondo;1;1;2;31
3531803;Monte Mor;4213609;Porto União;1;1;2;521
3534401;Osasco;4213609;Porto União;1;1;2;519
4106803;Cruz Machado;4213609;Porto União;1;1;2;43
4109401;Guarapuava;4213609;Porto União;1;1;2;107
4113908;Mallet;4213609;Porto União;1;1;2;50
4116950;Nova Esperança do Sudoeste;4213609;Porto União;1;1;2;225
4118204;Paranaguá;4213609;Porto União;1;1;2;259
4120309;Porto Vitória;4213609;Porto União;1;1;2;23
4120606;Prudentópolis;4213609;Porto União;1;1;2;118
4121505;Rebouças;4213609;Porto União;1;1;2;81
4125605;São Mateus do Sul;4213609;Porto União;1;1;2;82
4203808;Canoinhas;4213609;Porto União;1;1;2;63
4204301;Concórdia;4213609;Porto União;1;1;2;142
4208203;Itajaí;4213609;Porto União;1;1;2;241
4210100;Mafra;4213609;Porto União;1;1;2;121
4210704;Matos Costa;4213609;Porto União;1;1;2;23
3106200;Belo Horizonte;4213500;Porto Belo;1;1;2;918
3106705;Betim;4213500;Porto Belo;1;1;2;903
3202801;Itapemirim;4213500;Porto Belo;1;1;2;1006
3534401;Osasco;4213500;Porto Belo;1;1;2;438
3548500;Santos;4213500;Porto Belo;1;1;2;422
4202701;Botuverá;4213500;Porto Belo;1;1;2;49
4202909;Brusque;4213500;Porto Belo;1;1;2;34
4204202;Chapecó;4213500;Porto Belo;1;1;2;401
4204806;Curitibanos;4213500;Porto Belo;1;1;2;201
4205704;Garopaba;4213500;Porto Belo;1;1;2;97
4206306;Guabiruba;4213500;Porto Belo;1;1;2;42
4207106;Ilhota;4213500;Porto Belo;1;1;2;38
4210209;Major Gercino;4213500;Porto Belo;1;1;2;47
4211504;Nova Trento;4213500;Porto Belo;1;1;2;37
4212502;Penha;4213500;Porto Belo;1;1;2;40
4213302;Ponte Alta;4213500;Porto Belo;1;1;2;182
3534401;Osasco;4213401;Ponte Serrada;1;1;2;632
4101804;Araucária;4213401;Ponte Serrada;1;1;2;295
4108502;General Carneiro;4213401;Ponte Serrada;1;1;2;85
4204350;Cordilheira Alta;4213401;Ponte Serrada;1;1;2;63
4204806;Curitibanos;4213401;Ponte Serrada;1;1;2;148
4205407;Florianópolis;4213401;Ponte Serrada;1;1;2;358
4209003;Joaçaba;4213401;Ponte Serrada;1;1;2;56
4212270;Passos Maia;4213401;Ponte Serrada;1;1;2;11
4104907;Castro;4213351;Ponte Alta do Norte;1;1;2;266
4203253;Capão Alto;4213351;Ponte Alta do Norte;1;1;2;86
4205407;Florianópolis;4213351;Ponte Alta do Norte;1;1;2;199
4205506;Fraiburgo;4213351;Ponte Alta do Norte;1;1;2;48
4209300;Lages;4213351;Ponte Alta do Norte;1;1;2;73
4210308;Major Vieira;4213351;Ponte Alta do Norte;1;1;2;89
3205002;Serra;4213302;Ponte Alta;1;1;2;1265
4203402;Campo Belo do Sul;4213302;Ponte Alta;1;1;2;59
4205407;Florianópolis;4213302;Ponte Alta;1;1;2;185
4209003;Joaçaba;4213302;Ponte Alta;1;1;2;121
4209300;Lages;4213302;Ponte Alta;1;1;2;36
4211751;Otacílio Costa;4213302;Ponte Alta;1;1;2;25
2304400;Fortaleza;4213203;Pomerode;1;1;2;2731
2611606;Recife;4213203;Pomerode;1;1;2;2460
2930709;Simões Filho;4213203;Pomerode;1;1;2;1854
3118601;Contagem;4213203;Pomerode;1;1;2;902
3201704;Conceição do Castelo;4213203;Pomerode;1;1;2;1045
3304557;Rio de Janeiro;4213203;Pomerode;1;1;2;720
3504107;Atibaia;4213203;Pomerode;1;1;2;477
3506003;Bauru;4213203;Pomerode;1;1;2;488
3516200;Franca;4213203;Pomerode;1;1;2;708
3519055;Holambra;4213203;Pomerode;1;1;2;500
3529005;Marília;4213203;Pomerode;1;1;2;506
3529401;Mauá;4213203;Pomerode;1;1;2;432
3530300;Mirassol;4213203;Pomerode;1;1;2;657
3533403;Nova Odessa;4213203;Pomerode;1;1;2;477
3534401;Osasco;4213203;Pomerode;1;1;2;426
3543402;Ribeirão Preto;4213203;Pomerode;1;1;2;633
3543907;Rio Claro;4213203;Pomerode;1;1;2;505
3549805;São José do Rio Preto;4213203;Pomerode;1;1;2;656
3551702;Sertãozinho;4213203;Pomerode;1;1;2;631
4105805;Colombo;4213203;Pomerode;1;1;2;165
4113700;Londrina;4213203;Pomerode;1;1;2;428
4115200;Maringá;4213203;Pomerode;1;1;2;455
4204608;Criciúma;4213203;Pomerode;1;1;2;214
4206900;Ibirama;4213203;Pomerode;1;1;2;49
4208302;Itapema;4213203;Pomerode;1;1;2;66
4209300;Lages;4213203;Pomerode;1;1;2;165
4211306;Navegantes;4213203;Pomerode;1;1;2;52
4204103;Caxambu do Sul;4213153;Planalto Alegre;1;1;2;10
4206652;Guatambú;4213153;Planalto Alegre;1;1;2;12
4208203;Itajaí;4213153;Planalto Alegre;1;1;2;410
3515004;Embu;4213104;Piratuba;1;1;2;635
3550308;São Paulo;4213104;Piratuba;1;1;2;650
4205506;Fraiburgo;4213104;Piratuba;1;1;2;95
4206702;Herval d'Oeste;4213104;Piratuba;1;1;2;37
4209003;Joaçaba;4213104;Piratuba;1;1;2;38
2910800;Feira de Santana;4213005;Pinheiro Preto;1;1;2;2004
4203006;Caçador;4213005;Pinheiro Preto;1;1;2;31
4205407;Florianópolis;4213005;Pinheiro Preto;1;1;2;277
3516200;Franca;4212908;Pinhalzinho;1;1;2;884
3534401;Osasco;4212908;Pinhalzinho;1;1;2;710
4122800;Salgado Filho;4212908;Pinhalzinho;1;1;2;84
4127858;Três Barras do Paraná;4212908;Pinhalzinho;1;1;2;159
4200556;Águas Frias;4212908;Pinhalzinho;1;1;2;12
4202008;Balneário Camboriú;4212908;Pinhalzinho;1;1;2;429
4202404;Blumenau;4212908;Pinhalzinho;1;1;2;389
4202537;Bom Jesus;4212908;Pinhalzinho;1;1;2;59
4202578;Bom Jesus do Oeste;4212908;Pinhalzinho;1;1;2;20
4204301;Concórdia;4212908;Pinhalzinho;1;1;2;105
4204756;Cunhataí;4212908;Pinhalzinho;1;1;2;17
4204806;Curitibanos;4212908;Pinhalzinho;1;1;2;243
4207502;Indaial;4212908;Pinhalzinho;1;1;2;374
4212106;Palmitos;4212908;Pinhalzinho;1;1;2;29
2408102;Natal;4212809;Piçarras;1;1;2;2641
2507507;João Pessoa;4212809;Piçarras;1;1;2;2529
3525003;Jandira;4212809;Piçarras;1;1;2;400
3525904;Jundiaí;4212809;Piçarras;1;1;2;435
3527306;Louveira;4212809;Piçarras;1;1;2;443
3534401;Osasco;4212809;Piçarras;1;1;2;404
3550308;São Paulo;4212809;Piçarras;1;1;2;399
4125506;São José dos Pinhais;4212809;Piçarras;1;1;2;142
4201307;Araquari;4212809;Piçarras;1;1;2;43
4202206;Benedito Novo;4212809;Piçarras;1;1;2;65
4203204;Camboriú;4212809;Piçarras;1;1;2;30
4203808;Canoinhas;4212809;Piçarras;1;1;2;179
4204350;Cordilheira Alta;4212809;Piçarras;1;1;2;391
4204806;Curitibanos;4212809;Piçarras;1;1;2;196
4205803;Garuva;4212809;Piçarras;1;1;2;82
4208906;Jaraguá do Sul;4212809;Piçarras;1;1;2;47
4202404;Blumenau;4212700;Petrolândia;1;1;2;89
4204806;Curitibanos;4212700;Petrolândia;1;1;2;94
4205407;Florianópolis;4212700;Petrolândia;1;1;2;117
4205407;Florianópolis;4212601;Peritiba;1;1;2;336
4207601;Ipira;4212601;Peritiba;1;1;2;12
1500602;Altamira;4212502;Penha;1;1;2;2636
3131307;Ipatinga;4212502;Penha;1;1;2;1005
3152709;Prados;4212502;Penha;1;1;2;777
3303302;Niterói;4212502;Penha;1;1;2;696
3303500;Nova Iguaçu;4212502;Penha;1;1;2;677
3506003;Bauru;4212502;Penha;1;1;2;496
3513009;Cotia;4212502;Penha;1;1;2;393
3534401;Osasco;4212502;Penha;1;1;2;406
3550308;São Paulo;4212502;Penha;1;1;2;401
4101804;Araucária;4212502;Penha;1;1;2;153
4106902;Curitiba;4212502;Penha;1;1;2;164
4202008;Balneário Camboriú;4212502;Penha;1;1;2;21
4202909;Brusque;4212502;Penha;1;1;2;41
4203204;Camboriú;4212502;Penha;1;1;2;25
4204202;Chapecó;4212502;Penha;1;1;2;396
4205902;Gaspar;4212502;Penha;1;1;2;33
3556206;Valinhos;4212403;Pedras Grandes;1;1;2;641
4208203;Itajaí;4212403;Pedras Grandes;1;1;2;171
3550308;São Paulo;4212304;Paulo Lopes;1;1;2;516
4204608;Criciúma;4212304;Paulo Lopes;1;1;2;104
4205704;Garopaba;4212304;Paulo Lopes;1;1;2;8
4207304;Imbituba;4212304;Paulo Lopes;1;1;2;25
4210407;Maracajá;4212304;Paulo Lopes;1;1;2;124
3505708;Barueri;4212270;Passos Maia;1;1;2;624
4203006;Caçador;4212270;Passos Maia;1;1;2;96
4205308;Faxinal dos Guedes;4212270;Passos Maia;1;1;2;22
4205407;Florianópolis;4212254;Passo de Torres;1;1;2;219
4209409;Laguna;4212254;Passo de Torres;1;1;2;123
4204202;Chapecó;4212239;Paraíso;1;1;2;118
4204608;Criciúma;4212239;Paraíso;1;1;2;487
4206405;Guaraciaba;4212239;Paraíso;1;1;2;15
3534401;Osasco;4212205;Papanduva;1;1;2;456
3550308;São Paulo;4212205;Papanduva;1;1;2;458
4204301;Concórdia;4212205;Papanduva;1;1;2;210
4204806;Curitibanos;4212205;Papanduva;1;1;2;110
4206405;Guaraciaba;4212205;Papanduva;1;1;2;338
4207007;Içara;4212205;Papanduva;1;1;2;274
4209003;Joaçaba;4212205;Papanduva;1;1;2;165
2602902;Cabo de Santo Agostinho;4212106;Palmitos;1;1;2;2688
3525904;Jundiaí;4212106;Palmitos;1;1;2;747
3534401;Osasco;4212106;Palmitos;1;1;2;735
4115408;Marmeleiro;4212106;Palmitos;1;1;2;102
4204202;Chapecó;4212106;Palmitos;1;1;2;52
4204806;Curitibanos;4212106;Palmitos;1;1;2;254
4205001;Dionísio Cerqueira;4212106;Palmitos;1;1;2;100
4207007;Içara;4212106;Palmitos;1;1;2;427
4207106;Ilhota;4212106;Palmitos;1;1;2;429
3115300;Cataguases;4212056;Palmeira;1;1;2;996
3301702;Duque de Caxias;4212056;Palmeira;1;1;2;851
3509254;Cajati;4212056;Palmeira;1;1;2;374
3552502;Suzano;4212056;Palmeira;1;1;2;583
4204558;Correia Pinto;4212056;Palmeira;1;1;2;20
4204806;Curitibanos;4212056;Palmeira;1;1;2;56
4205407;Florianópolis;4212056;Palmeira;1;1;2;162
4211751;Otacílio Costa;4212056;Palmeira;1;1;2;12
4104501;Capanema;4212007;Palma Sola;1;1;2;90
4114351;Manfrinópolis;4212007;Palma Sola;1;1;2;23
4118501;Pato Branco;4212007;Palma Sola;1;1;2;63
4124806;São João;4212007;Palma Sola;1;1;2;80
4200804;Anchieta;4212007;Palma Sola;1;1;2;21
4205407;Florianópolis;4212007;Palma Sola;1;1;2;497
4206405;Guaraciaba;4212007;Palma Sola;1;1;2;37
1302603;Manaus;4211900;Palhoça;1;1;2;2910
2304400;Fortaleza;4211900;Palhoça;1;1;2;2807
3300100;Angra dos Reis;4211900;Palhoça;1;1;2;678
3301603;Duas Barras;4211900;Palhoça;1;1;2;863
3502903;Araçoiaba da Serra;4211900;Palhoça;1;1;2;472
3509502;Campinas;4211900;Palhoça;1;1;2;551
3513009;Cotia;4211900;Palhoça;1;1;2;482
3515004;Embu;4211900;Palhoça;1;1;2;480
3518701;Guarujá;4211900;Palhoça;1;1;2;474
3522505;Itapevi;4211900;Palhoça;1;1;2;487
3524709;Jaguariúna;4211900;Palhoça;1;1;2;573
3530607;Moji das Cruzes;4211900;Palhoça;1;1;2;516
3533403;Nova Odessa;4211900;Palhoça;1;1;2;559
3545209;Salto;4211900;Palhoça;1;1;2;512
3547304;Santana de Parnaíba;4211900;Palhoça;1;1;2;498
3548906;São Carlos;4211900;Palhoça;1;1;2;628
3554003;Tatuí;4211900;Palhoça;1;1;2;484
4100400;Almirante Tamandaré;4211900;Palhoça;1;1;2;263
4105805;Colombo;4211900;Palhoça;1;1;2;270
4107652;Fazenda Rio Grande;4211900;Palhoça;1;1;2;227
4115200;Maringá;4211900;Palhoça;1;1;2;560
4200606;Águas Mornas;4211900;Palhoça;1;1;2;12
4200705;Alfredo Wagner;4211900;Palhoça;1;1;2;59
4201901;Aurora;4211900;Palhoça;1;1;2;96
4202453;Bombinhas;4211900;Palhoça;1;1;2;60
4203204;Camboriú;4211900;Palhoça;1;1;2;69
4204004;Catanduvas;4211900;Palhoça;1;1;2;297
4204301;Concórdia;4211900;Palhoça;1;1;2;326
4204350;Cordilheira Alta;4211900;Palhoça;1;1;2;391
4204806;Curitibanos;4211900;Palhoça;1;1;2;188
4207106;Ilhota;4211900;Palhoça;1;1;2;83
4208500;Ituporanga;4211900;Palhoça;1;1;2;89
4209508;Laurentino;4211900;Palhoça;1;1;2;109
4211306;Navegantes;4211900;Palhoça;1;1;2;86
4205407;Florianópolis;4211892;Painel;1;1;2;160
4209300;Lages;4211892;Painel;1;1;2;27
4204202;Chapecó;4211876;Paial;1;1;2;20
4204301;Concórdia;4211876;Paial;1;1;2;48
4204350;Cordilheira Alta;4211876;Paial;1;1;2;33
4104303;Campo Mourão;4211850;Ouro Verde;1;1;2;294
4106902;Curitiba;4211850;Ouro Verde;1;1;2;330
4114401;Mangueirinha;4211850;Ouro Verde;1;1;2;85
4204459;Coronel Martins;4211850;Ouro Verde;1;1;2;41
4205175;Entre Rios;4211850;Ouro Verde;1;1;2;27
4209003;Joaçaba;4211850;Ouro Verde;1;1;2;92
4203006;Caçador;4211801;Ouro;1;1;2;79
4204301;Concórdia;4211801;Ouro;1;1;2;39
4206702;Herval d'Oeste;4211801;Ouro;1;1;2;20
4207601;Ipira;4211801;Ouro;1;1;2;15
3205309;Vitória;4211751;Otacílio Costa;1;1;2;1237
3304557;Rio de Janeiro;4211751;Otacílio Costa;1;1;2;838
3518800;Guarulhos;4211751;Otacílio Costa;1;1;2;566
3547809;Santo André;4211751;Otacílio Costa;1;1;2;550
3548500;Santos;4211751;Otacílio Costa;1;1;2;541
4101804;Araucária;4211751;Otacílio Costa;1;1;2;222
4106209;Contenda;4211751;Otacílio Costa;1;1;2;208
4200200;Agrolândia;4211751;Otacílio Costa;1;1;2;30
4201000;Anita Garibaldi;4211751;Otacílio Costa;1;1;2;102
4201257;Apiúna;4211751;Otacílio Costa;1;1;2;88
4202008;Balneário Camboriú;4211751;Otacílio Costa;1;1;2;152
4203253;Capão Alto;4211751;Otacílio Costa;1;1;2;63
4203402;Campo Belo do Sul;4211751;Otacílio Costa;1;1;2;78
4204152;Celso Ramos;4211751;Otacílio Costa;1;1;2;121
4204301;Concórdia;4211751;Otacílio Costa;1;1;2;189
4205407;Florianópolis;4211751;Otacílio Costa;1;1;2;159
4208302;Itapema;4211751;Otacílio Costa;1;1;2;152
4208500;Ituporanga;4211751;Otacílio Costa;1;1;2;52
4209904;Lontras;4211751;Otacílio Costa;1;1;2;67
2704302;Maceió;4211702;Orleans;1;1;2;2420
3512407;Cordeirópolis;4211702;Orleans;1;1;2;672
3516200;Franca;4211702;Orleans;1;1;2;882
3534401;Osasco;4211702;Orleans;1;1;2;584
4202404;Blumenau;4211702;Orleans;1;1;2;155
4203956;Capivari de Baixo;4211702;Orleans;1;1;2;37
4204806;Curitibanos;4211702;Orleans;1;1;2;172
4205407;Florianópolis;4211702;Orleans;1;1;2;113
4206108;Grão Pará;4211702;Orleans;1;1;2;17
4209102;Joinville;4211702;Orleans;1;1;2;231
1100122;Ji-Paraná;4211603;Nova Veneza;1;1;2;2270
1400100;Boa Vista;4211603;Nova Veneza;1;1;2;3634
1505536;Parauapebas;4211603;Nova Veneza;1;1;2;2504
1600303;Macapá;4211603;Nova Veneza;1;1;2;3179
1721000;Palmas;4211603;Nova Veneza;1;1;2;2026
2105302;Imperatriz;4211603;Nova Veneza;1;1;2;2566
2408003;Mossoró;4211603;Nova Veneza;1;1;2;2825
2503209;Cabedelo;4211603;Nova Veneza;1;1;2;2742
2504009;Campina Grande;4211603;Nova Veneza;1;1;2;2681
2604106;Caruaru;4211603;Nova Veneza;1;1;2;2573
2910800;Feira de Santana;4211603;Nova Veneza;1;1;2;2056
3118601;Contagem;4211603;Nova Veneza;1;1;2;1093
3170206;Uberlândia;4211603;Nova Veneza;1;1;2;1084
3205309;Vitória;4211603;Nova Veneza;1;1;2;1272
3304557;Rio de Janeiro;4211603;Nova Veneza;1;1;2;872
3502804;Araçatuba;4211603;Nova Veneza;1;1;2;826
3506003;Bauru;4211603;Nova Veneza;1;1;2;699
3509502;Campinas;4211603;Nova Veneza;1;1;2;677
3525904;Jundiaí;4211603;Nova Veneza;1;1;2;654
3529005;Marília;4211603;Nova Veneza;1;1;2;712
3534401;Osasco;4211603;Nova Veneza;1;1;2;622
3541406;Presidente Prudente;4211603;Nova Veneza;1;1;2;743
3543402;Ribeirão Preto;4211603;Nova Veneza;1;1;2;845
3549805;São José do Rio Preto;4211603;Nova Veneza;1;1;2;865
3550308;São Paulo;4211603;Nova Veneza;1;1;2;616
3552205;Sorocaba;4211603;Nova Veneza;1;1;2;602
4104808;Cascavel;4211603;Nova Veneza;1;1;2;559
4108304;Foz do Iguaçu;4211603;Nova Veneza;1;1;2;594
4115200;Maringá;4211603;Nova Veneza;1;1;2;622
4119905;Ponta Grossa;4211603;Nova Veneza;1;1;2;397
4125506;São José dos Pinhais;4211603;Nova Veneza;1;1;2;345
4201406;Araranguá;4211603;Nova Veneza;1;1;2;34
4202008;Balneário Camboriú;4211603;Nova Veneza;1;1;2;199
4202404;Blumenau;4211603;Nova Veneza;1;1;2;191
4204251;Cocal do Sul;4211603;Nova Veneza;1;1;2;17
4204806;Curitibanos;4211603;Nova Veneza;1;1;2;185
4205456;Forquilhinha;4211603;Nova Veneza;1;1;2;12
4208203;Itajaí;4211603;Nova Veneza;1;1;2;201
4208906;Jaraguá do Sul;4211603;Nova Veneza;1;1;2;242
4209607;Lauro Muller;4211603;Nova Veneza;1;1;2;29
4210803;Meleiro;4211603;Nova Veneza;1;1;2;25
3106200;Belo Horizonte;4211504;Nova Trento;1;1;2;947
3516200;Franca;4211504;Nova Trento;1;1;2;761
3534401;Osasco;4211504;Nova Trento;1;1;2;465
4103701;Cambé;4211504;Nova Trento;1;1;2;497
4202008;Balneário Camboriú;4211504;Nova Trento;1;1;2;41
4202701;Botuverá;4211504;Nova Trento;1;1;2;17
4204806;Curitibanos;4211504;Nova Trento;1;1;2;166
4208906;Jaraguá do Sul;4211504;Nova Trento;1;1;2;90
4209102;Joinville;4211504;Nova Trento;1;1;2;112
4204103;Caxambu do Sul;4211454;Nova Itaberaba;1;1;2;25
4204301;Concórdia;4211454;Nova Itaberaba;1;1;2;85
4204806;Curitibanos;4211454;Nova Itaberaba;1;1;2;223
4204806;Curitibanos;4211405;Nova Erechim;1;1;2;233
4205407;Florianópolis;4211405;Nova Erechim;1;1;2;444
1501402;Belém;4211306;Navegantes;1;1;2;2821
2611606;Recife;4211306;Navegantes;1;1;2;2446
2704302;Maceió;4211306;Navegantes;1;1;2;2265
3143302;Montes Claros;4211306;Navegantes;1;1;2;1214
3205002;Serra;4211306;Navegantes;1;1;2;1102
3300100;Angra dos Reis;4211306;Navegantes;1;1;2;613
3501608;Americana;4211306;Navegantes;1;1;2;477
3508504;Caçapava;4211306;Navegantes;1;1;2;509
3509502;Campinas;4211306;Navegantes;1;1;2;468
3513801;Diadema;4211306;Navegantes;1;1;2;408
3515004;Embu;4211306;Navegantes;1;1;2;400
3518701;Guarujá;4211306;Navegantes;1;1;2;401
3521150;Ipiguá;4211306;Navegantes;1;1;2;694
3525003;Jandira;4211306;Navegantes;1;1;2;410
3525904;Jundiaí;4211306;Navegantes;1;1;2;445
3534401;Osasco;4211306;Navegantes;1;1;2;414
4101804;Araucária;4211306;Navegantes;1;1;2;160
4110953;Itaipulândia;4211306;Navegantes;1;1;2;587
4113700;Londrina;4211306;Navegantes;1;1;2;465
4127106;Telêmaco Borba;4211306;Navegantes;1;1;2;340
4201307;Araquari;4211306;Navegantes;1;1;2;57
4202107;Barra Velha;4211306;Navegantes;1;1;2;28
4202206;Benedito Novo;4211306;Navegantes;1;1;2;70
4204806;Curitibanos;4211306;Navegantes;1;1;2;197
4205100;Dona Emma;4211306;Navegantes;1;1;2;105
4206009;Governador Celso Ramos;4211306;Navegantes;1;1;2;50
4207106;Ilhota;4211306;Navegantes;1;1;2;15
4201406;Araranguá;4211256;Morro Grande;1;1;2;28
2504009;Campina Grande;4211207;Morro da Fumaça;1;1;2;2670
2601904;Bezerros;4211207;Morro da Fumaça;1;1;2;2575
2803609;Laranjeiras;4211207;Morro da Fumaça;1;1;2;2267
3516200;Franca;4211207;Morro da Fumaça;1;1;2;914
3518800;Guarulhos;4211207;Morro da Fumaça;1;1;2;631
3534401;Osasco;4211207;Morro da Fumaça;1;1;2;612
4105201;Cerro Azul;4211207;Morro da Fumaça;1;1;2;424
4202800;Braço do Norte;4211207;Morro da Fumaça;1;1;2;42
4203956;Capivari de Baixo;4211207;Morro da Fumaça;1;1;2;34
4204251;Cocal do Sul;4211207;Morro da Fumaça;1;1;2;13
4204707;Cunha Porã;4211207;Morro da Fumaça;1;1;2;430
4205407;Florianópolis;4211207;Morro da Fumaça;1;1;2;135
4206108;Grão Pará;4211207;Morro da Fumaça;1;1;2;52
4208807;Jaguaruna;4211207;Morro da Fumaça;1;1;2;18
4208906;Jaraguá do Sul;4211207;Morro da Fumaça;1;1;2;241
4209102;Joinville;4211207;Morro da Fumaça;1;1;2;265
4209607;Lauro Muller;4211207;Morro da Fumaça;1;1;2;34
4106902;Curitiba;4211108;Monte Castelo;1;1;2;147
4204301;Concórdia;4211108;Monte Castelo;1;1;2;197
4204806;Curitibanos;4211108;Monte Castelo;1;1;2;97
4205407;Florianópolis;4211108;Monte Castelo;1;1;2;213
4209003;Joaçaba;4211108;Monte Castelo;1;1;2;152
4209102;Joinville;4211108;Monte Castelo;1;1;2;138
4210001;Luiz Alves;4211108;Monte Castelo;1;1;2;133
3550308;São Paulo;4211058;Monte Carlo;1;1;2;579
4203006;Caçador;4211058;Monte Carlo;1;1;2;48
4204301;Concórdia;4211058;Monte Carlo;1;1;2;103
4204558;Correia Pinto;4211058;Monte Carlo;1;1;2;73
4204806;Curitibanos;4211058;Monte Carlo;1;1;2;38
4208203;Itajaí;4211058;Monte Carlo;1;1;2;223
4209003;Joaçaba;4211058;Monte Carlo;1;1;2;57
1302603;Manaus;4211009;Mondaí;1;1;2;2723
3534401;Osasco;4211009;Mondaí;1;1;2;761
4204202;Chapecó;4211009;Mondaí;1;1;2;82
4204707;Cunha Porã;4211009;Mondaí;1;1;2;36
4204806;Curitibanos;4211009;Mondaí;1;1;2;283
4204905;Descanso;4211009;Mondaí;1;1;2;30
4205407;Florianópolis;4211009;Mondaí;1;1;2;493
4208401;Itapiranga;4211009;Mondaí;1;1;2;27
3550308;São Paulo;4210902;Modelo;1;1;2;718
4202578;Bom Jesus do Oeste;4210902;Modelo;1;1;2;11
4203501;Campo Erê;4210902;Modelo;1;1;2;43
4205407;Florianópolis;4210902;Modelo;1;1;2;462
4200309;Agronômica;4210852;Mirim Doce;1;1;2;35
4201703;Ascurra;4210852;Mirim Doce;1;1;2;72
4202404;Blumenau;4210852;Mirim Doce;1;1;2;103
4205902;Gaspar;4210852;Mirim Doce;1;1;2;114
3507902;Brotas;4210803;Meleiro;1;1;2;739
3522406;Itapeva;4210803;Meleiro;1;1;2;542
3542602;Registro;4210803;Meleiro;1;1;2;506
3550308;São Paulo;4210803;Meleiro;1;1;2;640
4125506;São José dos Pinhais;4210803;Meleiro;1;1;2;367
4201406;Araranguá;4210803;Meleiro;1;1;2;19
4204608;Criciúma;4210803;Meleiro;1;1;2;31
4204806;Curitibanos;4210803;Meleiro;1;1;2;196
4205407;Florianópolis;4210803;Meleiro;1;1;2;175
4205456;Forquilhinha;4210803;Meleiro;1;1;2;18
4208708;Jacinto Machado;4210803;Meleiro;1;1;2;22
4208906;Jaraguá do Sul;4210803;Meleiro;1;1;2;266
4108502;General Carneiro;4210704;Matos Costa;1;1;2;17
4203006;Caçador;4210704;Matos Costa;1;1;2;37
4205407;Florianópolis;4210704;Matos Costa;1;1;2;291
3529005;Marília;4210605;Massaranduba;1;1;2;495
3534401;Osasco;4210605;Massaranduba;1;1;2;405
3537156;Pedrinhas Paulista;4210605;Massaranduba;1;1;2;455
3550308;São Paulo;4210605;Massaranduba;1;1;2;401
3551702;Sertãozinho;4210605;Massaranduba;1;1;2;614
4106902;Curitiba;4210605;Massaranduba;1;1;2;133
4115200;Maringá;4210605;Massaranduba;1;1;2;454
4119905;Ponta Grossa;4210605;Massaranduba;1;1;2;202
4125506;São José dos Pinhais;4210605;Massaranduba;1;1;2;120
4204806;Curitibanos;4210605;Massaranduba;1;1;2;175
4207502;Indaial;4210605;Massaranduba;1;1;2;39
4208104;Itaiópolis;4210605;Massaranduba;1;1;2;94
4204202;Chapecó;4210555;Marema;1;1;2;34
4205407;Florianópolis;4210555;Marema;1;1;2;419
1200401;Rio Branco;4210506;Maravilha;1;1;2;2317
3303302;Niterói;4210506;Maravilha;1;1;2;1076
3516200;Franca;4210506;Maravilha;1;1;2;888
3534401;Osasco;4210506;Maravilha;1;1;2;721
4102604;Barracão;4210506;Maravilha;1;1;2;74
4106902;Curitiba;4210506;Maravilha;1;1;2;411
4108403;Francisco Beltrão;4210506;Maravilha;1;1;2;76
4109401;Guarapuava;4210506;Maravilha;1;1;2;228
4116950;Nova Esperança do Sudoeste;4210506;Maravilha;1;1;2;95
4127700;Toledo;4210506;Maravilha;1;1;2;233
4200507;Águas de Chapecó;4210506;Maravilha;1;1;2;39
4203006;Caçador;4210506;Maravilha;1;1;2;207
4204301;Concórdia;4210506;Maravilha;1;1;2;126
4204350;Cordilheira Alta;4210506;Maravilha;1;1;2;58
4204806;Curitibanos;4210506;Maravilha;1;1;2;262
4207650;Iporã do Oeste;4210506;Maravilha;1;1;2;44
4208401;Itapiranga;4210506;Maravilha;1;1;2;70
2504009;Campina Grande;4210407;Maracajá;1;1;2;2698
4105508;Cianorte;4210407;Maracajá;1;1;2;648
4125506;São José dos Pinhais;4210407;Maracajá;1;1;2;367
4202800;Braço do Norte;4210407;Maracajá;1;1;2;69
4204251;Cocal do Sul;4210407;Maracajá;1;1;2;30
4205407;Florianópolis;4210407;Maracajá;1;1;2;166
4209409;Laguna;4210407;Maracajá;1;1;2;73
3550308;São Paulo;4210308;Major Vieira;1;1;2;471
4108403;Francisco Beltrão;4210308;Major Vieira;1;1;2;274
4118709;Paulo Frontin;4210308;Major Vieira;1;1;2;62
4122305;Rio Negro;4210308;Major Vieira;1;1;2;60
4202800;Braço do Norte;4210308;Major Vieira;1;1;2;242
4204301;Concórdia;4210308;Major Vieira;1;1;2;194
4204806;Curitibanos;4210308;Major Vieira;1;1;2;104
4205407;Florianópolis;4210308;Major Vieira;1;1;2;227
4208104;Itaiópolis;4210308;Major Vieira;1;1;2;42
4209003;Joaçaba;4210308;Major Vieira;1;1;2;149
4106902;Curitiba;4210209;Major Gercino;1;1;2;222
4202701;Botuverá;4210209;Major Gercino;1;1;2;27
4205407;Florianópolis;4210209;Major Gercino;1;1;2;47
3509502;Campinas;4210100;Mafra;1;1;2;452
3516200;Franca;4210100;Mafra;1;1;2;664
3534401;Osasco;4210100;Mafra;1;1;2;418
3547809;Santo André;4210100;Mafra;1;1;2;428
4101507;Arapongas;4210100;Mafra;1;1;2;341
4104204;Campo Largo;4210100;Mafra;1;1;2;82
4104907;Castro;4210100;Mafra;1;1;2;152
4107652;Fazenda Rio Grande;4210100;Mafra;1;1;2;75
4108403;Francisco Beltrão;4210100;Mafra;1;1;2;322
4113908;Mallet;4210100;Mafra;1;1;2;102
4117701;Palmeira;4210100;Mafra;1;1;2;81
4118204;Paranaguá;4210100;Mafra;1;1;2;142
4120606;Prudentópolis;4210100;Mafra;1;1;2;157
4202131;Bela Vista do Toldo;4210100;Mafra;1;1;2;64
4202404;Blumenau;4210100;Mafra;1;1;2;118
4203204;Camboriú;4210100;Mafra;1;1;2;151
4203600;Campos Novos;4210100;Mafra;1;1;2;198
4205506;Fraiburgo;4210100;Mafra;1;1;2;146
4208302;Itapema;4210100;Mafra;1;1;2;160
4208500;Ituporanga;4210100;Mafra;1;1;2;143
4203006;Caçador;4210050;Macieira;1;1;2;29
4208203;Itajaí;4210050;Macieira;1;1;2;261
3534708;Ourinhos;4210035;Luzerna;1;1;2;485
3550308;São Paulo;4210035;Luzerna;1;1;2;610
4101804;Araucária;4210035;Luzerna;1;1;2;267
4106902;Curitiba;4210035;Luzerna;1;1;2;286
4128203;União da Vitória;4210035;Luzerna;1;1;2;100
4202404;Blumenau;4210035;Luzerna;1;1;2;240
4203006;Caçador;4210035;Luzerna;1;1;2;54
4204202;Chapecó;4210035;Luzerna;1;1;2;112
4209102;Joinville;4210035;Luzerna;1;1;2;276
3143302;Montes Claros;4210001;Luiz Alves;1;1;2;1208
3550308;São Paulo;4210001;Luiz Alves;1;1;2;407
4200101;Abelardo Luz;4210001;Luiz Alves;1;1;2;338
4200200;Agrolândia;4210001;Luiz Alves;1;1;2;117
4202107;Barra Velha;4210001;Luiz Alves;1;1;2;23
4203600;Campos Novos;4210001;Luiz Alves;1;1;2;241
4204806;Curitibanos;4210001;Luiz Alves;1;1;2;177
4205407;Florianópolis;4210001;Luiz Alves;1;1;2;105
4205803;Garuva;4210001;Luiz Alves;1;1;2;77
4207106;Ilhota;4210001;Luiz Alves;1;1;2;22
4208203;Itajaí;4210001;Luiz Alves;1;1;2;30
4208500;Ituporanga;4210001;Luiz Alves;1;1;2;102
3151800;Poços de Caldas;4209904;Lontras;1;1;2;665
3500402;Águas da Prata;4209904;Lontras;1;1;2;641
3534401;Osasco;4209904;Lontras;1;1;2;484
3550308;São Paulo;4209904;Lontras;1;1;2;481
4115200;Maringá;4209904;Lontras;1;1;2;475
4202909;Brusque;4209904;Lontras;1;1;2;63
4204806;Curitibanos;4209904;Lontras;1;1;2;106
4205407;Florianópolis;4209904;Lontras;1;1;2;112
4209151;José Boiteux;4209904;Lontras;1;1;2;25
4104808;Cascavel;4209854;Lindóia do Sul;1;1;2;271
4205407;Florianópolis;4209854;Lindóia do Sul;1;1;2;358
4204806;Curitibanos;4209805;Leoberto Leal;1;1;2;132
4205407;Florianópolis;4209805;Leoberto Leal;1;1;2;77
4207403;Imbuia;4209805;Leoberto Leal;1;1;2;14
3534401;Osasco;4209706;Lebon Régis;1;1;2;536
3550308;São Paulo;4209706;Lebon Régis;1;1;2;537
2304400;Fortaleza;4209607;Lauro Muller;1;1;2;2902
2408003;Mossoró;4209607;Lauro Muller;1;1;2;2798
2507507;João Pessoa;4209607;Lauro Muller;1;1;2;2703
2905701;Camaçari;4209607;Lauro Muller;1;1;2;2020
3534401;Osasco;4209607;Lauro Muller;1;1;2;594
3546702;Santa Gertrudes;4209607;Lauro Muller;1;1;2;681
3550308;São Paulo;4209607;Lauro Muller;1;1;2;588
4202800;Braço do Norte;4209607;Lauro Muller;1;1;2;26
4203956;Capivari de Baixo;4209607;Lauro Muller;1;1;2;43
4204707;Cunha Porã;4209607;Lauro Muller;1;1;2;403
4205407;Florianópolis;4209607;Lauro Muller;1;1;2;123
4207007;Içara;4209607;Lauro Muller;1;1;2;38
3550308;São Paulo;4209508;Laurentino;1;1;2;496
4202404;Blumenau;4209508;Laurentino;1;1;2;71
4204806;Curitibanos;4209508;Laurentino;1;1;2;86
4205407;Florianópolis;4209508;Laurentino;1;1;2;128
4104808;Cascavel;4209458;Lajeado Grande;1;1;2;229
4204202;Chapecó;4209458;Lajeado Grande;1;1;2;29
2927408;Salvador;4209409;Laguna;1;1;2;1966
3516200;Franca;4209409;Laguna;1;1;2;889
3534401;Osasco;4209409;Laguna;1;1;2;581
3548500;Santos;4209409;Laguna;1;1;2;560
3550308;São Paulo;4209409;Laguna;1;1;2;574
4119152;Pinhais;4209409;Laguna;1;1;2;337
4201406;Araranguá;4209409;Laguna;1;1;2;83
4204806;Curitibanos;4209409;Laguna;1;1;2;218
4206207;Gravatal;4209409;Laguna;1;1;2;26
4208203;Itajaí;4209409;Laguna;1;1;2;170
4208906;Jaraguá do Sul;4209409;Laguna;1;1;2;222
4209102;Joinville;4209409;Laguna;1;1;2;243
1703073;Barra do Ouro;4209300;Lages;1;1;2;2236
3107307;Bocaiúva;4209300;Lages;1;1;2;1333
3156908;Sacramento;4209300;Lages;1;1;2;922
3301702;Duque de Caxias;4209300;Lages;1;1;2;878
3501608;Americana;4209300;Lages;1;1;2;631
3504909;Bananal;4209300;Lages;1;1;2;811
3509205;Cajamar;4209300;Lages;1;1;2;595
3509502;Campinas;4209300;Lages;1;1;2;629
3521408;Iracemápolis;4209300;Lages;1;1;2;639
3524709;Jaguariúna;4209300;Lages;1;1;2;651
3547304;Santana de Parnaíba;4209300;Lages;1;1;2;585
3547809;Santo André;4209300;Lages;1;1;2;590
3552205;Sorocaba;4209300;Lages;1;1;2;552
4101606;Arapoti;4209300;Lages;1;1;2;407
4107652;Fazenda Rio Grande;4209300;Lages;1;1;2;258
4108403;Francisco Beltrão;4209300;Lages;1;1;2;327
4109401;Guarapuava;4209300;Lages;1;1;2;289
4116950;Nova Esperança do Sudoeste;4209300;Lages;1;1;2;355
4119400;Piraí do Sul;4209300;Lages;1;1;2;362
4127106;Telêmaco Borba;4209300;Lages;1;1;2;382
4200705;Alfredo Wagner;4209300;Lages;1;1;2;99
4201000;Anita Garibaldi;4209300;Lages;1;1;2;79
4202305;Biguaçu;4209300;Lages;1;1;2;164
4202701;Botuverá;4209300;Lages;1;1;2;141
4202909;Brusque;4209300;Lages;1;1;2;161
4203204;Camboriú;4209300;Lages;1;1;2;182
4203402;Campo Belo do Sul;4209300;Lages;1;1;2;43
4206900;Ibirama;4209300;Lages;1;1;2;115
4205407;Florianópolis;4209201;Lacerdópolis;1;1;2;306
4209003;Joaçaba;4209201;Lacerdópolis;1;1;2;13
4205431;Formosa do Sul;4209177;Jupiá;1;1;2;28
4205605;Galvão;4209177;Jupiá;1;1;2;8
4202008;Balneário Camboriú;4209151;José Boiteux;1;1;2;94
4202404;Blumenau;4209151;José Boiteux;1;1;2;55
4205407;Florianópolis;4209151;José Boiteux;1;1;2;131
4207502;Indaial;4209151;José Boiteux;1;1;2;40
1100205;Porto Velho;4209102;Joinville;1;1;2;2405
1500800;Ananindeua;4209102;Joinville;1;1;2;2756
1501402;Belém;4209102;Joinville;1;1;2;2755
1503606;Itaituba;4209102;Joinville;1;1;2;2531
2307650;Maracanaú;4209102;Joinville;1;1;2;2662
2312908;Sobral;4209102;Joinville;1;1;2;2627
2403251;Parnamirim;4209102;Joinville;1;1;2;2595
2408102;Natal;4209102;Joinville;1;1;2;2605
2507507;João Pessoa;4209102;Joinville;1;1;2;2495
2609600;Olinda;4209102;Joinville;1;1;2;2418
2704302;Maceió;4209102;Joinville;1;1;2;2224
2901106;Amélia Rodrigues;4209102;Joinville;1;1;2;1814
2910800;Feira de Santana;4209102;Joinville;1;1;2;1815
2919207;Lauro de Freitas;4209102;Joinville;1;1;2;1793
2930709;Simões Filho;4209102;Joinville;1;1;2;1798
3127701;Governador Valadares;4209102;Joinville;1;1;2;1063
3128303;Guaranésia;4209102;Joinville;1;1;2;587
3136702;Juiz de Fora;4209102;Joinville;1;1;2;738
3144805;Nova Lima;4209102;Joinville;1;1;2;848
3170701;Varginha;4209102;Joinville;1;1;2;628
3201209;Cachoeiro de Itapemirim;4209102;Joinville;1;1;2;971
3201308;Cariacica;4209102;Joinville;1;1;2;1058
3202405;Guarapari;4209102;Joinville;1;1;2;1024
3205002;Serra;4209102;Joinville;1;1;2;1077
3205101;Viana;4209102;Joinville;1;1;2;1039
3205200;Vila Velha;4209102;Joinville;1;1;2;1059
3303302;Niterói;4209102;Joinville;1;1;2;681
3303500;Nova Iguaçu;4209102;Joinville;1;1;2;659
3304201;Resende;4209102;Joinville;1;1;2;602
3304904;São Gonçalo;4209102;Joinville;1;1;2;690
3500709;Agudos;4209102;Joinville;1;1;2;421
3506003;Bauru;4209102;Joinville;1;1;2;437
3507605;Bragança Paulista;4209102;Joinville;1;1;2;434
3510401;Capivari;4209102;Joinville;1;1;2;388
3511508;Cerquilho;4209102;Joinville;1;1;2;362
3513108;Cravinhos;4209102;Joinville;1;1;2;558
3515707;Ferraz de Vasconcelos;4209102;Joinville;1;1;2;391
3518404;Guaratinguetá;4209102;Joinville;1;1;2;528
3522208;Itapecerica da Serra;4209102;Joinville;1;1;2;347
3522505;Itapevi;4209102;Joinville;1;1;2;357
3523909;Itu;4209102;Joinville;1;1;2;366
3524402;Jacareí;4209102;Joinville;1;1;2;436
3526902;Limeira;4209102;Joinville;1;1;2;436
3527207;Lorena;4209102;Joinville;1;1;2;541
3527306;Louveira;4209102;Joinville;1;1;2;402
3528403;Mairinque;4209102;Joinville;1;1;2;345
3530607;Moji das Cruzes;4209102;Joinville;1;1;2;401
3539806;Poá;4209102;Joinville;1;1;2;394
3545209;Salto;4209102;Joinville;1;1;2;375
3545803;Santa Bárbara d'Oeste;4209102;Joinville;1;1;2;416
3548906;São Carlos;4209102;Joinville;1;1;2;481
3552502;Suzano;4209102;Joinville;1;1;2;394
3554102;Taubaté;4209102;Joinville;1;1;2;486
3557006;Votorantim;4209102;Joinville;1;1;2;338
4101507;Arapongas;4209102;Joinville;1;1;2;407
4103701;Cambé;4209102;Joinville;1;1;2;407
4104253;Campo Magro;4209102;Joinville;1;1;2;117
4105508;Cianorte;4209102;Joinville;1;1;2;469
4108403;Francisco Beltrão;4209102;Joinville;1;1;2;419
4108809;Guaíra;4209102;Joinville;1;1;2;584
4114203;Mandaguari;4209102;Joinville;1;1;2;412
4114609;Marechal Cândido Rondon;4209102;Joinville;1;1;2;550
4115705;Matinhos;4209102;Joinville;1;1;2;59
4122404;Rolândia;4209102;Joinville;1;1;2;412
4124020;Santa Tereza do Oeste;4209102;Joinville;1;1;2;493
4127106;Telêmaco Borba;4209102;Joinville;1;1;2;278
4128203;União da Vitória;4209102;Joinville;1;1;2;228
4202206;Benedito Novo;4209102;Joinville;1;1;2;76
4202800;Braço do Norte;4209102;Joinville;1;1;2;223
4203600;Campos Novos;4209102;Joinville;1;1;2;268
4203907;Capinzal;4209102;Joinville;1;1;2;300
4204509;Corupá;4209102;Joinville;1;1;2;41
4208104;Itaiópolis;4209102;Joinville;1;1;2;105
1504208;Marabá;4209003;Joaçaba;1;1;2;2421
1508407;Xinguara;4209003;Joaçaba;1;1;2;2224
1703867;Cariri do Tocantins;4209003;Joaçaba;1;1;2;1704
2100055;Açailândia;4209003;Joaçaba;1;1;2;2484
2906501;Candeias;4209003;Joaçaba;1;1;2;2020
2927408;Salvador;4209003;Joaçaba;1;1;2;1997
3505500;Barretos;4209003;Joaçaba;1;1;2;784
3516200;Franca;4209003;Joaçaba;1;1;2;834
3518800;Guarulhos;4209003;Joaçaba;1;1;2;637
3525003;Jandira;4209003;Joaçaba;1;1;2;605
3534708;Ourinhos;4209003;Joaçaba;1;1;2;488
3548807;São Caetano do Sul;4209003;Joaçaba;1;1;2;624
3549805;São José do Rio Preto;4209003;Joaçaba;1;1;2;730
4101804;Araucária;4209003;Joaçaba;1;1;2;273
4104907;Castro;4209003;Joaçaba;1;1;2;300
4108304;Foz do Iguaçu;4209003;Joaçaba;1;1;2;342
4108502;General Carneiro;4209003;Joaçaba;1;1;2;83
4114609;Marechal Cândido Rondon;4209003;Joaçaba;1;1;2;378
4118204;Paranaguá;4209003;Joaçaba;1;1;2;341
4118501;Pato Branco;4209003;Joaçaba;1;1;2;150
4119152;Pinhais;4209003;Joaçaba;1;1;2;299
4122305;Rio Negro;4209003;Joaçaba;1;1;2;207
4201604;Arroio Trinta;4209003;Joaçaba;1;1;2;31
4202008;Balneário Camboriú;4209003;Joaçaba;1;1;2;284
4202131;Bela Vista do Toldo;4209003;Joaçaba;1;1;2;144
4202800;Braço do Norte;4209003;Joaçaba;1;1;2;268
4203204;Camboriú;4209003;Joaçaba;1;1;2;283
4203303;Campo Alegre;4209003;Joaçaba;1;1;2;249
4204152;Celso Ramos;4209003;Joaçaba;1;1;2;58
4204350;Cordilheira Alta;4209003;Joaçaba;1;1;2;110
4206801;Ibicaré;4209003;Joaçaba;1;1;2;19
4207007;Içara;4209003;Joaçaba;1;1;2;284
4207601;Ipira;4209003;Joaçaba;1;1;2;35
4208203;Itajaí;4209003;Joaçaba;1;1;2;278
4208906;Jaraguá do Sul;4209003;Joaçaba;1;1;2;255
4204202;Chapecó;4208955;Jardinópolis;1;1;2;49
1300805;Borba;4208906;Jaraguá do Sul;1;1;2;2635
1302603;Manaus;4208906;Jaraguá do Sul;1;1;2;2784
1503606;Itaituba;4208906;Jaraguá do Sul;1;1;2;2547
1709302;Guaraí;4208906;Jaraguá do Sul;1;1;2;1949
2408102;Natal;4208906;Jaraguá do Sul;1;1;2;2633
2500601;Alhandra;4208906;Jaraguá do Sul;1;1;2;2497
2602902;Cabo de Santo Agostinho;4208906;Jaraguá do Sul;1;1;2;2414
2616407;Vitória de Santo Antão;4208906;Jaraguá do Sul;1;1;2;2415
3118601;Contagem;4208906;Jaraguá do Sul;1;1;2;874
3136702;Juiz de Fora;4208906;Jaraguá do Sul;1;1;2;768
3201308;Cariacica;4208906;Jaraguá do Sul;1;1;2;1087
3205200;Vila Velha;4208906;Jaraguá do Sul;1;1;2;1088
3302403;Macaé;4208906;Jaraguá do Sul;1;1;2;840
3304201;Resende;4208906;Jaraguá do Sul;1;1;2;632
3519071;Hortolândia;4208906;Jaraguá do Sul;1;1;2;441
3520509;Indaiatuba;4208906;Jaraguá do Sul;1;1;2;417
3526209;Juquitiba;4208906;Jaraguá do Sul;1;1;2;345
3531803;Monte Mor;4208906;Jaraguá do Sul;1;1;2;428
3548906;São Carlos;4208906;Jaraguá do Sul;1;1;2;507
3554003;Tatuí;4208906;Jaraguá do Sul;1;1;2;368
3556453;Vargem Grande Paulista;4208906;Jaraguá do Sul;1;1;2;378
4104204;Campo Largo;4208906;Jaraguá do Sul;1;1;2;122
4105508;Cianorte;4208906;Jaraguá do Sul;1;1;2;467
4106209;Contenda;4208906;Jaraguá do Sul;1;1;2;100
4109609;Guaratuba;4208906;Jaraguá do Sul;1;1;2;73
4111803;Jacarezinho;4208906;Jaraguá do Sul;1;1;2;380
4113205;Lapa;4208906;Jaraguá do Sul;1;1;2;101
4114609;Marechal Cândido Rondon;4208906;Jaraguá do Sul;1;1;2;537
4115705;Matinhos;4208906;Jaraguá do Sul;1;1;2;89
4118204;Paranaguá;4208906;Jaraguá do Sul;1;1;2;112
4118501;Pato Branco;4208906;Jaraguá do Sul;1;1;2;358
4119509;Piraquara;4208906;Jaraguá do Sul;1;1;2;115
4122305;Rio Negro;4208906;Jaraguá do Sul;1;1;2;83
4203808;Canoinhas;4208906;Jaraguá do Sul;1;1;2;137
4203907;Capinzal;4208906;Jaraguá do Sul;1;1;2;271
4204301;Concórdia;4208906;Jaraguá do Sul;1;1;2;305
4205506;Fraiburgo;4208906;Jaraguá do Sul;1;1;2;194
4206900;Ibirama;4208906;Jaraguá do Sul;1;1;2;77
4208450;Itapoá;4208906;Jaraguá do Sul;1;1;2;59
2905701;Camaçari;4208807;Jaguaruna;1;1;2;2022
3205002;Serra;4208807;Jaguaruna;1;1;2;1250
3505708;Barueri;4208807;Jaguaruna;1;1;2;602
3516200;Franca;4208807;Jaguaruna;1;1;2;907
3534401;Osasco;4208807;Jaguaruna;1;1;2;602
4202909;Brusque;4208807;Jaguaruna;1;1;2;169
4204608;Criciúma;4208807;Jaguaruna;1;1;2;36
4204806;Curitibanos;4208807;Jaguaruna;1;1;2;214
4207007;Içara;4208807;Jaguaruna;1;1;2;29
4207205;Imaruí;4208807;Jaguaruna;1;1;2;37
4208708;Jacinto Machado;4208807;Jaguaruna;1;1;2;84
2927408;Salvador;4208708;Jacinto Machado;1;1;2;2056
3305109;São João de Meriti;4208708;Jacinto Machado;1;1;2;916
3534401;Osasco;4208708;Jacinto Machado;1;1;2;668
4201406;Araranguá;4208708;Jacinto Machado;1;1;2;27
4201950;Balneário Arroio do Silva;4208708;Jacinto Machado;1;1;2;33
4204806;Curitibanos;4208708;Jacinto Machado;1;1;2;208
4207007;Içara;4208708;Jacinto Machado;1;1;2;55
4200408;Água Doce;4208609;Jaborá;1;1;2;26
4204004;Catanduvas;4208609;Jaborá;1;1;2;13
4204806;Curitibanos;4208609;Jaborá;1;1;2;113
4205407;Florianópolis;4208609;Jaborá;1;1;2;323
4207601;Ipira;4208609;Jaborá;1;1;2;24
3304557;Rio de Janeiro;4208500;Ituporanga;1;1;2;794
3510203;Capão Bonito;4208500;Ituporanga;1;1;2;396
3531308;Monte Alto;4208500;Ituporanga;1;1;2;687
3534401;Osasco;4208500;Ituporanga;1;1;2;509
3537800;Piedade;4208500;Ituporanga;1;1;2;461
3545308;Salto de Pirapora;4208500;Ituporanga;1;1;2;461
3548005;Santo Antônio de Posse;4208500;Ituporanga;1;1;2;593
3550308;São Paulo;4208500;Ituporanga;1;1;2;506
4101804;Araucária;4208500;Ituporanga;1;1;2;203
4109401;Guarapuava;4208500;Ituporanga;1;1;2;288
4118501;Pato Branco;4208500;Ituporanga;1;1;2;328
4200705;Alfredo Wagner;4208500;Ituporanga;1;1;2;42
4201000;Anita Garibaldi;4208500;Ituporanga;1;1;2;154
4202602;Bom Retiro;4208500;Ituporanga;1;1;2;44
4202909;Brusque;4208500;Ituporanga;1;1;2;77
4203600;Campos Novos;4208500;Ituporanga;1;1;2;160
4203808;Canoinhas;4208500;Ituporanga;1;1;2;156
4203907;Capinzal;4208500;Ituporanga;1;1;2;199
4205902;Gaspar;4208500;Ituporanga;1;1;2;83
4207007;Içara;4208500;Ituporanga;1;1;2;148
3106200;Belo Horizonte;4208450;Itapoá;1;1;2;826
3534401;Osasco;4208450;Itapoá;1;1;2;340
3550308;São Paulo;4208450;Itapoá;1;1;2;337
4118204;Paranaguá;4208450;Itapoá;1;1;2;60
4119905;Ponta Grossa;4208450;Itapoá;1;1;2;188
4125506;São José dos Pinhais;4208450;Itapoá;1;1;2;83
4201307;Araquari;4208450;Itapoá;1;1;2;31
4202909;Brusque;4208450;Itapoá;1;1;2;111
4208203;Itajaí;4208450;Itapoá;1;1;2;92
3516200;Franca;4208401;Itapiranga;1;1;2;954
3534401;Osasco;4208401;Itapiranga;1;1;2;787
4202107;Barra Velha;4208401;Itapiranga;1;1;2;497
4202404;Blumenau;4208401;Itapiranga;1;1;2;460
4203105;Caibi;4208401;Itapiranga;1;1;2;44
4204707;Cunha Porã;4208401;Itapiranga;1;1;2;62
4204806;Curitibanos;4208401;Itapiranga;1;1;2;309
4204905;Descanso;4208401;Itapiranga;1;1;2;43
1721000;Palmas;4208302;Itapema;1;1;2;1852
3300407;Barra Mansa;4208302;Itapema;1;1;2;665
3304557;Rio de Janeiro;4208302;Itapema;1;1;2;702
3503208;Araraquara;4208302;Itapema;1;1;2;589
3504008;Assis;4208302;Itapema;1;1;2;521
3516200;Franca;4208302;Itapema;1;1;2;735
3534401;Osasco;4208302;Itapema;1;1;2;433
4104303;Campo Mourão;4208302;Itapema;1;1;2;499
4109609;Guaratuba;4208302;Itapema;1;1;2;127
4111902;Jaguapitã;4208302;Itapema;1;1;2;523
4118501;Pato Branco;4208302;Itapema;1;1;2;409
4119152;Pinhais;4208302;Itapema;1;1;2;190
4203006;Caçador;4208302;Itapema;1;1;2;245
4203600;Campos Novos;4208302;Itapema;1;1;2;259
4204350;Cordilheira Alta;4208302;Itapema;1;1;2;397
4204558;Correia Pinto;4208302;Itapema;1;1;2;180
4204806;Curitibanos;4208302;Itapema;1;1;2;196
4206504;Guaramirim;4208302;Itapema;1;1;2;77
4207106;Ilhota;4208302;Itapema;1;1;2;28
1300805;Borba;4208203;Itajaí;1;1;2;2692
1500800;Ananindeua;4208203;Itajaí;1;1;2;2829
1504208;Marabá;4208203;Itajaí;1;1;2;2387
1505536;Parauapebas;4208203;Itajaí;1;1;2;2319
2101400;Balsas;4208203;Itajaí;1;1;2;2166
2102804;Carolina;4208203;Itajaí;1;1;2;2170
2106300;Magalhães de Almeida;4208203;Itajaí;1;1;2;2676
2112001;Tasso Fragoso;4208203;Itajaí;1;1;2;2060
2305233;Horizonte;4208203;Itajaí;1;1;2;2704
2403251;Parnamirim;4208203;Itajaí;1;1;2;2649
2507507;João Pessoa;4208203;Itajaí;1;1;2;2546
2609600;Olinda;4208203;Itajaí;1;1;2;2468
2616407;Vitória de Santo Antão;4208203;Itajaí;1;1;2;2438
2800605;Barra dos Coqueiros;4208203;Itajaí;1;1;2;2096
2910057;Dias d'Ávila;4208203;Itajaí;1;1;2;1870
2913606;Ilhéus;4208203;Itajaí;1;1;2;1628
2929305;São Gonçalo dos Campos;4208203;Itajaí;1;1;2;1854
2930709;Simões Filho;4208203;Itajaí;1;1;2;1849
3104106;Arceburgo;4208203;Itajaí;1;1;2;642
3106903;Bicas;4208203;Itajaí;1;1;2;800
3120508;Cristina;4208203;Itajaí;1;1;2;624
3127107;Frutal;4208203;Itajaí;1;1;2;757
3133808;Itaúna;4208203;Itajaí;1;1;2;858
3143302;Montes Claros;4208203;Itajaí;1;1;2;1223
3144805;Nova Lima;4208203;Itajaí;1;1;2;901
3147907;Passos;4208203;Itajaí;1;1;2;721
3151800;Poços de Caldas;4208203;Itajaí;1;1;2;612
3154903;Rio Casca;4208203;Itajaí;1;1;2;948
3156700;Sabará;4208203;Itajaí;1;1;2;916
3170107;Uberaba;4208203;Itajaí;1;1;2;801
3201209;Cachoeiro de Itapemirim;4208203;Itajaí;1;1;2;1005
3202603;Iconha;4208203;Itajaí;1;1;2;1028
3301702;Duque de Caxias;4208203;Itajaí;1;1;2;704
3302403;Macaé;4208203;Itajaí;1;1;2;839
3304201;Resende;4208203;Itajaí;1;1;2;645
3304300;Rio Bonito;4208203;Itajaí;1;1;2;760
3501905;Amparo;4208203;Itajaí;1;1;2;508
3502804;Araçatuba;4208203;Itajaí;1;1;2;654
3504008;Assis;4208203;Itajaí;1;1;2;502
3504503;Avaré;4208203;Itajaí;1;1;2;426
3505500;Barretos;4208203;Itajaí;1;1;2;708
3506508;Birigui;4208203;Itajaí;1;1;2;643
3507902;Brotas;4208203;Itajaí;1;1;2;519
3509601;Campo Limpo Paulista;4208203;Itajaí;1;1;2;456
3509700;Campos do Jordão;4208203;Itajaí;1;1;2;561
3511508;Cerquilho;4208203;Itajaí;1;1;2;430
3514106;Dois Córregos;4208203;Itajaí;1;1;2;508
3515103;Embu-Guaçu;4208203;Itajaí;1;1;2;393
3518701;Guarujá;4208203;Itajaí;1;1;2;411
3519600;Ibitinga;4208203;Itajaí;1;1;2;575
3523909;Itu;4208203;Itajaí;1;1;2;429
3524006;Itupeva;4208203;Itajaí;1;1;2;451
3527108;Lins;4208203;Itajaí;1;1;2;591
3530508;Mococa;4208203;Itajaí;1;1;2;628
3530607;Moji das Cruzes;4208203;Itajaí;1;1;2;451
3536208;Pariquera-Açu;4208203;Itajaí;1;1;2;261
3536257;Parisi;4208203;Itajaí;1;1;2;747
3536505;Paulínia;4208203;Itajaí;1;1;2;489
3543907;Rio Claro;4208203;Itajaí;1;1;2;515
3545803;Santa Bárbara d'Oeste;4208203;Itajaí;1;1;2;482
3546405;Santa Cruz do Rio Pardo;4208203;Itajaí;1;1;2;456
3548906;São Carlos;4208203;Itajaí;1;1;2;551
3549102;São João da Boa Vista;4208203;Itajaí;1;1;2;583
3549805;São José do Rio Preto;4208203;Itajaí;1;1;2;680
3552403;Sumaré;4208203;Itajaí;1;1;2;479
3552809;Taboão da Serra;4208203;Itajaí;1;1;2;418
3554508;Tietê;4208203;Itajaí;1;1;2;437
3556107;Valentim Gentil;4208203;Itajaí;1;1;2;735
3556503;Várzea Paulista;4208203;Itajaí;1;1;2;454
3556701;Vinhedo;4208203;Itajaí;1;1;2;467
3557006;Votorantim;4208203;Itajaí;1;1;2;401
4101507;Arapongas;4208203;Itajaí;1;1;2;471
4104204;Campo Largo;4208203;Itajaí;1;1;2;181
4104907;Castro;4208203;Itajaí;1;1;2;271
4105508;Cianorte;4208203;Itajaí;1;1;2;523
4108304;Foz do Iguaçu;4208203;Itajaí;1;1;2;589
4109302;Guaraniaçu;4208203;Itajaí;1;1;2;454
4109807;Ibiporã;4208203;Itajaí;1;1;2;465
4110805;Iretama;4208203;Itajaí;1;1;2;432
4111209;Itapejara d'Oeste;4208203;Itajaí;1;1;2;416
4113502;Loanda;4208203;Itajaí;1;1;2;617
4115804;Medianeira;4208203;Itajaí;1;1;2;558
4116208;Morretes;4208203;Itajaí;1;1;2;162
4127106;Telêmaco Borba;4208203;Itajaí;1;1;2;342
4200101;Abelardo Luz;4208203;Itajaí;1;1;2;357
4201307;Araquari;4208203;Itajaí;1;1;2;63
4203154;Calmon;4208203;Itajaí;1;1;2;236
4203709;Canelinha;4208203;Itajaí;1;1;2;36
4203808;Canoinhas;4208203;Itajaí;1;1;2;184
4204509;Corupá;4208203;Itajaí;1;1;2;75
4205456;Forquilhinha;4208203;Itajaí;1;1;2;213
4205704;Garopaba;4208203;Itajaí;1;1;2;121
4206009;Governador Celso Ramos;4208203;Itajaí;1;1;2;45
4206306;Guabiruba;4208203;Itajaí;1;1;2;29
4207304;Imbituba;4208203;Itajaí;1;1;2;138
4208005;Itá;4208203;Itajaí;1;1;2;360
3534401;Osasco;4208104;Itaiópolis;1;1;2;437
4101606;Arapoti;4208104;Itaiópolis;1;1;2;241
4119905;Ponta Grossa;4208104;Itaiópolis;1;1;2;139
4202131;Bela Vista do Toldo;4208104;Itaiópolis;1;1;2;56
4202404;Blumenau;4208104;Itaiópolis;1;1;2;107
4203808;Canoinhas;4208104;Itaiópolis;1;1;2;53
4204806;Curitibanos;4208104;Itaiópolis;1;1;2;125
4205407;Florianópolis;4208104;Itaiópolis;1;1;2;197
1702109;Araguaína;4208005;Itá;1;1;2;2257
1712504;Marianópolis do Tocantins;4208005;Itá;1;1;2;1952
3550308;São Paulo;4208005;Itá;1;1;2;686
3304557;Rio de Janeiro;4207908;Irineópolis;1;1;2;831
3534401;Osasco;4207908;Irineópolis;1;1;2;497
4118709;Paulo Frontin;4207908;Irineópolis;1;1;2;22
4122305;Rio Negro;4207908;Irineópolis;1;1;2;101
4128104;Umuarama;4207908;Irineópolis;1;1;2;372
4203808;Canoinhas;4207908;Irineópolis;1;1;2;39
4204806;Curitibanos;4207908;Irineópolis;1;1;2;116
4205407;Florianópolis;4207908;Irineópolis;1;1;2;274
4205431;Formosa do Sul;4207858;Irati;1;1;2;10
4207007;Içara;4207858;Irati;1;1;2;428
3550308;São Paulo;4207809;Irani;1;1;2;635
4118501;Pato Branco;4207809;Irani;1;1;2;116
4201273;Arabutã;4207809;Irani;1;1;2;28
4203600;Campos Novos;4207809;Irani;1;1;2;81
4204004;Catanduvas;4207809;Irani;1;1;2;22
4204558;Correia Pinto;4207809;Irani;1;1;2;165
4205407;Florianópolis;4207809;Irani;1;1;2;343
4205407;Florianópolis;4207759;Iraceminha;1;1;2;487
3550308;São Paulo;4207700;Ipumirim;1;1;2;657
4204004;Catanduvas;4207700;Ipumirim;1;1;2;45
4205407;Florianópolis;4207700;Ipumirim;1;1;2;364
4206702;Herval d'Oeste;4207700;Ipumirim;1;1;2;65
4104303;Campo Mourão;4207684;Ipuaçu;1;1;2;287
4106902;Curitiba;4207684;Ipuaçu;1;1;2;340
4107405;Enéas Marques;4207684;Ipuaçu;1;1;2;104
4117602;Palmas;4207684;Ipuaçu;1;1;2;50
4202537;Bom Jesus;4207684;Ipuaçu;1;1;2;12
4204301;Concórdia;4207684;Ipuaçu;1;1;2;78
4205407;Florianópolis;4207684;Ipuaçu;1;1;2;408
3534401;Osasco;4207650;Iporã do Oeste;1;1;2;763
4202156;Belmonte;4207650;Iporã do Oeste;1;1;2;18
4204202;Chapecó;4207650;Iporã do Oeste;1;1;2;92
4204301;Concórdia;4207601;Ipira;1;1;2;30
2611101;Petrolina;4207577;Iomerê;1;1;2;2203
4202008;Balneário Camboriú;4207577;Iomerê;1;1;2;254
4205407;Florianópolis;4207577;Iomerê;1;1;2;279
2105302;Imperatriz;4207502;Indaial;1;1;2;2372
3106705;Betim;4207502;Indaial;1;1;2;910
3134905;Jacutinga;4207502;Indaial;1;1;2;571
3143302;Montes Claros;4207502;Indaial;1;1;2;1237
3303708;Paraíba do Sul;4207502;Indaial;1;1;2;781
3304557;Rio de Janeiro;4207502;Indaial;1;1;2;734
3523909;Itu;4207502;Indaial;1;1;2;443
3524600;Jacupiranga;4207502;Indaial;1;1;2;273
3524709;Jaguariúna;4207502;Indaial;1;1;2;514
3534401;Osasco;4207502;Indaial;1;1;2;443
3548708;São Bernardo do Campo;4207502;Indaial;1;1;2;438
4104303;Campo Mourão;4207502;Indaial;1;1;2;443
4106902;Curitiba;4207502;Indaial;1;1;2;162
4115200;Maringá;4207502;Indaial;1;1;2;466
4118907;Pérola;4207502;Indaial;1;1;2;555
4119905;Ponta Grossa;4207502;Indaial;1;1;2;219
4120606;Prudentópolis;4207502;Indaial;1;1;2;257
4120853;Quatro Pontes;4207502;Indaial;1;1;2;533
4122305;Rio Negro;4207502;Indaial;1;1;2;104
4128203;União da Vitória;4207502;Indaial;1;1;2;202
4200408;Água Doce;4207502;Indaial;1;1;2;231
4201109;Anitápolis;4207502;Indaial;1;1;2;112
4201802;Atalanta;4207502;Indaial;1;1;2;80
4202206;Benedito Novo;4207502;Indaial;1;1;2;19
4202453;Bombinhas;4207502;Indaial;1;1;2;74
4202602;Bom Retiro;4207502;Indaial;1;1;2;103
4202701;Botuverá;4207502;Indaial;1;1;2;37
4204350;Cordilheira Alta;4207502;Indaial;1;1;2;339
4204806;Curitibanos;4207502;Indaial;1;1;2;143
4206207;Gravatal;4207502;Indaial;1;1;2;160
4206504;Guaramirim;4207502;Indaial;1;1;2;52
4204806;Curitibanos;4207403;Imbuia;1;1;2;119
4205407;Florianópolis;4207403;Imbuia;1;1;2;90
2412559;São Miguel de Touros;4207304;Imbituba;1;1;2;2822
2611606;Recife;4207304;Imbituba;1;1;2;2562
2905701;Camaçari;4207304;Imbituba;1;1;2;1971
3106200;Belo Horizonte;4207304;Imbituba;1;1;2;1023
3148004;Patos de Minas;4207304;Imbituba;1;1;2;1085
3201209;Cachoeiro de Itapemirim;4207304;Imbituba;1;1;2;1094
3205309;Vitória;4207304;Imbituba;1;1;2;1191
3505708;Barueri;4207304;Imbituba;1;1;2;548
3516200;Franca;4207304;Imbituba;1;1;2;856
3524006;Itupeva;4207304;Imbituba;1;1;2;580
3526605;Lavrinhas;4207304;Imbituba;1;1;2;723
3534401;Osasco;4207304;Imbituba;1;1;2;548
3543907;Rio Claro;4207304;Imbituba;1;1;2;650
3548500;Santos;4207304;Imbituba;1;1;2;528
3552809;Taboão da Serra;4207304;Imbituba;1;1;2;543
4106902;Curitiba;4207304;Imbituba;1;1;2;309
4120804;Quatro Barras;4207304;Imbituba;1;1;2;314
4202800;Braço do Norte;4207304;Imbituba;1;1;2;42
4204806;Curitibanos;4207304;Imbituba;1;1;2;207
4206108;Grão Pará;4207304;Imbituba;1;1;2;49
4207007;Içara;4207304;Imbituba;1;1;2;80
3534401;Osasco;4207205;Imaruí;1;1;2;566
4201406;Araranguá;4207205;Imaruí;1;1;2;94
4202909;Brusque;4207205;Imaruí;1;1;2;136
4204608;Criciúma;4207205;Imaruí;1;1;2;65
4204806;Curitibanos;4207205;Imaruí;1;1;2;207
4205407;Florianópolis;4207205;Imaruí;1;1;2;87
4205704;Garopaba;4207205;Imaruí;1;1;2;38
1302603;Manaus;4207106;Ilhota;1;1;2;2834
3136702;Juiz de Fora;4207106;Ilhota;1;1;2;781
3143302;Montes Claros;4207106;Ilhota;1;1;2;1222
3534401;Osasco;4207106;Ilhota;1;1;2;423
3538709;Piracicaba;4207106;Ilhota;1;1;2;474
3548807;São Caetano do Sul;4207106;Ilhota;1;1;2;426
4109609;Guaratuba;4207106;Ilhota;1;1;2;107
4118402;Paranavaí;4207106;Ilhota;1;1;2;550
4122404;Rolândia;4207106;Ilhota;1;1;2;469
4202453;Bombinhas;4207106;Ilhota;1;1;2;39
4203709;Canelinha;4207106;Ilhota;1;1;2;41
4204806;Curitibanos;4207106;Ilhota;1;1;2;181
1500602;Altamira;4207007;Içara;1;1;2;2840
1504208;Marabá;4207007;Içara;1;1;2;2584
2607901;Jaboatão dos Guararapes;4207007;Içara;1;1;2;2630
2804805;Nossa Senhora do Socorro;4207007;Içara;1;1;2;2274
2927408;Salvador;4207007;Içara;1;1;2;2009
3118601;Contagem;4207007;Içara;1;1;2;1092
3157807;Santa Luzia;4207007;Içara;1;1;2;1116
3162955;São José da Lapa;4207007;Içara;1;1;2;1119
3201209;Cachoeiro de Itapemirim;4207007;Içara;1;1;2;1169
3205002;Serra;4207007;Içara;1;1;2;1275
3304557;Rio de Janeiro;4207007;Içara;1;1;2;866
3503307;Araras;4207007;Içara;1;1;2;728
3504107;Atibaia;4207007;Içara;1;1;2;674
3516200;Franca;4207007;Içara;1;1;2;923
3522406;Itapeva;4207007;Içara;1;1;2;527
3527207;Lorena;4207007;Içara;1;1;2;775
3530607;Moji das Cruzes;4207007;Içara;1;1;2;644
3534401;Osasco;4207007;Içara;1;1;2;622
4101804;Araucária;4207007;Içara;1;1;2;347
4104808;Cascavel;4207007;Içara;1;1;2;579
4105805;Colombo;4207007;Içara;1;1;2;384
4106902;Curitiba;4207007;Içara;1;1;2;364
4110706;Irati;4207007;Içara;1;1;2;382
4202909;Brusque;4207007;Içara;1;1;2;184
4203006;Caçador;4207007;Içara;1;1;2;275
4204806;Curitibanos;4207007;Içara;1;1;2;205
4205456;Forquilhinha;4207007;Içara;1;1;2;17
1301704;Humaitá;4206900;Ibirama;1;1;2;2506
3200607;Aracruz;4206900;Ibirama;1;1;2;1200
3518800;Guarulhos;4206900;Ibirama;1;1;2;494
3534401;Osasco;4206900;Ibirama;1;1;2;473
3550308;São Paulo;4206900;Ibirama;1;1;2;470
4104204;Campo Largo;4206900;Ibirama;1;1;2;177
4104501;Capanema;4206900;Ibirama;1;1;2;449
4202909;Brusque;4206900;Ibirama;1;1;2;60
4204608;Criciúma;4206900;Ibirama;1;1;2;178
4205100;Dona Emma;4206900;Ibirama;1;1;2;22
4206504;Guaramirim;4206900;Ibirama;1;1;2;82
4204301;Concórdia;4206801;Ibicaré;1;1;2;66
4205407;Florianópolis;4206801;Ibicaré;1;1;2;288
4206702;Herval d'Oeste;4206801;Ibicaré;1;1;2;17
3543402;Ribeirão Preto;4206751;Ibiam;1;1;2;746
4200051;Abdon Batista;4206751;Ibiam;1;1;2;52
4203600;Campos Novos;4206751;Ibiam;1;1;2;27
4205407;Florianópolis;4206751;Ibiam;1;1;2;274
3545209;Salto;4206702;Herval d'Oeste;1;1;2;603
4105508;Cianorte;4206702;Herval d'Oeste;1;1;2;406
4115200;Maringá;4206702;Herval d'Oeste;1;1;2;419
4203006;Caçador;4206702;Herval d'Oeste;1;1;2;59
4203907;Capinzal;4206702;Herval d'Oeste;1;1;2;20
4204004;Catanduvas;4206702;Herval d'Oeste;1;1;2;23
4204608;Criciúma;4206702;Herval d'Oeste;1;1;2;266
4204806;Curitibanos;4206702;Herval d'Oeste;1;1;2;89
4204400;Coronel Freitas;4206652;Guatambú;1;1;2;26
4102604;Barracão;4206603;Guarujá do Sul;1;1;2;19
4104808;Cascavel;4206603;Guarujá do Sul;1;1;2;160
4205407;Florianópolis;4206603;Guarujá do Sul;1;1;2;520
1502806;Curralinho;4206504;Guaramirim;1;1;2;2734
1505486;Pacajá;4206504;Guaramirim;1;1;2;2503
2304400;Fortaleza;4206504;Guaramirim;1;1;2;2699
2309607;Pacajus;4206504;Guaramirim;1;1;2;2660
2408003;Mossoró;4206504;Guaramirim;1;1;2;2599
2604106;Caruaru;4206504;Guaramirim;1;1;2;2360
2616407;Vitória de Santo Antão;4206504;Guaramirim;1;1;2;2411
3106705;Betim;4206504;Guaramirim;1;1;2;860
3170107;Uberaba;4206504;Guaramirim;1;1;2;753
3205200;Vila Velha;4206504;Guaramirim;1;1;2;1081
3301702;Duque de Caxias;4206504;Guaramirim;1;1;2;693
3304003;Piraí;4206504;Guaramirim;1;1;2;658
3504503;Avaré;4206504;Guaramirim;1;1;2;374
3506508;Birigui;4206504;Guaramirim;1;1;2;587
3518800;Guarulhos;4206504;Guaramirim;1;1;2;413
3524402;Jacareí;4206504;Guaramirim;1;1;2;461
3529005;Marília;4206504;Guaramirim;1;1;2;480
3529401;Mauá;4206504;Guaramirim;1;1;2;399
3534401;Osasco;4206504;Guaramirim;1;1;2;392
3541000;Praia Grande;4206504;Guaramirim;1;1;2;375
3542602;Registro;4206504;Guaramirim;1;1;2;243
3543402;Ribeirão Preto;4206504;Guaramirim;1;1;2;601
3547304;Santana de Parnaíba;4206504;Guaramirim;1;1;2;393
3548906;São Carlos;4206504;Guaramirim;1;1;2;505
3549805;São José do Rio Preto;4206504;Guaramirim;1;1;2;627
3552205;Sorocaba;4206504;Guaramirim;1;1;2;363
4101804;Araucária;4206504;Guaramirim;1;1;2;106
4104303;Campo Mourão;4206504;Guaramirim;1;1;2;429
4104808;Cascavel;4206504;Guaramirim;1;1;2;473
4110409;Indianópolis;4206504;Guaramirim;1;1;2;492
4114302;Mandirituba;4206504;Guaramirim;1;1;2;83
4119905;Ponta Grossa;4206504;Guaramirim;1;1;2;190
4120655;Quarto Centenário;4206504;Guaramirim;1;1;2;470
4125506;São José dos Pinhais;4206504;Guaramirim;1;1;2;105
4201406;Araranguá;4206504;Guaramirim;1;1;2;278
4202008;Balneário Camboriú;4206504;Guaramirim;1;1;2;65
4202701;Botuverá;4206504;Guaramirim;1;1;2;81
4202800;Braço do Norte;4206504;Guaramirim;1;1;2;200
4202909;Brusque;4206504;Guaramirim;1;1;2;69
4203006;Caçador;4206504;Guaramirim;1;1;2;212
4203204;Camboriú;4206504;Guaramirim;1;1;2;69
4203303;Campo Alegre;4206504;Guaramirim;1;1;2;41
4204806;Curitibanos;4206504;Guaramirim;1;1;2;183
4205407;Florianópolis;4206504;Guaramirim;1;1;2;133
4205803;Garuva;4206504;Guaramirim;1;1;2;52
3534401;Osasco;4206405;Guaraciaba;1;1;2;744
4104501;Capanema;4206405;Guaraciaba;1;1;2;105
4204202;Chapecó;4206405;Guaraciaba;1;1;2;106
4205001;Dionísio Cerqueira;4206405;Guaraciaba;1;1;2;37
4205407;Florianópolis;4206405;Guaraciaba;1;1;2;512
3519600;Ibitinga;4206306;Guabiruba;1;1;2;591
3534401;Osasco;4206306;Guabiruba;1;1;2;448
3548807;São Caetano do Sul;4206306;Guabiruba;1;1;2;452
3549805;São José do Rio Preto;4206306;Guabiruba;1;1;2;694
3550308;São Paulo;4206306;Guabiruba;1;1;2;444
4105508;Cianorte;4206306;Guabiruba;1;1;2;517
4106902;Curitiba;4206306;Guabiruba;1;1;2;185
4109609;Guaratuba;4206306;Guabiruba;1;1;2;131
4202404;Blumenau;4206306;Guabiruba;1;1;2;17
4204806;Curitibanos;4206306;Guabiruba;1;1;2;161
4205407;Florianópolis;4206306;Guabiruba;1;1;2;74
4205902;Gaspar;4206306;Guabiruba;1;1;2;17
3503307;Araras;4206207;Gravatal;1;1;2;680
3546702;Santa Gertrudes;4206207;Gravatal;1;1;2;666
4203956;Capivari de Baixo;4206207;Gravatal;1;1;2;15
4206108;Grão Pará;4206207;Gravatal;1;1;2;27
3550308;São Paulo;4206108;Grão Pará;1;1;2;561
4201505;Armazém;4206108;Grão Pará;1;1;2;24
4204608;Criciúma;4206108;Grão Pará;1;1;2;55
4204707;Cunha Porã;4206108;Grão Pará;1;1;2;408
4204806;Curitibanos;4206108;Grão Pará;1;1;2;166
4205407;Florianópolis;4206108;Grão Pará;1;1;2;97
3534401;Osasco;4206009;Governador Celso Ramos;1;1;2;454
1100205;Porto Velho;4205902;Gaspar;1;1;2;2451
1100304;Vilhena;4205902;Gaspar;1;1;2;1891
1302603;Manaus;4205902;Gaspar;1;1;2;2832
1500800;Ananindeua;4205902;Gaspar;1;1;2;2828
1703842;Campos Lindos;4205902;Gaspar;1;1;2;2101
1709302;Guaraí;4205902;Gaspar;1;1;2;1998
1709500;Gurupi;4205902;Gaspar;1;1;2;1685
1716505;Pedro Afonso;4205902;Gaspar;1;1;2;1985
1718204;Porto Nacional;4205902;Gaspar;1;1;2;1797
1721000;Palmas;4205902;Gaspar;1;1;2;1835
2100808;Anapurus;4205902;Gaspar;1;1;2;2631
2101400;Balsas;4205902;Gaspar;1;1;2;2167
2109007;Porto Franco;4205902;Gaspar;1;1;2;2282
2109502;Riachão;4205902;Gaspar;1;1;2;2175
2110658;São Domingos do Azeitão;4205902;Gaspar;1;1;2;2263
2111300;São Luís;4205902;Gaspar;1;1;2;2735
2112001;Tasso Fragoso;4205902;Gaspar;1;1;2;2062
2201150;Baixa Grande do Ribeiro;4205902;Gaspar;1;1;2;2141
2201903;Bom Jesus;4205902;Gaspar;1;1;2;2024
2203230;Currais;4205902;Gaspar;1;1;2;2029
2206209;Miguel Alves;4205902;Gaspar;1;1;2;2580
2304400;Fortaleza;4205902;Gaspar;1;1;2;2743
2903201;Barreiras;4205902;Gaspar;1;1;2;1672
2909307;Correntina;4205902;Gaspar;1;1;2;1559
2913606;Ilhéus;4205902;Gaspar;1;1;2;1638
3103504;Araguari;4205902;Gaspar;1;1;2;921
3109303;Buritis;4205902;Gaspar;1;1;2;1274
3118601;Contagem;4205902;Gaspar;1;1;2;908
3143302;Montes Claros;4205902;Gaspar;1;1;2;1230
3147006;Paracatu;4205902;Gaspar;1;1;2;1092
3170107;Uberaba;4205902;Gaspar;1;1;2;802
3170701;Varginha;4205902;Gaspar;1;1;2;693
3201506;Colatina;4205902;Gaspar;1;1;2;1147
3205309;Vitória;4205902;Gaspar;1;1;2;1118
3301009;Campos dos Goytacazes;4205902;Gaspar;1;1;2;936
3304557;Rio de Janeiro;4205902;Gaspar;1;1;2;715
3502804;Araçatuba;4205902;Gaspar;1;1;2;648
3506003;Bauru;4205902;Gaspar;1;1;2;509
3509502;Campinas;4205902;Gaspar;1;1;2;484
3522208;Itapecerica da Serra;4205902;Gaspar;1;1;2;412
3534708;Ourinhos;4205902;Gaspar;1;1;2;447
3542206;Rancharia;4205902;Gaspar;1;1;2;554
3543907;Rio Claro;4205902;Gaspar;1;1;2;519
3548500;Santos;4205902;Gaspar;1;1;2;422
3554003;Tatuí;4205902;Gaspar;1;1;2;412
4100608;Alto Paraná;4205902;Gaspar;1;1;2;534
4104808;Cascavel;4205902;Gaspar;1;1;2;495
4113700;Londrina;4205902;Gaspar;1;1;2;456
4202206;Benedito Novo;4205902;Gaspar;1;1;2;45
4202453;Bombinhas;4205902;Gaspar;1;1;2;48
4204301;Concórdia;4205902;Gaspar;1;1;2;306
3518800;Guarulhos;4205803;Garuva;1;1;2;366
3523107;Itaquaquecetuba;4205803;Garuva;1;1;2;376
3525904;Jundiaí;4205803;Garuva;1;1;2;370
3536505;Paulínia;4205803;Garuva;1;1;2;399
3548708;São Bernardo do Campo;4205803;Garuva;1;1;2;341
4115200;Maringá;4205803;Garuva;1;1;2;419
4117701;Palmeira;4205803;Garuva;1;1;2;133
4118204;Paranaguá;4205803;Garuva;1;1;2;57
4119954;Pontal do Paraná;4205803;Garuva;1;1;2;52
4128104;Umuarama;4205803;Garuva;1;1;2;510
4201307;Araquari;4205803;Garuva;1;1;2;39
4202057;Balneário Barra do Sul;4205803;Garuva;1;1;2;52
4202404;Blumenau;4205803;Garuva;1;1;2;105
4204509;Corupá;4205803;Garuva;1;1;2;59
3205002;Serra;4205704;Garopaba;1;1;2;1182
3516200;Franca;4205704;Garopaba;1;1;2;838
4202701;Botuverá;4205704;Garopaba;1;1;2;100
4204806;Curitibanos;4205704;Garopaba;1;1;2;208
4200556;Águas Frias;4205605;Galvão;1;1;2;50
4205407;Florianópolis;4205605;Galvão;1;1;2;437
4106902;Curitiba;4205555;Frei Rogério;1;1;2;243
4203600;Campos Novos;4205555;Frei Rogério;1;1;2;49
4204806;Curitibanos;4205555;Frei Rogério;1;1;2;23
4205506;Fraiburgo;4205555;Frei Rogério;1;1;2;20
2301109;Aracati;4205506;Fraiburgo;1;1;2;2774
2408003;Mossoró;4205506;Fraiburgo;1;1;2;2731
3513009;Cotia;4205506;Fraiburgo;1;1;2;545
3516200;Franca;4205506;Fraiburgo;1;1;2;795
3534401;Osasco;4205506;Fraiburgo;1;1;2;559
4104451;Cantagalo;4205506;Fraiburgo;1;1;2;218
4115309;Mariópolis;4205506;Fraiburgo;1;1;2;178
4117701;Palmeira;4205506;Fraiburgo;1;1;2;199
4122305;Rio Negro;4205506;Fraiburgo;1;1;2;151
4125506;São José dos Pinhais;4205506;Fraiburgo;1;1;2;238
4200408;Água Doce;4205506;Fraiburgo;1;1;2;63
4202602;Bom Retiro;4205506;Fraiburgo;1;1;2;166
4203402;Campo Belo do Sul;4205506;Fraiburgo;1;1;2;98
4204301;Concórdia;4205506;Fraiburgo;1;1;2;111
4205407;Florianópolis;4205506;Fraiburgo;1;1;2;247
2604106;Caruaru;4205456;Forquilhinha;1;1;2;2582
3127388;Goianá;4205456;Forquilhinha;1;1;2;996
3534401;Osasco;4205456;Forquilhinha;1;1;2;632
4201950;Balneário Arroio do Silva;4205456;Forquilhinha;1;1;2;24
4202008;Balneário Camboriú;4205456;Forquilhinha;1;1;2;209
4202800;Braço do Norte;4205456;Forquilhinha;1;1;2;60
4204806;Curitibanos;4205456;Forquilhinha;1;1;2;197
4118501;Pato Branco;4205431;Formosa do Sul;1;1;2;48
4204202;Chapecó;4205431;Formosa do Sul;1;1;2;54
1100288;Rolim de Moura;4205407;Florianópolis;1;1;2;2142
1200401;Rio Branco;4205407;Florianópolis;1;1;2;2658
1400100;Boa Vista;4205407;Florianópolis;1;1;2;3555
1720259;São Salvador do Tocantins;4205407;Florianópolis;1;1;2;1644
1721000;Palmas;4205407;Florianópolis;1;1;2;1907
2302206;Beberibe;4205407;Florianópolis;1;1;2;2765
2607208;Ipojuca;4205407;Florianópolis;1;1;2;2468
2609600;Olinda;4205407;Florianópolis;1;1;2;2513
2704302;Maceió;4205407;Florianópolis;1;1;2;2318
2800605;Barra dos Coqueiros;4205407;Florianópolis;1;1;2;2142
2905701;Camaçari;4205407;Florianópolis;1;1;2;1907
2919207;Lauro de Freitas;4205407;Florianópolis;1;1;2;1890
2925303;Porto Seguro;4205407;Florianópolis;1;1;2;1523
2927408;Salvador;4205407;Florianópolis;1;1;2;1872
2927705;Santa Cruz Cabrália;4205407;Florianópolis;1;1;2;1539
3111002;Campestre;4205407;Florianópolis;1;1;2;687
3117876;Confins;4205407;Florianópolis;1;1;2;982
3132404;Itajubá;4205407;Florianópolis;1;1;2;645
3151800;Poços de Caldas;4205407;Florianópolis;1;1;2;672
3152501;Pouso Alegre;4205407;Florianópolis;1;1;2;645
3159605;Santa Rita do Sapucaí;4205407;Florianópolis;1;1;2;651
3201209;Cachoeiro de Itapemirim;4205407;Florianópolis;1;1;2;1035
3203346;Marechal Floriano;4205407;Florianópolis;1;1;2;1094
3301702;Duque de Caxias;4205407;Florianópolis;1;1;2;734
3302403;Macaé;4205407;Florianópolis;1;1;2;863
3303906;Petrópolis;4205407;Florianópolis;1;1;2;760
3304524;Rio das Ostras;4205407;Florianópolis;1;1;2;852
3503901;Arujá;4205407;Florianópolis;1;1;2;512
3504008;Assis;4205407;Florianópolis;1;1;2;577
3504305;Avaí;4205407;Florianópolis;1;1;2;608
3506003;Bauru;4205407;Florianópolis;1;1;2;584
3511409;Cerqueira César;4205407;Florianópolis;1;1;2;509
3511508;Cerquilho;4205407;Florianópolis;1;1;2;496
3518404;Guaratinguetá;4205407;Florianópolis;1;1;2;620
3520509;Indaiatuba;4205407;Florianópolis;1;1;2;514
3524006;Itupeva;4205407;Florianópolis;1;1;2;512
3525904;Jundiaí;4205407;Florianópolis;1;1;2;513
3539509;Pitangueiras;4205407;Florianópolis;1;1;2;730
3539806;Poá;4205407;Florianópolis;1;1;2;498
3541000;Praia Grande;4205407;Florianópolis;1;1;2;447
3548500;Santos;4205407;Florianópolis;1;1;2;461
3549805;São José do Rio Preto;4205407;Florianópolis;1;1;2;754
3550704;São Sebastião;4205407;Florianópolis;1;1;2;520
3552205;Sorocaba;4205407;Florianópolis;1;1;2;466
3554508;Tietê;4205407;Florianópolis;1;1;2;504
3556206;Valinhos;4205407;Florianópolis;1;1;2;533
3556701;Vinhedo;4205407;Florianópolis;1;1;2;527
4104303;Campo Mourão;4205407;Florianópolis;1;1;2;544
4109807;Ibiporã;4205407;Florianópolis;1;1;2;538
4113304;Laranjeiras do Sul;4205407;Florianópolis;1;1;2;456
4114500;Manoel Ribas;4205407;Florianópolis;1;1;2;459
4115705;Matinhos;4205407;Florianópolis;1;1;2;197
4118501;Pato Branco;4205407;Florianópolis;1;1;2;434
4119301;Pinhão;4205407;Florianópolis;1;1;2;373
4119509;Piraquara;4205407;Florianópolis;1;1;2;244
4120606;Prudentópolis;4205407;Florianópolis;1;1;2;360
4120903;Quedas do Iguaçu;4205407;Florianópolis;1;1;2;491
4122156;Rio Bonito do Iguaçu;4205407;Florianópolis;1;1;2;456
4122206;Rio Branco do Sul;4205407;Florianópolis;1;1;2;277
4125209;São Jorge d'Oeste;4205407;Florianópolis;1;1;2;479
4126272;Saudade do Iguaçu;4205407;Florianópolis;1;1;2;453
4200101;Abelardo Luz;4205407;Florianópolis;1;1;2;392
4200200;Agrolândia;4205407;Florianópolis;1;1;2;131
4200804;Anchieta;4205407;Florianópolis;1;1;2;487
4201505;Armazém;4205407;Florianópolis;1;1;2;89
4201604;Arroio Trinta;4205407;Florianópolis;1;1;2;287
4201802;Atalanta;4205407;Florianópolis;1;1;2;126
4201901;Aurora;4205407;Florianópolis;1;1;2;115
4201950;Balneário Arroio do Silva;4205407;Florianópolis;1;1;2;176
4202057;Balneário Barra do Sul;4205407;Florianópolis;1;1;2;126
4202073;Balneário Gaivota;4205407;Florianópolis;1;1;2;204
4202156;Belmonte;4205407;Florianópolis;1;1;2;507
4202206;Benedito Novo;4205407;Florianópolis;1;1;2;123
4202537;Bom Jesus;4205407;Florianópolis;1;1;2;395
4203105;Caibi;4205407;Florianópolis;1;1;2;473
4203154;Calmon;4205407;Florianópolis;1;1;2;276
4203253;Capão Alto;4205407;Florianópolis;1;1;2;201
4203303;Campo Alegre;4205407;Florianópolis;1;1;2;172
4203501;Campo Erê;4205407;Florianópolis;1;1;2;467
4203709;Canelinha;4205407;Florianópolis;1;1;2;45
4204004;Catanduvas;4205407;Florianópolis;1;1;2;317
4204103;Caxambu do Sul;4205407;Florianópolis;1;1;2;433
4204152;Celso Ramos;4205407;Florianópolis;1;1;2;278
4204178;Cerro Negro;4205407;Florianópolis;1;1;2;237
4204251;Cocal do Sul;4205407;Florianópolis;1;1;2;138
4204400;Coronel Freitas;4205407;Florianópolis;1;1;2;419
4204558;Correia Pinto;4205407;Florianópolis;1;1;2;182
4204707;Cunha Porã;4205407;Florianópolis;1;1;2;464
4204905;Descanso;4205407;Florianópolis;1;1;2;498
4205001;Dionísio Cerqueira;4205407;Florianópolis;1;1;2;523
4205100;Dona Emma;4205407;Florianópolis;1;1;2;137
4205159;Doutor Pedrinho;4205407;Florianópolis;1;1;2;137
4205191;Ermo;4205407;Florianópolis;1;1;2;190
4205209;Erval Velho;4205407;Florianópolis;1;1;2;291
4205308;Faxinal dos Guedes;4205407;Florianópolis;1;1;2;377
4204707;Cunha Porã;4205357;Flor do Sertão;1;1;2;22
3505708;Barueri;4205308;Faxinal dos Guedes;1;1;2;645
3534401;Osasco;4205308;Faxinal dos Guedes;1;1;2;650
3550308;São Paulo;4205308;Faxinal dos Guedes;1;1;2;654
4200101;Abelardo Luz;4205308;Faxinal dos Guedes;1;1;2;33
4204806;Curitibanos;4205308;Faxinal dos Guedes;1;1;2;171
4201406;Araranguá;4205191;Ermo;1;1;2;15
4204202;Chapecó;4205175;Entre Rios;1;1;2;43
4106902;Curitiba;4205159;Doutor Pedrinho;1;1;2;143
4202404;Blumenau;4205159;Doutor Pedrinho;1;1;2;49
3518800;Guarulhos;4205001;Dionísio Cerqueira;1;1;2;766
3534401;Osasco;4205001;Dionísio Cerqueira;1;1;2;741
4104501;Capanema;4205001;Dionísio Cerqueira;1;1;2;68
4108403;Francisco Beltrão;4205001;Dionísio Cerqueira;1;1;2;62
4118501;Pato Branco;4205001;Dionísio Cerqueira;1;1;2;97
4204350;Cordilheira Alta;4205001;Dionísio Cerqueira;1;1;2;126
4204806;Curitibanos;4205001;Dionísio Cerqueira;1;1;2;323
4202156;Belmonte;4204905;Descanso;1;1;2;10
1100023;Ariquemes;4204806;Curitibanos;1;1;2;2248
1100130;Machadinho d'Oeste;4204806;Curitibanos;1;1;2;2246
1503606;Itaituba;4204806;Curitibanos;1;1;2;2599
1505031;Novo Progresso;4204806;Curitibanos;1;1;2;2272
1718758;Rio Sono;4204806;Curitibanos;1;1;2;1999
3106705;Betim;4204806;Curitibanos;1;1;2;1018
3157708;Santa Juliana;4204806;Curitibanos;1;1;2;930
3505708;Barueri;4204806;Curitibanos;1;1;2;553
3534401;Osasco;4204806;Curitibanos;1;1;2;556
4108403;Francisco Beltrão;4204806;Curitibanos;1;1;2;275
4108502;General Carneiro;4204806;Curitibanos;1;1;2;117
4115754;Mauá da Serra;4204806;Curitibanos;1;1;2;378
4116950;Nova Esperança do Sudoeste;4204806;Curitibanos;1;1;2;302
4118501;Pato Branco;4204806;Curitibanos;1;1;2;233
4127106;Telêmaco Borba;4204806;Curitibanos;1;1;2;322
4200101;Abelardo Luz;4204806;Curitibanos;1;1;2;187
4200309;Agronômica;4204806;Curitibanos;1;1;2;86
4200705;Alfredo Wagner;4204806;Curitibanos;1;1;2;134
4201000;Anita Garibaldi;4204806;Curitibanos;1;1;2;70
4201208;Antônio Carlos;4204806;Curitibanos;1;1;2;180
4201257;Apiúna;4204806;Curitibanos;1;1;2;123
4201406;Araranguá;4204806;Curitibanos;1;1;2;216
4201703;Ascurra;4204806;Curitibanos;1;1;2;124
4201901;Aurora;4204806;Curitibanos;1;1;2;96
4202008;Balneário Camboriú;4204806;Curitibanos;1;1;2;192
4202107;Barra Velha;4204806;Curitibanos;1;1;2;199
4202453;Bombinhas;4204806;Curitibanos;1;1;2;205
4202602;Bom Retiro;4204806;Curitibanos;1;1;2;125
4202701;Botuverá;4204806;Curitibanos;1;1;2;151
4202859;Braço do Trombudo;4204806;Curitibanos;1;1;2;69
4202875;Brunópolis;4204806;Curitibanos;1;1;2;27
4202909;Brusque;4204806;Curitibanos;1;1;2;169
4203105;Caibi;4204806;Curitibanos;1;1;2;266
4203204;Camboriú;4204806;Curitibanos;1;1;2;191
4203303;Campo Alegre;4204806;Curitibanos;1;1;2;178
4203402;Campo Belo do Sul;4204806;Curitibanos;1;1;2;71
4203501;Campo Erê;4204806;Curitibanos;1;1;2;263
4203709;Canelinha;4204806;Curitibanos;1;1;2;180
4204251;Cocal do Sul;4204806;Curitibanos;1;1;2;195
4204400;Coronel Freitas;4204806;Curitibanos;1;1;2;212
4204707;Cunha Porã;4204806;Curitibanos;1;1;2;257
3134202;Ituiutaba;4204707;Cunha Porã;1;1;2;947
3534401;Osasco;4204707;Cunha Porã;1;1;2;727
4102604;Barracão;4204707;Cunha Porã;1;1;2;86
4200507;Águas de Chapecó;4204707;Cunha Porã;1;1;2;27
4202578;Bom Jesus do Oeste;4204707;Cunha Porã;1;1;2;24
4204202;Chapecó;4204707;Cunha Porã;1;1;2;59
1302603;Manaus;4204608;Criciúma;1;1;2;2991
1721000;Palmas;4204608;Criciúma;1;1;2;2028
2304285;Eusébio;4204608;Criciúma;1;1;2;2919
2408102;Natal;4204608;Criciúma;1;1;2;2842
2504603;Conde;4204608;Criciúma;1;1;2;2717
2602902;Cabo de Santo Agostinho;4204608;Criciúma;1;1;2;2614
2607901;Jaboatão dos Guararapes;4204608;Criciúma;1;1;2;2630
2616407;Vitória de Santo Antão;4204608;Criciúma;1;1;2;2618
2919207;Lauro de Freitas;4204608;Criciúma;1;1;2;2026
2919553;Luís Eduardo magalhães;4204608;Criciúma;1;1;2;1863
2927408;Salvador;4204608;Criciúma;1;1;2;2008
3144508;Nazareno;4204608;Criciúma;1;1;2;941
3169307;Três Corações;4204608;Criciúma;1;1;2;870
3201209;Cachoeiro de Itapemirim;4204608;Criciúma;1;1;2;1171
3304003;Piraí;4204608;Criciúma;1;1;2;849
3507605;Bragança Paulista;4204608;Criciúma;1;1;2;689
3509205;Cajamar;4204608;Criciúma;1;1;2;635
3511300;Cedral;4204608;Criciúma;1;1;2;860
3513801;Diadema;4204608;Criciúma;1;1;2;612
3516200;Franca;4204608;Criciúma;1;1;2;919
3522406;Itapeva;4204608;Criciúma;1;1;2;521
3527207;Lorena;4204608;Criciúma;1;1;2;775
3530706;Mogi Guaçu;4204608;Criciúma;1;1;2;739
3533403;Nova Odessa;4204608;Criciúma;1;1;2;683
3538709;Piracicaba;4204608;Criciúma;1;1;2;675
3543402;Ribeirão Preto;4204608;Criciúma;1;1;2;845
3548708;São Bernardo do Campo;4204608;Criciúma;1;1;2;610
3548807;São Caetano do Sul;4204608;Criciúma;1;1;2;621
3552205;Sorocaba;4204608;Criciúma;1;1;2;601
3552403;Sumaré;4204608;Criciúma;1;1;2;678
3556701;Vinhedo;4204608;Criciúma;1;1;2;665
3557303;Estiva Gerbi;4204608;Criciúma;1;1;2;748
4101804;Araucária;4204608;Criciúma;1;1;2;341
4109302;Guaraniaçu;4204608;Criciúma;1;1;2;516
4109401;Guarapuava;4204608;Criciúma;1;1;2;414
4118907;Pérola;4204608;Criciúma;1;1;2;677
4119905;Ponta Grossa;4204608;Criciúma;1;1;2;401
4120804;Quatro Barras;4204608;Criciúma;1;1;2;367
4122206;Rio Branco do Sul;4204608;Criciúma;1;1;2;385
4125506;São José dos Pinhais;4204608;Criciúma;1;1;2;347
4201257;Apiúna;4204608;Criciúma;1;1;2;180
4201505;Armazém;4204608;Criciúma;1;1;2;57
4203600;Campos Novos;4204608;Criciúma;1;1;2;225
4203808;Canoinhas;4204608;Criciúma;1;1;2;290
4204558;Correia Pinto;4204608;Criciúma;1;1;2;153
3115300;Cataguases;4204558;Correia Pinto;1;1;2;1010
4108403;Francisco Beltrão;4204558;Correia Pinto;1;1;2;312
4119301;Pinhão;4204558;Correia Pinto;1;1;2;245
4127106;Telêmaco Borba;4204558;Correia Pinto;1;1;2;358
4203402;Campo Belo do Sul;4204558;Correia Pinto;1;1;2;53
4203600;Campos Novos;4204558;Correia Pinto;1;1;2;86
3118601;Contagem;4204509;Corupá;1;1;2;878
3534401;Osasco;4204509;Corupá;1;1;2;401
4104204;Campo Largo;4204509;Corupá;1;1;2;111
4106902;Curitiba;4204509;Corupá;1;1;2;110
4115200;Maringá;4204509;Corupá;1;1;2;424
4119905;Ponta Grossa;4204509;Corupá;1;1;2;172
4202008;Balneário Camboriú;4204509;Corupá;1;1;2;84
4202404;Blumenau;4204509;Corupá;1;1;2;60
4204202;Chapecó;4204459;Coronel Martins;1;1;2;66
3147600;Passa Quatro;4204400;Coronel Freitas;1;1;2;906
3534401;Osasco;4204400;Coronel Freitas;1;1;2;689
3550308;São Paulo;4204400;Coronel Freitas;1;1;2;694
4106902;Curitiba;4204350;Cordilheira Alta;1;1;2;372
4200101;Abelardo Luz;4204350;Cordilheira Alta;1;1;2;55
4202008;Balneário Camboriú;4204350;Cordilheira Alta;1;1;2;393
4202404;Blumenau;4204350;Cordilheira Alta;1;1;2;354
4203006;Caçador;4204350;Cordilheira Alta;1;1;2;155
4203808;Canoinhas;4204350;Cordilheira Alta;1;1;2;236
4204301;Concórdia;4204350;Cordilheira Alta;1;1;2;67
1100205;Porto Velho;4204301;Concórdia;1;1;2;2324
1500800;Ananindeua;4204301;Concórdia;1;1;2;2880
1501402;Belém;4204301;Concórdia;1;1;2;2878
1508407;Xinguara;4204301;Concórdia;1;1;2;2235
2105302;Imperatriz;4204301;Concórdia;1;1;2;2440
2211001;Teresina;4204301;Concórdia;1;1;2;2596
2803203;Itaporanga d'Ajuda;4204301;Concórdia;1;1;2;2268
2905701;Camaçari;4204301;Concórdia;1;1;2;2064
2930709;Simões Filho;4204301;Concórdia;1;1;2;2051
3106200;Belo Horizonte;4204301;Concórdia;1;1;2;1121
3106705;Betim;4204301;Concórdia;1;1;2;1102
3151800;Poços de Caldas;4204301;Concórdia;1;1;2;804
3169604;Tupaciguara;4204301;Concórdia;1;1;2;1007
3200607;Aracruz;4204301;Concórdia;1;1;2;1397
3205200;Vila Velha;4204301;Concórdia;1;1;2;1358
3302007;Itaguaí;4204301;Concórdia;1;1;2;936
3506003;Bauru;4204301;Concórdia;1;1;2;611
3511102;Catanduva;4204301;Concórdia;1;1;2;734
3516200;Franca;4204301;Concórdia;1;1;2;863
3522307;Itapetininga;4204301;Concórdia;1;1;2;559
3525904;Jundiaí;4204301;Concórdia;1;1;2;670
3527306;Louveira;4204301;Concórdia;1;1;2;673
3536505;Paulínia;4204301;Concórdia;1;1;2;684
3548708;São Bernardo do Campo;4204301;Concórdia;1;1;2;657
3549904;São José dos Campos;4204301;Concórdia;1;1;2;745
3554003;Tatuí;4204301;Concórdia;1;1;2;591
4102604;Barracão;4204301;Concórdia;1;1;2;193
4102901;Bituruna;4204301;Concórdia;1;1;2;126
4103024;Boa Esperança do Iguaçu;4204301;Concórdia;1;1;2;211
4105805;Colombo;4204301;Concórdia;1;1;2;349
4106456;Coronel Domingos Soares;4204301;Concórdia;1;1;2;110
4107207;Dois Vizinhos;4204301;Concórdia;1;1;2;193
4109302;Guaraniaçu;4204301;Concórdia;1;1;2;247
4115408;Marmeleiro;4204301;Concórdia;1;1;2;155
4116950;Nova Esperança do Sudoeste;4204301;Concórdia;1;1;2;190
4118402;Paranavaí;4204301;Concórdia;1;1;2;458
4122404;Rolândia;4204301;Concórdia;1;1;2;438
4123006;Salto do Lontra;4204301;Concórdia;1;1;2;204
4125753;São Pedro do Iguaçu;4204301;Concórdia;1;1;2;311
4200101;Abelardo Luz;4204301;Concórdia;1;1;2;79
4200754;Alto Bela Vista;4204301;Concórdia;1;1;2;27
4201653;Arvoredo;4204301;Concórdia;1;1;2;46
4202008;Balneário Camboriú;4204301;Concórdia;1;1;2;331
4202131;Bela Vista do Toldo;4204301;Concórdia;1;1;2;186
4202404;Blumenau;4204301;Concórdia;1;1;2;292
4202800;Braço do Norte;4204301;Concórdia;1;1;2;307
4203303;Campo Alegre;4204301;Concórdia;1;1;2;294
4203501;Campo Erê;4204301;Concórdia;1;1;2;139
4203808;Canoinhas;4204301;Concórdia;1;1;2;194
4204004;Catanduvas;4204301;Concórdia;1;1;2;37
2304400;Fortaleza;4204251;Cocal do Sul;1;1;2;2921
2927408;Salvador;4204251;Cocal do Sul;1;1;2;2000
3509502;Campinas;4204251;Cocal do Sul;1;1;2;668
3516200;Franca;4204251;Cocal do Sul;1;1;2;911
3525904;Jundiaí;4204251;Cocal do Sul;1;1;2;644
3530706;Mogi Guaçu;4204251;Cocal do Sul;1;1;2;731
3534401;Osasco;4204251;Cocal do Sul;1;1;2;612
3543907;Rio Claro;4204251;Cocal do Sul;1;1;2;706
4104204;Campo Largo;4204251;Cocal do Sul;1;1;2;349
4106902;Curitiba;4204251;Cocal do Sul;1;1;2;351
4113700;Londrina;4204251;Cocal do Sul;1;1;2;613
4119905;Ponta Grossa;4204251;Cocal do Sul;1;1;2;396
1302603;Manaus;4204202;Chapecó;1;1;2;2744
1400100;Boa Vista;4204202;Chapecó;1;1;2;3401
1501402;Belém;4204202;Chapecó;1;1;2;2873
1504208;Marabá;4204202;Chapecó;1;1;2;2428
1721000;Palmas;4204202;Chapecó;1;1;2;1897
2308005;Massapê;4204202;Chapecó;1;1;2;2851
2408102;Natal;4204202;Chapecó;1;1;2;2864
2507507;João Pessoa;4204202;Chapecó;1;1;2;2764
2609600;Olinda;4204202;Chapecó;1;1;2;2691
2611606;Recife;4204202;Chapecó;1;1;2;2679
2616407;Vitória de Santo Antão;4204202;Chapecó;1;1;2;2659
2910800;Feira de Santana;4204202;Chapecó;1;1;2;2088
2927408;Salvador;4204202;Chapecó;1;1;2;2059
3118601;Contagem;4204202;Chapecó;1;1;2;1146
3170206;Uberlândia;4204202;Chapecó;1;1;2;1001
3205002;Serra;4204202;Chapecó;1;1;2;1419
3305505;Saquarema;4204202;Chapecó;1;1;2;1097
3502804;Araçatuba;4204202;Chapecó;1;1;2;685
3503307;Araras;4204202;Chapecó;1;1;2;733
3509254;Cajati;4204202;Chapecó;1;1;2;515
3516200;Franca;4204202;Chapecó;1;1;2;885
3522604;Itapira;4204202;Chapecó;1;1;2;766
3525003;Jandira;4204202;Chapecó;1;1;2;685
3525904;Jundiaí;4204202;Chapecó;1;1;2;708
3527108;Lins;4204202;Chapecó;1;1;2;662
3543402;Ribeirão Preto;4204202;Chapecó;1;1;2;809
3544103;Rio Grande da Serra;4204202;Chapecó;1;1;2;715
3547304;Santana de Parnaíba;4204202;Chapecó;1;1;2;690
3548807;São Caetano do Sul;4204202;Chapecó;1;1;2;708
3549904;São José dos Campos;4204202;Chapecó;1;1;2;788
3552205;Sorocaba;4204202;Chapecó;1;1;2;642
3552809;Taboão da Serra;4204202;Chapecó;1;1;2;692
3556453;Vargem Grande Paulista;4204202;Chapecó;1;1;2;671
3556701;Vinhedo;4204202;Chapecó;1;1;2;713
4102901;Bituruna;4204202;Chapecó;1;1;2;149
4104659;Carambeí;4204202;Chapecó;1;1;2;347
4107207;Dois Vizinhos;4204202;Chapecó;1;1;2;158
4107850;Flor da Serra do Sul;4204202;Chapecó;1;1;2;119
4108601;Goioerê;4204202;Chapecó;1;1;2;325
4109401;Guarapuava;4204202;Chapecó;1;1;2;222
4109807;Ibiporã;4204202;Chapecó;1;1;2;452
4110409;Indianópolis;4204202;Chapecó;1;1;2;403
4111209;Itapejara d'Oeste;4204202;Chapecó;1;1;2;128
4115408;Marmeleiro;4204202;Chapecó;1;1;2;114
4118600;Paula Freitas;4204202;Chapecó;1;1;2;194
4119509;Piraquara;4204202;Chapecó;1;1;2;396
4119806;Planalto;4204202;Chapecó;1;1;2;191
4120804;Quatro Barras;4204202;Chapecó;1;1;2;399
4122305;Rio Negro;4204202;Chapecó;1;1;2;300
4127502;Tibagi;4204202;Chapecó;1;1;2;361
4127700;Toledo;4204202;Chapecó;1;1;2;287
4201653;Arvoredo;4204202;Chapecó;1;1;2;17
4202800;Braço do Norte;4204202;Chapecó;1;1;2;368
4203204;Camboriú;4204202;Chapecó;1;1;2;390
4203600;Campos Novos;4204178;Cerro Negro;1;1;2;50
4201000;Anita Garibaldi;4204152;Celso Ramos;1;1;2;21
3170206;Uberlândia;4204004;Catanduvas;1;1;2;962
4107207;Dois Vizinhos;4204004;Catanduvas;1;1;2;200
4108502;General Carneiro;4204004;Catanduvas;1;1;2;80
4115408;Marmeleiro;4204004;Catanduvas;1;1;2;167
4200408;Água Doce;4204004;Catanduvas;1;1;2;15
4203600;Campos Novos;4204004;Catanduvas;1;1;2;61
3106200;Belo Horizonte;4203956;Capivari de Baixo;1;1;2;1057
3505708;Barueri;4203956;Capivari de Baixo;1;1;2;582
3512407;Cordeirópolis;4203956;Capivari de Baixo;1;1;2;676
3524402;Jacareí;4203956;Capivari de Baixo;1;1;2;637
3547304;Santana de Parnaíba;4203956;Capivari de Baixo;1;1;2;588
3549904;São José dos Campos;4203956;Capivari de Baixo;1;1;2;652
4201406;Araranguá;4203956;Capivari de Baixo;1;1;2;76
4202008;Balneário Camboriú;4203956;Capivari de Baixo;1;1;2;164
2928901;São Desidério;4203907;Capinzal;1;1;2;1772
3516200;Franca;4203907;Capinzal;1;1;2;855
3534401;Osasco;4203907;Capinzal;1;1;2;631
3552403;Sumaré;4203907;Capinzal;1;1;2;655
2611606;Recife;4203808;Canoinhas;1;1;2;2483
3534401;Osasco;4203808;Canoinhas;1;1;2;464
3548807;São Caetano do Sul;4203808;Canoinhas;1;1;2;477
3552403;Sumaré;4203808;Canoinhas;1;1;2;486
4101804;Araucária;4203808;Canoinhas;1;1;2;122
4104907;Castro;4203808;Canoinhas;1;1;2;161
4108403;Francisco Beltrão;4203808;Canoinhas;1;1;2;264
4109401;Guarapuava;4203808;Canoinhas;1;1;2;137
4110201;Inácio Martins;4203808;Canoinhas;1;1;2;96
4113205;Lapa;4203808;Canoinhas;1;1;2;85
4116950;Nova Esperança do Sudoeste;4203808;Canoinhas;1;1;2;286
4201307;Araquari;4203808;Canoinhas;1;1;2;164
4201406;Araranguá;4203808;Canoinhas;1;1;2;318
4202008;Balneário Camboriú;4203808;Canoinhas;1;1;2;194
4203204;Camboriú;4203808;Canoinhas;1;1;2;195
4202701;Botuverá;4203709;Canelinha;1;1;2;29
4202909;Brusque;4203709;Canelinha;1;1;2;23
3148004;Patos de Minas;4203600;Campos Novos;1;1;2;1078
3304557;Rio de Janeiro;4203600;Campos Novos;1;1;2;922
3516200;Franca;4203600;Campos Novos;1;1;2;846
3524006;Itupeva;4203600;Campos Novos;1;1;2;622
3534401;Osasco;4203600;Campos Novos;1;1;2;609
3542602;Registro;4203600;Campos Novos;1;1;2;458
3543907;Rio Claro;4203600;Campos Novos;1;1;2;659
3548708;São Bernardo do Campo;4203600;Campos Novos;1;1;2;610
3550308;São Paulo;4203600;Campos Novos;1;1;2;610
4108403;Francisco Beltrão;4203600;Campos Novos;1;1;2;234
4200408;Água Doce;4203600;Campos Novos;1;1;2;58
4201257;Apiúna;4203600;Campos Novos;1;1;2;185
4202404;Blumenau;4203600;Campos Novos;1;1;2;218
4202438;Bocaina do Sul;4203600;Campos Novos;1;1;2;131
4202453;Bombinhas;4203600;Campos Novos;1;1;2;266
4202503;Bom Jardim da Serra;4203600;Campos Novos;1;1;2;188
4202602;Bom Retiro;4203600;Campos Novos;1;1;2;176
3534401;Osasco;4203501;Campo Erê;1;1;2;696
4102604;Barracão;4203501;Campo Erê;1;1;2;58
4117602;Palmas;4203501;Campo Erê;1;1;2;111
4124806;São João;4203501;Campo Erê;1;1;2;72
4201000;Anita Garibaldi;4203402;Campo Belo do Sul;1;1;2;43
4203253;Capão Alto;4203402;Campo Belo do Sul;1;1;2;25
3556206;Valinhos;4203303;Campo Alegre;1;1;2;421
4118402;Paranavaí;4203303;Campo Alegre;1;1;2;465
4119152;Pinhais;4203303;Campo Alegre;1;1;2;83
4122008;Rio Azul;4203303;Campo Alegre;1;1;2;161
4127601;Tijucas do Sul;4203303;Campo Alegre;1;1;2;30
2304400;Fortaleza;4203204;Camboriú;1;1;2;2743
3143302;Montes Claros;4203204;Camboriú;1;1;2;1230
3304557;Rio de Janeiro;4203204;Camboriú;1;1;2;701
3505708;Barueri;4203204;Camboriú;1;1;2;428
3511102;Catanduva;4203204;Camboriú;1;1;2;652
3534401;Osasco;4203204;Camboriú;1;1;2;429
4101804;Araucária;4203204;Camboriú;1;1;2;174
4202107;Barra Velha;4203204;Camboriú;1;1;2;44
4202404;Blumenau;4203204;Camboriú;1;1;2;39
4108502;General Carneiro;4203154;Calmon;1;1;2;29
3103504;Araguari;4203105;Caibi;1;1;2;1053
3534401;Osasco;4203105;Caibi;1;1;2;746
4108304;Foz do Iguaçu;4203105;Caibi;1;1;2;210
4120606;Prudentópolis;4203105;Caibi;1;1;2;302
4200507;Águas de Chapecó;4203105;Caibi;1;1;2;29
3304557;Rio de Janeiro;4203006;Caçador;1;1;2;881
3506003;Bauru;4203006;Caçador;1;1;2;532
3516200;Franca;4203006;Caçador;1;1;2;780
3524600;Jacupiranga;4203006;Caçador;1;1;2;384
3530706;Mogi Guaçu;4203006;Caçador;1;1;2;640
3542602;Registro;4203006;Caçador;1;1;2;405
4104808;Cascavel;4203006;Caçador;1;1;2;311
4104907;Castro;4203006;Caçador;1;1;2;246
4105409;Chopinzinho;4203006;Caçador;1;1;2;176
4106456;Coronel Domingos Soares;4203006;Caçador;1;1;2;113
4111803;Jacarezinho;4203006;Caçador;1;1;2;417
4113205;Lapa;4203006;Caçador;1;1;2;178
4115200;Maringá;4203006;Caçador;1;1;2;382
4116950;Nova Esperança do Sudoeste;4203006;Caçador;1;1;2;237
4118204;Paranaguá;4203006;Caçador;1;1;2;285
4200408;Água Doce;4203006;Caçador;1;1;2;51
4202305;Biguaçu;4203006;Caçador;1;1;2;251
4202800;Braço do Norte;4203006;Caçador;1;1;2;253
3134905;Jacutinga;4202909;Brusque;1;1;2;577
3303500;Nova Iguaçu;4202909;Brusque;1;1;2;715
3502804;Araçatuba;4202909;Brusque;1;1;2;667
3504107;Atibaia;4202909;Brusque;1;1;2;497
3505708;Barueri;4202909;Brusque;1;1;2;444
3509502;Campinas;4202909;Brusque;1;1;2;498
3516200;Franca;4202909;Brusque;1;1;2;740
3518800;Guarulhos;4202909;Brusque;1;1;2;465
3519600;Ibitinga;4202909;Brusque;1;1;2;591
3525003;Jandira;4202909;Brusque;1;1;2;441
3526100;Juquiá;4202909;Brusque;1;1;2;331
3526902;Limeira;4202909;Brusque;1;1;2;523
3541406;Presidente Prudente;4202909;Brusque;1;1;2;600
3543402;Ribeirão Preto;4202909;Brusque;1;1;2;667
3547304;Santana de Parnaíba;4202909;Brusque;1;1;2;449
4101507;Arapongas;4202909;Brusque;1;1;2;477
4101804;Araucária;4202909;Brusque;1;1;2;174
4104204;Campo Largo;4202909;Brusque;1;1;2;191
4104808;Cascavel;4202909;Brusque;1;1;2;506
4105805;Colombo;4202909;Brusque;1;1;2;206
4108304;Foz do Iguaçu;4202909;Brusque;1;1;2;577
4109401;Guarapuava;4202909;Brusque;1;1;2;314
4112108;Jandaia do Sul;4202909;Brusque;1;1;2;470
4118204;Paranaguá;4202909;Brusque;1;1;2;171
4127700;Toledo;4202909;Brusque;1;1;2;544
4128807;Xambrê;4202909;Brusque;1;1;2;582
4202305;Biguaçu;4202909;Brusque;1;1;2;49
3118601;Contagem;4202859;Braço do Trombudo;1;1;2;996
2211001;Teresina;4202800;Braço do Norte;1;1;2;2632
2611101;Petrolina;4202800;Braço do Norte;1;1;2;2247
3509205;Cajamar;4202800;Braço do Norte;1;1;2;588
3516200;Franca;4202800;Braço do Norte;1;1;2;873
3534401;Osasco;4202800;Braço do Norte;1;1;2;573
4125506;São José dos Pinhais;4202800;Braço do Norte;1;1;2;303
4128203;União da Vitória;4202800;Braço do Norte;1;1;2;293
3303500;Nova Iguaçu;4202701;Botuverá;1;1;2;734
4105508;Cianorte;4202701;Botuverá;1;1;2;521
4115200;Maringá;4202701;Botuverá;1;1;2;502
4104907;Castro;4202602;Bom Retiro;1;1;2;339
4106902;Curitiba;4202602;Bom Retiro;1;1;2;262
4202438;Bocaina do Sul;4202602;Bom Retiro;1;1;2;45
4200556;Águas Frias;4202578;Bom Jesus do Oeste;1;1;2;30
4200101;Abelardo Luz;4202537;Bom Jesus;1;1;2;21
3534401;Osasco;4202453;Bombinhas;1;1;2;435
3550308;São Paulo;4202453;Bombinhas;1;1;2;428
4106902;Curitiba;4202453;Bombinhas;1;1;2;203
4202404;Blumenau;4202438;Bocaina do Sul;1;1;2;122
1200401;Rio Branco;4202404;Blumenau;1;1;2;2580
1400100;Boa Vista;4202404;Blumenau;1;1;2;3473
1500800;Ananindeua;4202404;Blumenau;1;1;2;2830
1504208;Marabá;4202404;Blumenau;1;1;2;2388
1600303;Macapá;4202404;Blumenau;1;1;2;2995
1721000;Palmas;4202404;Blumenau;1;1;2;1837
2105302;Imperatriz;4202404;Blumenau;1;1;2;2377
2111300;São Luís;4202404;Blumenau;1;1;2;2739
2211001;Teresina;4202404;Blumenau;1;1;2;2489
2305233;Horizonte;4202404;Blumenau;1;1;2;2716
2403251;Parnamirim;4202404;Blumenau;1;1;2;2664
2405801;João Câmara;4202404;Blumenau;1;1;2;2676
2408102;Natal;4202404;Blumenau;1;1;2;2675
2507507;João Pessoa;4202404;Blumenau;1;1;2;2563
2704302;Maceió;4202404;Blumenau;1;1;2;2291
2800308;Aracaju;4202404;Blumenau;1;1;2;2108
2933307;Vitória da Conquista;4202404;Blumenau;1;1;2;1551
3118601;Contagem;4202404;Blumenau;1;1;2;916
3143302;Montes Claros;4202404;Blumenau;1;1;2;1236
3143401;Monte Sião;4202404;Blumenau;1;1;2;557
3147204;Paraguaçu;4202404;Blumenau;1;1;2;681
3170107;Uberaba;4202404;Blumenau;1;1;2;806
3201209;Cachoeiro de Itapemirim;4202404;Blumenau;1;1;2;1030
3201308;Cariacica;4202404;Blumenau;1;1;2;1117
3205002;Serra;4202404;Blumenau;1;1;2;1136
3205101;Viana;4202404;Blumenau;1;1;2;1097
3205200;Vila Velha;4202404;Blumenau;1;1;2;1117
3305109;São João de Meriti;4202404;Blumenau;1;1;2;722
3305505;Saquarema;4202404;Blumenau;1;1;2;789
3500709;Agudos;4202404;Blumenau;1;1;2;495
3501608;Americana;4202404;Blumenau;1;1;2;496
3510609;Carapicuíba;4202404;Blumenau;1;1;2;438
3522208;Itapecerica da Serra;4202404;Blumenau;1;1;2;419
3526704;Leme;4202404;Blumenau;1;1;2;552
3526902;Limeira;4202404;Blumenau;1;1;2;513
3529906;Miracatu;4202404;Blumenau;1;1;2;336
3538006;Pindamonhangaba;4202404;Blumenau;1;1;2;569
3538709;Piracicaba;4202404;Blumenau;1;1;2;485
3540754;Potim;4202404;Blumenau;1;1;2;589
3541406;Presidente Prudente;4202404;Blumenau;1;1;2;579
3545308;Salto de Pirapora;4202404;Blumenau;1;1;2;394
3548500;Santos;4202404;Blumenau;1;1;2;431
4102901;Bituruna;4202404;Blumenau;1;1;2;260
4104204;Campo Largo;4202404;Blumenau;1;1;2;171
4104808;Cascavel;4202404;Blumenau;1;1;2;485
4106407;Cornélio Procópio;4202404;Blumenau;1;1;2;445
4107652;Fazenda Rio Grande;4202404;Blumenau;1;1;2;145
4117909;Palotina;4202404;Blumenau;1;1;2;550
4118204;Paranaguá;4202404;Blumenau;1;1;2;160
4118501;Pato Branco;4202404;Blumenau;1;1;2;364
4119152;Pinhais;4202404;Blumenau;1;1;2;167
4120804;Quatro Barras;4202404;Blumenau;1;1;2;175
4122305;Rio Negro;4202404;Blumenau;1;1;2;118
4123006;Salto do Lontra;4202404;Blumenau;1;1;2;438
4128104;Umuarama;4202404;Blumenau;1;1;2;547
4201406;Araranguá;4202404;Blumenau;1;1;2;225
4202107;Barra Velha;4202404;Blumenau;1;1;2;50
4202305;Biguaçu;4202404;Blumenau;1;1;2;71
2408102;Natal;4202305;Biguaçu;1;1;2;2707
3106705;Betim;4202305;Biguaçu;1;1;2;940
3118601;Contagem;4202305;Biguaçu;1;1;2;949
3301702;Duque de Caxias;4202305;Biguaçu;1;1;2;740
3505708;Barueri;4202305;Biguaçu;1;1;2;476
3516200;Franca;4202305;Biguaçu;1;1;2;780
3525102;Jardinópolis;4202305;Biguaçu;1;1;2;723
3525904;Jundiaí;4202305;Biguaçu;1;1;2;509
3534401;Osasco;4202305;Biguaçu;1;1;2;476
3536505;Paulínia;4202305;Biguaçu;1;1;2;545
4101002;Ampére;4202305;Biguaçu;1;1;2;500
4105805;Colombo;4202305;Biguaçu;1;1;2;254
4109609;Guaratuba;4202305;Biguaçu;1;1;2;172
4115200;Maringá;4202305;Biguaçu;1;1;2;549
4126256;Sarandi;4202305;Biguaçu;1;1;2;545
4202008;Balneário Camboriú;4202305;Biguaçu;1;1;2;56
3534401;Osasco;4202206;Benedito Novo;1;1;2;440
3550308;São Paulo;4202206;Benedito Novo;1;1;2;438
4106902;Curitiba;4202206;Benedito Novo;1;1;2;150
4201257;Apiúna;4202206;Benedito Novo;1;1;2;28
4201703;Ascurra;4202206;Benedito Novo;1;1;2;19
4202008;Balneário Camboriú;4202206;Benedito Novo;1;1;2;73
2919553;Luís Eduardo magalhães;4202107;Barra Velha;1;1;2;1632
3505708;Barueri;4202107;Barra Velha;1;1;2;390
3524402;Jacareí;4202107;Barra Velha;1;1;2;457
3529401;Mauá;4202107;Barra Velha;1;1;2;396
3550308;São Paulo;4202107;Barra Velha;1;1;2;388
4106902;Curitiba;4202107;Barra Velha;1;1;2;144
4119152;Pinhais;4202107;Barra Velha;1;1;2;139
3546702;Santa Gertrudes;4202073;Balneário Gaivota;1;1;2;767
4201950;Balneário Arroio do Silva;4202073;Balneário Gaivota;1;1;2;28
3205200;Vila Velha;4202057;Balneário Barra do Sul;1;1;2;1057
3513702;Descalvado;4202057;Balneário Barra do Sul;1;1;2;516
3543907;Rio Claro;4202057;Balneário Barra do Sul;1;1;2;463
4101804;Araucária;4202057;Balneário Barra do Sul;1;1;2;121
4113700;Londrina;4202057;Balneário Barra do Sul;1;1;2;427
1100205;Porto Velho;4202008;Balneário Camboriú;1;1;2;2471
1200401;Rio Branco;4202008;Balneário Camboriú;1;1;2;2608
1501402;Belém;4202008;Balneário Camboriú;1;1;2;2833
1504208;Marabá;4202008;Balneário Camboriú;1;1;2;2392
1505536;Parauapebas;4202008;Balneário Camboriú;1;1;2;2324
1506807;Santarém;4202008;Balneário Camboriú;1;1;2;2770
1600303;Macapá;4202008;Balneário Camboriú;1;1;2;3002
2111300;São Luís;4202008;Balneário Camboriú;1;1;2;2737
2211001;Teresina;4202008;Balneário Camboriú;1;1;2;2485
2304400;Fortaleza;4202008;Balneário Camboriú;1;1;2;2739
2307304;Juazeiro do Norte;4202008;Balneário Camboriú;1;1;2;2357
2403251;Parnamirim;4202008;Balneário Camboriú;1;1;2;2650
2501807;Bayeux;4202008;Balneário Camboriú;1;1;2;2549
2611606;Recife;4202008;Balneário Camboriú;1;1;2;2456
2707701;Rio Largo;4202008;Balneário Camboriú;1;1;2;2284
2800308;Aracaju;4202008;Balneário Camboriú;1;1;2;2091
2913606;Ilhéus;4202008;Balneário Camboriú;1;1;2;1628
2919207;Lauro de Freitas;4202008;Balneário Camboriú;1;1;2;1844
2927408;Salvador;4202008;Balneário Camboriú;1;1;2;1827
3117876;Confins;4202008;Balneário Camboriú;1;1;2;932
3143302;Montes Claros;4202008;Balneário Camboriú;1;1;2;1225
3170206;Uberlândia;4202008;Balneário Camboriú;1;1;2;896
3200136;Águia Branca;4202008;Balneário Camboriú;1;1;2;1171
3201209;Cachoeiro de Itapemirim;4202008;Balneário Camboriú;1;1;2;1004
3300100;Angra dos Reis;4202008;Balneário Camboriú;1;1;2;622
3300407;Barra Mansa;4202008;Balneário Camboriú;1;1;2;659
3305406;Sapucaia;4202008;Balneário Camboriú;1;1;2;788
3509502;Campinas;4202008;Balneário Camboriú;1;1;2;480
3513009;Cotia;4202008;Balneário Camboriú;1;1;2;413
3513801;Diadema;4202008;Balneário Camboriú;1;1;2;418
3515004;Embu;4202008;Balneário Camboriú;1;1;2;411
3516200;Franca;4202008;Balneário Camboriú;1;1;2;725
3519600;Ibitinga;4202008;Balneário Camboriú;1;1;2;580
3520509;Indaiatuba;4202008;Balneário Camboriú;1;1;2;454
3523206;Itararé;4202008;Balneário Camboriú;1;1;2;326
3523909;Itu;4202008;Balneário Camboriú;1;1;2;432
3526902;Limeira;4202008;Balneário Camboriú;1;1;2;506
3529005;Marília;4202008;Balneário Camboriú;1;1;2;542
3543402;Ribeirão Preto;4202008;Balneário Camboriú;1;1;2;652
3546702;Santa Gertrudes;4202008;Balneário Camboriú;1;1;2;514
3548708;São Bernardo do Campo;4202008;Balneário Camboriú;1;1;2;416
4100202;Adrianópolis;4202008;Balneário Camboriú;1;1;2;257
4101408;Apucarana;4202008;Balneário Camboriú;1;1;2;467
4101804;Araucária;4202008;Balneário Camboriú;1;1;2;171
4102604;Barracão;4202008;Balneário Camboriú;1;1;2;496
4108809;Guaíra;4202008;Balneário Camboriú;1;1;2;632
4115200;Maringá;4202008;Balneário Camboriú;1;1;2;506
4115408;Marmeleiro;4202008;Balneário Camboriú;1;1;2;440
4200200;Agrolândia;4202008;Balneário Camboriú;1;1;2;123
4201257;Apiúna;4202008;Balneário Camboriú;1;1;2;70
4201307;Araquari;4202008;Balneário Camboriú;1;1;2;69
4115804;Medianeira;4201901;Aurora;1;1;2;492
4200200;Agrolândia;4201901;Aurora;1;1;2;21
4106902;Curitiba;4201802;Atalanta;1;1;2;225
4200200;Agrolândia;4201802;Atalanta;1;1;2;5
3143302;Montes Claros;4201703;Ascurra;1;1;2;1250
3304557;Rio de Janeiro;4201703;Ascurra;1;1;2;751
4108502;General Carneiro;4201604;Arroio Trinta;1;1;2;56
2210607;São Raimundo Nonato;4201406;Araranguá;1;1;2;2296
2615607;Trindade;4201406;Araranguá;1;1;2;2488
3136702;Juiz de Fora;4201406;Araranguá;1;1;2;987
3205101;Viana;4201406;Araranguá;1;1;2;1265
3302254;Itatiaia;4201406;Araranguá;1;1;2;854
3509502;Campinas;4201406;Araranguá;1;1;2;709
3515004;Embu;4201406;Araranguá;1;1;2;638
3516200;Franca;4201406;Araranguá;1;1;2;951
3534401;Osasco;4201406;Araranguá;1;1;2;652
3548807;São Caetano do Sul;4201406;Araranguá;1;1;2;653
3549805;São José do Rio Preto;4201406;Araranguá;1;1;2;900
4118204;Paranaguá;4201406;Araranguá;1;1;2;383
4119152;Pinhais;4201406;Araranguá;1;1;2;389
4124103;Santo Antônio da Platina;4201406;Araranguá;1;1;2;628
3106200;Belo Horizonte;4201307;Araquari;1;1;2;856
3128709;Guaxupé;4201307;Araquari;1;1;2;597
3205002;Serra;4201307;Araquari;1;1;2;1078
3300407;Barra Mansa;4201307;Araquari;1;1;2;620
3300704;Cabo Frio;4201307;Araquari;1;1;2;766
3515707;Ferraz de Vasconcelos;4201307;Araquari;1;1;2;394
3522109;Itanhaém;4201307;Araquari;1;1;2;313
3526704;Leme;4201307;Araquari;1;1;2;483
3530607;Moji das Cruzes;4201307;Araquari;1;1;2;404
3534401;Osasco;4201307;Araquari;1;1;2;371
3543402;Ribeirão Preto;4201307;Araquari;1;1;2;586
3546702;Santa Gertrudes;4201307;Araquari;1;1;2;451
3553955;Tarumã;4201307;Araquari;1;1;2;439
4103701;Cambé;4201307;Araquari;1;1;2;420
4104204;Campo Largo;4201307;Araquari;1;1;2;125
4117602;Palmas;4201307;Araquari;1;1;2;319
4118204;Paranaguá;4201307;Araquari;1;1;2;90
4119152;Pinhais;4201307;Araquari;1;1;2;111
3151800;Poços de Caldas;4201257;Apiúna;1;1;2;645
3509502;Campinas;4201257;Apiúna;1;1;2;512
3518800;Guarulhos;4201257;Apiúna;1;1;2;485
3534401;Osasco;4201257;Apiúna;1;1;2;464
4117222;Nova Santa Rosa;4201257;Apiúna;1;1;2;531
3304557;Rio de Janeiro;4201000;Anita Garibaldi;1;1;2;929
4200051;Abdon Batista;4201000;Anita Garibaldi;1;1;2;14
4200705;Alfredo Wagner;4200903;Angelina;1;1;2;37
3550308;São Paulo;4200754;Alto Bela Vista;1;1;2;662
4101804;Araucária;4200705;Alfredo Wagner;1;1;2;234
3148103;Patrocínio;4200556;Águas Frias;1;1;2;1045
3550308;São Paulo;4200556;Águas Frias;1;1;2;707
4114401;Mangueirinha;4200556;Águas Frias;1;1;2;124
3550308;São Paulo;4200507;Águas de Chapecó;1;1;2;726
3550308;São Paulo;4200408;Água Doce;1;1;2;607
3552205;Sorocaba;4200408;Água Doce;1;1;2;556
4108502;General Carneiro;4200408;Água Doce;1;1;2;67
4117602;Palmas;4200408;Água Doce;1;1;2;69
4118501;Pato Branco;4200408;Água Doce;1;1;2;139
4123857;Santa Maria do Oeste;4200408;Água Doce;1;1;2;230
3534401;Osasco;4200200;Agrolândia;1;1;2;521
3556701;Vinhedo;4200200;Agrolândia;1;1;2;559
3148004;Patos de Minas;4200101;Abelardo Luz;1;1;2;1048
3534401;Osasco;4200101;Abelardo Luz;1;1;2;640
3550308;São Paulo;4200101;Abelardo Luz;1;1;2;645
4106506;Coronel Vivida;4200101;Abelardo Luz;1;1;2;67
4106902;Curitiba;4200101;Abelardo Luz;1;1;2;326
4109401;Guarapuava;4200101;Abelardo Luz;1;1;2;156
4115309;Mariópolis;4200101;Abelardo Luz;1;1;2;33
4117909;Palotina;4200101;Abelardo Luz;1;1;2;291
4124400;Santo Antônio do Sudoeste;4200101;Abelardo Luz;1;1;2;149
4128203;União da Vitória;4200101;Abelardo Luz;1;1;2;122
4128708;Vitorino;4200101;Abelardo Luz;1;1;2;55
4106902;Curitiba;4200051;Abdon Batista;1;1;2;295
4114708;Maria Helena;4128807;Xambrê;1;1;2;32
4128104;Umuarama;4128807;Xambrê;1;1;2;18
3304557;Rio de Janeiro;4128708;Vitorino;1;1;2;1011
4104808;Cascavel;4128708;Vitorino;1;1;2;162
4115200;Maringá;4128708;Vitorino;1;1;2;326
4117602;Palmas;4128708;Vitorino;1;1;2;85
4125209;São Jorge d'Oeste;4128708;Vitorino;1;1;2;65
4128203;União da Vitória;4128708;Vitorino;1;1;2;163
3522653;Itapirapuã Paulista;4128633;Doutor Ulysses;1;1;2;26
3550308;São Paulo;4128633;Doutor Ulysses;1;1;2;297
4106902;Curitiba;4128625;Alto Paraíso;1;1;2;504
4108809;Guaíra;4128625;Alto Paraíso;1;1;2;84
4107405;Enéas Marques;4128609;Verê;1;1;2;27
4108403;Francisco Beltrão;4128609;Verê;1;1;2;27
4111209;Itapejara d'Oeste;4128609;Verê;1;1;2;13
4115804;Medianeira;4128559;Vera Cruz do Oeste;1;1;2;34
2408003;Mossoró;4128534;Ventania;1;1;2;2451
2918407;Juazeiro;4128534;Ventania;1;1;2;1889
3523206;Itararé;4128534;Ventania;1;1;2;93
3550308;São Paulo;4128534;Ventania;1;1;2;370
4106209;Contenda;4128534;Ventania;1;1;2;174
4107751;Figueira;4128534;Ventania;1;1;2;47
4109708;Ibaiti;4128534;Ventania;1;1;2;43
4110078;Imbaú;4128534;Ventania;1;1;2;57
4111704;Jaboti;4128534;Ventania;1;1;2;58
4112009;Jaguariaíva;4128534;Ventania;1;1;2;56
4119400;Piraí do Sul;4128534;Ventania;1;1;2;46
4124707;São Jerônimo da Serra;4128534;Ventania;1;1;2;76
4126306;Sengés;4128534;Ventania;1;1;2;80
3505807;Bastos;4128500;Wenceslau Braz;1;1;2;235
3523206;Itararé;4128500;Wenceslau Braz;1;1;2;55
3534401;Osasco;4128500;Wenceslau Braz;1;1;2;311
3553807;Taquarituba;4128500;Wenceslau Braz;1;1;2;70
4101804;Araucária;4128500;Wenceslau Braz;1;1;2;195
4102109;Astorga;4128500;Wenceslau Braz;1;1;2;200
4104907;Castro;4128500;Wenceslau Braz;1;1;2;104
4106407;Cornélio Procópio;4128500;Wenceslau Braz;1;1;2;114
4111704;Jaboti;4128500;Wenceslau Braz;1;1;2;30
4111803;Jacarezinho;4128500;Wenceslau Braz;1;1;2;82
4119202;Pinhalão;4128500;Wenceslau Braz;1;1;2;25
4120705;Quatiguá;4128500;Wenceslau Braz;1;1;2;35
4121802;Ribeirão Claro;4128500;Wenceslau Braz;1;1;2;75
4127809;Tomazina;4128500;Wenceslau Braz;1;1;2;17
3534401;Osasco;4128401;Uraí;1;1;2;412
3553955;Tarumã;4128401;Uraí;1;1;2;55
4103602;Cambará;4128401;Uraí;1;1;2;76
4109708;Ibaiti;4128401;Uraí;1;1;2;96
4121307;Rancho Alegre;4128401;Uraí;1;1;2;19
4122404;Rolândia;4128401;Uraí;1;1;2;60
4123204;Santa Cecília do Pavão;4128401;Uraí;1;1;2;35
4124103;Santo Antônio da Platina;4128401;Uraí;1;1;2;71
4111308;Itaúna do Sul;4128302;Uniflor;1;1;2;84
4118105;Paranacity;4128302;Uniflor;1;1;2;17
1100304;Vilhena;4128203;União da Vitória;1;1;2;1723
3304557;Rio de Janeiro;4128203;União da Vitória;1;1;2;864
3516200;Franca;4128203;União da Vitória;1;1;2;733
3526209;Juquitiba;4128203;União da Vitória;1;1;2;480
3526803;Lençóis Paulista;4128203;União da Vitória;1;1;2;467
3534401;Osasco;4128203;União da Vitória;1;1;2;527
3541406;Presidente Prudente;4128203;União da Vitória;1;1;2;460
4101507;Arapongas;4128203;União da Vitória;1;1;2;319
4101804;Araucária;4128203;União da Vitória;1;1;2;190
4104204;Campo Largo;4128203;União da Vitória;1;1;2;185
4106456;Coronel Domingos Soares;4128203;União da Vitória;1;1;2;88
4106506;Coronel Vivida;4128203;União da Vitória;1;1;2;144
4106803;Cruz Machado;4128203;União da Vitória;1;1;2;35
4108403;Francisco Beltrão;4128203;União da Vitória;1;1;2;192
4113700;Londrina;4128203;União da Vitória;1;1;2;330
4114401;Mangueirinha;4128203;União da Vitória;1;1;2;109
4115200;Maringá;4128203;União da Vitória;1;1;2;325
4118204;Paranaguá;4128203;União da Vitória;1;1;2;269
4119301;Pinhão;4128203;União da Vitória;1;1;2;82
4121505;Rebouças;4128203;União da Vitória;1;1;2;86
4122008;Rio Azul;4128203;União da Vitória;1;1;2;70
4122305;Rio Negro;4128203;União da Vitória;1;1;2;136
1200401;Rio Branco;4128104;Umuarama;1;1;2;2084
1400100;Boa Vista;4128104;Umuarama;1;1;2;3029
1500800;Ananindeua;4128104;Umuarama;1;1;2;2521
1504422;Marituba;4128104;Umuarama;1;1;2;2523
1709500;Gurupi;4128104;Umuarama;1;1;2;1396
1722081;Wanderlândia;4128104;Umuarama;1;1;2;1939
2111201;São José de Ribamar;4128104;Umuarama;1;1;2;2514
2307304;Juazeiro do Norte;4128104;Umuarama;1;1;2;2283
2906873;Capim Grosso;4128104;Umuarama;1;1;2;1893
3143401;Monte Sião;4128104;Umuarama;1;1;2;700
3201209;Cachoeiro de Itapemirim;4128104;Umuarama;1;1;2;1276
3303500;Nova Iguaçu;4128104;Umuarama;1;1;2;1006
3505807;Bastos;4128104;Umuarama;1;1;2;330
3516200;Franca;4128104;Umuarama;1;1;2;693
3518206;Guararapes;4128104;Umuarama;1;1;2;385
3529005;Marília;4128104;Umuarama;1;1;2;381
3542404;Regente Feijó;4128104;Umuarama;1;1;2;265
3543402;Ribeirão Preto;4128104;Umuarama;1;1;2;627
3548807;São Caetano do Sul;4128104;Umuarama;1;1;2;688
4102109;Astorga;4128104;Umuarama;1;1;2;177
4103370;Brasilândia do Sul;4128104;Umuarama;1;1;2;55
4104204;Campo Largo;4128104;Umuarama;1;1;2;433
4104501;Capanema;4128104;Umuarama;1;1;2;221
4106308;Corbélia;4128104;Umuarama;1;1;2;116
4107207;Dois Vizinhos;4128104;Umuarama;1;1;2;223
4108320;Francisco Alves;4128104;Umuarama;1;1;2;65
4110052;Iguatu;4128104;Umuarama;1;1;2;111
4110409;Indianópolis;4128104;Umuarama;1;1;2;70
4110607;Iporã;4128104;Umuarama;1;1;2;49
4110656;Iracema do Oeste;4128104;Umuarama;1;1;2;76
4111506;Ivaiporã;4128104;Umuarama;1;1;2;172
4112108;Jandaia do Sul;4128104;Umuarama;1;1;2;171
4114203;Mandaguari;4128104;Umuarama;1;1;2;165
4115101;Mariluz;4128104;Umuarama;1;1;2;34
4115606;Matelândia;4128104;Umuarama;1;1;2;181
4116109;Moreira Sales;4128104;Umuarama;1;1;2;47
4116901;Nova Esperança;4128104;Umuarama;1;1;2;129
4122503;Roncador;4128104;Umuarama;1;1;2;143
4122701;Sabáudia;4128104;Umuarama;1;1;2;186
4124020;Santa Tereza do Oeste;4128104;Umuarama;1;1;2;149
4124053;Santa Terezinha de Itaipu;4128104;Umuarama;1;1;2;220
4125357;São Jorge do Patrocínio;4128104;Umuarama;1;1;2;62
4125704;São Miguel do Iguaçu;4128104;Umuarama;1;1;2;202
4127106;Telêmaco Borba;4128104;Umuarama;1;1;2;279
4127403;Terra Roxa;4128104;Umuarama;1;1;2;92
3534401;Osasco;4128005;Ubiratã;1;1;2;635
4101051;Anahy;4128005;Ubiratã;1;1;2;19
4107504;Engenheiro Beltrão;4128005;Ubiratã;1;1;2;110
4108205;Formosa do Oeste;4128005;Ubiratã;1;1;2;44
4108601;Goioerê;4128005;Ubiratã;1;1;2;39
4109401;Guarapuava;4128005;Ubiratã;1;1;2;181
4110607;Iporã;4128005;Ubiratã;1;1;2;95
4112108;Jandaia do Sul;4128005;Ubiratã;1;1;2;171
4112207;Janiópolis;4128005;Ubiratã;1;1;2;50
4114005;Mamborê;4128005;Ubiratã;1;1;2;52
4115804;Medianeira;4128005;Ubiratã;1;1;2;140
4117909;Palotina;4128005;Ubiratã;1;1;2;88
4118402;Paranavaí;4128005;Ubiratã;1;1;2;170
4118501;Pato Branco;4128005;Ubiratã;1;1;2;189
4119608;Pitanga;4128005;Ubiratã;1;1;2;127
4123501;Santa Helena;4128005;Ubiratã;1;1;2;140
4127205;Terra Boa;4128005;Ubiratã;1;1;2;102
3534401;Osasco;4127965;Turvo;1;1;2;504
4101804;Araucária;4127965;Turvo;1;1;2;224
4103958;Campina do Simão;4127965;Turvo;1;1;2;30
4104303;Campo Mourão;4127965;Turvo;1;1;2;140
4111506;Ivaiporã;4127965;Turvo;1;1;2;90
4117909;Palotina;4127965;Turvo;1;1;2;244
4119301;Pinhão;4127965;Turvo;1;1;2;74
4103354;Braganey;4127957;Tupãssi;1;1;2;47
4105300;Céu Azul;4127957;Tupãssi;1;1;2;71
4106308;Corbélia;4127957;Tupãssi;1;1;2;31
4106902;Curitiba;4127957;Tupãssi;1;1;2;439
4109302;Guaraniaçu;4127957;Tupãssi;1;1;2;88
4110656;Iracema do Oeste;4127957;Tupãssi;1;1;2;24
4116703;Nova Aurora;4127957;Tupãssi;1;1;2;27
3550308;São Paulo;4127908;Tuneiras do Oeste;1;1;2;634
4105508;Cianorte;4127908;Tuneiras do Oeste;1;1;2;36
4106605;Cruzeiro do Oeste;4127908;Tuneiras do Oeste;1;1;2;22
4108601;Goioerê;4127908;Tuneiras do Oeste;1;1;2;39
4120655;Quarto Centenário;4127908;Tuneiras do Oeste;1;1;2;50
3518503;Guareí;4127882;Tunas do Paraná;1;1;2;199
4100400;Almirante Tamandaré;4127882;Tunas do Paraná;1;1;2;45
4101804;Araucária;4127882;Tunas do Paraná;1;1;2;75
3534401;Osasco;4127858;Três Barras do Paraná;1;1;2;671
3550308;São Paulo;4127858;Três Barras do Paraná;1;1;2;681
4105003;Catanduvas;4127858;Três Barras do Paraná;1;1;2;24
4108304;Foz do Iguaçu;4127858;Três Barras do Paraná;1;1;2;133
4109302;Guaraniaçu;4127858;Três Barras do Paraná;1;1;2;45
4113304;Laranjeiras do Sul;4127858;Três Barras do Paraná;1;1;2;70
4114609;Marechal Cândido Rondon;4127858;Três Barras do Paraná;1;1;2;130
4116950;Nova Esperança do Sudoeste;4127858;Três Barras do Paraná;1;1;2;55
4123006;Salto do Lontra;4127858;Três Barras do Paraná;1;1;2;42
4123303;Santa Cruz de Monte Castelo;4127858;Três Barras do Paraná;1;1;2;273
3534708;Ourinhos;4127809;Tomazina;1;1;2;88
4101606;Arapoti;4127809;Tomazina;1;1;2;44
4102406;Bandeirantes;4127809;Tomazina;1;1;2;85
4126603;Siqueira Campos;4127809;Tomazina;1;1;2;15
1100122;Ji-Paraná;4127700;Toledo;1;1;2;1719
3118601;Contagem;4127700;Toledo;1;1;2;1100
3139003;Machado;4127700;Toledo;1;1;2;854
3205200;Vila Velha;4127700;Toledo;1;1;2;1420
3504008;Assis;4127700;Toledo;1;1;2;403
3505708;Barueri;4127700;Toledo;1;1;2;706
3516200;Franca;4127700;Toledo;1;1;2;784
3529005;Marília;4127700;Toledo;1;1;2;472
3529401;Mauá;4127700;Toledo;1;1;2;745
3534302;Orlândia;4127700;Toledo;1;1;2;734
3541406;Presidente Prudente;4127700;Toledo;1;1;2;372
3543402;Ribeirão Preto;4127700;Toledo;1;1;2;715
3548807;São Caetano do Sul;4127700;Toledo;1;1;2;735
4100509;Altônia;4127700;Toledo;1;1;2;95
4101002;Ampére;4127700;Toledo;1;1;2;135
4105003;Catanduvas;4127700;Toledo;1;1;2;81
4105300;Céu Azul;4127700;Toledo;1;1;2;48
4108601;Goioerê;4127700;Toledo;1;1;2;95
4110953;Itaipulândia;4127700;Toledo;1;1;2;72
4112751;Jesuítas;4127700;Toledo;1;1;2;53
4115358;Maripá;4127700;Toledo;1;1;2;35
4115853;Mercedes;4127700;Toledo;1;1;2;50
4116059;Missal;4127700;Toledo;1;1;2;64
4117206;Nova Olímpia;4127700;Toledo;1;1;2;154
4119152;Pinhais;4127700;Toledo;1;1;2;470
4120903;Quedas do Iguaçu;4127700;Toledo;1;1;2;118
4125308;São Jorge do Ivaí;4127700;Toledo;1;1;2;204
3304557;Rio de Janeiro;4127601;Tijucas do Sul;1;1;2;678
3534401;Osasco;4127601;Tijucas do Sul;1;1;2;357
4103107;Bocaiúva do Sul;4127601;Tijucas do Sul;1;1;2;80
4104105;Campo do Tenente;4127601;Tijucas do Sul;1;1;2;49
4104204;Campo Largo;4127601;Tijucas do Sul;1;1;2;61
4107652;Fazenda Rio Grande;4127601;Tijucas do Sul;1;1;2;32
4119103;Piên;4127601;Tijucas do Sul;1;1;2;30
4119152;Pinhais;4127601;Tijucas do Sul;1;1;2;54
3534401;Osasco;4127502;Tibagi;1;1;2;381
4107009;Curiúva;4127502;Tibagi;1;1;2;53
4112009;Jaguariaíva;4127502;Tibagi;1;1;2;78
4113700;Londrina;4127502;Tibagi;1;1;2;153
4115705;Matinhos;4127502;Tibagi;1;1;2;237
4116208;Morretes;4127502;Tibagi;1;1;2;193
4119400;Piraí do Sul;4127502;Tibagi;1;1;2;48
4121703;Reserva;4127502;Tibagi;1;1;2;47
3505807;Bastos;4127403;Terra Roxa;1;1;2;420
3513009;Cotia;4127403;Terra Roxa;1;1;2;731
3534401;Osasco;4127403;Terra Roxa;1;1;2;744
4100707;Alto Piquiri;4127403;Terra Roxa;1;1;2;68
4102000;Assis Chateaubriand;4127403;Terra Roxa;1;1;2;67
4105508;Cianorte;4127403;Terra Roxa;1;1;2;162
4106308;Corbélia;4127403;Terra Roxa;1;1;2;108
4113700;Londrina;4127403;Terra Roxa;1;1;2;313
4115200;Maringá;4127403;Terra Roxa;1;1;2;234
4117222;Nova Santa Rosa;4127403;Terra Roxa;1;1;2;37
4119905;Ponta Grossa;4127403;Terra Roxa;1;1;2;415
4124053;Santa Terezinha de Itaipu;4127403;Terra Roxa;1;1;2;146
4126256;Sarandi;4127403;Terra Roxa;1;1;2;239
2101608;Barra do Corda;4127304;Terra Rica;1;1;2;2037
3107406;Bom Despacho;4127304;Terra Rica;1;1;2;818
3534401;Osasco;4127304;Terra Rica;1;1;2;608
3541406;Presidente Prudente;4127304;Terra Rica;1;1;2;141
4107108;Diamante do Norte;4127304;Terra Rica;1;1;2;25
4115200;Maringá;4127304;Terra Rica;1;1;2;107
4122404;Rolândia;4127304;Terra Rica;1;1;2;145
4124608;São Carlos do Ivaí;4127304;Terra Rica;1;1;2;69
4124905;São João do Caiuá;4127304;Terra Rica;1;1;2;33
3505807;Bastos;4127205;Terra Boa;1;1;2;268
3534401;Osasco;4127205;Terra Boa;1;1;2;576
4101408;Apucarana;4127205;Terra Boa;1;1;2;104
4102505;Barbosa Ferraz;4127205;Terra Boa;1;1;2;54
4114401;Mangueirinha;4127205;Terra Boa;1;1;2;242
4122404;Rolândia;4127205;Terra Boa;1;1;2;121
4126801;Tapejara;4127205;Terra Boa;1;1;2;44
1500602;Altamira;4127106;Telêmaco Borba;1;1;2;2350
3106200;Belo Horizonte;4127106;Telêmaco Borba;1;1;2;832
3524402;Jacareí;4127106;Telêmaco Borba;1;1;2;492
3535804;Paranapanema;4127106;Telêmaco Borba;1;1;2;221
3547809;Santo André;4127106;Telêmaco Borba;1;1;2;427
3548500;Santos;4127106;Telêmaco Borba;1;1;2;441
3548708;São Bernardo do Campo;4127106;Telêmaco Borba;1;1;2;420
3548807;São Caetano do Sul;4127106;Telêmaco Borba;1;1;2;424
3556701;Vinhedo;4127106;Telêmaco Borba;1;1;2;402
4101408;Apucarana;4127106;Telêmaco Borba;1;1;2;119
4104006;Campina Grande do Sul;4127106;Telêmaco Borba;1;1;2;195
4104659;Carambeí;4127106;Telêmaco Borba;1;1;2;85
4105805;Colombo;4127106;Telêmaco Borba;1;1;2;176
4107009;Curiúva;4127106;Telêmaco Borba;1;1;2;43
4107751;Figueira;4127106;Telêmaco Borba;1;1;2;64
4111506;Ivaiporã;4127106;Telêmaco Borba;1;1;2;107
4111803;Jacarezinho;4127106;Telêmaco Borba;1;1;2;150
4112108;Jandaia do Sul;4127106;Telêmaco Borba;1;1;2;130
4115705;Matinhos;4127106;Telêmaco Borba;1;1;2;268
4117701;Palmeira;4127106;Telêmaco Borba;1;1;2;136
4120606;Prudentópolis;4127106;Telêmaco Borba;1;1;2;101
4122008;Rio Azul;4127106;Telêmaco Borba;1;1;2;152
3534401;Osasco;4127007;Teixeira Soares;1;1;2;419
3550308;São Paulo;4127007;Teixeira Soares;1;1;2;426
4101804;Araucária;4127007;Teixeira Soares;1;1;2;110
4104659;Carambeí;4127007;Teixeira Soares;1;1;2;62
4104907;Castro;4127007;Teixeira Soares;1;1;2;77
4124103;Santo Antônio da Platina;4127007;Teixeira Soares;1;1;2;232
3550308;São Paulo;4126900;Tapira;1;1;2;658
4105508;Cianorte;4126900;Tapira;1;1;2;61
4107256;Douradina;4126900;Tapira;1;1;2;24
4114005;Mamborê;4126900;Tapira;1;1;2;123
4114708;Maria Helena;4126900;Tapira;1;1;2;35
4118402;Paranavaí;4126900;Tapira;1;1;2;68
3520509;Indaiatuba;4126801;Tapejara;1;1;2;577
3534401;Osasco;4126801;Tapejara;1;1;2;620
3550308;São Paulo;4126801;Tapejara;1;1;2;634
4100509;Altônia;4126801;Tapejara;1;1;2;105
4105607;Cidade Gaúcha;4126801;Tapejara;1;1;2;40
4112108;Jandaia do Sul;4126801;Tapejara;1;1;2;126
4117503;Paiçandu;4126801;Tapejara;1;1;2;89
4118006;Paraíso do Norte;4126801;Tapejara;1;1;2;57
4122404;Rolândia;4126801;Tapejara;1;1;2;160
4123857;Santa Maria do Oeste;4126801;Tapejara;1;1;2;169
4126504;Sertanópolis;4126801;Tapejara;1;1;2;201
3534401;Osasco;4126702;Tamboara;1;1;2;583
4105508;Cianorte;4126702;Tamboara;1;1;2;53
4116505;Nova Aliança do Ivaí;4126702;Tamboara;1;1;2;14
4118006;Paraíso do Norte;4126702;Tamboara;1;1;2;16
4119707;Planaltina do Paraná;4126702;Tamboara;1;1;2;50
4124608;São Carlos do Ivaí;4126702;Tamboara;1;1;2;13
2925303;Porto Seguro;4126678;Tamarana;1;1;2;1439
3550308;São Paulo;4126678;Tamarana;1;1;2;453
4102109;Astorga;4126678;Tamarana;1;1;2;79
4103701;Cambé;4126678;Tamarana;1;1;2;51
4106407;Cornélio Procópio;4126678;Tamarana;1;1;2;75
4109807;Ibiporã;4126678;Tamarana;1;1;2;51
4114203;Mandaguari;4126678;Tamarana;1;1;2;65
4114906;Marilândia do Sul;4126678;Tamarana;1;1;2;22
4124509;Santo Inácio;4126678;Tamarana;1;1;2;134
3541406;Presidente Prudente;4126652;Sulina;1;1;2;417
4106506;Coronel Vivida;4126652;Sulina;1;1;2;37
4126272;Saudade do Iguaçu;4126652;Sulina;1;1;2;10
3534401;Osasco;4126603;Siqueira Campos;1;1;2;311
4102109;Astorga;4126603;Siqueira Campos;1;1;2;193
4102406;Bandeirantes;4126603;Siqueira Campos;1;1;2;84
4104709;Carlópolis;4126603;Siqueira Campos;1;1;2;31
4106902;Curitiba;4126603;Siqueira Campos;1;1;2;201
4111803;Jacarezinho;4126603;Siqueira Campos;1;1;2;62
4112801;Joaquim Távora;4126603;Siqueira Campos;1;1;2;22
4113700;Londrina;4126603;Siqueira Campos;1;1;2;141
4114203;Mandaguari;4126603;Siqueira Campos;1;1;2;191
4119905;Ponta Grossa;4126603;Siqueira Campos;1;1;2;161
4121802;Ribeirão Claro;4126603;Siqueira Campos;1;1;2;55
4125407;São José da Boa Vista;4126603;Siqueira Campos;1;1;2;31
3304557;Rio de Janeiro;4126504;Sertanópolis;1;1;2;797
3504008;Assis;4126504;Sertanópolis;1;1;2;75
3534401;Osasco;4126504;Sertanópolis;1;1;2;439
3548500;Santos;4126504;Sertanópolis;1;1;2;491
4101101;Andirá;4126504;Sertanópolis;1;1;2;83
4118204;Paranaguá;4126504;Sertanópolis;1;1;2;379
4119905;Ponta Grossa;4126504;Sertanópolis;1;1;2;244
4121901;Ribeirão do Pinhal;4126504;Sertanópolis;1;1;2;80
4123907;Santa Mariana;4126504;Sertanópolis;1;1;2;54
4124707;São Jerônimo da Serra;4126504;Sertanópolis;1;1;2;80
4126009;São Sebastião da Amoreira;4126504;Sertanópolis;1;1;2;53
3504008;Assis;4126405;Sertaneja;1;1;2;58
3550308;São Paulo;4126405;Sertaneja;1;1;2;436
4103602;Cambará;4126405;Sertaneja;1;1;2;78
4115200;Maringá;4126405;Sertaneja;1;1;2;120
4120507;Primeiro de Maio;4126405;Sertaneja;1;1;2;30
4122404;Rolândia;4126405;Sertaneja;1;1;2;62
4115606;Matelândia;4126355;Serranópolis do Iguaçu;1;1;2;16
4124053;Santa Terezinha de Itaipu;4126355;Serranópolis do Iguaçu;1;1;2;40
4125704;São Miguel do Iguaçu;4126355;Serranópolis do Iguaçu;1;1;2;19
3518800;Guarulhos;4126306;Sengés;1;1;2;304
3522307;Itapetininga;4126306;Sengés;1;1;2;155
3534401;Osasco;4126306;Sengés;1;1;2;279
4101606;Arapoti;4126306;Sengés;1;1;2;37
4102109;Astorga;4126306;Sengés;1;1;2;243
4104105;Campo do Tenente;4126306;Sengés;1;1;2;208
4109708;Ibaiti;4126306;Sengés;1;1;2;79
4125407;São José da Boa Vista;4126306;Sengés;1;1;2;29
4103222;Bom Sucesso do Sul;4126272;Saudade do Iguaçu;1;1;2;48
4105409;Chopinzinho;4126272;Saudade do Iguaçu;1;1;2;20
4107207;Dois Vizinhos;4126272;Saudade do Iguaçu;1;1;2;44
4125209;São Jorge d'Oeste;4126272;Saudade do Iguaçu;1;1;2;30
2602902;Cabo de Santo Agostinho;4126256;Sarandi;1;1;2;2356
2919553;Luís Eduardo magalhães;4126256;Sarandi;1;1;2;1391
3106705;Betim;4126256;Sarandi;1;1;2;866
3300704;Cabo Frio;4126256;Sarandi;1;1;2;1002
3302403;Macaé;4126256;Sarandi;1;1;2;1023
3518800;Guarulhos;4126256;Sarandi;1;1;2;543
3526803;Lençóis Paulista;4126256;Sarandi;1;1;2;325
3526902;Limeira;4126256;Sarandi;1;1;2;467
3530201;Mirante do Paranapanema;4126256;Sarandi;1;1;2;128
3534401;Osasco;4126256;Sarandi;1;1;2;520
3541406;Presidente Prudente;4126256;Sarandi;1;1;2;153
3557204;Chavantes;4126256;Sarandi;1;1;2;225
4101408;Apucarana;4126256;Sarandi;1;1;2;45
4101804;Araucária;4126256;Sarandi;1;1;2;348
4112108;Jandaia do Sul;4126256;Sarandi;1;1;2;29
4118204;Paranaguá;4126256;Sarandi;1;1;2;416
4118402;Paranavaí;4126256;Sarandi;1;1;2;70
4120408;Presidente Castelo Branco;4126256;Sarandi;1;1;2;34
4122404;Rolândia;4126256;Sarandi;1;1;2;54
4125803;São Pedro do Ivaí;4126256;Sarandi;1;1;2;47
3534708;Ourinhos;4126207;Sapopema;1;1;2;124
3550308;São Paulo;4126207;Sapopema;1;1;2;401
4102406;Bandeirantes;4126207;Sapopema;1;1;2;91
3304557;Rio de Janeiro;4126108;São Tomé;1;1;2;953
3514809;Eldorado;4126108;São Tomé;1;1;2;472
4118006;Paraíso do Norte;4126108;São Tomé;1;1;2;28
4122602;Rondon;4126108;São Tomé;1;1;2;22
3550308;São Paulo;4126009;São Sebastião da Amoreira;1;1;2;421
4103602;Cambará;4126009;São Sebastião da Amoreira;1;1;2;84
4103701;Cambé;4126009;São Sebastião da Amoreira;1;1;2;56
4107009;Curiúva;4126009;São Sebastião da Amoreira;1;1;2;70
4117008;Nova Fátima;4126009;São Sebastião da Amoreira;1;1;2;20
3550308;São Paulo;4125902;São Pedro do Paraná;1;1;2;683
4108809;Guaíra;4125902;São Pedro do Paraná;1;1;2;176
4117107;Nova Londrina;4125902;São Pedro do Paraná;1;1;2;25
3534401;Osasco;4125803;São Pedro do Ivaí;1;1;2;517
4101804;Araucária;4125803;São Pedro do Ivaí;1;1;2;316
4103206;Bom Sucesso;4125803;São Pedro do Ivaí;1;1;2;20
4103305;Borrazópolis;4125803;São Pedro do Ivaí;1;1;2;29
4107504;Engenheiro Beltrão;4125803;São Pedro do Ivaí;1;1;2;42
4111100;Itambé;4125803;São Pedro do Ivaí;1;1;2;26
4111506;Ivaiporã;4125803;São Pedro do Ivaí;1;1;2;44
4114807;Marialva;4125803;São Pedro do Ivaí;1;1;2;43
4115200;Maringá;4125803;São Pedro do Ivaí;1;1;2;49
4121703;Reserva;4125803;São Pedro do Ivaí;1;1;2;135
4106902;Curitiba;4125753;São Pedro do Iguaçu;1;1;2;465
4115804;Medianeira;4125753;São Pedro do Iguaçu;1;1;2;46
4117909;Palotina;4125753;São Pedro do Iguaçu;1;1;2;71
3170206;Uberlândia;4125704;São Miguel do Iguaçu;1;1;2;925
3516200;Franca;4125704;São Miguel do Iguaçu;1;1;2;861
3522604;Itapira;4125704;São Miguel do Iguaçu;1;1;2;806
3552403;Sumaré;4125704;São Miguel do Iguaçu;1;1;2;750
4105003;Catanduvas;4125704;São Miguel do Iguaçu;1;1;2;110
4108403;Francisco Beltrão;4125704;São Miguel do Iguaçu;1;1;2;145
4108809;Guaíra;4125704;São Miguel do Iguaçu;1;1;2;139
4114807;Marialva;4125704;São Miguel do Iguaçu;1;1;2;320
4115853;Mercedes;4125704;São Miguel do Iguaçu;1;1;2;100
4118451;Pato Bragado;4125704;São Miguel do Iguaçu;1;1;2;81
4122404;Rolândia;4125704;São Miguel do Iguaçu;1;1;2;365
4124020;Santa Tereza do Oeste;4125704;São Miguel do Iguaçu;1;1;2;70
3157708;Santa Juliana;4125605;São Mateus do Sul;1;1;2;775
3505708;Barueri;4125605;São Mateus do Sul;1;1;2;433
3509502;Campinas;4125605;São Mateus do Sul;1;1;2;463
3534401;Osasco;4125605;São Mateus do Sul;1;1;2;439
3549706;São José do Rio Pardo;4125605;São Mateus do Sul;1;1;2;583
4107736;Fernandes Pinheiro;4125605;São Mateus do Sul;1;1;2;50
4114807;Marialva;4125605;São Mateus do Sul;1;1;2;296
4115200;Maringá;4125605;São Mateus do Sul;1;1;2;307
4117701;Palmeira;4125605;São Mateus do Sul;1;1;2;59
4121208;Quitandinha;4125605;São Mateus do Sul;1;1;2;89
4121505;Rebouças;4125605;São Mateus do Sul;1;1;2;39
4122008;Rio Azul;4125605;São Mateus do Sul;1;1;2;43
3550308;São Paulo;4125555;São Manoel do Paraná;1;1;2;614
4105508;Cianorte;4125555;São Manoel do Paraná;1;1;2;29
4107256;Douradina;4125555;São Manoel do Paraná;1;1;2;66
4110409;Indianópolis;4125555;São Manoel do Paraná;1;1;2;10
4115903;Mirador;4125555;São Manoel do Paraná;1;1;2;21
1100205;Porto Velho;4125506;São José dos Pinhais;1;1;2;2329
1301100;Careiro;4125506;São José dos Pinhais;1;1;2;2631
1500800;Ananindeua;4125506;São José dos Pinhais;1;1;2;2675
1501402;Belém;4125506;São José dos Pinhais;1;1;2;2673
1503606;Itaituba;4125506;São José dos Pinhais;1;1;2;2445
1508050;Trairão;4125506;São José dos Pinhais;1;1;2;2383
1508407;Xinguara;4125506;São José dos Pinhais;1;1;2;2042
1703107;Barrolândia;4125506;São José dos Pinhais;1;1;2;1738
1721000;Palmas;4125506;São José dos Pinhais;1;1;2;1682
1722081;Wanderlândia;4125506;São José dos Pinhais;1;1;2;2069
2211001;Teresina;4125506;São José dos Pinhais;1;1;2;2343
2301000;Aquiraz;4125506;São José dos Pinhais;1;1;2;2605
2304285;Eusébio;4125506;São José dos Pinhais;1;1;2;2604
2408003;Mossoró;4125506;São José dos Pinhais;1;1;2;2519
2408102;Natal;4125506;São José dos Pinhais;1;1;2;2556
2501807;Bayeux;4125506;São José dos Pinhais;1;1;2;2451
2513802;Santa Teresinha;4125506;São José dos Pinhais;1;1;2;2327
2602902;Cabo de Santo Agostinho;4125506;São José dos Pinhais;1;1;2;2342
2610707;Paulista;4125506;São José dos Pinhais;1;1;2;2381
2707701;Rio Largo;4125506;São José dos Pinhais;1;1;2;2190
2804805;Nossa Senhora do Socorro;4125506;São José dos Pinhais;1;1;2;1996
2905701;Camaçari;4125506;São José dos Pinhais;1;1;2;1766
2910057;Dias d'Ávila;4125506;São José dos Pinhais;1;1;2;1775
2929503;São Sebastião do Passé;4125506;São José dos Pinhais;1;1;2;1773
3104106;Arceburgo;4125506;São José dos Pinhais;1;1;2;513
3105905;Barroso;4125506;São José dos Pinhais;1;1;2;705
3109907;Caetanópolis;4125506;São José dos Pinhais;1;1;2;835
3113404;Caratinga;4125506;São José dos Pinhais;1;1;2;935
3119955;Córrego Fundo;4125506;São José dos Pinhais;1;1;2;668
3124500;Estiva;4125506;São José dos Pinhais;1;1;2;464
3130705;Indianópolis;4125506;São José dos Pinhais;1;1;2;730
3138203;Lavras;4125506;São José dos Pinhais;1;1;2;631
3159605;Santa Rita do Sapucaí;4125506;São José dos Pinhais;1;1;2;502
3160603;Santo Hipólito;4125506;São José dos Pinhais;1;1;2;937
3167202;Sete Lagoas;4125506;São José dos Pinhais;1;1;2;832
3203205;Linhares;4125506;São José dos Pinhais;1;1;2;1130
3205101;Viana;4125506;São José dos Pinhais;1;1;2;1022
3205200;Vila Velha;4125506;São José dos Pinhais;1;1;2;1043
3301108;Cantagalo;4125506;São José dos Pinhais;1;1;2;784
3302403;Macaé;4125506;São José dos Pinhais;1;1;2;804
3305109;São João de Meriti;4125506;São José dos Pinhais;1;1;2;652
3504305;Avaí;4125506;São José dos Pinhais;1;1;2;376
3506102;Bebedouro;4125506;São José dos Pinhais;1;1;2;514
3507605;Bragança Paulista;4125506;São José dos Pinhais;1;1;2;389
3509007;Caieiras;4125506;São José dos Pinhais;1;1;2;342
3513405;Cruzeiro;4125506;São José dos Pinhais;1;1;2;532
3513504;Cubatão;4125506;São José dos Pinhais;1;1;2;330
3516200;Franca;4125506;São José dos Pinhais;1;1;2;581
3518305;Guararema;4125506;São José dos Pinhais;1;1;2;391
3522307;Itapetininga;4125506;São José dos Pinhais;1;1;2;245
3522406;Itapeva;4125506;São José dos Pinhais;1;1;2;176
3522505;Itapevi;4125506;São José dos Pinhais;1;1;2;314
3524600;Jacupiranga;4125506;São José dos Pinhais;1;1;2;151
3524709;Jaguariúna;4125506;São José dos Pinhais;1;1;2;382
3526902;Limeira;4125506;São José dos Pinhais;1;1;2;374
3528403;Mairinque;4125506;São José dos Pinhais;1;1;2;297
3530607;Moji das Cruzes;4125506;São José dos Pinhais;1;1;2;370
3541000;Praia Grande;4125506;São José dos Pinhais;1;1;2;325
3541406;Presidente Prudente;4125506;São José dos Pinhais;1;1;2;436
3546801;Santa Isabel;4125506;São José dos Pinhais;1;1;2;384
3547304;Santana de Parnaíba;4125506;São José dos Pinhais;1;1;2;324
3548500;Santos;4125506;São José dos Pinhais;1;1;2;336
3549904;São José dos Campos;4125506;São José dos Pinhais;1;1;2;418
3551702;Sertãozinho;4125506;São José dos Pinhais;1;1;2;501
3552403;Sumaré;4125506;São José dos Pinhais;1;1;2;356
3556206;Valinhos;4125506;São José dos Pinhais;1;1;2;358
3557006;Votorantim;4125506;São José dos Pinhais;1;1;2;285
4100400;Almirante Tamandaré;4125506;São José dos Pinhais;1;1;2;27
4102307;Balsa Nova;4125506;São José dos Pinhais;1;1;2;46
4102901;Bituruna;4125506;São José dos Pinhais;1;1;2;249
4104303;Campo Mourão;4125506;São José dos Pinhais;1;1;2;361
4105706;Clevelândia;4125506;São José dos Pinhais;1;1;2;345
4107009;Curiúva;4125506;São José dos Pinhais;1;1;2;210
4107207;Dois Vizinhos;4125506;São José dos Pinhais;1;1;2;390
4108403;Francisco Beltrão;4125506;São José dos Pinhais;1;1;2;395
4108601;Goioerê;4125506;São José dos Pinhais;1;1;2;411
4109005;Guapirama;4125506;São José dos Pinhais;1;1;2;240
4110706;Irati;4125506;São José dos Pinhais;1;1;2;146
4111902;Jaguapitã;4125506;São José dos Pinhais;1;1;2;356
4114302;Mandirituba;4125506;São José dos Pinhais;1;1;2;30
4115606;Matelândia;4125506;São José dos Pinhais;1;1;2;484
4115705;Matinhos;4125506;São José dos Pinhais;1;1;2;69
4116208;Morretes;4125506;São José dos Pinhais;1;1;2;36
4116406;Nossa Senhora das Graças;4125506;São José dos Pinhais;1;1;2;390
4122404;Rolândia;4125506;São José dos Pinhais;1;1;2;329
4117453;Ouro Verde do Oeste;4125456;São José das Palmeiras;1;1;2;20
4119905;Ponta Grossa;4125456;São José das Palmeiras;1;1;2;399
3523206;Itararé;4125407;São José da Boa Vista;1;1;2;38
4109708;Ibaiti;4125407;São José da Boa Vista;1;1;2;55
3505807;Bastos;4125357;São Jorge do Patrocínio;1;1;2;381
3550308;São Paulo;4125357;São Jorge do Patrocínio;1;1;2;742
4103370;Brasilândia do Sul;4125357;São Jorge do Patrocínio;1;1;2;65
4118907;Pérola;4125357;São Jorge do Patrocínio;1;1;2;26
4105508;Cianorte;4125308;São Jorge do Ivaí;1;1;2;39
4113700;Londrina;4125308;São Jorge do Ivaí;1;1;2;120
4114104;Mandaguaçu;4125308;São Jorge do Ivaí;1;1;2;21
4116901;Nova Esperança;4125308;São Jorge do Ivaí;1;1;2;30
4117404;Ourizona;4125308;São Jorge do Ivaí;1;1;2;12
4117909;Palotina;4125308;São Jorge do Ivaí;1;1;2;181
4124509;Santo Inácio;4125308;São Jorge do Ivaí;1;1;2;97
4106902;Curitiba;4125209;São Jorge d'Oeste;1;1;2;365
4108403;Francisco Beltrão;4125209;São Jorge d'Oeste;1;1;2;44
3304557;Rio de Janeiro;4125100;São João do Triunfo;1;1;2;764
3534401;Osasco;4125100;São João do Triunfo;1;1;2;422
4102307;Balsa Nova;4125100;São João do Triunfo;1;1;2;67
4106902;Curitiba;4125100;São João do Triunfo;1;1;2;104
4110706;Irati;4125100;São João do Triunfo;1;1;2;41
4111506;Ivaiporã;4125100;São João do Triunfo;1;1;2;213
4115754;Mauá da Serra;4125100;São João do Triunfo;1;1;2;218
4117305;Ortigueira;4125100;São João do Triunfo;1;1;2;176
4117602;Palmas;4125100;São João do Triunfo;1;1;2;192
3534401;Osasco;4125001;São João do Ivaí;1;1;2;513
4101507;Arapongas;4125001;São João do Ivaí;1;1;2;74
4106852;Cruzmaltina;4125001;São João do Ivaí;1;1;2;37
4108551;Godoy Moreira;4125001;São João do Ivaí;1;1;2;24
4112504;Jardim Alegre;4125001;São João do Ivaí;1;1;2;26
4114203;Mandaguari;4125001;São João do Ivaí;1;1;2;48
4115200;Maringá;4125001;São João do Ivaí;1;1;2;62
4117909;Palotina;4125001;São João do Ivaí;1;1;2;206
4118501;Pato Branco;4125001;São João do Ivaí;1;1;2;264
4122404;Rolândia;4125001;São João do Ivaí;1;1;2;87
3529005;Marília;4124905;São João do Caiuá;1;1;2;254
3534401;Osasco;4124905;São João do Caiuá;1;1;2;576
4115200;Maringá;4124905;São João do Caiuá;1;1;2;77
4116901;Nova Esperança;4124905;São João do Caiuá;1;1;2;40
4118105;Paranacity;4124905;São João do Caiuá;1;1;2;21
4124608;São Carlos do Ivaí;4124905;São João do Caiuá;1;1;2;54
3170107;Uberaba;4124806;São João;1;1;2;822
3534401;Osasco;4124806;São João;1;1;2;642
3543402;Ribeirão Preto;4124806;São João;1;1;2;710
4103024;Boa Esperança do Iguaçu;4124806;São João;1;1;2;53
4106571;Cruzeiro do Iguaçu;4124806;São João;1;1;2;47
4106902;Curitiba;4124806;São João;1;1;2;346
4114401;Mangueirinha;4124806;São João;1;1;2;56
4115804;Medianeira;4124806;São João;1;1;2;150
4116950;Nova Esperança do Sudoeste;4124806;São João;1;1;2;55
4117602;Palmas;4124806;São João;1;1;2;106
4118204;Paranaguá;4124806;São João;1;1;2;418
4119004;Pérola d'Oeste;4124806;São João;1;1;2;102
4120150;Porto Barreiro;4124806;São João;1;1;2;44
4120903;Quedas do Iguaçu;4124806;São João;1;1;2;46
4122156;Rio Bonito do Iguaçu;4124806;São João;1;1;2;42
3304557;Rio de Janeiro;4124707;São Jerônimo da Serra;1;1;2;766
3534401;Osasco;4124707;São Jerônimo da Serra;1;1;2;403
3550308;São Paulo;4124707;São Jerônimo da Serra;1;1;2;417
4101903;Assaí;4124707;São Jerônimo da Serra;1;1;2;41
4113700;Londrina;4124707;São Jerônimo da Serra;1;1;2;63
4117214;Nova Santa Bárbara;4124707;São Jerônimo da Serra;1;1;2;15
4118402;Paranavaí;4124707;São Jerônimo da Serra;1;1;2;187
4123204;Santa Cecília do Pavão;4124707;São Jerônimo da Serra;1;1;2;24
3515350;Euclides da Cunha Paulista;4124608;São Carlos do Ivaí;1;1;2;84
3529302;Matão;4124608;São Carlos do Ivaí;1;1;2;456
4107108;Diamante do Norte;4124608;São Carlos do Ivaí;1;1;2;83
4116901;Nova Esperança;4124608;São Carlos do Ivaí;1;1;2;31
3539202;Pirapozinho;4124509;Santo Inácio;1;1;2;56
4113700;Londrina;4124509;Santo Inácio;1;1;2;94
4113809;Lupionópolis;4124509;Santo Inácio;1;1;2;15
4114807;Marialva;4124509;Santo Inácio;1;1;2;87
4122602;Rondon;4124509;Santo Inácio;1;1;2;127
1716109;Paraíso do Tocantins;4124400;Santo Antônio do Sudoeste;1;1;2;1819
1721000;Palmas;4124400;Santo Antônio do Sudoeste;1;1;2;1812
3516200;Franca;4124400;Santo Antônio do Sudoeste;1;1;2;871
4103156;Bom Jesus do Sul;4124400;Santo Antônio do Sudoeste;1;1;2;19
4109401;Guarapuava;4124400;Santo Antônio do Sudoeste;1;1;2;238
4114351;Manfrinópolis;4124400;Santo Antônio do Sudoeste;1;1;2;42
4115804;Medianeira;4124400;Santo Antônio do Sudoeste;1;1;2;94
4118501;Pato Branco;4124400;Santo Antônio do Sudoeste;1;1;2;108
4121406;Realeza;4124400;Santo Antônio do Sudoeste;1;1;2;38
4122404;Rolândia;4124400;Santo Antônio do Sudoeste;1;1;2;384
4123808;Santa Izabel do Oeste;4124400;Santo Antônio do Sudoeste;1;1;2;36
3550308;São Paulo;4124301;Santo Antônio do Paraíso;1;1;2;409
4106001;Congonhinhas;4124301;Santo Antônio do Paraíso;1;1;2;11
4111803;Jacarezinho;4124301;Santo Antônio do Paraíso;1;1;2;74
4113700;Londrina;4124301;Santo Antônio do Paraíso;1;1;2;56
3550308;São Paulo;4124202;Santo Antônio do Caiuá;1;1;2;595
2403251;Parnamirim;4124103;Santo Antônio da Platina;1;1;2;2412
3170206;Uberlândia;4124103;Santo Antônio da Platina;1;1;2;521
3501608;Americana;4124103;Santo Antônio da Platina;1;1;2;290
3502101;Andradina;4124103;Santo Antônio da Platina;1;1;2;293
3506300;Bernardino de Campos;4124103;Santo Antônio da Platina;1;1;2;72
3511102;Catanduva;4124103;Santo Antônio da Platina;1;1;2;264
3516200;Franca;4124103;Santo Antônio da Platina;1;1;2;410
3521804;Itaí;4124103;Santo Antônio da Platina;1;1;2;105
3522307;Itapetininga;4124103;Santo Antônio da Platina;1;1;2;213
3523206;Itararé;4124103;Santo Antônio da Platina;1;1;2;119
3523909;Itu;4124103;Santo Antônio da Platina;1;1;2;288
3527108;Lins;4124103;Santo Antônio da Platina;1;1;2;182
3530607;Moji das Cruzes;4124103;Santo Antônio da Platina;1;1;2;402
3535309;Palmital;4124103;Santo Antônio da Platina;1;1;2;58
3537305;Penápolis;4124103;Santo Antônio da Platina;1;1;2;207
3540002;Pompéia;4124103;Santo Antônio da Platina;1;1;2;132
3542008;Quintana;4124103;Santo Antônio da Platina;1;1;2;137
3542206;Rancharia;4124103;Santo Antônio da Platina;1;1;2;143
3546405;Santa Cruz do Rio Pardo;4124103;Santo Antônio da Platina;1;1;2;66
3548500;Santos;4124103;Santo Antônio da Platina;1;1;2;391
3552205;Sorocaba;4124103;Santo Antônio da Platina;1;1;2;268
3557204;Chavantes;4124103;Santo Antônio da Platina;1;1;2;50
4100103;Abatiá;4124103;Santo Antônio da Platina;1;1;2;21
4101101;Andirá;4124103;Santo Antônio da Platina;1;1;2;30
4101804;Araucária;4124103;Santo Antônio da Platina;1;1;2;264
4102109;Astorga;4124103;Santo Antônio da Platina;1;1;2;159
4102406;Bandeirantes;4124103;Santo Antônio da Platina;1;1;2;34
4103701;Cambé;4124103;Santo Antônio da Platina;1;1;2;119
4104808;Cascavel;4124103;Santo Antônio da Platina;1;1;2;390
4112009;Jaguariaíva;4124103;Santo Antônio da Platina;1;1;2;116
4119400;Piraí do Sul;4124103;Santo Antônio da Platina;1;1;2;140
4122404;Rolândia;4124103;Santo Antônio da Platina;1;1;2;129
4123105;Santa Amélia;4124103;Santo Antônio da Platina;1;1;2;32
4123907;Santa Mariana;4124103;Santo Antônio da Platina;1;1;2;45
3516200;Franca;4124053;Santa Terezinha de Itaipu;1;1;2;882
3534401;Osasco;4124053;Santa Terezinha de Itaipu;1;1;2;793
3550308;São Paulo;4124053;Santa Terezinha de Itaipu;1;1;2;803
4107538;Entre Rios do Oeste;4124053;Santa Terezinha de Itaipu;1;1;2;84
4108809;Guaíra;4124053;Santa Terezinha de Itaipu;1;1;2;149
4110953;Itaipulândia;4124053;Santa Terezinha de Itaipu;1;1;2;36
4114609;Marechal Cândido Rondon;4124053;Santa Terezinha de Itaipu;1;1;2;105
4115200;Maringá;4124053;Santa Terezinha de Itaipu;1;1;2;335
2611606;Recife;4124020;Santa Tereza do Oeste;1;1;2;2600
3106200;Belo Horizonte;4124020;Santa Tereza do Oeste;1;1;2;1114
3304557;Rio de Janeiro;4124020;Santa Tereza do Oeste;1;1;2;1066
3509502;Campinas;4124020;Santa Tereza do Oeste;1;1;2;700
3513009;Cotia;4124020;Santa Tereza do Oeste;1;1;2;693
3534401;Osasco;4124020;Santa Tereza do Oeste;1;1;2;707
4103453;Cafelândia;4124020;Santa Tereza do Oeste;1;1;2;57
4104055;Campo Bonito;4124020;Santa Tereza do Oeste;1;1;2;65
4105300;Céu Azul;4124020;Santa Tereza do Oeste;1;1;2;24
4106902;Curitiba;4124020;Santa Tereza do Oeste;1;1;2;441
4107124;Diamante do Sul;4124020;Santa Tereza do Oeste;1;1;2;96
4109302;Guaraniaçu;4124020;Santa Tereza do Oeste;1;1;2;77
4114609;Marechal Cândido Rondon;4124020;Santa Tereza do Oeste;1;1;2;70
4115606;Matelândia;4124020;Santa Tereza do Oeste;1;1;2;42
4121257;Ramilândia;4124020;Santa Tereza do Oeste;1;1;2;40
3522802;Itaporanga;4124004;Santana do Itararé;1;1;2;15
3550308;São Paulo;4124004;Santana do Itararé;1;1;2;304
4101507;Arapongas;4124004;Santana do Itararé;1;1;2;188
4109401;Guarapuava;4124004;Santana do Itararé;1;1;2;261
3541406;Presidente Prudente;4123956;Santa Mônica;1;1;2;206
4107256;Douradina;4123956;Santa Mônica;1;1;2;36
4117107;Nova Londrina;4123956;Santa Mônica;1;1;2;40
4118402;Paranavaí;4123956;Santa Mônica;1;1;2;68
4123709;Santa Isabel do Ivaí;4123956;Santa Mônica;1;1;2;16
1500800;Ananindeua;4123907;Santa Mariana;1;1;2;2418
3534401;Osasco;4123907;Santa Mariana;1;1;2;385
3534708;Ourinhos;4123907;Santa Mariana;1;1;2;66
3539806;Poá;4123907;Santa Mariana;1;1;2;429
3553955;Tarumã;4123907;Santa Mariana;1;1;2;45
4101101;Andirá;4123907;Santa Mariana;1;1;2;32
4101408;Apucarana;4123907;Santa Mariana;1;1;2;106
4101903;Assaí;4123907;Santa Mariana;1;1;2;41
4103602;Cambará;4123907;Santa Mariana;1;1;2;47
4106902;Curitiba;4123907;Santa Mariana;1;1;2;283
4111001;Itambaracá;4123907;Santa Mariana;1;1;2;19
4115200;Maringá;4123907;Santa Mariana;1;1;2;148
4103909;Campina da Lagoa;4123857;Santa Maria do Oeste;1;1;2;102
4104055;Campo Bonito;4123857;Santa Maria do Oeste;1;1;2;115
4104808;Cascavel;4123857;Santa Maria do Oeste;1;1;2;161
4111506;Ivaiporã;4123857;Santa Maria do Oeste;1;1;2;78
4115200;Maringá;4123857;Santa Maria do Oeste;1;1;2;167
4121604;Renascença;4123857;Santa Maria do Oeste;1;1;2;176
4104501;Capanema;4123824;Santa Lúcia;1;1;2;39
4119509;Piraquara;4123824;Santa Lúcia;1;1;2;453
3534401;Osasco;4123808;Santa Izabel do Oeste;1;1;2;712
4104600;Capitão Leônidas Marques;4123808;Santa Izabel do Oeste;1;1;2;40
4106902;Curitiba;4123808;Santa Izabel do Oeste;1;1;2;422
4108403;Francisco Beltrão;4123808;Santa Izabel do Oeste;1;1;2;52
4117255;Nova Prata do Iguaçu;4123808;Santa Izabel do Oeste;1;1;2;25
4119806;Planalto;4123808;Santa Izabel do Oeste;1;1;2;31
3534401;Osasco;4123709;Santa Isabel do Ivaí;1;1;2;663
4121000;Querência do Norte;4123709;Santa Isabel do Ivaí;1;1;2;29
4123303;Santa Cruz de Monte Castelo;4123709;Santa Isabel do Ivaí;1;1;2;10
3516200;Franca;4123501;Santa Helena;1;1;2;839
3534401;Osasco;4123501;Santa Helena;1;1;2;771
3542404;Regente Feijó;4123501;Santa Helena;1;1;2;421
3550308;São Paulo;4123501;Santa Helena;1;1;2;783
4101507;Arapongas;4123501;Santa Helena;1;1;2;331
4104303;Campo Mourão;4123501;Santa Helena;1;1;2;215
4105300;Céu Azul;4123501;Santa Helena;1;1;2;55
4107157;Diamante d'Oeste;4123501;Santa Helena;1;1;2;22
4107538;Entre Rios do Oeste;4123501;Santa Helena;1;1;2;21
4109401;Guarapuava;4123501;Santa Helena;1;1;2;295
4119905;Ponta Grossa;4123501;Santa Helena;1;1;2;420
1302603;Manaus;4123402;Santa Fé;1;1;2;2347
3106200;Belo Horizonte;4123402;Santa Fé;1;1;2;866
3205200;Vila Velha;4123402;Santa Fé;1;1;2;1200
3302700;Maricá;4123402;Santa Fé;1;1;2;921
3529005;Marília;4123402;Santa Fé;1;1;2;210
3534401;Osasco;4123402;Santa Fé;1;1;2;518
4101507;Arapongas;4123402;Santa Fé;1;1;2;56
4103800;Cambira;4123402;Santa Fé;1;1;2;64
4106902;Curitiba;4123402;Santa Fé;1;1;2;371
4107603;Faxinal;4123402;Santa Fé;1;1;2;119
4108700;Grandes Rios;4123402;Santa Fé;1;1;2;127
4109401;Guarapuava;4123402;Santa Fé;1;1;2;263
4116307;Munhoz de Melo;4123402;Santa Fé;1;1;2;13
3505807;Bastos;4123303;Santa Cruz de Monte Castelo;1;1;2;286
3534401;Osasco;4123303;Santa Cruz de Monte Castelo;1;1;2;672
4118402;Paranavaí;4123303;Santa Cruz de Monte Castelo;1;1;2;89
3534708;Ourinhos;4123204;Santa Cecília do Pavão;1;1;2;108
3550308;São Paulo;4123204;Santa Cecília do Pavão;1;1;2;423
4106902;Curitiba;4123204;Santa Cecília do Pavão;1;1;2;262
4117214;Nova Santa Bárbara;4123204;Santa Cecília do Pavão;1;1;2;11
4118204;Paranaguá;4123204;Santa Cecília do Pavão;1;1;2;324
4103602;Cambará;4123105;Santa Amélia;1;1;2;43
4106407;Cornélio Procópio;4123105;Santa Amélia;1;1;2;26
3534401;Osasco;4123006;Salto do Lontra;1;1;2;694
4101002;Ampére;4123006;Salto do Lontra;1;1;2;22
4113304;Laranjeiras do Sul;4123006;Salto do Lontra;1;1;2;91
4118501;Pato Branco;4123006;Salto do Lontra;1;1;2;82
3505005;Barão de Antonina;4122909;Salto do Itararé;1;1;2;9
3522802;Itaporanga;4122909;Salto do Itararé;1;1;2;20
4112306;Japira;4122909;Salto do Itararé;1;1;2;56
4102604;Barracão;4122800;Salgado Filho;1;1;2;28
4104428;Candói;4122800;Salgado Filho;1;1;2;132
4108403;Francisco Beltrão;4122800;Salgado Filho;1;1;2;32
4114351;Manfrinópolis;4122800;Salgado Filho;1;1;2;6
3516903;General Salgado;4122701;Sabáudia;1;1;2;319
3536505;Paulínia;4122701;Sabáudia;1;1;2;453
3543402;Ribeirão Preto;4122701;Sabáudia;1;1;2;450
4119657;Pitangueiras;4122701;Sabáudia;1;1;2;10
4104303;Campo Mourão;4122651;Rosário do Ivaí;1;1;2;116
4104428;Candói;4122651;Rosário do Ivaí;1;1;2;178
4108700;Grandes Rios;4122651;Rosário do Ivaí;1;1;2;28
4113700;Londrina;4122651;Rosário do Ivaí;1;1;2;109
4114203;Mandaguari;4122651;Rosário do Ivaí;1;1;2;91
4115754;Mauá da Serra;4122651;Rosário do Ivaí;1;1;2;42
3505807;Bastos;4122602;Rondon;1;1;2;264
4105607;Cidade Gaúcha;4122602;Rondon;1;1;2;19
4106902;Curitiba;4122602;Rondon;1;1;2;422
4117206;Nova Olímpia;4122602;Rondon;1;1;2;34
4118006;Paraíso do Norte;4122602;Rondon;1;1;2;22
4122503;Roncador;4122602;Rondon;1;1;2;141
4102505;Barbosa Ferraz;4122503;Roncador;1;1;2;68
4103909;Campina da Lagoa;4122503;Roncador;1;1;2;53
4110805;Iretama;4122503;Roncador;1;1;2;26
4111506;Ivaiporã;4122503;Roncador;1;1;2;69
4114203;Mandaguari;4122503;Roncador;1;1;2;129
4115739;Mato Rico;4122503;Roncador;1;1;2;17
4117909;Palotina;4122503;Roncador;1;1;2;159
4118808;Peabiru;4122503;Roncador;1;1;2;77
4119608;Pitanga;4122503;Roncador;1;1;2;56
1100064;Colorado do Oeste;4122404;Rolândia;1;1;2;1452
2109601;Rosário;4122404;Rolândia;1;1;2;2360
2607901;Jaboatão dos Guararapes;4122404;Rolândia;1;1;2;2325
2704302;Maceió;4122404;Rolândia;1;1;2;2158
3106200;Belo Horizonte;4122404;Rolândia;1;1;2;837
3154606;Ribeirão das Neves;4122404;Rolândia;1;1;2;834
3519907;Iepê;4122404;Rolândia;1;1;2;78
3524303;Jaboticabal;4122404;Rolândia;1;1;2;385
3534708;Ourinhos;4122404;Rolândia;1;1;2;154
3548500;Santos;4122404;Rolândia;1;1;2;519
3548708;São Bernardo do Campo;4122404;Rolândia;1;1;2;492
3549904;São José dos Campos;4122404;Rolândia;1;1;2;561
3553807;Taquarituba;4122404;Rolândia;1;1;2;219
3553955;Tarumã;4122404;Rolândia;1;1;2;102
4102000;Assis Chateaubriand;4122404;Rolândia;1;1;2;254
4102109;Astorga;4122404;Rolândia;1;1;2;32
4103305;Borrazópolis;4122404;Rolândia;1;1;2;73
4104709;Carlópolis;4122404;Rolândia;1;1;2;169
4104907;Castro;4122404;Rolândia;1;1;2;212
4105508;Cianorte;4122404;Rolândia;1;1;2;132
4106001;Congonhinhas;4122404;Rolândia;1;1;2;88
4106605;Cruzeiro do Oeste;4122404;Rolândia;1;1;2;182
4107009;Curiúva;4122404;Rolândia;1;1;2;123
4107504;Engenheiro Beltrão;4122404;Rolândia;1;1;2;106
4107702;Fênix;4122404;Rolândia;1;1;2;92
4108007;Florestópolis;4122404;Rolândia;1;1;2;50
4108403;Francisco Beltrão;4122404;Rolândia;1;1;2;353
4108809;Guaíra;4122404;Rolândia;1;1;2;307
4109401;Guarapuava;4122404;Rolândia;1;1;2;231
4110607;Iporã;4122404;Rolândia;1;1;2;251
4110706;Irati;4122404;Rolândia;1;1;2;252
4111506;Ivaiporã;4122404;Rolândia;1;1;2;110
4111803;Jacarezinho;4122404;Rolândia;1;1;2;139
4112108;Jandaia do Sul;4122404;Rolândia;1;1;2;43
4112702;Jataizinho;4122404;Rolândia;1;1;2;40
4113429;Lidianópolis;4122404;Rolândia;1;1;2;93
4113502;Loanda;4122404;Rolândia;1;1;2;186
4114104;Mandaguaçu;4122404;Rolândia;1;1;2;78
4114609;Marechal Cândido Rondon;4122404;Rolândia;1;1;2;309
4114807;Marialva;4122404;Rolândia;1;1;2;47
4115002;Marilena;4122404;Rolândia;1;1;2;182
4115754;Mauá da Serra;4122404;Rolândia;1;1;2;67
4116901;Nova Esperança;4122404;Rolândia;1;1;2;87
4117107;Nova Londrina;4122404;Rolândia;1;1;2;176
4117909;Palotina;4122404;Rolândia;1;1;2;273
4118006;Paraíso do Norte;4122404;Rolândia;1;1;2;126
4118204;Paranaguá;4122404;Rolândia;1;1;2;384
4119905;Ponta Grossa;4122404;Rolândia;1;1;2;234
4120705;Quatiguá;4122404;Rolândia;1;1;2;152
4121307;Rancho Alegre;4122404;Rolândia;1;1;2;54
2607901;Jaboatão dos Guararapes;4122305;Rio Negro;1;1;2;2436
3534401;Osasco;4122305;Rio Negro;1;1;2;412
3550308;São Paulo;4122305;Rio Negro;1;1;2;413
3552502;Suzano;4122305;Rio Negro;1;1;2;447
4101309;Antônio Olinto;4122305;Rio Negro;1;1;2;42
4104204;Campo Largo;4122305;Rio Negro;1;1;2;77
4117701;Palmeira;4122305;Rio Negro;1;1;2;78
4118204;Paranaguá;4122305;Rio Negro;1;1;2;137
4118709;Paulo Frontin;4122305;Rio Negro;1;1;2;104
4119103;Piên;4122305;Rio Negro;1;1;2;37
4119152;Pinhais;4122305;Rio Negro;1;1;2;95
4121208;Quitandinha;4122305;Rio Negro;1;1;2;40
1506187;Rondon do Pará;4122206;Rio Branco do Sul;1;1;2;2259
3117876;Confins;4122206;Rio Branco do Sul;1;1;2;809
3509254;Cajati;4122206;Rio Branco do Sul;1;1;2;130
3510401;Capivari;4122206;Rio Branco do Sul;1;1;2;303
3516200;Franca;4122206;Rio Branco do Sul;1;1;2;548
3534401;Osasco;4122206;Rio Branco do Sul;1;1;2;312
4101804;Araucária;4122206;Rio Branco do Sul;1;1;2;45
4107652;Fazenda Rio Grande;4122206;Rio Branco do Sul;1;1;2;52
4115200;Maringá;4122206;Rio Branco do Sul;1;1;2;326
4115705;Matinhos;4122206;Rio Branco do Sul;1;1;2;102
4117701;Palmeira;4122206;Rio Branco do Sul;1;1;2;75
4119954;Pontal do Paraná;4122206;Rio Branco do Sul;1;1;2;97
4120804;Quatro Barras;4122206;Rio Branco do Sul;1;1;2;31
3550308;São Paulo;4122172;Rio Branco do Ivaí;1;1;2;478
4101507;Arapongas;4122172;Rio Branco do Ivaí;1;1;2;102
4104402;Cândido de Abreu;4122172;Rio Branco do Ivaí;1;1;2;27
4108700;Grandes Rios;4122172;Rio Branco do Ivaí;1;1;2;28
4113700;Londrina;4122172;Rio Branco do Ivaí;1;1;2;115
4114203;Mandaguari;4122172;Rio Branco do Ivaí;1;1;2;94
3534401;Osasco;4122156;Rio Bonito do Iguaçu;1;1;2;612
4104428;Candói;4122156;Rio Bonito do Iguaçu;1;1;2;41
4104451;Cantagalo;4122156;Rio Bonito do Iguaçu;1;1;2;42
4117057;Nova Laranjeiras;4122156;Rio Bonito do Iguaçu;1;1;2;20
4117800;Palmital;4122156;Rio Bonito do Iguaçu;1;1;2;74
4119301;Pinhão;4122156;Rio Bonito do Iguaçu;1;1;2;90
4119905;Ponta Grossa;4122156;Rio Bonito do Iguaçu;1;1;2;241
4120903;Quedas do Iguaçu;4122156;Rio Bonito do Iguaçu;1;1;2;39
3534401;Osasco;4122008;Rio Azul;1;1;2;467
4110201;Inácio Martins;4122008;Rio Azul;1;1;2;34
4119905;Ponta Grossa;4122008;Rio Azul;1;1;2;94
4120606;Prudentópolis;4122008;Rio Azul;1;1;2;61
4121505;Rebouças;4122008;Rio Azul;1;1;2;16
3534401;Osasco;4121901;Ribeirão do Pinhal;1;1;2;365
3534708;Ourinhos;4121901;Ribeirão do Pinhal;1;1;2;66
3550308;São Paulo;4121901;Ribeirão do Pinhal;1;1;2;380
4101101;Andirá;4121901;Ribeirão do Pinhal;1;1;2;42
4101606;Arapoti;4121901;Ribeirão do Pinhal;1;1;2;99
4102802;Bela Vista do Paraíso;4121901;Ribeirão do Pinhal;1;1;2;97
4103602;Cambará;4121901;Ribeirão do Pinhal;1;1;2;49
4104659;Carambeí;4121901;Ribeirão do Pinhal;1;1;2;169
4104709;Carlópolis;4121901;Ribeirão do Pinhal;1;1;2;65
4106407;Cornélio Procópio;4121901;Ribeirão do Pinhal;1;1;2;40
4109708;Ibaiti;4121901;Ribeirão do Pinhal;1;1;2;53
4112801;Joaquim Távora;4121901;Ribeirão do Pinhal;1;1;2;47
4112900;Jundiaí do Sul;4121901;Ribeirão do Pinhal;1;1;2;12
4117305;Ortigueira;4121901;Ribeirão do Pinhal;1;1;2;107
1100049;Cacoal;4121802;Ribeirão Claro;1;1;2;1743
3504008;Assis;4121802;Ribeirão Claro;1;1;2;91
3515400;Fartura;4121802;Ribeirão Claro;1;1;2;33
3526803;Lençóis Paulista;4121802;Ribeirão Claro;1;1;2;116
3529005;Marília;4121802;Ribeirão Claro;1;1;2;109
3534401;Osasco;4121802;Ribeirão Claro;1;1;2;306
3534708;Ourinhos;4121802;Ribeirão Claro;1;1;2;28
4106902;Curitiba;4121802;Ribeirão Claro;1;1;2;253
4109708;Ibaiti;4121802;Ribeirão Claro;1;1;2;86
4113700;Londrina;4121802;Ribeirão Claro;1;1;2;143
4119400;Piraí do Sul;4121802;Ribeirão Claro;1;1;2;152
4104428;Candói;4121752;Reserva do Iguaçu;1;1;2;24
4106902;Curitiba;4121752;Reserva do Iguaçu;1;1;2;277
4109401;Guarapuava;4121752;Reserva do Iguaçu;1;1;2;76
4119301;Pinhão;4121752;Reserva do Iguaçu;1;1;2;40
2308708;Morada Nova;4121703;Reserva;1;1;2;2472
3109402;Buritizeiro;4121703;Reserva;1;1;2;994
3534401;Osasco;4121703;Reserva;1;1;2;427
3550308;São Paulo;4121703;Reserva;1;1;2;438
4101408;Apucarana;4121703;Reserva;1;1;2;135
4101804;Araucária;4121703;Reserva;1;1;2;180
4102505;Barbosa Ferraz;4121703;Reserva;1;1;2;135
4110078;Imbaú;4121703;Reserva;1;1;2;24
4110706;Irati;4121703;Reserva;1;1;2;94
4111407;Ivaí;4121703;Reserva;1;1;2;40
4111506;Ivaiporã;4121703;Reserva;1;1;2;99
4112108;Jandaia do Sul;4121703;Reserva;1;1;2;141
4116901;Nova Esperança;4121703;Reserva;1;1;2;212
4117701;Palmeira;4121703;Reserva;1;1;2;122
4118501;Pato Branco;4121703;Reserva;1;1;2;254
4120606;Prudentópolis;4121703;Reserva;1;1;2;66
3550308;São Paulo;4121604;Renascença;1;1;2;684
4101804;Araucária;4121604;Renascença;1;1;2;361
4106902;Curitiba;4121604;Renascença;1;1;2;375
4107207;Dois Vizinhos;4121604;Renascença;1;1;2;47
4116950;Nova Esperança do Sudoeste;4121604;Renascença;1;1;2;40
4118204;Paranaguá;4121604;Renascença;1;1;2;445
3528502;Mairiporã;4121505;Rebouças;1;1;2;482
4106902;Curitiba;4121505;Rebouças;1;1;2;142
4110201;Inácio Martins;4121505;Rebouças;1;1;2;39
4113205;Lapa;4121505;Rebouças;1;1;2;100
4113908;Mallet;4121505;Rebouças;1;1;2;31
4114609;Marechal Cândido Rondon;4121505;Rebouças;1;1;2;357
4119905;Ponta Grossa;4121505;Rebouças;1;1;2;78
3148004;Patos de Minas;4121406;Realeza;1;1;2;1052
3534401;Osasco;4121406;Realeza;1;1;2;715
4105409;Chopinzinho;4121406;Realeza;1;1;2;102
4106308;Corbélia;4121406;Realeza;1;1;2;112
4107207;Dois Vizinhos;4121406;Realeza;1;1;2;49
4114609;Marechal Cândido Rondon;4121406;Realeza;1;1;2;144
4117222;Nova Santa Rosa;4121406;Realeza;1;1;2;150
4117255;Nova Prata do Iguaçu;4121406;Realeza;1;1;2;25
4117909;Palotina;4121406;Realeza;1;1;2;165
4119004;Pérola d'Oeste;4121406;Realeza;1;1;2;21
4120903;Quedas do Iguaçu;4121406;Realeza;1;1;2;73
4108601;Goioerê;4121356;Rancho Alegre d'Oeste;1;1;2;14
4113700;Londrina;4121356;Rancho Alegre d'Oeste;1;1;2;214
4117909;Palotina;4121356;Rancho Alegre d'Oeste;1;1;2;87
4102406;Bandeirantes;4121307;Rancho Alegre;1;1;2;56
4103602;Cambará;4121307;Rancho Alegre;1;1;2;86
4106407;Cornélio Procópio;4121307;Rancho Alegre;1;1;2;29
4113700;Londrina;4121307;Rancho Alegre;1;1;2;35
4115200;Maringá;4121307;Rancho Alegre;1;1;2;112
4110953;Itaipulândia;4121257;Ramilândia;1;1;2;28
3534401;Osasco;4121208;Quitandinha;1;1;2;373
4100301;Agudos do Sul;4121208;Quitandinha;1;1;2;21
4101804;Araucária;4121208;Quitandinha;1;1;2;33
4106902;Curitiba;4121208;Quitandinha;1;1;2;53
4119152;Pinhais;4121208;Quitandinha;1;1;2;56
4119905;Ponta Grossa;4121208;Quitandinha;1;1;2;108
3530508;Mococa;4121109;Quinta do Sol;1;1;2;578
3550308;São Paulo;4121109;Quinta do Sol;1;1;2;558
4104303;Campo Mourão;4121109;Quinta do Sol;1;1;2;34
4117909;Palotina;4121109;Quinta do Sol;1;1;2;178
3502804;Araçatuba;4121000;Querência do Norte;1;1;2;370
4108908;Guairaçá;4121000;Querência do Norte;1;1;2;83
3534401;Osasco;4120903;Quedas do Iguaçu;1;1;2;646
3550308;São Paulo;4120903;Quedas do Iguaçu;1;1;2;656
4104600;Capitão Leônidas Marques;4120903;Quedas do Iguaçu;1;1;2;71
4107207;Dois Vizinhos;4120903;Quedas do Iguaçu;1;1;2;35
4111209;Itapejara d'Oeste;4120903;Quedas do Iguaçu;1;1;2;58
4114500;Manoel Ribas;4120903;Quedas do Iguaçu;1;1;2;162
4119905;Ponta Grossa;4120903;Quedas do Iguaçu;1;1;2;278
4104808;Cascavel;4120853;Quatro Pontes;1;1;2;67
4111555;Ivaté;4120853;Quatro Pontes;1;1;2;143
4115853;Mercedes;4120853;Quatro Pontes;1;1;2;23
4117222;Nova Santa Rosa;4120853;Quatro Pontes;1;1;2;12
1100205;Porto Velho;4120804;Quatro Barras;1;1;2;2321
1500602;Altamira;4120804;Quatro Barras;1;1;2;2474
1502152;Canaã dos Carajás;4120804;Quatro Barras;1;1;2;2089
1721000;Palmas;4120804;Quatro Barras;1;1;2;1662
2611606;Recife;4120804;Quatro Barras;1;1;2;2342
2905701;Camaçari;4120804;Quatro Barras;1;1;2;1746
2910057;Dias d'Ávila;4120804;Quatro Barras;1;1;2;1755
2919207;Lauro de Freitas;4120804;Quatro Barras;1;1;2;1730
3106705;Betim;4120804;Quatro Barras;1;1;2;769
3118601;Contagem;4120804;Quatro Barras;1;1;2;779
3156700;Sabará;4120804;Quatro Barras;1;1;2;799
3168101;Tapira;4120804;Quatro Barras;1;1;2;643
3169901;Ubá;4120804;Quatro Barras;1;1;2;767
3203205;Linhares;4120804;Quatro Barras;1;1;2;1112
3301702;Duque de Caxias;4120804;Quatro Barras;1;1;2;642
3505708;Barueri;4120804;Quatro Barras;1;1;2;301
3513801;Diadema;4120804;Quatro Barras;1;1;2;309
3518800;Guarulhos;4120804;Quatro Barras;1;1;2;330
3523909;Itu;4120804;Quatro Barras;1;1;2;291
3524402;Jacareí;4120804;Quatro Barras;1;1;2;386
3530300;Mirassol;4120804;Quatro Barras;1;1;2;505
3534401;Osasco;4120804;Quatro Barras;1;1;2;305
3547304;Santana de Parnaíba;4120804;Quatro Barras;1;1;2;303
4101200;Antonina;4120804;Quatro Barras;1;1;2;36
4101507;Arapongas;4120804;Quatro Barras;1;1;2;320
4103107;Bocaiúva do Sul;4120804;Quatro Barras;1;1;2;18
4105201;Cerro Azul;4120804;Quatro Barras;1;1;2;63
4119509;Piraquara;4120804;Quatro Barras;1;1;2;9
1507953;Tailândia;4120705;Quatiguá;1;1;2;2283
3522802;Itaporanga;4120705;Quatiguá;1;1;2;46
3523206;Itararé;4120705;Quatiguá;1;1;2;83
3534708;Ourinhos;4120705;Quatiguá;1;1;2;65
4101606;Arapoti;4120705;Quatiguá;1;1;2;66
4106902;Curitiba;4120705;Quatiguá;1;1;2;216
4109708;Ibaiti;4120705;Quatiguá;1;1;2;43
4111803;Jacarezinho;4120705;Quatiguá;1;1;2;47
1100205;Porto Velho;4120655;Quarto Centenário;1;1;2;2011
4101804;Araucária;4120655;Quarto Centenário;1;1;2;402
4103453;Cafelândia;4120655;Quarto Centenário;1;1;2;45
4104808;Cascavel;4120655;Quarto Centenário;1;1;2;83
4113700;Londrina;4120655;Quarto Centenário;1;1;2;223
4115200;Maringá;4120655;Quarto Centenário;1;1;2;149
4117909;Palotina;4120655;Quarto Centenário;1;1;2;74
3507100;Bom Jesus dos Perdões;4120606;Prudentópolis;1;1;2;511
3516200;Franca;4120606;Prudentópolis;1;1;2;630
3534401;Osasco;4120606;Prudentópolis;1;1;2;464
4101804;Araucária;4120606;Prudentópolis;1;1;2;169
4102109;Astorga;4120606;Prudentópolis;1;1;2;229
4102901;Bituruna;4120606;Prudentópolis;1;1;2;117
4104659;Carambeí;4120606;Prudentópolis;1;1;2;100
4104808;Cascavel;4120606;Prudentópolis;1;1;2;246
4110508;Ipiranga;4120606;Prudentópolis;1;1;2;50
4111506;Ivaiporã;4120606;Prudentópolis;1;1;2;128
4118501;Pato Branco;4120606;Prudentópolis;1;1;2;199
4118709;Paulo Frontin;4120606;Prudentópolis;1;1;2;93
4119301;Pinhão;4120606;Prudentópolis;1;1;2;83
4119608;Pitanga;4120606;Prudentópolis;1;1;2;88
3534401;Osasco;4120507;Primeiro de Maio;1;1;2;445
4101903;Assaí;4120507;Primeiro de Maio;1;1;2;62
4103701;Cambé;4120507;Primeiro de Maio;1;1;2;54
4106902;Curitiba;4120507;Primeiro de Maio;1;1;2;339
4115200;Maringá;4120507;Primeiro de Maio;1;1;2;111
4120002;Porecatu;4120507;Primeiro de Maio;1;1;2;35
4116901;Nova Esperança;4120408;Presidente Castelo Branco;1;1;2;12
4118402;Paranavaí;4120408;Presidente Castelo Branco;1;1;2;36
4102752;Bela Vista da Caroba;4120358;Pranchita;1;1;2;17
4106902;Curitiba;4120358;Pranchita;1;1;2;449
4103404;Cafeara;4120333;Prado Ferreira;1;1;2;39
4108007;Florestópolis;4120333;Prado Ferreira;1;1;2;20
4111902;Jaguapitã;4120333;Prado Ferreira;1;1;2;12
4113700;Londrina;4120333;Prado Ferreira;1;1;2;41
4115200;Maringá;4120333;Prado Ferreira;1;1;2;66
4120002;Porecatu;4120333;Prado Ferreira;1;1;2;32
2903201;Barreiras;4120309;Porto Vitória;1;1;2;1655
3550308;São Paulo;4120309;Porto Vitória;1;1;2;532
4106803;Cruz Machado;4120309;Porto Vitória;1;1;2;20
4117107;Nova Londrina;4120200;Porto Rico;1;1;2;29
4118402;Paranavaí;4120200;Porto Rico;1;1;2;92
2307650;Maracanaú;4120101;Porto Amazonas;1;1;2;2628
3550308;São Paulo;4120101;Porto Amazonas;1;1;2;385
4100400;Almirante Tamandaré;4120101;Porto Amazonas;1;1;2;63
4102307;Balsa Nova;4120101;Porto Amazonas;1;1;2;26
4113205;Lapa;4120101;Porto Amazonas;1;1;2;30
4116208;Morretes;4120101;Porto Amazonas;1;1;2;106
4117701;Palmeira;4120101;Porto Amazonas;1;1;2;17
4119152;Pinhais;4120101;Porto Amazonas;1;1;2;71
4119905;Ponta Grossa;4120101;Porto Amazonas;1;1;2;56
3507902;Brotas;4120002;Porecatu;1;1;2;338
3513801;Diadema;4120002;Porecatu;1;1;2;501
3516200;Franca;4120002;Porecatu;1;1;2;473
3519907;Iepê;4120002;Porecatu;1;1;2;33
3532157;Nantes;4120002;Porecatu;1;1;2;21
3534401;Osasco;4120002;Porecatu;1;1;2;480
4101903;Assaí;4120002;Porecatu;1;1;2;88
4113809;Lupionópolis;4120002;Porecatu;1;1;2;29
4116000;Miraselva;4120002;Porecatu;1;1;2;26
4119905;Ponta Grossa;4120002;Porecatu;1;1;2;289
3503901;Arujá;4119954;Pontal do Paraná;1;1;2;334
3513504;Cubatão;4119954;Pontal do Paraná;1;1;2;286
3534401;Osasco;4119954;Pontal do Paraná;1;1;2;292
4101200;Antonina;4119954;Pontal do Paraná;1;1;2;39
4105805;Colombo;4119954;Pontal do Paraná;1;1;2;87
4111506;Ivaiporã;4119954;Pontal do Paraná;1;1;2;357
4114302;Mandirituba;4119954;Pontal do Paraná;1;1;2;83
4119905;Ponta Grossa;4119954;Pontal do Paraná;1;1;2;177
2109007;Porto Franco;4119905;Ponta Grossa;1;1;2;2092
2211001;Teresina;4119905;Ponta Grossa;1;1;2;2324
2408102;Natal;4119905;Ponta Grossa;1;1;2;2570
2500601;Alhandra;4119905;Ponta Grossa;1;1;2;2444
2601201;Arcoverde;4119905;Ponta Grossa;1;1;2;2233
2607901;Jaboatão dos Guararapes;4119905;Ponta Grossa;1;1;2;2378
2609600;Olinda;4119905;Ponta Grossa;1;1;2;2396
2611101;Petrolina;4119905;Ponta Grossa;1;1;2;1980
2611606;Recife;4119905;Ponta Grossa;1;1;2;2384
2918407;Juazeiro;4119905;Ponta Grossa;1;1;2;1964
2919207;Lauro de Freitas;4119905;Ponta Grossa;1;1;2;1775
3118304;Conselheiro Lafaiete;4119905;Ponta Grossa;1;1;2;799
3118601;Contagem;4119905;Ponta Grossa;1;1;2;832
3126109;Formiga;4119905;Ponta Grossa;1;1;2;697
3133758;Itaú de Minas;4119905;Ponta Grossa;1;1;2;588
3148004;Patos de Minas;4119905;Ponta Grossa;1;1;2;808
3151800;Poços de Caldas;4119905;Ponta Grossa;1;1;2;516
3162005;São Gonçalo do Sapucaí;4119905;Ponta Grossa;1;1;2;578
3170206;Uberlândia;4119905;Ponta Grossa;1;1;2;712
3172202;Wenceslau Braz;4119905;Ponta Grossa;1;1;2;556
3205002;Serra;4119905;Ponta Grossa;1;1;2;1121
3301108;Cantagalo;4119905;Ponta Grossa;1;1;2;852
3301702;Duque de Caxias;4119905;Ponta Grossa;1;1;2;732
3302502;Magé;4119905;Ponta Grossa;1;1;2;760
3303302;Niterói;4119905;Ponta Grossa;1;1;2;748
3304201;Resende;4119905;Ponta Grossa;1;1;2;639
3306305;Volta Redonda;4119905;Ponta Grossa;1;1;2;671
3501608;Americana;4119905;Ponta Grossa;1;1;2;385
3506003;Bauru;4119905;Ponta Grossa;1;1;2;325
3509254;Cajati;4119905;Ponta Grossa;1;1;2;210
3511409;Cerqueira César;4119905;Ponta Grossa;1;1;2;250
3512407;Cordeirópolis;4119905;Ponta Grossa;1;1;2;397
3513009;Cotia;4119905;Ponta Grossa;1;1;2;366
3513801;Diadema;4119905;Ponta Grossa;1;1;2;389
3514809;Eldorado;4119905;Ponta Grossa;1;1;2;217
3516200;Franca;4119905;Ponta Grossa;1;1;2;575
3517703;Guará;4119905;Ponta Grossa;1;1;2;568
3518800;Guarulhos;4119905;Ponta Grossa;1;1;2;406
3519501;Ibirarema;4119905;Ponta Grossa;1;1;2;254
3522505;Itapevi;4119905;Ponta Grossa;1;1;2;366
3523404;Itatiba;4119905;Ponta Grossa;1;1;2;406
3523909;Itu;4119905;Ponta Grossa;1;1;2;351
3524402;Jacareí;4119905;Ponta Grossa;1;1;2;467
3524600;Jacupiranga;4119905;Ponta Grossa;1;1;2;223
3526902;Limeira;4119905;Ponta Grossa;1;1;2;395
3529302;Matão;4119905;Ponta Grossa;1;1;2;426
3530706;Mogi Guaçu;4119905;Ponta Grossa;1;1;2;445
3534708;Ourinhos;4119905;Ponta Grossa;1;1;2;237
3543402;Ribeirão Preto;4119905;Ponta Grossa;1;1;2;497
3545209;Salto;4119905;Ponta Grossa;1;1;2;357
3547304;Santana de Parnaíba;4119905;Ponta Grossa;1;1;2;374
3548807;São Caetano do Sul;4119905;Ponta Grossa;1;1;2;397
3549904;São José dos Campos;4119905;Ponta Grossa;1;1;2;478
3552205;Sorocaba;4119905;Ponta Grossa;1;1;2;322
3552809;Taboão da Serra;4119905;Ponta Grossa;1;1;2;379
3555000;Tupã;4119905;Ponta Grossa;1;1;2;353
4100400;Almirante Tamandaré;4119905;Ponta Grossa;1;1;2;90
4101002;Ampére;4119905;Ponta Grossa;1;1;2;347
4101101;Andirá;4119905;Ponta Grossa;1;1;2;228
4101705;Araruna;4119905;Ponta Grossa;1;1;2;268
4102109;Astorga;4119905;Ponta Grossa;1;1;2;256
4102307;Balsa Nova;4119905;Ponta Grossa;1;1;2;75
4102406;Bandeirantes;4119905;Ponta Grossa;1;1;2;222
4102604;Barracão;4119905;Ponta Grossa;1;1;2;373
4102901;Bituruna;4119905;Ponta Grossa;1;1;2;183
4104105;Campo do Tenente;4119905;Ponta Grossa;1;1;2;108
4104253;Campo Magro;4119905;Ponta Grossa;1;1;2;78
4104402;Cândido de Abreu;4119905;Ponta Grossa;1;1;2;132
4104428;Candói;4119905;Ponta Grossa;1;1;2;211
4105300;Céu Azul;4119905;Ponta Grossa;1;1;2;372
4106506;Coronel Vivida;4119905;Ponta Grossa;1;1;2;261
4106803;Cruz Machado;4119905;Ponta Grossa;1;1;2;157
4107603;Faxinal;4119905;Ponta Grossa;1;1;2;168
4108502;General Carneiro;4119905;Ponta Grossa;1;1;2;187
4109708;Ibaiti;4119905;Ponta Grossa;1;1;2;138
4109807;Ibiporã;4119905;Ponta Grossa;1;1;2;222
4110078;Imbaú;4119905;Ponta Grossa;1;1;2;95
4110409;Indianópolis;4119905;Ponta Grossa;1;1;2;311
4111258;Itaperuçu;4119905;Ponta Grossa;1;1;2;82
4111506;Ivaiporã;4119905;Ponta Grossa;1;1;2;183
4112108;Jandaia do Sul;4119905;Ponta Grossa;1;1;2;223
4113908;Mallet;4119905;Ponta Grossa;1;1;2;108
4114401;Mangueirinha;4119905;Ponta Grossa;1;1;2;224
4114500;Manoel Ribas;4119905;Ponta Grossa;1;1;2;165
4115606;Matelândia;4119905;Ponta Grossa;1;1;2;387
4115705;Matinhos;4119905;Ponta Grossa;1;1;2;179
4116208;Morretes;4119905;Ponta Grossa;1;1;2;141
4116901;Nova Esperança;4119905;Ponta Grossa;1;1;2;295
4117503;Paiçandu;4119905;Ponta Grossa;1;1;2;263
4117800;Palmital;4119905;Ponta Grossa;1;1;2;207
4118402;Paranavaí;4119905;Ponta Grossa;1;1;2;319
4118808;Peabiru;4119905;Ponta Grossa;1;1;2;255
4119301;Pinhão;4119905;Ponta Grossa;1;1;2;165
4107546;Espigão Alto do Iguaçu;4119806;Planalto;1;1;2;99
4108403;Francisco Beltrão;4119806;Planalto;1;1;2;82
4118204;Paranaguá;4119806;Planalto;1;1;2;523
4118501;Pato Branco;4119806;Planalto;1;1;2;125
3550308;São Paulo;4119707;Planaltina do Paraná;1;1;2;648
4101705;Araruna;4119707;Planaltina do Paraná;1;1;2;111
4113502;Loanda;4119707;Planaltina do Paraná;1;1;2;24
4116109;Moreira Sales;4119707;Planaltina do Paraná;1;1;2;117
4113700;Londrina;4119657;Pitangueiras;1;1;2;45
3304557;Rio de Janeiro;4119608;Pitanga;1;1;2;878
3505807;Bastos;4119608;Pitanga;1;1;2;331
3534401;Osasco;4119608;Pitanga;1;1;2;518
4101507;Arapongas;4119608;Pitanga;1;1;2;153
4103040;Boa Ventura de São Roque;4119608;Pitanga;1;1;2;17
4103958;Campina do Simão;4119608;Pitanga;1;1;2;35
4104808;Cascavel;4119608;Pitanga;1;1;2;173
4105805;Colombo;4119608;Pitanga;1;1;2;260
4108957;Guamiranga;4119608;Pitanga;1;1;2;107
4113700;Londrina;4119608;Pitanga;1;1;2;174
4115200;Maringá;4119608;Pitanga;1;1;2;149
4116802;Nova Cantu;4119608;Pitanga;1;1;2;83
4117305;Ortigueira;4119608;Pitanga;1;1;2;102
4118501;Pato Branco;4119608;Pitanga;1;1;2;186
2111300;São Luís;4119509;Piraquara;1;1;2;2576
2408102;Natal;4119509;Piraquara;1;1;2;2542
2611606;Recife;4119509;Piraquara;1;1;2;2347
2704302;Maceió;4119509;Piraquara;1;1;2;2167
2913606;Ilhéus;4119509;Piraquara;1;1;2;1524
2927408;Salvador;4119509;Piraquara;1;1;2;1717
2933307;Vitória da Conquista;4119509;Piraquara;1;1;2;1417
3106200;Belo Horizonte;4119509;Piraquara;1;1;2;792
3127701;Governador Valadares;4119509;Piraquara;1;1;2;1011
3136702;Juiz de Fora;4119509;Piraquara;1;1;2;700
3143302;Montes Claros;4119509;Piraquara;1;1;2;1089
3151800;Poços de Caldas;4119509;Piraquara;1;1;2;477
3152501;Pouso Alegre;4119509;Piraquara;1;1;2;473
3170701;Varginha;4119509;Piraquara;1;1;2;567
3301702;Duque de Caxias;4119509;Piraquara;1;1;2;644
3505708;Barueri;4119509;Piraquara;1;1;2;306
3534401;Osasco;4119509;Piraquara;1;1;2;310
3538006;Pindamonhangaba;4119509;Piraquara;1;1;2;454
3541406;Presidente Prudente;4119509;Piraquara;1;1;2;433
3542602;Registro;4119509;Piraquara;1;1;2;157
4101408;Apucarana;4119509;Piraquara;1;1;2;317
4101804;Araucária;4119509;Piraquara;1;1;2;38
4104006;Campina Grande do Sul;4119509;Piraquara;1;1;2;15
4104204;Campo Largo;4119509;Piraquara;1;1;2;47
4104808;Cascavel;4119509;Piraquara;1;1;2;445
4107652;Fazenda Rio Grande;4119509;Piraquara;1;1;2;34
4110706;Irati;4119509;Piraquara;1;1;2;158
4113205;Lapa;4119509;Piraquara;1;1;2;75
4118204;Paranaguá;4119509;Piraquara;1;1;2;53
3170206;Uberlândia;4119400;Piraí do Sul;1;1;2;648
3516200;Franca;4119400;Piraí do Sul;1;1;2;512
3534401;Osasco;4119400;Piraí do Sul;1;1;2;337
4101606;Arapoti;4119400;Piraí do Sul;1;1;2;46
4101804;Araucária;4119400;Piraí do Sul;1;1;2;127
4104659;Carambeí;4119400;Piraí do Sul;1;1;2;43
4104709;Carlópolis;4119400;Piraí do Sul;1;1;2;127
4109708;Ibaiti;4119400;Piraí do Sul;1;1;2;81
4111407;Ivaí;4119400;Piraí do Sul;1;1;2;106
4117305;Ortigueira;4119400;Piraí do Sul;1;1;2;109
4117602;Palmas;4119400;Piraí do Sul;1;1;2;300
3304557;Rio de Janeiro;4119301;Pinhão;1;1;2;890
3534401;Osasco;4119301;Pinhão;1;1;2;540
4101804;Araucária;4119301;Pinhão;1;1;2;227
4104303;Campo Mourão;4119301;Pinhão;1;1;2;197
4108304;Foz do Iguaçu;4119301;Pinhão;1;1;2;285
4110706;Irati;4119301;Pinhão;1;1;2;105
4114401;Mangueirinha;4119301;Pinhão;1;1;2;59
4116208;Morretes;4119301;Pinhão;1;1;2;284
4117602;Palmas;4119301;Pinhão;1;1;2;95
4118501;Pato Branco;4119301;Pinhão;1;1;2;117
4101002;Ampére;4119251;Pinhal de São Bento;1;1;2;13
4104709;Carlópolis;4119202;Pinhalão;1;1;2;53
4112801;Joaquim Távora;4119202;Pinhalão;1;1;2;36
4113700;Londrina;4119202;Pinhalão;1;1;2;124
1504422;Marituba;4119152;Pinhais;1;1;2;2666
2303709;Caucaia;4119152;Pinhais;1;1;2;2604
2307650;Maracanaú;4119152;Pinhais;1;1;2;2592
2607901;Jaboatão dos Guararapes;4119152;Pinhais;1;1;2;2349
2910800;Feira de Santana;4119152;Pinhais;1;1;2;1759
2919207;Lauro de Freitas;4119152;Pinhais;1;1;2;1743
3106309;Belo Oriente;4119152;Pinhais;1;1;2;954
3106705;Betim;4119152;Pinhais;1;1;2;782
3136702;Juiz de Fora;4119152;Pinhais;1;1;2;710
3157807;Santa Luzia;4119152;Pinhais;1;1;2;820
3169901;Ubá;4119152;Pinhais;1;1;2;781
3201605;Conceição da Barra;4119152;Pinhais;1;1;2;1195
3205309;Vitória;4119152;Pinhais;1;1;2;1049
3301702;Duque de Caxias;4119152;Pinhais;1;1;2;656
3303302;Niterói;4119152;Pinhais;1;1;2;670
3304524;Rio das Ostras;4119152;Pinhais;1;1;2;792
3502101;Andradina;4119152;Pinhais;1;1;2;546
3506003;Bauru;4119152;Pinhais;1;1;2;344
3508504;Caçapava;4119152;Pinhais;1;1;2;434
3509205;Cajamar;4119152;Pinhais;1;1;2;327
3509502;Campinas;4119152;Pinhais;1;1;2;353
3513801;Diadema;4119152;Pinhais;1;1;2;323
3515004;Embu;4119152;Pinhais;1;1;2;307
3520509;Indaiatuba;4119152;Pinhais;1;1;2;325
3522208;Itapecerica da Serra;4119152;Pinhais;1;1;2;302
3524600;Jacupiranga;4119152;Pinhais;1;1;2;146
3526803;Lençóis Paulista;4119152;Pinhais;1;1;2;317
3526902;Limeira;4119152;Pinhais;1;1;2;366
3529005;Marília;4119152;Pinhais;1;1;2;365
3534302;Orlândia;4119152;Pinhais;1;1;2;539
3543303;Ribeirão Pires;4119152;Pinhais;1;1;2;337
3548906;São Carlos;4119152;Pinhais;1;1;2;400
3552403;Sumaré;4119152;Pinhais;1;1;2;348
4100301;Agudos do Sul;4119152;Pinhais;1;1;2;62
4101507;Arapongas;4119152;Pinhais;1;1;2;318
4101606;Arapoti;4119152;Pinhais;1;1;2;156
4103453;Cafelândia;4119152;Pinhais;1;1;2;424
4104253;Campo Magro;4119152;Pinhais;1;1;2;27
4106605;Cruzeiro do Oeste;4119152;Pinhais;1;1;2;429
4109401;Guarapuava;4119152;Pinhais;1;1;2;228
4109609;Guaratuba;4119152;Pinhais;1;1;2;77
4113908;Mallet;4119152;Pinhais;1;1;2;171
4115705;Matinhos;4119152;Pinhais;1;1;2;75
3534401;Osasco;4119103;Piên;1;1;2;386
4101804;Araucária;4119103;Piên;1;1;2;57
4111209;Itapejara d'Oeste;4119004;Pérola d'Oeste;1;1;2;94
3534401;Osasco;4118907;Pérola;1;1;2;702
4103701;Cambé;4118907;Pérola;1;1;2;252
4107520;Esperança Nova;4118907;Pérola;1;1;2;16
4110607;Iporã;4118907;Pérola;1;1;2;22
4113700;Londrina;4118907;Pérola;1;1;2;263
4114708;Maria Helena;4118907;Pérola;1;1;2;53
4117909;Palotina;4118907;Pérola;1;1;2;56
3541406;Presidente Prudente;4118857;Perobal;1;1;2;282
3552205;Sorocaba;4118857;Perobal;1;1;2;603
4100707;Alto Piquiri;4118857;Perobal;1;1;2;15
4106605;Cruzeiro do Oeste;4118857;Perobal;1;1;2;36
4107504;Engenheiro Beltrão;4118857;Perobal;1;1;2;117
4111555;Ivaté;4118857;Perobal;1;1;2;54
4114708;Maria Helena;4118857;Perobal;1;1;2;37
4115200;Maringá;4118857;Perobal;1;1;2;159
4117206;Nova Olímpia;4118857;Perobal;1;1;2;57
4117909;Palotina;4118857;Perobal;1;1;2;60
3534401;Osasco;4118808;Peabiru;1;1;2;566
4101705;Araruna;4118808;Peabiru;1;1;2;16
4104808;Cascavel;4118808;Peabiru;1;1;2;161
4106605;Cruzeiro do Oeste;4118808;Peabiru;1;1;2;76
4112207;Janiópolis;4118808;Peabiru;1;1;2;51
4113700;Londrina;4118808;Peabiru;1;1;2;139
3550308;São Paulo;4118709;Paulo Frontin;1;1;2;492
4104006;Campina Grande do Sul;4118709;Paulo Frontin;1;1;2;195
3550308;São Paulo;4118600;Paula Freitas;1;1;2;510
4102901;Bituruna;4118600;Paula Freitas;1;1;2;62
4112009;Jaguariaíva;4118600;Paula Freitas;1;1;2;248
4117701;Palmeira;4118600;Paula Freitas;1;1;2;127
1500503;Almeirim;4118501;Pato Branco;1;1;2;2736
1505304;Oriximiná;4118501;Pato Branco;1;1;2;2726
1508100;Tucuruí;4118501;Pato Branco;1;1;2;2502
1600303;Macapá;4118501;Pato Branco;1;1;2;2913
3106200;Belo Horizonte;4118501;Pato Branco;1;1;2;1100
3125101;Extrema;4118501;Pato Branco;1;1;2;729
3148004;Patos de Minas;4118501;Pato Branco;1;1;2;1037
3205200;Vila Velha;4118501;Pato Branco;1;1;2;1367
3305505;Saquarema;4118501;Pato Branco;1;1;2;1073
3502309;Anhembi;4118501;Pato Branco;1;1;2;585
3504602;Bady Bassitt;4118501;Pato Branco;1;1;2;667
3505708;Barueri;4118501;Pato Branco;1;1;2;646
3506003;Bauru;4118501;Pato Branco;1;1;2;556
3513801;Diadema;4118501;Pato Branco;1;1;2;661
3516200;Franca;4118501;Pato Branco;1;1;2;813
3518701;Guarujá;4118501;Pato Branco;1;1;2;681
3534401;Osasco;4118501;Pato Branco;1;1;2;653
3548708;São Bernardo do Campo;4118501;Pato Branco;1;1;2;662
4100400;Almirante Tamandaré;4118501;Pato Branco;1;1;2;348
4101408;Apucarana;4118501;Pato Branco;1;1;2;319
4101507;Arapongas;4118501;Pato Branco;1;1;2;335
4101804;Araucária;4118501;Pato Branco;1;1;2;333
4102406;Bandeirantes;4118501;Pato Branco;1;1;2;413
4102604;Barracão;4118501;Pato Branco;1;1;2;97
4103909;Campina da Lagoa;4118501;Pato Branco;1;1;2;182
4106803;Cruz Machado;4118501;Pato Branco;1;1;2;133
4108502;General Carneiro;4118501;Pato Branco;1;1;2;136
4108601;Goioerê;4118501;Pato Branco;1;1;2;228
4110508;Ipiranga;4118501;Pato Branco;1;1;2;246
4110706;Irati;4118501;Pato Branco;1;1;2;218
4111209;Itapejara d'Oeste;4118501;Pato Branco;1;1;2;33
4111407;Ivaí;4118501;Pato Branco;1;1;2;224
4112504;Jardim Alegre;4118501;Pato Branco;1;1;2;247
4113452;Lindoeste;4118501;Pato Branco;1;1;2;141
4113908;Mallet;4118501;Pato Branco;1;1;2;188
4114609;Marechal Cândido Rondon;4118501;Pato Branco;1;1;2;231
4114807;Marialva;4118501;Pato Branco;1;1;2;316
4116950;Nova Esperança do Sudoeste;4118501;Pato Branco;1;1;2;70
4117255;Nova Prata do Iguaçu;4118501;Pato Branco;1;1;2;95
4117701;Palmeira;4118501;Pato Branco;1;1;2;279
4118402;Paranavaí;4118501;Pato Branco;1;1;2;348
4104808;Cascavel;4118451;Pato Bragado;1;1;2;86
4108809;Guaíra;4118451;Pato Bragado;1;1;2;58
4115853;Mercedes;4118451;Pato Bragado;1;1;2;20
1100304;Vilhena;4118402;Paranavaí;1;1;2;1373
1709500;Gurupi;4118402;Paranavaí;1;1;2;1304
3506102;Bebedouro;4118402;Paranavaí;1;1;2;463
3508504;Caçapava;4118402;Paranavaí;1;1;2;691
3513405;Cruzeiro;4118402;Paranavaí;1;1;2;767
3514908;Elias Fausto;4118402;Paranavaí;1;1;2;520
3515350;Euclides da Cunha Paulista;4118402;Paranavaí;1;1;2;61
3516200;Franca;4118402;Paranavaí;1;1;2;585
3524402;Jacareí;4118402;Paranavaí;1;1;2;667
3527207;Lorena;4118402;Paranavaí;1;1;2;754
3537305;Penápolis;4118402;Paranavaí;1;1;2;305
3538006;Pindamonhangaba;4118402;Paranavaí;1;1;2;715
3547304;Santana de Parnaíba;4118402;Paranavaí;1;1;2;568
3548708;São Bernardo do Campo;4118402;Paranavaí;1;1;2;606
3552809;Taboão da Serra;4118402;Paranavaí;1;1;2;585
3554102;Taubaté;4118402;Paranavaí;1;1;2;703
3554300;Teodoro Sampaio;4118402;Paranavaí;1;1;2;67
4100905;Amaporã;4118402;Paranavaí;1;1;2;35
4102208;Atalaia;4118402;Paranavaí;1;1;2;41
4105607;Cidade Gaúcha;4118402;Paranavaí;1;1;2;60
4105904;Colorado;4118402;Paranavaí;1;1;2;57
4107900;Floresta;4118402;Paranavaí;1;1;2;67
4108304;Foz do Iguaçu;4118402;Paranavaí;1;1;2;341
4108601;Goioerê;4118402;Paranavaí;1;1;2;136
4110706;Irati;4118402;Paranavaí;1;1;2;323
4111308;Itaúna do Sul;4118402;Paranavaí;1;1;2;61
4112108;Jandaia do Sul;4118402;Paranavaí;1;1;2;100
4112405;Japurá;4118402;Paranavaí;1;1;2;43
4114807;Marialva;4118402;Paranavaí;1;1;2;80
4115002;Marilena;4118402;Paranavaí;1;1;2;73
4115903;Mirador;4118402;Paranavaí;1;1;2;38
4117206;Nova Olímpia;4118402;Paranavaí;1;1;2;78
4118105;Paranacity;4118402;Paranavaí;1;1;2;35
4112603;Jardim Olinda;4118303;Paranapoema;1;1;2;8
4115200;Maringá;4118303;Paranapoema;1;1;2;90
2611606;Recife;4118204;Paranaguá;1;1;2;2331
2800605;Barra dos Coqueiros;4118204;Paranaguá;1;1;2;1971
2803609;Laranjeiras;4118204;Paranaguá;1;1;2;1968
2906501;Candeias;4118204;Paranaguá;1;1;2;1725
2919553;Luís Eduardo magalhães;4118204;Paranaguá;1;1;2;1516
2928901;São Desidério;4118204;Paranaguá;1;1;2;1503
3106200;Belo Horizonte;4118204;Paranaguá;1;1;2;774
3148004;Patos de Minas;4118204;Paranaguá;1;1;2;801
3170206;Uberlândia;4118204;Paranaguá;1;1;2;740
3300258;Arraial do Cabo;4118204;Paranaguá;1;1;2;711
3502754;Araçariguama;4118204;Paranaguá;1;1;2;280
3503208;Araraquara;4118204;Paranaguá;1;1;2;422
3509254;Cajati;4118204;Paranaguá;1;1;2;105
3509502;Campinas;4118204;Paranaguá;1;1;2;333
3520509;Indaiatuba;4118204;Paranaguá;1;1;2;305
3522307;Itapetininga;4118204;Paranaguá;1;1;2;228
3524006;Itupeva;4118204;Paranaguá;1;1;2;308
3535309;Palmital;4118204;Paranaguá;1;1;2;351
3536505;Paulínia;4118204;Paranaguá;1;1;2;342
3541307;Presidente Epitácio;4118204;Paranaguá;1;1;2;549
3545209;Salto;4118204;Paranaguá;1;1;2;293
3547502;Santa Rita do Passa Quatro;4118204;Paranaguá;1;1;2;442
3551009;São Vicente;4118204;Paranaguá;1;1;2;277
3552205;Sorocaba;4118204;Paranaguá;1;1;2;255
3552403;Sumaré;4118204;Paranaguá;1;1;2;332
3552809;Taboão da Serra;4118204;Paranaguá;1;1;2;283
4103222;Bom Sucesso do Sul;4118204;Paranaguá;1;1;2;434
4104204;Campo Largo;4118204;Paranaguá;1;1;2;98
4104501;Capanema;4118204;Paranaguá;1;1;2;528
4108403;Francisco Beltrão;4118204;Paranaguá;1;1;2;456
4108601;Goioerê;4118204;Paranaguá;1;1;2;471
4110102;Imbituva;4118204;Paranaguá;1;1;2;209
4113205;Lapa;4118204;Paranaguá;1;1;2;118
4117909;Palotina;4118204;Paranaguá;1;1;2;544
3534401;Osasco;4118105;Paranacity;1;1;2;555
4106704;Cruzeiro do Sul;4118105;Paranacity;1;1;2;4
4106902;Curitiba;4118105;Paranacity;1;1;2;406
4110904;Itaguajé;4118105;Paranacity;1;1;2;39
3534401;Osasco;4118006;Paraíso do Norte;1;1;2;596
4100905;Amaporã;4118006;Paraíso do Norte;1;1;2;28
4110409;Indianópolis;4118006;Paraíso do Norte;1;1;2;24
4116901;Nova Esperança;4118006;Paraíso do Norte;1;1;2;42
2607901;Jaboatão dos Guararapes;4117909;Palotina;1;1;2;2557
2919553;Luís Eduardo magalhães;4117909;Palotina;1;1;2;1560
3170107;Uberaba;4117909;Palotina;1;1;2;775
3504008;Assis;4117909;Palotina;1;1;2;385
3511102;Catanduva;4117909;Palotina;1;1;2;597
3513009;Cotia;4117909;Palotina;1;1;2;702
3513504;Cubatão;4117909;Palotina;1;1;2;750
3516200;Franca;4117909;Palotina;1;1;2;764
3526902;Limeira;4117909;Palotina;1;1;2;675
3534401;Osasco;4117909;Palotina;1;1;2;715
4100509;Altônia;4117909;Palotina;1;1;2;47
4101051;Anahy;4117909;Palotina;1;1;2;78
4101507;Arapongas;4117909;Palotina;1;1;2;259
4103354;Braganey;4117909;Palotina;1;1;2;90
4103701;Cambé;4117909;Palotina;1;1;2;279
4105706;Clevelândia;4117909;Palotina;1;1;2;270
4107306;Doutor Camargo;4117909;Palotina;1;1;2;181
4107504;Engenheiro Beltrão;4117909;Palotina;1;1;2;166
4107520;Esperança Nova;4117909;Palotina;1;1;2;64
4107553;Farol;4117909;Palotina;1;1;2;122
4107900;Floresta;4117909;Palotina;1;1;2;191
4108304;Foz do Iguaçu;4117909;Palotina;1;1;2;152
4109302;Guaraniaçu;4117909;Palotina;1;1;2;132
4109401;Guarapuava;4117909;Palotina;1;1;2;269
4109906;Icaraíma;4117909;Palotina;1;1;2;103
4110656;Iracema do Oeste;4117909;Palotina;1;1;2;48
4112207;Janiópolis;4117909;Palotina;1;1;2;106
4112504;Jardim Alegre;4117909;Palotina;1;1;2;215
4113700;Londrina;4117909;Palotina;1;1;2;290
4114005;Mamborê;4117909;Palotina;1;1;2;130
4114500;Manoel Ribas;4117909;Palotina;1;1;2;219
4116109;Moreira Sales;4117909;Palotina;1;1;2;85
4117453;Ouro Verde do Oeste;4117909;Palotina;1;1;2;57
3505807;Bastos;4117800;Palmital;1;1;2;360
3534401;Osasco;4117800;Palmital;1;1;2;564
4103040;Boa Ventura de São Roque;4117800;Palmital;1;1;2;58
4103453;Cafelândia;4117800;Palmital;1;1;2;117
4104428;Candói;4117800;Palmital;1;1;2;85
4111506;Ivaiporã;4117800;Palmital;1;1;2;87
4113254;Laranjal;4117800;Palmital;1;1;2;27
4113700;Londrina;4117800;Palmital;1;1;2;206
4116802;Nova Cantu;4117800;Palmital;1;1;2;44
4117305;Ortigueira;4117800;Palmital;1;1;2;147
2927408;Salvador;4117701;Palmeira;1;1;2;1772
3504008;Assis;4117701;Palmeira;1;1;2;309
3534401;Osasco;4117701;Palmeira;1;1;2;383
3541406;Presidente Prudente;4117701;Palmeira;1;1;2;390
4102307;Balsa Nova;4117701;Palmeira;1;1;2;41
4104303;Campo Mourão;4117701;Palmeira;1;1;2;283
4106209;Contenda;4117701;Palmeira;1;1;2;55
4106407;Cornélio Procópio;4117701;Palmeira;1;1;2;257
4110706;Irati;4117701;Palmeira;1;1;2;64
4111258;Itaperuçu;4117701;Palmeira;1;1;2;68
4111407;Ivaí;4117701;Palmeira;1;1;2;97
4113700;Londrina;4117701;Palmeira;1;1;2;262
3304557;Rio de Janeiro;4117602;Palmas;1;1;2;946
3510609;Carapicuíba;4117602;Palmas;1;1;2;605
3516200;Franca;4117602;Palmas;1;1;2;797
3526209;Juquitiba;4117602;Palmas;1;1;2;562
3534401;Osasco;4117602;Palmas;1;1;2;608
3542206;Rancharia;4117602;Palmas;1;1;2;485
4101002;Ampére;4117602;Palmas;1;1;2;163
4101507;Arapongas;4117602;Palmas;1;1;2;347
4105409;Chopinzinho;4117602;Palmas;1;1;2;90
4106506;Coronel Vivida;4117602;Palmas;1;1;2;80
4106803;Cruz Machado;4117602;Palmas;1;1;2;83
4107009;Curiúva;4117602;Palmas;1;1;2;312
4107207;Dois Vizinhos;4117602;Palmas;1;1;2;137
4107736;Fernandes Pinheiro;4117602;Palmas;1;1;2;186
4108502;General Carneiro;4117602;Palmas;1;1;2;66
4109708;Ibaiti;4117602;Palmas;1;1;2;342
4116208;Morretes;4117602;Palmas;1;1;2;332
3516200;Franca;4117503;Paiçandu;1;1;2;570
3527306;Louveira;4117503;Paiçandu;1;1;2;521
3534302;Orlândia;4117503;Paiçandu;1;1;2;519
3534401;Osasco;4117503;Paiçandu;1;1;2;537
3550308;São Paulo;4117503;Paiçandu;1;1;2;552
4106555;Corumbataí do Sul;4117503;Paiçandu;1;1;2;72
4106902;Curitiba;4117503;Paiçandu;1;1;2;358
4104303;Campo Mourão;4117453;Ouro Verde do Oeste;1;1;2;174
4104808;Cascavel;4117453;Ouro Verde do Oeste;1;1;2;48
4108403;Francisco Beltrão;4117453;Ouro Verde do Oeste;1;1;2;166
3534401;Osasco;4117305;Ortigueira;1;1;2;428
4101507;Arapongas;4117305;Ortigueira;1;1;2;101
4103503;Califórnia;4117305;Ortigueira;1;1;2;74
4103701;Cambé;4117305;Ortigueira;1;1;2;106
4104402;Cândido de Abreu;4117305;Ortigueira;1;1;2;56
4111506;Ivaiporã;4117305;Ortigueira;1;1;2;78
4112108;Jandaia do Sul;4117305;Ortigueira;1;1;2;97
4115200;Maringá;4117305;Ortigueira;1;1;2;131
4101408;Apucarana;4117297;Novo Itacolomi;1;1;2;23
4112108;Jandaia do Sul;4117297;Novo Itacolomi;1;1;2;23
4103909;Campina da Lagoa;4117271;Nova Tebas;1;1;2;88
4104303;Campo Mourão;4117271;Nova Tebas;1;1;2;63
3534401;Osasco;4117255;Nova Prata do Iguaçu;1;1;2;693
4101804;Araucária;4117255;Nova Prata do Iguaçu;1;1;2;396
4103024;Boa Esperança do Iguaçu;4117255;Nova Prata do Iguaçu;1;1;2;14
3116159;Chapada Gaúcha;4117222;Nova Santa Rosa;1;1;2;1304
4115853;Mercedes;4117222;Nova Santa Rosa;1;1;2;21
4106407;Cornélio Procópio;4117214;Nova Santa Bárbara;1;1;2;47
4106902;Curitiba;4117214;Nova Santa Bárbara;1;1;2;251
4107009;Curiúva;4117214;Nova Santa Bárbara;1;1;2;55
4112702;Jataizinho;4117214;Nova Santa Bárbara;1;1;2;46
4113700;Londrina;4117214;Nova Santa Bárbara;1;1;2;55
4107900;Floresta;4117206;Nova Olímpia;1;1;2;104
4114708;Maria Helena;4117206;Nova Olímpia;1;1;2;20
4117107;Nova Londrina;4117206;Nova Olímpia;1;1;2;79
3516200;Franca;4117107;Nova Londrina;1;1;2;620
3534401;Osasco;4117107;Nova Londrina;1;1;2;644
3544251;Rosana;4117107;Nova Londrina;1;1;2;22
3550308;São Paulo;4117107;Nova Londrina;1;1;2;660
4100905;Amaporã;4117107;Nova Londrina;1;1;2;42
4101507;Arapongas;4117107;Nova Londrina;1;1;2;174
4106001;Congonhinhas;4117107;Nova Londrina;1;1;2;265
4109906;Icaraíma;4117107;Nova Londrina;1;1;2;103
4113700;Londrina;4117107;Nova Londrina;1;1;2;198
4115200;Maringá;4117107;Nova Londrina;1;1;2;131
4115804;Medianeira;4117107;Nova Londrina;1;1;2;303
4100459;Altamira do Paraná;4117057;Nova Laranjeiras;1;1;2;59
4106902;Curitiba;4117057;Nova Laranjeiras;1;1;2;328
3534401;Osasco;4117008;Nova Fátima;1;1;2;386
4100103;Abatiá;4117008;Nova Fátima;1;1;2;29
4101507;Arapongas;4117008;Nova Fátima;1;1;2;90
4103602;Cambará;4117008;Nova Fátima;1;1;2;66
4104808;Cascavel;4116950;Nova Esperança do Sudoeste;1;1;2;108
4107207;Dois Vizinhos;4116950;Nova Esperança do Sudoeste;1;1;2;28
4107405;Enéas Marques;4116950;Nova Esperança do Sudoeste;1;1;2;11
2910800;Feira de Santana;4116901;Nova Esperança;1;1;2;1783
3304557;Rio de Janeiro;4116901;Nova Esperança;1;1;2;916
3516200;Franca;4116901;Nova Esperança;1;1;2;568
3534401;Osasco;4116901;Nova Esperança;1;1;2;556
3541406;Presidente Prudente;4116901;Nova Esperança;1;1;2;143
3555802;Urânia;4116901;Nova Esperança;1;1;2;361
4101408;Apucarana;4116901;Nova Esperança;1;1;2;88
4101804;Araucária;4116901;Nova Esperança;1;1;2;393
4102208;Atalaia;4116901;Nova Esperança;1;1;2;16
4103701;Cambé;4116901;Nova Esperança;1;1;2;96
4105508;Cianorte;4116901;Nova Esperança;1;1;2;67
4106704;Cruzeiro do Sul;4116901;Nova Esperança;1;1;2;25
4108106;Flórida;4116901;Nova Esperança;1;1;2;28
4112108;Jandaia do Sul;4116901;Nova Esperança;1;1;2;74
4112405;Japurá;4116901;Nova Esperança;1;1;2;48
4113601;Lobato;4116901;Nova Esperança;1;1;2;32
4113700;Londrina;4116901;Nova Esperança;1;1;2;108
2611606;Recife;4116802;Nova Cantu;1;1;2;2504
4100459;Altamira do Paraná;4116802;Nova Cantu;1;1;2;20
4106902;Curitiba;4116802;Nova Cantu;1;1;2;343
4112959;Juranda;4116802;Nova Cantu;1;1;2;39
4114203;Mandaguari;4116802;Nova Cantu;1;1;2;151
3534401;Osasco;4116703;Nova Aurora;1;1;2;662
4102000;Assis Chateaubriand;4116703;Nova Aurora;1;1;2;28
4103909;Campina da Lagoa;4116703;Nova Aurora;1;1;2;47
4106902;Curitiba;4116703;Nova Aurora;1;1;2;415
4107207;Dois Vizinhos;4116703;Nova Aurora;1;1;2;135
4116059;Missal;4116703;Nova Aurora;1;1;2;118
4116109;Moreira Sales;4116703;Nova Aurora;1;1;2;58
4103602;Cambará;4116604;Nova América da Colina;1;1;2;73
4106407;Cornélio Procópio;4116604;Nova América da Colina;1;1;2;18
3509502;Campinas;4116505;Nova Aliança do Ivaí;1;1;2;568
3541406;Presidente Prudente;4116505;Nova Aliança do Ivaí;1;1;2;169
4109203;Guaraci;4116406;Nossa Senhora das Graças;1;1;2;16
4105102;Centenário do Sul;4116307;Munhoz de Melo;1;1;2;41
4110003;Iguaraçu;4116307;Munhoz de Melo;1;1;2;8
4115200;Maringá;4116307;Munhoz de Melo;1;1;2;35
3534401;Osasco;4116208;Morretes;1;1;2;296
3548906;São Carlos;4116208;Morretes;1;1;2;394
4101804;Araucária;4116208;Morretes;1;1;2;58
4109708;Ibaiti;4116208;Morretes;1;1;2;225
4115408;Marmeleiro;4116208;Morretes;1;1;2;429
2408102;Natal;4116109;Moreira Sales;1;1;2;2656
3534401;Osasco;4116109;Moreira Sales;1;1;2;634
4104303;Campo Mourão;4116109;Moreira Sales;1;1;2;63
4112207;Janiópolis;4116109;Moreira Sales;1;1;2;25
3534401;Osasco;4116059;Missal;1;1;2;767
4104808;Cascavel;4116059;Missal;1;1;2;81
4108304;Foz do Iguaçu;4116059;Missal;1;1;2;53
4109906;Icaraíma;4116059;Missal;1;1;2;197
3550308;São Paulo;4116000;Miraselva;1;1;2;503
4109203;Guaraci;4116000;Miraselva;1;1;2;16
4113700;Londrina;4116000;Miraselva;1;1;2;51
3550308;São Paulo;4115853;Mercedes;1;1;2;765
4104808;Cascavel;4115853;Mercedes;1;1;2;90
4107538;Entre Rios do Oeste;4115853;Mercedes;1;1;2;29
4108809;Guaíra;4115853;Mercedes;1;1;2;40
4113700;Londrina;4115853;Mercedes;1;1;2;330
1507607;São Miguel do Guamá;4115804;Medianeira;1;1;2;2695
2800308;Aracaju;4115804;Medianeira;1;1;2;2288
3304557;Rio de Janeiro;4115804;Medianeira;1;1;2;1114
3505708;Barueri;4115804;Medianeira;1;1;2;749
3506102;Bebedouro;4115804;Medianeira;1;1;2;732
3516200;Franca;4115804;Medianeira;1;1;2;846
3534401;Osasco;4115804;Medianeira;1;1;2;757
4101408;Apucarana;4115804;Medianeira;1;1;2;327
4101507;Arapongas;4115804;Medianeira;1;1;2;338
4102109;Astorga;4115804;Medianeira;1;1;2;333
4105003;Catanduvas;4115804;Medianeira;1;1;2;95
4105805;Colombo;4115804;Medianeira;1;1;2;489
4105904;Colorado;4115804;Medianeira;1;1;2;345
4108403;Francisco Beltrão;4115804;Medianeira;1;1;2;137
4109708;Ibaiti;4115804;Medianeira;1;1;2;423
4113452;Lindoeste;4115804;Medianeira;1;1;2;53
4113502;Loanda;4115804;Medianeira;1;1;2;278
2607208;Ipojuca;4115754;Mauá da Serra;1;1;2;2332
3534401;Osasco;4115754;Mauá da Serra;1;1;2;453
4109401;Guarapuava;4115754;Mauá da Serra;1;1;2;167
4112108;Jandaia do Sul;4115754;Mauá da Serra;1;1;2;54
4114807;Marialva;4115754;Mauá da Serra;1;1;2;73
4101408;Apucarana;4115739;Mato Rico;1;1;2;145
3304557;Rio de Janeiro;4115705;Matinhos;1;1;2;619
3516200;Franca;4115705;Matinhos;1;1;2;595
3534401;Osasco;4115705;Matinhos;1;1;2;308
4105805;Colombo;4115705;Matinhos;1;1;2;92
4108601;Goioerê;4115705;Matinhos;1;1;2;478
3147105;Pará de Minas;4115606;Matelândia;1;1;2;1102
3168606;Teófilo Otoni;4115606;Matelândia;1;1;2;1474
3200904;Barra de São Francisco;4115606;Matelândia;1;1;2;1474
3502804;Araçatuba;4115606;Matelândia;1;1;2;567
3503208;Araraquara;4115606;Matelândia;1;1;2;694
3505807;Bastos;4115606;Matelândia;1;1;2;491
3516200;Franca;4115606;Matelândia;1;1;2;835
3534401;Osasco;4115606;Matelândia;1;1;2;745
3550308;São Paulo;4115606;Matelândia;1;1;2;756
4104303;Campo Mourão;4115606;Matelândia;1;1;2;209
4105300;Céu Azul;4115606;Matelândia;1;1;2;18
4108304;Foz do Iguaçu;4115606;Matelândia;1;1;2;59
4109401;Guarapuava;4115606;Matelândia;1;1;2;256
4110607;Iporã;4115606;Matelândia;1;1;2;141
4114609;Marechal Cândido Rondon;4115606;Matelândia;1;1;2;77
4113106;Kaloré;4115507;Marumbi;1;1;2;13
4114203;Mandaguari;4115507;Marumbi;1;1;2;18
3534401;Osasco;4115408;Marmeleiro;1;1;2;682
3550308;São Paulo;4115408;Marmeleiro;1;1;2;689
4103222;Bom Sucesso do Sul;4115408;Marmeleiro;1;1;2;21
4104808;Cascavel;4115408;Marmeleiro;1;1;2;140
4106506;Coronel Vivida;4115408;Marmeleiro;1;1;2;50
4106902;Curitiba;4115408;Marmeleiro;1;1;2;380
3541406;Presidente Prudente;4115358;Maripá;1;1;2;352
4104808;Cascavel;4115358;Maripá;1;1;2;70
4114609;Marechal Cândido Rondon;4115358;Maripá;1;1;2;28
3550308;São Paulo;4115309;Mariópolis;1;1;2;656
4106456;Coronel Domingos Soares;4115309;Mariópolis;1;1;2;54
4106902;Curitiba;4115309;Mariópolis;1;1;2;340
4109658;Honório Serpa;4115309;Mariópolis;1;1;2;29
4114401;Mangueirinha;4115309;Mariópolis;1;1;2;60
1100049;Cacoal;4115200;Maringá;1;1;2;1629
1100155;Ouro Preto do Oeste;4115200;Maringá;1;1;2;1737
1100452;Buritis;4115200;Maringá;1;1;2;1874
1200401;Rio Branco;4115200;Maringá;1;1;2;2159
1507953;Tailândia;4115200;Maringá;1;1;2;2285
1707009;Dianópolis;4115200;Maringá;1;1;2;1397
2105302;Imperatriz;4115200;Maringá;1;1;2;2030
2503209;Cabedelo;4115200;Maringá;1;1;2;2467
2504009;Campina Grande;4115200;Maringá;1;1;2;2386
2606002;Garanhuns;4115200;Maringá;1;1;2;2212
2607901;Jaboatão dos Guararapes;4115200;Maringá;1;1;2;2371
2616407;Vitória de Santo Antão;4115200;Maringá;1;1;2;2354
2706307;Palmeira dos Índios;4115200;Maringá;1;1;2;2159
2800308;Aracaju;4115200;Maringá;1;1;2;2017
2802106;Estância;4115200;Maringá;1;1;2;1963
2903201;Barreiras;4115200;Maringá;1;1;2;1419
2906501;Candeias;4115200;Maringá;1;1;2;1781
2910800;Feira de Santana;4115200;Maringá;1;1;2;1779
2933307;Vitória da Conquista;4115200;Maringá;1;1;2;1455
3106705;Betim;4115200;Maringá;1;1;2;871
3122306;Divinópolis;4115200;Maringá;1;1;2;799
3124104;Esmeraldas;4115200;Maringá;1;1;2;869
3127701;Governador Valadares;4115200;Maringá;1;1;2;1124
3149309;Pedro Leopoldo;4115200;Maringá;1;1;2;899
3170701;Varginha;4115200;Maringá;1;1;2;696
3205101;Viana;4115200;Maringá;1;1;2;1197
3205200;Vila Velha;4115200;Maringá;1;1;2;1218
3301009;Campos dos Goytacazes;4115200;Maringá;1;1;2;1093
3303302;Niterói;4115200;Maringá;1;1;2;903
3303906;Petrópolis;4115200;Maringá;1;1;2;893
3304110;Porto Real;4115200;Maringá;1;1;2;783
3305208;São Pedro da Aldeia;4115200;Maringá;1;1;2;1004
3501905;Amparo;4115200;Maringá;1;1;2;533
3505906;Batatais;4115200;Maringá;1;1;2;519
3512506;Coroados;4115200;Maringá;1;1;2;284
3513009;Cotia;4115200;Maringá;1;1;2;513
3515509;Fernandópolis;4115200;Maringá;1;1;2;388
3519071;Hortolândia;4115200;Maringá;1;1;2;484
3519303;Ibaté;4115200;Maringá;1;1;2;432
3519501;Ibirarema;4115200;Maringá;1;1;2;201
3519600;Ibitinga;4115200;Maringá;1;1;2;364
3520509;Indaiatuba;4115200;Maringá;1;1;2;480
3522505;Itapevi;4115200;Maringá;1;1;2;510
3524006;Itupeva;4115200;Maringá;1;1;2;498
3526803;Lençóis Paulista;4115200;Maringá;1;1;2;330
3527108;Lins;4115200;Maringá;1;1;2;292
3529302;Matão;4115200;Maringá;1;1;2;412
3529401;Mauá;4115200;Maringá;1;1;2;560
3530300;Mirassol;4115200;Maringá;1;1;2;378
3531209;Monte Alegre do Sul;4115200;Maringá;1;1;2;541
3534302;Orlândia;4115200;Maringá;1;1;2;507
3534708;Ourinhos;4115200;Maringá;1;1;2;213
3535507;Paraguaçu Paulista;4115200;Maringá;1;1;2;175
3536307;Patrocínio Paulista;4115200;Maringá;1;1;2;561
3536505;Paulínia;4115200;Maringá;1;1;2;492
3536703;Pederneiras;4115200;Maringá;1;1;2;343
3537305;Penápolis;4115200;Maringá;1;1;2;291
3539202;Pirapozinho;4115200;Maringá;1;1;2;135
3539806;Poá;4115200;Maringá;1;1;2;570
3541505;Presidente Venceslau;4115200;Maringá;1;1;2;175
3542602;Registro;4115200;Maringá;1;1;2;433
3543303;Ribeirão Pires;4115200;Maringá;1;1;2;564
3545803;Santa Bárbara d'Oeste;4115200;Maringá;1;1;2;466
3548500;Santos;4115200;Maringá;1;1;2;573
3548906;São Carlos;4115200;Maringá;1;1;2;439
3550100;São Manuel;4115200;Maringá;1;1;2;351
3550605;São Roque;4115200;Maringá;1;1;2;490
3551306;Sebastianópolis do Sul;4115200;Maringá;1;1;2;368
3552809;Taboão da Serra;4115200;Maringá;1;1;2;527
3554300;Teodoro Sampaio;4115200;Maringá;1;1;2;102
3555000;Tupã;4115200;Maringá;1;1;2;217
3556404;Vargem Grande do Sul;4115200;Maringá;1;1;2;541
4100509;Altônia;4115200;Maringá;1;1;2;207
4100806;Alvorada do Sul;4115200;Maringá;1;1;2;101
4100905;Amaporã;4115200;Maringá;1;1;2;95
4101150;Ângulo;4115200;Maringá;1;1;2;26
4102505;Barbosa Ferraz;4115200;Maringá;1;1;2;67
4103206;Bom Sucesso;4115200;Maringá;1;1;2;35
4103305;Borrazópolis;4115200;Maringá;1;1;2;66
4103479;Cafezal do Sul;4115200;Maringá;1;1;2;174
4103503;Califórnia;4115200;Maringá;1;1;2;63
4105300;Céu Azul;4115200;Maringá;1;1;2;274
4105706;Clevelândia;4115200;Maringá;1;1;2;333
4106001;Congonhinhas;4115200;Maringá;1;1;2;141
4107207;Dois Vizinhos;4115200;Maringá;1;1;2;281
4107504;Engenheiro Beltrão;4115200;Maringá;1;1;2;53
4107603;Faxinal;4115200;Maringá;1;1;2;90
4109609;Guaratuba;4115200;Maringá;1;1;2;437
4109906;Icaraíma;4115200;Maringá;1;1;2;186
4110607;Iporã;4115200;Maringá;1;1;2;193
4111506;Ivaiporã;4115200;Maringá;1;1;2;93
4111555;Ivaté;4115200;Maringá;1;1;2;147
4111803;Jacarezinho;4115200;Maringá;1;1;2;198
4113304;Laranjeiras do Sul;4115200;Maringá;1;1;2;230
4114302;Mandirituba;4115200;Maringá;1;1;2;374
4114609;Marechal Cândido Rondon;4115200;Maringá;1;1;2;251
4114708;Maria Helena;4115200;Maringá;1;1;2;132
3550308;São Paulo;4115101;Mariluz;1;1;2;661
4100509;Altônia;4115101;Mariluz;1;1;2;77
4104303;Campo Mourão;4115101;Mariluz;1;1;2;77
4108601;Goioerê;4115101;Mariluz;1;1;2;25
4112405;Japurá;4115002;Marilena;1;1;2;96
4103503;Califórnia;4114906;Marilândia do Sul;1;1;2;12
4104303;Campo Mourão;4114906;Marilândia do Sul;1;1;2;115
1100064;Colorado do Oeste;4114807;Marialva;1;1;2;1440
3304557;Rio de Janeiro;4114807;Marialva;1;1;2;872
3513504;Cubatão;4114807;Marialva;1;1;2;551
3516200;Franca;4114807;Marialva;1;1;2;550
3530607;Moji das Cruzes;4114807;Marialva;1;1;2;572
3534401;Osasco;4114807;Marialva;1;1;2;511
3552403;Sumaré;4114807;Marialva;1;1;2;467
4102406;Bandeirantes;4114807;Marialva;1;1;2;151
4103701;Cambé;4114807;Marialva;1;1;2;57
4104808;Cascavel;4114807;Marialva;1;1;2;235
4105508;Cianorte;4114807;Marialva;1;1;2;85
4106902;Curitiba;4114807;Marialva;1;1;2;336
4105508;Cianorte;4114708;Maria Helena;1;1;2;62
3300407;Barra Mansa;4114609;Marechal Cândido Rondon;1;1;2;1017
3509502;Campinas;4114609;Marechal Cândido Rondon;1;1;2;728
3534401;Osasco;4114609;Marechal Cândido Rondon;1;1;2;742
4101507;Arapongas;4114609;Marechal Cândido Rondon;1;1;2;293
4104303;Campo Mourão;4114609;Marechal Cândido Rondon;1;1;2;178
4104600;Capitão Leônidas Marques;4114609;Marechal Cândido Rondon;1;1;2;112
4108601;Goioerê;4114609;Marechal Cândido Rondon;1;1;2;112
3304557;Rio de Janeiro;4114500;Manoel Ribas;1;1;2;866
3534401;Osasco;4114500;Manoel Ribas;1;1;2;504
3550308;São Paulo;4114500;Manoel Ribas;1;1;2;516
4112108;Jandaia do Sul;4114500;Manoel Ribas;1;1;2;101
4112504;Jardim Alegre;4114500;Manoel Ribas;1;1;2;37
4113700;Londrina;4114500;Manoel Ribas;1;1;2;144
3534401;Osasco;4114401;Mangueirinha;1;1;2;597
4104451;Cantagalo;4114401;Mangueirinha;1;1;2;63
4105409;Chopinzinho;4114401;Mangueirinha;1;1;2;36
4106209;Contenda;4114401;Mangueirinha;1;1;2;266
4106456;Coronel Domingos Soares;4114401;Mangueirinha;1;1;2;35
4109401;Guarapuava;4114401;Mangueirinha;1;1;2;94
4111209;Itapejara d'Oeste;4114401;Mangueirinha;1;1;2;64
4113700;Londrina;4114401;Mangueirinha;1;1;2;310
4107850;Flor da Serra do Sul;4114351;Manfrinópolis;1;1;2;8
1100122;Ji-Paraná;4114302;Mandirituba;1;1;2;2038
3157708;Santa Juliana;4114302;Mandirituba;1;1;2;738
3304557;Rio de Janeiro;4114302;Mandirituba;1;1;2;682
3516200;Franca;4114302;Mandirituba;1;1;2;610
3534401;Osasco;4114302;Mandirituba;1;1;2;354
4104808;Cascavel;4114302;Mandirituba;1;1;2;423
4105805;Colombo;4114302;Mandirituba;1;1;2;59
4107009;Curiúva;4114302;Mandirituba;1;1;2;224
4111258;Itaperuçu;4114302;Mandirituba;1;1;2;62
4113205;Lapa;4114302;Mandirituba;1;1;2;39
3106200;Belo Horizonte;4114203;Mandaguari;1;1;2;878
3301900;Itaboraí;4114203;Mandaguari;1;1;2;905
3512902;Cosmorama;4114203;Mandaguari;1;1;2;393
3516200;Franca;4114203;Mandaguari;1;1;2;548
3522703;Itápolis;4114203;Mandaguari;1;1;2;365
3534401;Osasco;4114203;Mandaguari;1;1;2;502
3538006;Pindamonhangaba;4114203;Mandaguari;1;1;2;640
4101804;Araucária;4114203;Mandaguari;1;1;2;327
4102505;Barbosa Ferraz;4114203;Mandaguari;1;1;2;61
4103206;Bom Sucesso;4114203;Mandaguari;1;1;2;18
4103305;Borrazópolis;4114203;Mandaguari;1;1;2;44
4103503;Califórnia;4114203;Mandaguari;1;1;2;37
4103701;Cambé;4114203;Mandaguari;1;1;2;53
4103909;Campina da Lagoa;4114203;Mandaguari;1;1;2;160
4111506;Ivaiporã;4114203;Mandaguari;1;1;2;76
4112504;Jardim Alegre;4114203;Mandaguari;1;1;2;69
4113759;Lunardelli;4114203;Mandaguari;1;1;2;58
3505807;Bastos;4114104;Mandaguaçu;1;1;2;212
3512209;Conchal;4114104;Mandaguaçu;1;1;2;517
3516200;Franca;4114104;Mandaguaçu;1;1;2;570
3534401;Osasco;4114104;Mandaguaçu;1;1;2;547
3541406;Presidente Prudente;4114104;Mandaguaçu;1;1;2;153
3550308;São Paulo;4114104;Mandaguaçu;1;1;2;562
4101804;Araucária;4114104;Mandaguaçu;1;1;2;376
4104303;Campo Mourão;4114104;Mandaguaçu;1;1;2;82
4105508;Cianorte;4114104;Mandaguaçu;1;1;2;60
4112009;Jaguariaíva;4114104;Mandaguaçu;1;1;2;270
3534401;Osasco;4114005;Mamborê;1;1;2;587
3550308;São Paulo;4114005;Mamborê;1;1;2;600
4104808;Cascavel;4114005;Mamborê;1;1;2;117
4106902;Curitiba;4114005;Mamborê;1;1;2;352
4107553;Farol;4114005;Mamborê;1;1;2;26
4113734;Luiziana;4114005;Mamborê;1;1;2;26
3534401;Osasco;4113908;Mallet;1;1;2;477
4101804;Araucária;4113908;Mallet;1;1;2;146
4104204;Campo Largo;4113908;Mallet;1;1;2;137
4106902;Curitiba;4113908;Mallet;1;1;2;161
4110102;Imbituva;4113908;Mallet;1;1;2;75
4113205;Lapa;4113908;Mallet;1;1;2;111
3505708;Barueri;4113809;Lupionópolis;1;1;2;500
3541406;Presidente Prudente;4113809;Lupionópolis;1;1;2;74
4103800;Cambira;4113759;Lunardelli;1;1;2;57
4108700;Grandes Rios;4113759;Lunardelli;1;1;2;25
4106555;Corumbataí do Sul;4113734;Luiziana;1;1;2;26
1100023;Ariquemes;4113700;Londrina;1;1;2;1887
1100122;Ji-Paraná;4113700;Londrina;1;1;2;1732
1101203;Ministro Andreazza;4113700;Londrina;1;1;2;1697
1304062;Tabatinga;4113700;Londrina;1;1;2;2795
1400100;Boa Vista;4113700;Londrina;1;1;2;3040
1500800;Ananindeua;4113700;Londrina;1;1;2;2441
1504208;Marabá;4113700;Londrina;1;1;2;1994
1505536;Parauapebas;4113700;Londrina;1;1;2;1917
1506138;Redenção;4113700;Londrina;1;1;2;1696
1506807;Santarém;4113700;Londrina;1;1;2;2330
1702109;Araguaína;4113700;Londrina;1;1;2;1805
1709500;Gurupi;4113700;Londrina;1;1;2;1299
1718204;Porto Nacional;4113700;Londrina;1;1;2;1421
2105302;Imperatriz;4113700;Londrina;1;1;2;2001
2303501;Cascavel;4113700;Londrina;1;1;2;2468
2306306;Itapagé;4113700;Londrina;1;1;2;2447
2307304;Juazeiro do Norte;4113700;Londrina;1;1;2;2125
2307650;Maracanaú;4113700;Londrina;1;1;2;2474
2503209;Cabedelo;4113700;Londrina;1;1;2;2407
2602902;Cabo de Santo Agostinho;4113700;Londrina;1;1;2;2297
2605202;Escada;4113700;Londrina;1;1;2;2278
2606804;Igarassu;4113700;Londrina;1;1;2;2337
2607901;Jaboatão dos Guararapes;4113700;Londrina;1;1;2;2309
2611101;Petrolina;4113700;Londrina;1;1;2;1868
2802106;Estância;4113700;Londrina;1;1;2;1899
2802908;Itabaiana;4113700;Londrina;1;1;2;1949
2803500;Lagarto;4113700;Londrina;1;1;2;1911
2805703;Propriá;4113700;Londrina;1;1;2;2020
2900702;Alagoinhas;4113700;Londrina;1;1;2;1765
2903201;Barreiras;4113700;Londrina;1;1;2;1371
2913606;Ilhéus;4113700;Londrina;1;1;2;1525
2914802;Itabuna;4113700;Londrina;1;1;2;1512
2918407;Juazeiro;4113700;Londrina;1;1;2;1854
2919207;Lauro de Freitas;4113700;Londrina;1;1;2;1717
2922508;Nazaré;4113700;Londrina;1;1;2;1654
2924009;Paulo Afonso;4113700;Londrina;1;1;2;1989
2925303;Porto Seguro;4113700;Londrina;1;1;2;1423
2928703;Santo Antônio de Jesus;4113700;Londrina;1;1;2;1641
2931350;Teixeira de Freitas;4113700;Londrina;1;1;2;1313
2932804;Utinga;4113700;Londrina;1;1;2;1592
2933307;Vitória da Conquista;4113700;Londrina;1;1;2;1388
3103751;Araporã;4113700;Londrina;1;1;2;573
3118304;Conselheiro Lafaiete;4113700;Londrina;1;1;2;799
3127701;Governador Valadares;4113700;Londrina;1;1;2;1049
3131703;Itabira;4113700;Londrina;1;1;2;896
3134202;Ituiutaba;4113700;Londrina;1;1;2;509
3136702;Juiz de Fora;4113700;Londrina;1;1;2;814
3147105;Pará de Minas;4113700;Londrina;1;1;2;763
3166808;Serra do Salitre;4113700;Londrina;1;1;2;646
3167202;Sete Lagoas;4113700;Londrina;1;1;2;819
3200706;Atilio Vivacqua;4113700;Londrina;1;1;2;1044
3201209;Cachoeiro de Itapemirim;4113700;Londrina;1;1;2;1057
3201308;Cariacica;4113700;Londrina;1;1;2;1136
3201506;Colatina;4113700;Londrina;1;1;2;1142
3202405;Guarapari;4113700;Londrina;1;1;2;1113
3203908;Nova Venécia;4113700;Londrina;1;1;2;1197
3204906;São Mateus;4113700;Londrina;1;1;2;1242
3205010;Sooretama;4113700;Londrina;1;1;2;1205
3205101;Viana;4113700;Londrina;1;1;2;1119
3300209;Araruama;4113700;Londrina;1;1;2;901
3302205;Itaperuna;4113700;Londrina;1;1;2;971
3304201;Resende;4113700;Londrina;1;1;2;689
3304904;São Gonçalo;4113700;Londrina;1;1;2;828
3305109;São João de Meriti;4113700;Londrina;1;1;2;796
3305208;São Pedro da Aldeia;4113700;Londrina;1;1;2;925
3500501;Águas de Lindóia;4113700;Londrina;1;1;2;470
3502754;Araçariguama;4113700;Londrina;1;1;2;419
3504107;Atibaia;4113700;Londrina;1;1;2;471
3504305;Avaí;4113700;Londrina;1;1;2;225
3505807;Bastos;4113700;Londrina;1;1;2;158
3506300;Bernardino de Campos;4113700;Londrina;1;1;2;174
3506805;Bocaina;4113700;Londrina;1;1;2;298
3508306;Cabrália Paulista;4113700;Londrina;1;1;2;207
3510005;Cândido Mota;4113700;Londrina;1;1;2;99
3510500;Caraguatatuba;4113700;Londrina;1;1;2;584
3511300;Cedral;4113700;Londrina;1;1;2;327
3513306;Cruzália;4113700;Londrina;1;1;2;72
3513801;Diadema;4113700;Londrina;1;1;2;467
3515004;Embu;4113700;Londrina;1;1;2;442
3519501;Ibirarema;4113700;Londrina;1;1;2;122
3519907;Iepê;4113700;Londrina;1;1;2;71
3522703;Itápolis;4113700;Londrina;1;1;2;304
3524006;Itupeva;4113700;Londrina;1;1;2;419
3524709;Jaguariúna;4113700;Londrina;1;1;2;430
3527306;Louveira;4113700;Londrina;1;1;2;429
3528403;Mairinque;4113700;Londrina;1;1;2;407
3529401;Mauá;4113700;Londrina;1;1;2;482
3530300;Mirassol;4113700;Londrina;1;1;2;321
3530607;Moji das Cruzes;4113700;Londrina;1;1;2;509
3532157;Nantes;4113700;Londrina;1;1;2;76
3532207;Narandiba;4113700;Londrina;1;1;2;106
3535309;Palmital;4113700;Londrina;1;1;2;111
3535507;Paraguaçu Paulista;4113700;Londrina;1;1;2;113
3536109;Pardinho;4113700;Londrina;1;1;2;285
3536505;Paulínia;4113700;Londrina;1;1;2;413
3537305;Penápolis;4113700;Londrina;1;1;2;234
3539301;Pirassununga;4113700;Londrina;1;1;2;404
3541307;Presidente Epitácio;4113700;Londrina;1;1;2;194
3542206;Rancharia;4113700;Londrina;1;1;2;121
3543907;Rio Claro;4113700;Londrina;1;1;2;379
3545407;Salto Grande;4113700;Londrina;1;1;2;127
3546207;Santa Cruz da Conceição;4113700;Londrina;1;1;2;397
3546405;Santa Cruz do Rio Pardo;4113700;Londrina;1;1;2;161
3549102;São João da Boa Vista;4113700;Londrina;1;1;2;466
3551306;Sebastianópolis do Sul;4113700;Londrina;1;1;2;318
3551702;Sertãozinho;4113700;Londrina;1;1;2;400
3552403;Sumaré;4113700;Londrina;1;1;2;400
3553807;Taquarituba;4113700;Londrina;1;1;2;197
3554508;Tietê;4113700;Londrina;1;1;2;352
3557006;Votorantim;4113700;Londrina;1;1;2;386
4100103;Abatiá;4113700;Londrina;1;1;2;86
4100509;Altônia;4113700;Londrina;1;1;2;288
4100608;Alto Paraná;4113700;Londrina;1;1;2;121
4101200;Antonina;4113700;Londrina;1;1;2;340
4102604;Barracão;4113700;Londrina;1;1;2;414
4103305;Borrazópolis;4113700;Londrina;1;1;2;84
4103503;Califórnia;4113700;Londrina;1;1;2;44
4103800;Cambira;4113700;Londrina;1;1;2;56
4104402;Cândido de Abreu;4113700;Londrina;1;1;2;142
4104907;Castro;4113700;Londrina;1;1;2;199
4105409;Chopinzinho;4113700;Londrina;1;1;2;317
4106605;Cruzeiro do Oeste;4113700;Londrina;1;1;2;204
4107504;Engenheiro Beltrão;4113700;Londrina;1;1;2;127
4107751;Figueira;4113700;Londrina;1;1;2;98
4107801;Floraí;4113700;Londrina;1;1;2;118
4107900;Floresta;4113700;Londrina;1;1;2;101
4108007;Florestópolis;4113700;Londrina;1;1;2;54
4108320;Francisco Alves;4113700;Londrina;1;1;2;289
4108403;Francisco Beltrão;4113700;Londrina;1;1;2;366
4108700;Grandes Rios;4113700;Londrina;1;1;2;101
4109005;Guapirama;4113700;Londrina;1;1;2;116
4110102;Imbituva;4113700;Londrina;1;1;2;221
4110508;Ipiranga;4113700;Londrina;1;1;2;200
4110607;Iporã;4113700;Londrina;1;1;2;273
4110805;Iretama;4113700;Londrina;1;1;2;159
4111001;Itambaracá;4113700;Londrina;1;1;2;82
4111407;Ivaí;4113700;Londrina;1;1;2;192
4112207;Janiópolis;4113700;Londrina;1;1;2;192
4113304;Laranjeiras do Sul;4113700;Londrina;1;1;2;274
4100608;Alto Paraná;4113601;Lobato;1;1;2;40
4102109;Astorga;4113601;Lobato;1;1;2;38
4102208;Atalaia;4113601;Lobato;1;1;2;19
4105904;Colorado;4113601;Lobato;1;1;2;19
4107702;Fênix;4113601;Lobato;1;1;2;101
4110003;Iguaraçu;4113601;Lobato;1;1;2;24
3516200;Franca;4113502;Loanda;1;1;2;640
3534401;Osasco;4113502;Loanda;1;1;2;656
3541406;Presidente Prudente;4113502;Loanda;1;1;2;199
4105508;Cianorte;4113502;Loanda;1;1;2;98
4108601;Goioerê;4113502;Loanda;1;1;2;141
4108403;Francisco Beltrão;4113452;Lindoeste;1;1;2;105
4103305;Borrazópolis;4113429;Lidianópolis;1;1;2;20
4112504;Jardim Alegre;4113429;Lidianópolis;1;1;2;9
4106407;Cornélio Procópio;4113403;Leópolis;1;1;2;15
3516200;Franca;4113304;Laranjeiras do Sul;1;1;2;739
3534401;Osasco;4113304;Laranjeiras do Sul;1;1;2;606
4100459;Altamira do Paraná;4113304;Laranjeiras do Sul;1;1;2;75
4104055;Campo Bonito;4113304;Laranjeiras do Sul;1;1;2;68
4107546;Espigão Alto do Iguaçu;4113304;Laranjeiras do Sul;1;1;2;35
4109302;Guaraniaçu;4113304;Laranjeiras do Sul;1;1;2;53
4109757;Ibema;4113304;Laranjeiras do Sul;1;1;2;64
4111506;Ivaiporã;4113304;Laranjeiras do Sul;1;1;2;153
4106902;Curitiba;4113254;Laranjal;1;1;2;327
3505708;Barueri;4113205;Lapa;1;1;2;377
3516200;Franca;4113205;Lapa;1;1;2;622
3534401;Osasco;4113205;Lapa;1;1;2;382
4104105;Campo do Tenente;4113205;Lapa;1;1;2;23
4104659;Carambeí;4113205;Lapa;1;1;2;102
4110706;Irati;4113205;Lapa;1;1;2;98
4112108;Jandaia do Sul;4113106;Kaloré;1;1;2;24
3551306;Sebastianópolis do Sul;4113007;Jussara;1;1;2;417
4107306;Doutor Camargo;4113007;Jussara;1;1;2;27
4103008;Boa Esperança;4112959;Juranda;1;1;2;20
4103909;Campina da Lagoa;4112959;Juranda;1;1;2;20
4108601;Goioerê;4112959;Juranda;1;1;2;30
4112207;Janiópolis;4112959;Juranda;1;1;2;31
3534708;Ourinhos;4112900;Jundiaí do Sul;1;1;2;62
4103602;Cambará;4112900;Jundiaí do Sul;1;1;2;47
4106100;Conselheiro Mairinck;4112900;Jundiaí do Sul;1;1;2;23
3510609;Carapicuíba;4112801;Joaquim Távora;1;1;2;314
3534401;Osasco;4112801;Joaquim Távora;1;1;2;318
4101606;Arapoti;4112801;Joaquim Távora;1;1;2;73
4103602;Cambará;4112801;Joaquim Távora;1;1;2;53
4104907;Castro;4112801;Joaquim Távora;1;1;2;143
4106001;Congonhinhas;4112801;Joaquim Távora;1;1;2;67
4106902;Curitiba;4112801;Joaquim Távora;1;1;2;223
3550308;São Paulo;4112751;Jesuítas;1;1;2;686
4110656;Iracema do Oeste;4112751;Jesuítas;1;1;2;6
2603207;Caetés;4112702;Jataizinho;1;1;2;2137
2611606;Recife;4112702;Jataizinho;1;1;2;2301
2704302;Maceió;4112702;Jataizinho;1;1;2;2127
3534401;Osasco;4112702;Jataizinho;1;1;2;430
4103602;Cambará;4112702;Jataizinho;1;1;2;95
4103701;Cambé;4112702;Jataizinho;1;1;2;30
4106902;Curitiba;4112702;Jataizinho;1;1;2;298
4110300;Inajá;4112603;Jardim Olinda;1;1;2;25
3505807;Bastos;4112504;Jardim Alegre;1;1;2;268
3534401;Osasco;4112504;Jardim Alegre;1;1;2;502
4101655;Arapuã;4112504;Jardim Alegre;1;1;2;18
3551306;Sebastianópolis do Sul;4112405;Japurá;1;1;2;410
4107306;Doutor Camargo;4112405;Japurá;1;1;2;36
4112108;Jandaia do Sul;4112405;Japurá;1;1;2;94
3550308;São Paulo;4112306;Japira;1;1;2;356
4103602;Cambará;4112306;Japira;1;1;2;85
4106902;Curitiba;4112306;Japira;1;1;2;199
4105805;Colombo;4112207;Janiópolis;1;1;2;382
3516200;Franca;4112108;Jandaia do Sul;1;1;2;546
3534401;Osasco;4112108;Jandaia do Sul;1;1;2;495
3536505;Paulínia;4112108;Jandaia do Sul;1;1;2;466
3540705;Porto Ferreira;4112108;Jandaia do Sul;1;1;2;465
4101804;Araucária;4112108;Jandaia do Sul;1;1;2;319
4102109;Astorga;4112108;Jandaia do Sul;1;1;2;41
4103206;Bom Sucesso;4112108;Jandaia do Sul;1;1;2;17
4103503;Califórnia;4112108;Jandaia do Sul;1;1;2;30
4104402;Cândido de Abreu;4112108;Jandaia do Sul;1;1;2;111
4105904;Colorado;4112108;Jandaia do Sul;1;1;2;91
4106555;Corumbataí do Sul;4112108;Jandaia do Sul;1;1;2;74
4106605;Cruzeiro do Oeste;4112108;Jandaia do Sul;1;1;2;147
4107504;Engenheiro Beltrão;4112108;Jandaia do Sul;1;1;2;67
4107603;Faxinal;4112108;Jandaia do Sul;1;1;2;56
4108700;Grandes Rios;4112108;Jandaia do Sul;1;1;2;62
4111605;Ivatuba;4112108;Jandaia do Sul;1;1;2;59
1700350;Aliança do Tocantins;4112009;Jaguariaíva;1;1;2;1437
1716604;Peixe;4112009;Jaguariaíva;1;1;2;1360
1718204;Porto Nacional;4112009;Jaguariaíva;1;1;2;1507
2900702;Alagoinhas;4112009;Jaguariaíva;1;1;2;1738
2902203;Aramari;4112009;Jaguariaíva;1;1;2;1738
2907004;Cardeal da Silva;4112009;Jaguariaíva;1;1;2;1784
2910602;Esplanada;4112009;Jaguariaíva;1;1;2;1793
2923308;Ouriçangas;4112009;Jaguariaíva;1;1;2;1736
3304557;Rio de Janeiro;4112009;Jaguariaíva;1;1;2;668
3502705;Apiaí;4112009;Jaguariaíva;1;1;2;90
3520905;Ipaussu;4112009;Jaguariaíva;1;1;2;135
3522653;Itapirapuã Paulista;4112009;Jaguariaíva;1;1;2;63
3534401;Osasco;4112009;Jaguariaíva;1;1;2;305
3547304;Santana de Parnaíba;4112009;Jaguariaíva;1;1;2;295
4100202;Adrianópolis;4112009;Jaguariaíva;1;1;2;85
4102109;Astorga;4112009;Jaguariaíva;1;1;2;230
4104659;Carambeí;4112009;Jaguariaíva;1;1;2;83
4104808;Cascavel;4112009;Jaguariaíva;1;1;2;391
4106209;Contenda;4112009;Jaguariaíva;1;1;2;156
4109757;Ibema;4112009;Jaguariaíva;1;1;2;351
1100288;Rolim de Moura;4111902;Jaguapitã;1;1;2;1608
3134202;Ituiutaba;4111902;Jaguapitã;1;1;2;504
3502101;Andradina;4111902;Jaguapitã;1;1;2;242
3534401;Osasco;4111902;Jaguapitã;1;1;2;489
3550308;São Paulo;4111902;Jaguapitã;1;1;2;505
4101507;Arapongas;4111902;Jaguapitã;1;1;2;34
4106407;Cornélio Procópio;4111902;Jaguapitã;1;1;2;90
4106704;Cruzeiro do Sul;4111902;Jaguapitã;1;1;2;67
4106902;Curitiba;4111902;Jaguapitã;1;1;2;346
4109807;Ibiporã;4111902;Jaguapitã;1;1;2;53
3106705;Betim;4111803;Jacarezinho;1;1;2;688
3504503;Avaré;4111803;Jacarezinho;1;1;2;111
3506003;Bauru;4111803;Jacarezinho;1;1;2;131
3516200;Franca;4111803;Jacarezinho;1;1;2;392
3534401;Osasco;4111803;Jacarezinho;1;1;2;333
3538808;Piraju;4111803;Jacarezinho;1;1;2;65
3546405;Santa Cruz do Rio Pardo;4111803;Jacarezinho;1;1;2;48
3552809;Taboão da Serra;4111803;Jacarezinho;1;1;2;336
3557204;Chavantes;4111803;Jacarezinho;1;1;2;34
4101101;Andirá;4111803;Jacarezinho;1;1;2;24
4101408;Apucarana;4111803;Jacarezinho;1;1;2;154
4101606;Arapoti;4111803;Jacarezinho;1;1;2;113
4101804;Araucária;4111803;Jacarezinho;1;1;2;277
4102406;Bandeirantes;4111803;Jacarezinho;1;1;2;36
4104709;Carlópolis;4111803;Jacarezinho;1;1;2;43
3550308;São Paulo;4111704;Jaboti;1;1;2;349
4109708;Ibaiti;4111704;Jaboti;1;1;2;17
3534401;Osasco;4111555;Ivaté;1;1;2;673
2608909;Limoeiro;4111506;Ivaiporã;1;1;2;2405
3304557;Rio de Janeiro;4111506;Ivaiporã;1;1;2;868
4101655;Arapuã;4111506;Ivaiporã;1;1;2;11
4102505;Barbosa Ferraz;4111506;Ivaiporã;1;1;2;37
4104402;Cândido de Abreu;4111506;Ivaiporã;1;1;2;53
4104808;Cascavel;4111506;Ivaiporã;1;1;2;193
4107603;Faxinal;4111506;Ivaiporã;1;1;2;48
4108551;Godoy Moreira;4111506;Ivaiporã;1;1;2;22
4109708;Ibaiti;4111506;Ivaiporã;1;1;2;161
4109807;Ibiporã;4111506;Ivaiporã;1;1;2;128
3534401;Osasco;4111407;Ivaí;1;1;2;440
3550308;São Paulo;4111407;Ivaí;1;1;2;448
4108957;Guamiranga;4111407;Ivaí;1;1;2;21
3534401;Osasco;4111308;Itaúna do Sul;1;1;2;634
4107108;Diamante do Norte;4111308;Itaúna do Sul;1;1;2;9
3534401;Osasco;4111258;Itaperuçu;1;1;2;318
3536208;Pariquera-Açu;4111258;Itaperuçu;1;1;2;159
3550308;São Paulo;4111258;Itaperuçu;1;1;2;323
4105805;Colombo;4111258;Itaperuçu;1;1;2;13
3534401;Osasco;4111209;Itapejara d'Oeste;1;1;2;655
4103222;Bom Sucesso do Sul;4111209;Itapejara d'Oeste;1;1;2;12
4106506;Coronel Vivida;4111209;Itapejara d'Oeste;1;1;2;27
4106902;Curitiba;4111209;Itapejara d'Oeste;1;1;2;357
3534401;Osasco;4111100;Itambé;1;1;2;530
4101101;Andirá;4111001;Itambaracá;1;1;2;19
4103602;Cambará;4111001;Itambaracá;1;1;2;34
4106407;Cornélio Procópio;4111001;Itambaracá;1;1;2;32
4101002;Ampére;4110953;Itaipulândia;1;1;2;120
4104501;Capanema;4110953;Itaipulândia;1;1;2;79
4104808;Cascavel;4110953;Itaipulândia;1;1;2;88
4106902;Curitiba;4110953;Itaipulândia;1;1;2;507
3550308;São Paulo;4110904;Itaguajé;1;1;2;560
3505807;Bastos;4110805;Iretama;1;1;2;309
3534401;Osasco;4110805;Iretama;1;1;2;546
2905701;Camaçari;4110706;Irati;1;1;2;1848
2910800;Feira de Santana;4110706;Irati;1;1;2;1844
2919207;Lauro de Freitas;4110706;Irati;1;1;2;1833
3106705;Betim;4110706;Irati;1;1;2;882
3136702;Juiz de Fora;4110706;Irati;1;1;2;833
3148004;Patos de Minas;4110706;Irati;1;1;2;865
3306008;Três Rios;4110706;Irati;1;1;2;826
3525904;Jundiaí;4110706;Irati;1;1;2;451
3534401;Osasco;4110706;Irati;1;1;2;440
4101507;Arapongas;4110706;Irati;1;1;2;242
4106803;Cruz Machado;4110706;Irati;1;1;2;93
4110508;Ipiranga;4110706;Irati;1;1;2;51
4105508;Cianorte;4110656;Iracema do Oeste;1;1;2;114
3529401;Mauá;4110607;Iporã;1;1;2;737
3534401;Osasco;4110607;Iporã;1;1;2;704
4104808;Cascavel;4110607;Iporã;1;1;2;107
4105508;Cianorte;4110607;Iporã;1;1;2;118
4106902;Curitiba;4110607;Iporã;1;1;2;478
4107256;Douradina;4110607;Iporã;1;1;2;81
4108320;Francisco Alves;4110607;Iporã;1;1;2;16
4108601;Goioerê;4110607;Iporã;1;1;2;73
3525904;Jundiaí;4110508;Ipiranga;1;1;2;422
3550308;São Paulo;4110508;Ipiranga;1;1;2;423
4106902;Curitiba;4110508;Ipiranga;1;1;2;138
4110102;Imbituva;4110508;Ipiranga;1;1;2;23
3304557;Rio de Janeiro;4110409;Indianópolis;1;1;2;964
3506003;Bauru;4110409;Indianópolis;1;1;2;389
3550308;São Paulo;4110409;Indianópolis;1;1;2;618
4106902;Curitiba;4110409;Indianópolis;1;1;2;412
4107801;Floraí;4110409;Indianópolis;1;1;2;44
4108304;Foz do Iguaçu;4110409;Indianópolis;1;1;2;292
3550308;São Paulo;4110300;Inajá;1;1;2;580
3550308;São Paulo;4110201;Inácio Martins;1;1;2;490
4103040;Boa Ventura de São Roque;4110201;Inácio Martins;1;1;2;95
4103958;Campina do Simão;4110201;Inácio Martins;1;1;2;93
4104451;Cantagalo;4110201;Inácio Martins;1;1;2;107
4109401;Guarapuava;4110201;Inácio Martins;1;1;2;43
3523404;Itatiba;4110102;Imbituva;1;1;2;450
3534401;Osasco;4110102;Imbituva;1;1;2;425
3550308;São Paulo;4110102;Imbituva;1;1;2;433
4101606;Arapoti;4110102;Imbituva;1;1;2;142
4104907;Castro;4110102;Imbituva;1;1;2;74
4106902;Curitiba;4110102;Imbituva;1;1;2;134
3534401;Osasco;4110078;Imbaú;1;1;2;414
4101408;Apucarana;4110078;Imbaú;1;1;2;120
4107751;Figueira;4110078;Imbaú;1;1;2;75
4103354;Braganey;4110052;Iguatu;1;1;2;12
4104808;Cascavel;4110052;Iguatu;1;1;2;46
4101150;Ângulo;4110003;Iguaraçu;1;1;2;9
4101507;Arapongas;4110003;Iguaraçu;1;1;2;46
4102109;Astorga;4110003;Iguaraçu;1;1;2;17
4104808;Cascavel;4110003;Iguaraçu;1;1;2;256
4104808;Cascavel;4109906;Icaraíma;1;1;2;177
4106605;Cruzeiro do Oeste;4109906;Icaraíma;1;1;2;83
4106902;Curitiba;4109906;Icaraíma;1;1;2;513
2919553;Luís Eduardo magalhães;4109807;Ibiporã;1;1;2;1340
3170206;Uberlândia;4109807;Ibiporã;1;1;2;559
3503208;Araraquara;4109807;Ibiporã;1;1;2;336
3504008;Assis;4109807;Ibiporã;1;1;2;91
3510005;Cândido Mota;4109807;Ibiporã;1;1;2;89
3513801;Diadema;4109807;Ibiporã;1;1;2;456
3534401;Osasco;4109807;Ibiporã;1;1;2;437
3536505;Paulínia;4109807;Ibiporã;1;1;2;402
3538006;Pindamonhangaba;4109807;Ibiporã;1;1;2;572
3552205;Sorocaba;4109807;Ibiporã;1;1;2;364
3552908;Taciba;4109807;Ibiporã;1;1;2;100
3556701;Vinhedo;4109807;Ibiporã;1;1;2;417
4101606;Arapoti;4109807;Ibiporã;1;1;2;159
4102802;Bela Vista do Paraíso;4109807;Ibiporã;1;1;2;33
4105102;Centenário do Sul;4109807;Ibiporã;1;1;2;75
4109203;Guaraci;4109807;Ibiporã;1;1;2;70
4104055;Campo Bonito;4109757;Ibema;1;1;2;9
4105003;Catanduvas;4109757;Ibema;1;1;2;18
4106308;Corbélia;4109757;Ibema;1;1;2;45
4109302;Guaraniaçu;4109757;Ibema;1;1;2;14
1100015;Alta Floresta d'Oeste;4109708;Ibaiti;1;1;2;1758
1100098;Espigão d'Oeste;4109708;Ibaiti;1;1;2;1730
1100114;Jaru;4109708;Ibaiti;1;1;2;1917
1100130;Machadinho d'Oeste;4109708;Ibaiti;1;1;2;1972
1100148;Nova Brasilândia d'Oeste;4109708;Ibaiti;1;1;2;1799
1100155;Ouro Preto do Oeste;4109708;Ibaiti;1;1;2;1876
1100189;Pimenta Bueno;4109708;Ibaiti;1;1;2;1730
1100288;Rolim de Moura;4109708;Ibaiti;1;1;2;1750
1100296;Santa Luzia d'Oeste;4109708;Ibaiti;1;1;2;1747
1100304;Vilhena;4109708;Ibaiti;1;1;2;1569
1100320;São Miguel do Guaporé;4109708;Ibaiti;1;1;2;1826
1100338;Nova Mamoré;4109708;Ibaiti;1;1;2;2103
1100346;Alvorada d'Oeste;4109708;Ibaiti;1;1;2;1827
1100379;Alto Alegre dos Parecis;4109708;Ibaiti;1;1;2;1733
1100452;Buritis;4109708;Ibaiti;1;1;2;2017
1100809;Candeias do Jamari;4109708;Ibaiti;1;1;2;2125
1101492;São Francisco do Guaporé;4109708;Ibaiti;1;1;2;1855
1101500;Seringueiras;4109708;Ibaiti;1;1;2;1836
3502200;Angatuba;4109708;Ibaiti;1;1;2;185
3502705;Apiaí;4109708;Ibaiti;1;1;2;155
3516200;Franca;4109708;Ibaiti;1;1;2;462
3517604;Guapiara;4109708;Ibaiti;1;1;2;173
3521804;Itaí;4109708;Ibaiti;1;1;2;122
3522307;Itapetininga;4109708;Ibaiti;1;1;2;220
3522802;Itaporanga;4109708;Ibaiti;1;1;2;73
3538808;Piraju;4109708;Ibaiti;1;1;2;110
3553005;Taguaí;4109708;Ibaiti;1;1;2;91
3553807;Taquarituba;4109708;Ibaiti;1;1;2;103
4101101;Andirá;4109708;Ibaiti;1;1;2;89
4101408;Apucarana;4109708;Ibaiti;1;1;2;133
4101804;Araucária;4109708;Ibaiti;1;1;2;208
4101903;Assaí;4109708;Ibaiti;1;1;2;85
4104709;Carlópolis;4109708;Ibaiti;1;1;2;67
4106902;Curitiba;4109708;Ibaiti;1;1;2;197
4108700;Grandes Rios;4109708;Ibaiti;1;1;2;138
3304557;Rio de Janeiro;4109609;Guaratuba;1;1;2;633
3505708;Barueri;4109609;Guaratuba;1;1;2;322
3534401;Osasco;4109609;Guaratuba;1;1;2;325
3550308;São Paulo;4109609;Guaratuba;1;1;2;323
4100202;Adrianópolis;4109609;Guaratuba;1;1;2;143
4101200;Antonina;4109609;Guaratuba;1;1;2;63
4105805;Colombo;4109609;Guaratuba;1;1;2;96
4108809;Guaíra;4109609;Guaratuba;1;1;2;591
3550308;São Paulo;4109500;Guaraqueçaba;1;1;2;248
4101200;Antonina;4109500;Guaraqueçaba;1;1;2;40
2304400;Fortaleza;4109401;Guarapuava;1;1;2;2692
2611606;Recife;4109401;Guarapuava;1;1;2;2483
2918407;Juazeiro;4109401;Guarapuava;1;1;2;2051
3170107;Uberaba;4109401;Guarapuava;1;1;2;716
3170206;Uberlândia;4109401;Guarapuava;1;1;2;784
3300407;Barra Mansa;4109401;Guarapuava;1;1;2;789
3300704;Cabo Frio;4109401;Guarapuava;1;1;2;976
3500303;Aguaí;4109401;Guarapuava;1;1;2;578
3504008;Assis;4109401;Guarapuava;1;1;2;319
3507605;Bragança Paulista;4109401;Guarapuava;1;1;2;559
3518800;Guarulhos;4109401;Guarapuava;1;1;2;535
3543402;Ribeirão Preto;4109401;Guarapuava;1;1;2;593
3548807;São Caetano do Sul;4109401;Guarapuava;1;1;2;527
3549102;São João da Boa Vista;4109401;Guarapuava;1;1;2;598
3550902;São Simão;4109401;Guarapuava;1;1;2;581
4101606;Arapoti;4109401;Guarapuava;1;1;2;213
4103701;Cambé;4109401;Guarapuava;1;1;2;233
4103958;Campina do Simão;4109401;Guarapuava;1;1;2;51
4104907;Castro;4109401;Guarapuava;1;1;2;156
4105508;Cianorte;4109401;Guarapuava;1;1;2;223
4107546;Espigão Alto do Iguaçu;4109401;Guarapuava;1;1;2;139
4108502;General Carneiro;4109401;Guarapuava;1;1;2;116
4108650;Goioxim;4109401;Guarapuava;1;1;2;58
3505807;Bastos;4109302;Guaraniaçu;1;1;2;414
3534401;Osasco;4109302;Guaraniaçu;1;1;2;635
4105003;Catanduvas;4109302;Guaraniaçu;1;1;2;30
4107124;Diamante do Sul;4109302;Guaraniaçu;1;1;2;21
4108304;Foz do Iguaçu;4109302;Guaraniaçu;1;1;2;170
4103701;Cambé;4109203;Guaraci;1;1;2;53
3515400;Fartura;4109005;Guapirama;1;1;2;56
3534708;Ourinhos;4109005;Guapirama;1;1;2;61
3550308;São Paulo;4109005;Guapirama;1;1;2;347
4106407;Cornélio Procópio;4109005;Guapirama;1;1;2;73
3534401;Osasco;4108908;Guairaçá;1;1;2;610
4106902;Curitiba;4108908;Guairaçá;1;1;2;447
2503209;Cabedelo;4108809;Guaíra;1;1;2;2668
3170206;Uberlândia;4108809;Guaíra;1;1;2;828
3516200;Franca;4108809;Guaíra;1;1;2;791
3534401;Osasco;4108809;Guaíra;1;1;2;758
3549706;São José do Rio Pardo;4108809;Guaíra;1;1;2;790
3552403;Sumaré;4108809;Guaíra;1;1;2;719
3555000;Tupã;4108809;Guaíra;1;1;2;442
4101507;Arapongas;4108809;Guaíra;1;1;2;293
4102000;Assis Chateaubriand;4108809;Guaíra;1;1;2;82
4103701;Cambé;4108809;Guaíra;1;1;2;313
3534401;Osasco;4108700;Grandes Rios;1;1;2;483
4104402;Cândido de Abreu;4108700;Grandes Rios;1;1;2;50
4106852;Cruzmaltina;4108700;Grandes Rios;1;1;2;15
4106902;Curitiba;4108700;Grandes Rios;1;1;2;267
4107603;Faxinal;4108700;Grandes Rios;1;1;2;24
4104303;Campo Mourão;4108650;Goioxim;1;1;2;133
4104808;Cascavel;4108650;Goioxim;1;1;2;150
3516200;Franca;4108601;Goioerê;1;1;2;694
3534401;Osasco;4108601;Goioerê;1;1;2;636
4101507;Arapongas;4108601;Goioerê;1;1;2;182
4101705;Araruna;4108601;Goioerê;1;1;2;61
4102109;Astorga;4108601;Goioerê;1;1;2;174
4105805;Colombo;4108601;Goioerê;1;1;2;402
4106902;Curitiba;4108601;Goioerê;1;1;2;404
4107504;Engenheiro Beltrão;4108601;Goioerê;1;1;2;89
4106555;Corumbataí do Sul;4108551;Godoy Moreira;1;1;2;22
3516200;Franca;4108502;General Carneiro;1;1;2;755
3534401;Osasco;4108502;General Carneiro;1;1;2;549
3550308;São Paulo;4108502;General Carneiro;1;1;2;553
4106209;Contenda;4108502;General Carneiro;1;1;2;196
4103040;Boa Ventura de São Roque;4108452;Foz do Jordão;1;1;2;98
4104428;Candói;4108452;Foz do Jordão;1;1;2;6
4106506;Coronel Vivida;4108452;Foz do Jordão;1;1;2;60
4106902;Curitiba;4108452;Foz do Jordão;1;1;2;283
2913606;Ilhéus;4108403;Francisco Beltrão;1;1;2;1835
2919553;Luís Eduardo magalhães;4108403;Francisco Beltrão;1;1;2;1696
3106200;Belo Horizonte;4108403;Francisco Beltrão;1;1;2;1121
3304557;Rio de Janeiro;4108403;Francisco Beltrão;1;1;2;1031
3509502;Campinas;4108403;Francisco Beltrão;1;1;2;690
3516200;Franca;4108403;Francisco Beltrão;1;1;2;827
3524709;Jaguariúna;4108403;Francisco Beltrão;1;1;2;706
3534401;Osasco;4108403;Francisco Beltrão;1;1;2;682
4101507;Arapongas;4108403;Francisco Beltrão;1;1;2;336
4102752;Bela Vista da Caroba;4108403;Francisco Beltrão;1;1;2;65
4102901;Bituruna;4108403;Francisco Beltrão;1;1;2;151
4103057;Boa Vista da Aparecida;4108403;Francisco Beltrão;1;1;2;80
4103479;Cafezal do Sul;4108403;Francisco Beltrão;1;1;2;247
4103701;Cambé;4108403;Francisco Beltrão;1;1;2;356
4104303;Campo Mourão;4108403;Francisco Beltrão;1;1;2;235
4105300;Céu Azul;4108403;Francisco Beltrão;1;1;2;131
4106571;Cruzeiro do Iguaçu;4108403;Francisco Beltrão;1;1;2;52
4108304;Foz do Iguaçu;4108403;Francisco Beltrão;1;1;2;157
1302603;Manaus;4108304;Foz do Iguaçu;1;1;2;2533
1501303;Barcarena;4108304;Foz do Iguaçu;1;1;2;2713
1505031;Novo Progresso;4108304;Foz do Iguaçu;1;1;2;2034
1508159;Uruará;4108304;Foz do Iguaçu;1;1;2;2415
1702109;Araguaína;4108304;Foz do Iguaçu;1;1;2;2114
2101400;Balsas;4108304;Foz do Iguaçu;1;1;2;2150
2111300;São Luís;4108304;Foz do Iguaçu;1;1;2;2724
2200400;Altos;4108304;Foz do Iguaçu;1;1;2;2539
2201903;Bom Jesus;4108304;Foz do Iguaçu;1;1;2;2063
2604106;Caruaru;4108304;Foz do Iguaçu;1;1;2;2604
2605459;Fernando de Noronha;4108304;Foz do Iguaçu;1;1;2;3187
2607901;Jaboatão dos Guararapes;4108304;Foz do Iguaçu;1;1;2;2681
2611606;Recife;4108304;Foz do Iguaçu;1;1;2;2687
2613107;São Caitano;4108304;Foz do Iguaçu;1;1;2;2591
2921005;Mata de São João;4108304;Foz do Iguaçu;1;1;2;2124
2928703;Santo Antônio de Jesus;4108304;Foz do Iguaçu;1;1;2;2022
3103504;Araguari;4108304;Foz do Iguaçu;1;1;2;979
3106200;Belo Horizonte;4108304;Foz do Iguaçu;1;1;2;1208
3118601;Contagem;4108304;Foz do Iguaçu;1;1;2;1198
3132404;Itajubá;4108304;Foz do Iguaçu;1;1;2;960
3147006;Paracatu;4108304;Foz do Iguaçu;1;1;2;1178
3160405;Santo Antônio do Monte;4108304;Foz do Iguaçu;1;1;2;1088
3205002;Serra;4108304;Foz do Iguaçu;1;1;2;1521
3300100;Angra dos Reis;4108304;Foz do Iguaçu;1;1;2;1056
3303302;Niterói;4108304;Foz do Iguaçu;1;1;2;1171
3504008;Assis;4108304;Foz do Iguaçu;1;1;2;512
3508504;Caçapava;4108304;Foz do Iguaçu;1;1;2;915
3509601;Campo Limpo Paulista;4108304;Foz do Iguaçu;1;1;2;810
3516200;Franca;4108304;Foz do Iguaçu;1;1;2;890
3526902;Limeira;4108304;Foz do Iguaçu;1;1;2;778
3529005;Marília;4108304;Foz do Iguaçu;1;1;2;580
3530607;Moji das Cruzes;4108304;Foz do Iguaçu;1;1;2;857
3534708;Ourinhos;4108304;Foz do Iguaçu;1;1;2;537
3543907;Rio Claro;4108304;Foz do Iguaçu;1;1;2;770
3549805;São José do Rio Preto;4108304;Foz do Iguaçu;1;1;2;723
3549904;São José dos Campos;4108304;Foz do Iguaçu;1;1;2;896
4100509;Altônia;4108304;Foz do Iguaçu;1;1;2;191
3550308;São Paulo;4108205;Formosa do Oeste;1;1;2;679
4102000;Assis Chateaubriand;4108205;Formosa do Oeste;1;1;2;26
3550308;São Paulo;4108106;Flórida;1;1;2;548
2902906;Barra do Choça;4108007;Florestópolis;1;1;2;1397
3541406;Presidente Prudente;4108007;Florestópolis;1;1;2;81
3545803;Santa Bárbara d'Oeste;4108007;Florestópolis;1;1;2;408
3550308;São Paulo;4108007;Florestópolis;1;1;2;495
4100806;Alvorada do Sul;4108007;Florestópolis;1;1;2;18
4101507;Arapongas;4108007;Florestópolis;1;1;2;61
4103206;Bom Sucesso;4107900;Floresta;1;1;2;35
4102604;Barracão;4107850;Flor da Serra do Sul;1;1;2;33
3534401;Osasco;4107801;Floraí;1;1;2;565
4102208;Atalaia;4107801;Floraí;1;1;2;31
3534401;Osasco;4107751;Figueira;1;1;2;369
4101606;Arapoti;4107751;Figueira;1;1;2;68
4106902;Curitiba;4107736;Fernandes Pinheiro;1;1;2;126
3146008;Ouro Fino;4107702;Fênix;1;1;2;596
3550308;São Paulo;4107702;Fênix;1;1;2;543
4104402;Cândido de Abreu;4107702;Fênix;1;1;2;98
4106555;Corumbataí do Sul;4107702;Fênix;1;1;2;25
1100122;Ji-Paraná;4107652;Fazenda Rio Grande;1;1;2;2030
1100205;Porto Velho;4107652;Fazenda Rio Grande;1;1;2;2331
1302603;Manaus;4107652;Fazenda Rio Grande;1;1;2;2695
1505031;Novo Progresso;4107652;Fazenda Rio Grande;1;1;2;2129
1721000;Palmas;4107652;Fazenda Rio Grande;1;1;2;1696
2304400;Fortaleza;4107652;Fazenda Rio Grande;1;1;2;2630
2408102;Natal;4107652;Fazenda Rio Grande;1;1;2;2572
2609600;Olinda;4107652;Fazenda Rio Grande;1;1;2;2391
2704302;Maceió;4107652;Fazenda Rio Grande;1;1;2;2198
2800308;Aracaju;4107652;Fazenda Rio Grande;1;1;2;2012
2910800;Feira de Santana;4107652;Fazenda Rio Grande;1;1;2;1784
2927408;Salvador;4107652;Fazenda Rio Grande;1;1;2;1749
3106200;Belo Horizonte;4107652;Fazenda Rio Grande;1;1;2;825
3170206;Uberlândia;4107652;Fazenda Rio Grande;1;1;2;755
3205002;Serra;4107652;Fazenda Rio Grande;1;1;2;1076
3205309;Vitória;4107652;Fazenda Rio Grande;1;1;2;1069
3301009;Campos dos Goytacazes;4107652;Fazenda Rio Grande;1;1;2;899
3303302;Niterói;4107652;Fazenda Rio Grande;1;1;2;689
3304557;Rio de Janeiro;4107652;Fazenda Rio Grande;1;1;2;675
3505708;Barueri;4107652;Fazenda Rio Grande;1;1;2;339
3506003;Bauru;4107652;Fazenda Rio Grande;1;1;2;368
3509452;Campina do Monte Alegre;4107652;Fazenda Rio Grande;1;1;2;243
3509502;Campinas;4107652;Fazenda Rio Grande;1;1;2;379
3516200;Franca;4107652;Fazenda Rio Grande;1;1;2;597
3525904;Jundiaí;4107652;Fazenda Rio Grande;1;1;2;364
3529401;Mauá;4107652;Fazenda Rio Grande;1;1;2;359
3534401;Osasco;4107652;Fazenda Rio Grande;1;1;2;344
3543402;Ribeirão Preto;4107652;Fazenda Rio Grande;1;1;2;521
3543907;Rio Claro;4107652;Fazenda Rio Grande;1;1;2;399
3548807;São Caetano do Sul;4107652;Fazenda Rio Grande;1;1;2;355
3548906;São Carlos;4107652;Fazenda Rio Grande;1;1;2;426
3557006;Votorantim;4107652;Fazenda Rio Grande;1;1;2;303
4101507;Arapongas;4107652;Fazenda Rio Grande;1;1;2;327
4104006;Campina Grande do Sul;4107652;Fazenda Rio Grande;1;1;2;47
4104808;Cascavel;4107652;Fazenda Rio Grande;1;1;2;423
3534401;Osasco;4107603;Faxinal;1;1;2;463
3550308;São Paulo;4107603;Faxinal;1;1;2;476
4101507;Arapongas;4107603;Faxinal;1;1;2;67
4103503;Califórnia;4107603;Faxinal;1;1;2;40
4104808;Cascavel;4107546;Espigão Alto do Iguaçu;1;1;2;82
4105508;Cianorte;4107520;Esperança Nova;1;1;2;124
3534401;Osasco;4107504;Engenheiro Beltrão;1;1;2;558
3552403;Sumaré;4107504;Engenheiro Beltrão;1;1;2;519
4103453;Cafelândia;4107504;Engenheiro Beltrão;1;1;2;141
4106902;Curitiba;4107504;Engenheiro Beltrão;1;1;2;355
1100114;Jaru;4107405;Enéas Marques;1;1;2;1936
3541406;Presidente Prudente;4107405;Enéas Marques;1;1;2;457
3550308;São Paulo;4107405;Enéas Marques;1;1;2;694
4103024;Boa Esperança do Iguaçu;4107405;Enéas Marques;1;1;2;34
4106571;Cruzeiro do Iguaçu;4107405;Enéas Marques;1;1;2;36
4107207;Dois Vizinhos;4107405;Enéas Marques;1;1;2;25
3515004;Embu;4107306;Doutor Camargo;1;1;2;548
1100015;Alta Floresta d'Oeste;4107256;Douradina;1;1;2;1532
1100056;Cerejeiras;4107256;Douradina;1;1;2;1354
1100064;Colorado do Oeste;4107256;Douradina;1;1;2;1347
1100098;Espigão d'Oeste;4107256;Douradina;1;1;2;1517
1100114;Jaru;4107256;Douradina;1;1;2;1698
1100130;Machadinho d'Oeste;4107256;Douradina;1;1;2;1766
1100148;Nova Brasilândia d'Oeste;4107256;Douradina;1;1;2;1572
1100155;Ouro Preto do Oeste;4107256;Douradina;1;1;2;1657
1100189;Pimenta Bueno;4107256;Douradina;1;1;2;1513
1100254;Presidente Médici;4107256;Douradina;1;1;2;1595
1100320;São Miguel do Guaporé;4107256;Douradina;1;1;2;1595
1100338;Nova Mamoré;4107256;Douradina;1;1;2;1863
1100346;Alvorada d'Oeste;4107256;Douradina;1;1;2;1603
1100403;Alto Paraíso;4107256;Douradina;1;1;2;1804
1100452;Buritis;4107256;Douradina;1;1;2;1789
1100924;Chupinguaia;4107256;Douradina;1;1;2;1415
1100940;Cujubim;4107256;Douradina;1;1;2;1801
1101203;Ministro Andreazza;4107256;Douradina;1;1;2;1585
1101302;Mirante da Serra;4107256;Douradina;1;1;2;1649
1101401;Monte Negro;4107256;Douradina;1;1;2;1756
1101492;São Francisco do Guaporé;4107256;Douradina;1;1;2;1614
1101708;Urupá;4107256;Douradina;1;1;2;1627
1200013;Acrelândia;4107256;Douradina;1;1;2;2010
1200179;Capixaba;4107256;Douradina;1;1;2;2005
1200302;Feijó;4107256;Douradina;1;1;2;2373
1200385;Plácido de Castro;4107256;Douradina;1;1;2;1992
1200450;Senador Guiomard;4107256;Douradina;1;1;2;2043
1200500;Sena Madureira;4107256;Douradina;1;1;2;2189
1200609;Tarauacá;4107256;Douradina;1;1;2;2406
1300706;Boca do Acre;4107256;Douradina;1;1;2;2130
1301704;Humaitá;4107256;Douradina;1;1;2;1997
1500602;Altamira;4107256;Douradina;1;1;2;2239
1505031;Novo Progresso;4107256;Douradina;1;1;2;1808
1702109;Araguaína;4107256;Douradina;1;1;2;1859
2504009;Campina Grande;4107256;Douradina;1;1;2;2473
3504008;Assis;4107256;Douradina;1;1;2;301
3550308;São Paulo;4107256;Douradina;1;1;2;680
4106902;Curitiba;4107256;Douradina;1;1;2;471
3516200;Franca;4107207;Dois Vizinhos;1;1;2;800
3534401;Osasco;4107207;Dois Vizinhos;1;1;2;669
3548906;São Carlos;4107207;Dois Vizinhos;1;1;2;656
3556206;Valinhos;4107207;Dois Vizinhos;1;1;2;675
4101507;Arapongas;4107207;Dois Vizinhos;1;1;2;304
4102604;Barracão;4107207;Dois Vizinhos;1;1;2;80
4103057;Boa Vista da Aparecida;4107207;Dois Vizinhos;1;1;2;49
4105003;Catanduvas;4107207;Dois Vizinhos;1;1;2;60
4105508;Cianorte;4107207;Dois Vizinhos;1;1;2;234
4106506;Coronel Vivida;4107207;Dois Vizinhos;1;1;2;58
4104808;Cascavel;4107124;Diamante do Sul;1;1;2;79
3534401;Osasco;4107009;Curiúva;1;1;2;376
3550308;São Paulo;4107009;Curiúva;1;1;2;389
4101606;Arapoti;4107009;Curiúva;1;1;2;66
1100049;Cacoal;4106902;Curitiba;1;1;2;1945
1100114;Jaru;4106902;Curitiba;1;1;2;2093
1100155;Ouro Preto do Oeste;4106902;Curitiba;1;1;2;2053
1100189;Pimenta Bueno;4106902;Curitiba;1;1;2;1908
1100288;Rolim de Moura;4106902;Curitiba;1;1;2;1927
1100940;Cujubim;4106902;Curitiba;1;1;2;2189
1400100;Boa Vista;4106902;Curitiba;1;1;2;3314
1502152;Canaã dos Carajás;4106902;Curitiba;1;1;2;2096
1502400;Castanhal;4106902;Curitiba;1;1;2;2673
1502939;Dom Eliseu;4106902;Curitiba;1;1;2;2342
1504208;Marabá;4106902;Curitiba;1;1;2;2220
1505031;Novo Progresso;4106902;Curitiba;1;1;2;2106
1505536;Parauapebas;4106902;Curitiba;1;1;2;2150
1505809;Portel;4106902;Curitiba;1;1;2;2600
1506138;Redenção;4106902;Curitiba;1;1;2;1929
1506187;Rondon do Pará;4106902;Curitiba;1;1;2;2286
1506807;Santarém;4106902;Curitiba;1;1;2;2592
1508100;Tucuruí;4106902;Curitiba;1;1;2;2399
1600204;Calçoene;4106902;Curitiba;1;1;2;3095
1600709;Tartarugalzinho;4106902;Curitiba;1;1;2;2983
1702109;Araguaína;4106902;Curitiba;1;1;2;2021
1709302;Guaraí;4106902;Curitiba;1;1;2;1834
1709500;Gurupi;4106902;Curitiba;1;1;2;1519
1711902;Lagoa da Confusão;4106902;Curitiba;1;1;2;1621
1716109;Paraíso do Tocantins;4106902;Curitiba;1;1;2;1690
2100055;Açailândia;4106902;Curitiba;1;1;2;2272
2101400;Balsas;4106902;Curitiba;1;1;2;2008
2105427;Itinga do Maranhão;4106902;Curitiba;1;1;2;2328
2306256;Itaitinga;4106902;Curitiba;1;1;2;2587
2307650;Maracanaú;4106902;Curitiba;1;1;2;2594
2312908;Sobral;4106902;Curitiba;1;1;2;2554
2403251;Parnamirim;4106902;Curitiba;1;1;2;2542
2408003;Mossoró;4106902;Curitiba;1;1;2;2514
2503001;Caaporã;4106902;Curitiba;1;1;2;2415
2600054;Abreu e Lima;4106902;Curitiba;1;1;2;2381
2601102;Araripina;4106902;Curitiba;1;1;2;2151
2606804;Igarassu;4106902;Curitiba;1;1;2;2383
2607208;Ipojuca;4106902;Curitiba;1;1;2;2327
2700300;Arapiraca;4106902;Curitiba;1;1;2;2115
2804805;Nossa Senhora do Socorro;4106902;Curitiba;1;1;2;1994
2900702;Alagoinhas;4106902;Curitiba;1;1;2;1808
2906006;Campo Formoso;4106902;Curitiba;1;1;2;1864
2906501;Candeias;4106902;Curitiba;1;1;2;1753
2908507;Conceição do Jacuípe;4106902;Curitiba;1;1;2;1770
2909307;Correntina;4106902;Curitiba;1;1;2;1412
2910057;Dias d'Ávila;4106902;Curitiba;1;1;2;1773
2912202;Ibicoara;4106902;Curitiba;1;1;2;1540
2914802;Itabuna;4106902;Curitiba;1;1;2;1528
2921906;Mucugê;4106902;Curitiba;1;1;2;1575
2922003;Mucuri;4106902;Curitiba;1;1;2;1260
2924009;Paulo Afonso;4106902;Curitiba;1;1;2;2062
2928901;São Desidério;4106902;Curitiba;1;1;2;1506
2929305;São Gonçalo dos Campos;4106902;Curitiba;1;1;2;1751
2930709;Simões Filho;4106902;Curitiba;1;1;2;1752
2931350;Teixeira de Freitas;4106902;Curitiba;1;1;2;1281
3101607;Alfenas;4106902;Curitiba;1;1;2;555
3103504;Araguari;4106902;Curitiba;1;1;2;760
3103751;Araporã;4106902;Curitiba;1;1;2;775
3104007;Araxá;4106902;Curitiba;1;1;2;687
3105608;Barbacena;4106902;Curitiba;1;1;2;718
3106309;Belo Oriente;4106902;Curitiba;1;1;2;960
3109105;Bueno Brandão;4106902;Curitiba;1;1;2;442
3119401;Coronel Fabriciano;4106902;Curitiba;1;1;2;927
3122306;Divinópolis;4106902;Curitiba;1;1;2;728
3124500;Estiva;4106902;Curitiba;1;1;2;463
3125101;Extrema;4106902;Curitiba;1;1;2;412
3126109;Formiga;4106902;Curitiba;1;1;2;670
3131703;Itabira;4106902;Curitiba;1;1;2;876
3131901;Itabirito;4106902;Curitiba;1;1;2;784
3132404;Itajubá;4106902;Curitiba;1;1;2;506
3133600;Itapeva;4106902;Curitiba;1;1;2;424
3133758;Itaú de Minas;4106902;Curitiba;1;1;2;576
3133808;Itaúna;4106902;Curitiba;1;1;2;751
3134202;Ituiutaba;4106902;Curitiba;1;1;2;716
3134400;Iturama;4106902;Curitiba;1;1;2;637
3136652;Juatuba;4106902;Curitiba;1;1;2;779
3138203;Lavras;4106902;Curitiba;1;1;2;630
3138625;Limeira do Oeste;4106902;Curitiba;1;1;2;664
3139409;Manhuaçu;4106902;Curitiba;1;1;2;917
3140530;Martins Soares;4106902;Curitiba;1;1;2;930
3140803;Matias Barbosa;4106902;Curitiba;1;1;2;712
3141108;Matozinhos;4106902;Curitiba;1;1;2;829
3143906;Muriaé;4106902;Curitiba;1;1;2;841
3145901;Ouro Branco;4106902;Curitiba;1;1;2;776
3147006;Paracatu;4106902;Curitiba;1;1;2;937
3147303;Paraisópolis;4106902;Curitiba;1;1;2;473
3147907;Passos;4106902;Curitiba;1;1;2;586
3148004;Patos de Minas;4106902;Curitiba;1;1;2;807
3148103;Patrocínio;4106902;Curitiba;1;1;2;753
3152808;Prata;4106902;Curitiba;1;1;2;678
3154101;Recreio;4106902;Curitiba;1;1;2;803
3156700;Sabará;4106902;Curitiba;1;1;2;818
3157807;Santa Luzia;4106902;Curitiba;1;1;2;825
3158953;Santana do Paraíso;4106902;Curitiba;1;1;2;943
3163706;São Lourenço;4106902;Curitiba;1;1;2;561
3164704;São Sebastião do Paraíso;4106902;Curitiba;1;1;2;549
3165537;Sarzedo;4106902;Curitiba;1;1;2;784
3167202;Sete Lagoas;4106902;Curitiba;1;1;2;830
3169307;Três Corações;4106902;Curitiba;1;1;2;581
3169901;Ubá;4106902;Curitiba;1;1;2;788
3170404;Unaí;4106902;Curitiba;1;1;2;1027
3200201;Alegre;4106902;Curitiba;1;1;2;922
3201506;Colatina;4106902;Curitiba;1;1;2;1074
3202405;Guarapari;4106902;Curitiba;1;1;2;1013
3202603;Iconha;4106902;Curitiba;1;1;2;984
3203130;João Neiva;4106902;Curitiba;1;1;2;1079
3203205;Linhares;4106902;Curitiba;1;1;2;1133
3204906;São Mateus;4106902;Curitiba;1;1;2;1184
3205101;Viana;4106902;Curitiba;1;1;2;1026
3300100;Angra dos Reis;4106902;Curitiba;1;1;2;571
3300209;Araruama;4106902;Curitiba;1;1;2;747
3300308;Barra do Piraí;4106902;Curitiba;1;1;2;635
3300704;Cabo Frio;4106902;Curitiba;1;1;2;773
3300951;Comendador Levy Gasparian;4106902;Curitiba;1;1;2;710
3302007;Itaguaí;4106902;Curitiba;1;1;2;618
3302205;Itaperuna;4106902;Curitiba;1;1;2;874
3302601;Mangaratiba;4106902;Curitiba;1;1;2;595
3303203;Nilópolis;4106902;Curitiba;1;1;2;652
3304110;Porto Real;4106902;Curitiba;1;1;2;598
3304128;Quatis;4106902;Curitiba;1;1;2;603
3304144;Queimados;4106902;Curitiba;1;1;2;643
3304300;Rio Bonito;4106902;Curitiba;1;1;2;729
3306206;Vassouras;4106902;Curitiba;1;1;2;653
3500550;Águas de Santa Bárbara;4106902;Curitiba;1;1;2;283
3500709;Agudos;4106902;Curitiba;1;1;2;328
3501004;Altinópolis;4106902;Curitiba;1;1;2;524
3501301;Álvares Machado;4106902;Curitiba;1;1;2;430
3501905;Amparo;4106902;Curitiba;1;1;2;394
3502507;Aparecida;4106902;Curitiba;1;1;2;496
3503802;Artur Nogueira;4106902;Curitiba;1;1;2;381
3503901;Arujá;4106902;Curitiba;1;1;2;373
3505203;Bariri;4106902;Curitiba;1;1;2;376
3505302;Barra Bonita;4106902;Curitiba;1;1;2;334
3505906;Batatais;4106902;Curitiba;1;1;2;530
3506102;Bebedouro;4106902;Curitiba;1;1;2;504
3506359;Bertioga;4106902;Curitiba;1;1;2;361
3509403;Cajuru;4106902;Curitiba;1;1;2;501
3510153;Canitar;4106902;Curitiba;1;1;2;273
3511409;Cerqueira César;4106902;Curitiba;1;1;2;266
3511607;Cesário Lange;4106902;Curitiba;1;1;2;279
3512407;Cordeirópolis;4106902;Curitiba;1;1;2;375
3512803;Cosmópolis;4106902;Curitiba;1;1;2;373
3514403;Dracena;4106902;Curitiba;1;1;2;487
3515186;Espírito Santo do Pinhal;4106902;Curitiba;1;1;2;440
3515509;Fernandópolis;4106902;Curitiba;1;1;2;579
3516705;Garça;4106902;Curitiba;1;1;2;358
3518305;Guararema;4106902;Curitiba;1;1;2;394
3519600;Ibitinga;4106902;Curitiba;1;1;2;410
3519709;Ibiúna;4106902;Curitiba;1;1;2;286
3520103;Igarapava;4106902;Curitiba;1;1;2;616
3520202;Igaratá;4106902;Curitiba;1;1;2;399
3520905;Ipaussu;4106902;Curitiba;1;1;2;265
3521002;Iperó;4106902;Curitiba;1;1;2;281
3521903;Itajobi;4106902;Curitiba;1;1;2;457
3522109;Itanhaém;4106902;Curitiba;1;1;2;286
3523404;Itatiba;4106902;Curitiba;1;1;2;364
3524006;Itupeva;4106902;Curitiba;1;1;2;337
3525300;Jaú;4106902;Curitiba;1;1;2;357
3526001;Junqueirópolis;4106902;Curitiba;1;1;2;483
3526704;Leme;4106902;Curitiba;1;1;2;406
3527603;Luís Antônio;4106902;Curitiba;1;1;2;458
3528403;Mairinque;4106902;Curitiba;1;1;2;297
3528502;Mairiporã;4106902;Curitiba;1;1;2;357
3529302;Matão;4106902;Curitiba;1;1;2;434
3530300;Mirassol;4106902;Curitiba;1;1;2;512
3530508;Mococa;4106902;Curitiba;1;1;2;493
3533403;Nova Odessa;4106902;Curitiba;1;1;2;356
3533908;Olímpia;4106902;Curitiba;1;1;2;520
3534302;Orlândia;4106902;Curitiba;1;1;2;540
3536703;Pederneiras;4106902;Curitiba;1;1;2;345
3537107;Pedreira;4106902;Curitiba;1;1;2;382
3537305;Penápolis;4106902;Curitiba;1;1;2;450
3537404;Pereira Barreto;4106902;Curitiba;1;1;2;563
3537602;Peruíbe;4106902;Curitiba;1;1;2;261
3537909;Pilar do Sul;4106902;Curitiba;1;1;2;239
3539103;Pirapora do Bom Jesus;4106902;Curitiba;1;1;2;321
3539301;Pirassununga;4106902;Curitiba;1;1;2;422
3540200;Pontal;4106902;Curitiba;1;1;2;504
3540606;Porto Feliz;4106902;Curitiba;1;1;2;303
3540705;Porto Ferreira;4106902;Curitiba;1;1;2;436
3542206;Rancharia;4106902;Curitiba;1;1;2;389
3542404;Regente Feijó;4106902;Curitiba;1;1;2;408
3542909;Ribeirão Bonito;4106902;Curitiba;1;1;2;389
3545308;Salto de Pirapora;4106902;Curitiba;1;1;2;262
3546306;Santa Cruz das Palmeiras;4106902;Curitiba;1;1;2;448
3546405;Santa Cruz do Rio Pardo;4106902;Curitiba;1;1;2;283
3546603;Santa Fé do Sul;4106902;Curitiba;1;1;2;603
3547502;Santa Rita do Passa Quatro;4106902;Curitiba;1;1;2;450
3547601;Santa Rosa de Viterbo;4106902;Curitiba;1;1;2;479
3548005;Santo Antônio de Posse;4106902;Curitiba;1;1;2;392
3549706;São José do Rio Pardo;4106902;Curitiba;1;1;2;487
3550100;São Manuel;4106902;Curitiba;1;1;2;308
3550605;São Roque;4106902;Curitiba;1;1;2;302
3550704;São Sebastião;4106902;Curitiba;1;1;2;428
3551009;São Vicente;4106902;Curitiba;1;1;2;328
3554300;Teodoro Sampaio;4106902;Curitiba;1;1;2;431
3554508;Tietê;4106902;Curitiba;1;1;2;303
3555000;Tupã;4106902;Curitiba;1;1;2;407
3555406;Ubatuba;4106902;Curitiba;1;1;2;473
3556404;Vargem Grande do Sul;4106902;Curitiba;1;1;2;465
3556453;Vargem Grande Paulista;4106902;Curitiba;1;1;2;304
3557105;Votuporanga;4106902;Curitiba;1;1;2;557
4100301;Agudos do Sul;4106902;Curitiba;1;1;2;62
4100509;Altônia;4106902;Curitiba;1;1;2;491
4100608;Alto Paraná;4106902;Curitiba;1;1;2;395
4100707;Alto Piquiri;4106902;Curitiba;1;1;2;443
4102505;Barbosa Ferraz;4106902;Curitiba;1;1;2;312
4102604;Barracão;4106902;Curitiba;1;1;2;447
4102703;Barra do Jacaré;4106902;Curitiba;1;1;2;272
4103057;Boa Vista da Aparecida;4106902;Curitiba;1;1;2;414
4103354;Braganey;4106902;Curitiba;1;1;2;390
4103453;Cafelândia;4106902;Curitiba;1;1;2;414
4104501;Capanema;4106902;Curitiba;1;1;2;455
4104600;Capitão Leônidas Marques;4106902;Curitiba;1;1;2;435
4104709;Carlópolis;4106902;Curitiba;1;1;2;227
4105409;Chopinzinho;4106902;Curitiba;1;1;2;329
4105607;Cidade Gaúcha;4106902;Curitiba;1;1;2;430
4106456;Coronel Domingos Soares;4106902;Curitiba;1;1;2;290
4106506;Coronel Vivida;4106902;Curitiba;1;1;2;335
4106852;Cruzmaltina;4106902;Curitiba;1;1;2;268
4101408;Apucarana;4106852;Cruzmaltina;1;1;2;50
4104303;Campo Mourão;4106852;Cruzmaltina;1;1;2;95
3534401;Osasco;4106803;Cruz Machado;1;1;2;529
3550308;São Paulo;4106803;Cruz Machado;1;1;2;534
4101309;Antônio Olinto;4106803;Cruz Machado;1;1;2;115
4101804;Araucária;4106803;Cruz Machado;1;1;2;200
3505807;Bastos;4106704;Cruzeiro do Sul;1;1;2;186
3550308;São Paulo;4106704;Cruzeiro do Sul;1;1;2;572
2608909;Limoeiro;4106605;Cruzeiro do Oeste;1;1;2;2463
3534302;Orlândia;4106605;Cruzeiro do Oeste;1;1;2;623
3534401;Osasco;4106605;Cruzeiro do Oeste;1;1;2;640
3547809;Santo André;4106605;Cruzeiro do Oeste;1;1;2;667
4101507;Arapongas;4106605;Cruzeiro do Oeste;1;1;2;171
4104303;Campo Mourão;4106605;Cruzeiro do Oeste;1;1;2;76
4104808;Cascavel;4106605;Cruzeiro do Oeste;1;1;2;134
4103024;Boa Esperança do Iguaçu;4106571;Cruzeiro do Iguaçu;1;1;2;9
4101408;Apucarana;4106555;Corumbataí do Sul;1;1;2;90
4102505;Barbosa Ferraz;4106555;Corumbataí do Sul;1;1;2;14
4104303;Campo Mourão;4106555;Corumbataí do Sul;1;1;2;28
3534401;Osasco;4106506;Coronel Vivida;1;1;2;633
4104428;Candói;4106506;Coronel Vivida;1;1;2;54
3534401;Osasco;4106456;Coronel Domingos Soares;1;1;2;598
4102901;Bituruna;4106456;Coronel Domingos Soares;1;1;2;48
4104303;Campo Mourão;4106456;Coronel Domingos Soares;1;1;2;244
4106209;Contenda;4106456;Coronel Domingos Soares;1;1;2;256
3504008;Assis;4106407;Cornélio Procópio;1;1;2;61
3514403;Dracena;4106407;Cornélio Procópio;1;1;2;205
3534401;Osasco;4106407;Cornélio Procópio;1;1;2;399
3534708;Ourinhos;4106407;Cornélio Procópio;1;1;2;81
3543402;Ribeirão Preto;4106407;Cornélio Procópio;1;1;2;368
3546405;Santa Cruz do Rio Pardo;4106407;Cornélio Procópio;1;1;2;110
4100103;Abatiá;4106407;Cornélio Procópio;1;1;2;38
4101903;Assaí;4106407;Cornélio Procópio;1;1;2;28
4102109;Astorga;4106407;Cornélio Procópio;1;1;2;103
4104303;Campo Mourão;4106407;Cornélio Procópio;1;1;2;202
4105508;Cianorte;4106407;Cornélio Procópio;1;1;2;206
3534401;Osasco;4106308;Corbélia;1;1;2;669
4103354;Braganey;4106308;Corbélia;1;1;2;18
4103909;Campina da Lagoa;4106308;Corbélia;1;1;2;55
4105805;Colombo;4106308;Corbélia;1;1;2;413
3526209;Juquitiba;4106209;Contenda;1;1;2;313
3534401;Osasco;4106209;Contenda;1;1;2;362
3550308;São Paulo;4106209;Contenda;1;1;2;364
4104204;Campo Largo;4106209;Contenda;1;1;2;24
3550308;São Paulo;4106100;Conselheiro Mairinck;1;1;2;359
1709302;Guaraí;4106001;Congonhinhas;1;1;2;1636
4102802;Bela Vista do Paraíso;4106001;Congonhinhas;1;1;2;89
4103602;Cambará;4106001;Congonhinhas;1;1;2;74
2910800;Feira de Santana;4105904;Colorado;1;1;2;1743
3508900;Caiabu;4105904;Colorado;1;1;2;118
3516200;Franca;4105904;Colorado;1;1;2;530
3534401;Osasco;4105904;Colorado;1;1;2;538
3539202;Pirapozinho;4105904;Colorado;1;1;2;79
4101507;Arapongas;4105904;Colorado;1;1;2;84
4102109;Astorga;4105904;Colorado;1;1;2;54
4103305;Borrazópolis;4105904;Colorado;1;1;2;128
1501402;Belém;4105805;Colombo;1;1;2;2642
2604106;Caruaru;4105805;Colombo;1;1;2;2269
3106200;Belo Horizonte;4105805;Colombo;1;1;2;789
3117603;Conceição do Pará;4105805;Colombo;1;1;2;745
3168705;Timóteo;4105805;Colombo;1;1;2;905
3203205;Linhares;4105805;Colombo;1;1;2;1119
3501905;Amparo;4105805;Colombo;1;1;2;376
3502705;Apiaí;4105805;Colombo;1;1;2;92
3503208;Araraquara;4105805;Colombo;1;1;2;399
3505708;Barueri;4105805;Colombo;1;1;2;306
3506003;Bauru;4105805;Colombo;1;1;2;323
3509502;Campinas;4105805;Colombo;1;1;2;340
3512407;Cordeirópolis;4105805;Colombo;1;1;2;355
3513504;Cubatão;4105805;Colombo;1;1;2;320
3513801;Diadema;4105805;Colombo;1;1;2;315
3516200;Franca;4105805;Colombo;1;1;2;553
3520509;Indaiatuba;4105805;Colombo;1;1;2;312
3522505;Itapevi;4105805;Colombo;1;1;2;298
3525003;Jandira;4105805;Colombo;1;1;2;302
3525904;Jundiaí;4105805;Colombo;1;1;2;328
3526803;Lençóis Paulista;4105805;Colombo;1;1;2;296
3529302;Matão;4105805;Colombo;1;1;2;413
3534708;Ourinhos;4105805;Colombo;1;1;2;260
3545209;Salto;4105805;Colombo;1;1;2;300
3547304;Santana de Parnaíba;4105805;Colombo;1;1;2;307
4103701;Cambé;4105805;Colombo;1;1;2;297
4105201;Cerro Azul;4105805;Colombo;1;1;2;48
3516200;Franca;4105706;Clevelândia;1;1;2;815
3534401;Osasco;4105706;Clevelândia;1;1;2;644
3530607;Moji das Cruzes;4105607;Cidade Gaúcha;1;1;2;691
3534401;Osasco;4105607;Cidade Gaúcha;1;1;2;630
3550308;São Paulo;4105607;Cidade Gaúcha;1;1;2;645
1100205;Porto Velho;4105508;Cianorte;1;1;2;1983
1302603;Manaus;4105508;Cianorte;1;1;2;2386
2607901;Jaboatão dos Guararapes;4105508;Cianorte;1;1;2;2433
2611606;Recife;4105508;Cianorte;1;1;2;2439
3136702;Juiz de Fora;4105508;Cianorte;1;1;2;962
3170107;Uberaba;4105508;Cianorte;1;1;2;641
3170206;Uberlândia;4105508;Cianorte;1;1;2;683
3504503;Avaré;4105508;Cianorte;1;1;2;379
3505807;Bastos;4105508;Cianorte;1;1;2;270
3509502;Campinas;4105508;Cianorte;1;1;2;570
3511300;Cedral;4105508;Cianorte;1;1;2;455
3516200;Franca;4105508;Cianorte;1;1;2;628
3518206;Guararapes;4105508;Cianorte;1;1;2;331
3531209;Monte Alegre do Sul;4105508;Cianorte;1;1;2;611
3534401;Osasco;4105508;Cianorte;1;1;2;592
3541505;Presidente Venceslau;4105508;Cianorte;1;1;2;214
3543402;Ribeirão Preto;4105508;Cianorte;1;1;2;560
3544251;Rosana;4105508;Cianorte;1;1;2;129
3545803;Santa Bárbara d'Oeste;4105508;Cianorte;1;1;2;537
3549904;São José dos Campos;4105508;Cianorte;1;1;2;686
4100509;Altônia;4105508;Cianorte;1;1;2;134
4101705;Araruna;4105508;Cianorte;1;1;2;32
4101804;Araucária;4105508;Cianorte;1;1;2;392
4102109;Astorga;4105508;Cianorte;1;1;2;106
4102406;Bandeirantes;4105508;Cianorte;1;1;2;235
4102505;Barbosa Ferraz;4105508;Cianorte;1;1;2;73
4102604;Barracão;4105508;Cianorte;1;1;2;304
4103354;Braganey;4105508;Cianorte;1;1;2;138
4103701;Cambé;4105508;Cianorte;1;1;2;141
3534401;Osasco;4105409;Chopinzinho;1;1;2;625
3550308;São Paulo;4105409;Chopinzinho;1;1;2;632
4104428;Candói;4105409;Chopinzinho;1;1;2;42
1502939;Dom Eliseu;4105300;Céu Azul;1;1;2;2381
3534401;Osasco;4105300;Céu Azul;1;1;2;730
4104600;Capitão Leônidas Marques;4105300;Céu Azul;1;1;2;44
3502705;Apiaí;4105201;Cerro Azul;1;1;2;55
3522653;Itapirapuã Paulista;4105201;Cerro Azul;1;1;2;29
3523206;Itararé;4105201;Cerro Azul;1;1;2;80
3534401;Osasco;4105201;Cerro Azul;1;1;2;287
3550308;São Paulo;4105201;Cerro Azul;1;1;2;293
4100400;Almirante Tamandaré;4105201;Cerro Azul;1;1;2;56
4104907;Castro;4105201;Cerro Azul;1;1;2;80
3541406;Presidente Prudente;4105102;Centenário do Sul;1;1;2;79
4101903;Assaí;4105102;Centenário do Sul;1;1;2;99
4102802;Bela Vista do Paraíso;4105102;Centenário do Sul;1;1;2;46
3506003;Bauru;4105003;Catanduvas;1;1;2;515
3534401;Osasco;4105003;Catanduvas;1;1;2;664
3550308;São Paulo;4105003;Catanduvas;1;1;2;674
2607901;Jaboatão dos Guararapes;4104907;Castro;1;1;2;2347
3170206;Uberlândia;4104907;Castro;1;1;2;675
3500709;Agudos;4104907;Castro;1;1;2;275
3506508;Birigui;4104907;Castro;1;1;2;386
3507159;Bom Sucesso de Itararé;4104907;Castro;1;1;2;105
3510807;Casa Branca;4104907;Castro;1;1;2;446
3521705;Itaberá;4104907;Castro;1;1;2;137
3534401;Osasco;4104907;Castro;1;1;2;356
3543006;Ribeirão Branco;4104907;Castro;1;1;2;144
3548906;São Carlos;4104907;Castro;1;1;2;374
3553807;Taquarituba;4104907;Castro;1;1;2;161
4101507;Arapongas;4104907;Castro;1;1;2;206
4101705;Araruna;4104907;Castro;1;1;2;264
4101804;Araucária;4104907;Castro;1;1;2;111
4103040;Boa Ventura de São Roque;4104907;Castro;1;1;2;160
4104204;Campo Largo;4104907;Castro;1;1;2;92
1100015;Alta Floresta d'Oeste;4104808;Cascavel;1;1;2;1662
1100080;Costa Marques;4104808;Cascavel;1;1;2;1736
1100148;Nova Brasilândia d'Oeste;4104808;Cascavel;1;1;2;1701
1100288;Rolim de Moura;4104808;Cascavel;1;1;2;1661
1100320;São Miguel do Guaporé;4104808;Cascavel;1;1;2;1721
1200401;Rio Branco;4104808;Cascavel;1;1;2;2161
1301704;Humaitá;4104808;Cascavel;1;1;2;2136
1301902;Itacoatiara;4104808;Cascavel;1;1;2;2466
1302603;Manaus;4104808;Cascavel;1;1;2;2496
1500800;Ananindeua;4104808;Cascavel;1;1;2;2653
1505536;Parauapebas;4104808;Cascavel;1;1;2;2124
1708205;Formoso do Araguaia;4104808;Cascavel;1;1;2;1505
2105302;Imperatriz;4104808;Cascavel;1;1;2;2227
2307650;Maracanaú;4104808;Cascavel;1;1;2;2732
2503001;Caaporã;4104808;Cascavel;1;1;2;2630
2602902;Cabo de Santo Agostinho;4104808;Cascavel;1;1;2;2562
2604106;Caruaru;4104808;Cascavel;1;1;2;2498
2609600;Olinda;4104808;Cascavel;1;1;2;2593
2903201;Barreiras;4104808;Cascavel;1;1;2;1632
2909307;Correntina;4104808;Cascavel;1;1;2;1545
2918001;Jequié;4104808;Cascavel;1;1;2;1795
2927408;Salvador;4104808;Cascavel;1;1;2;1969
3106705;Betim;4104808;Cascavel;1;1;2;1072
3125705;Felixlândia;4104808;Cascavel;1;1;2;1088
3126109;Formiga;4104808;Cascavel;1;1;2;940
3147006;Paracatu;4104808;Cascavel;1;1;2;1069
3148004;Patos de Minas;4104808;Cascavel;1;1;2;984
3152501;Pouso Alegre;4104808;Cascavel;1;1;2;809
3156700;Sabará;4104808;Cascavel;1;1;2;1109
3171105;Veríssimo;4104808;Cascavel;1;1;2;776
3203346;Marechal Floriano;4104808;Cascavel;1;1;2;1365
3305505;Saquarema;4104808;Cascavel;1;1;2;1126
3306008;Três Rios;4104808;Cascavel;1;1;2;1070
3502804;Araçatuba;4104808;Cascavel;1;1;2;509
3504008;Assis;4104808;Cascavel;1;1;2;393
3506003;Bauru;4104808;Cascavel;1;1;2;524
3506508;Birigui;4104808;Cascavel;1;1;2;509
3507605;Bragança Paulista;4104808;Cascavel;1;1;2;727
3507902;Brotas;4104808;Cascavel;1;1;2;609
3515509;Fernandópolis;4104808;Cascavel;1;1;2;607
3516101;Florínia;4104808;Cascavel;1;1;2;355
3516200;Franca;4104808;Cascavel;1;1;2;774
3517406;Guaíra;4104808;Cascavel;1;1;2;724
3524402;Jacareí;4104808;Cascavel;1;1;2;775
3526803;Lençóis Paulista;4104808;Cascavel;1;1;2;532
3530805;Moji-Mirim;4104808;Cascavel;1;1;2;706
3534302;Orlândia;4104808;Cascavel;1;1;2;725
3534708;Ourinhos;4104808;Cascavel;1;1;2;418
3536505;Paulínia;4104808;Cascavel;1;1;2;676
3543402;Ribeirão Preto;4104808;Cascavel;1;1;2;703
3545407;Salto Grande;4104808;Cascavel;1;1;2;416
3547304;Santana de Parnaíba;4104808;Cascavel;1;1;2;677
3548708;São Bernardo do Campo;4104808;Cascavel;1;1;2;704
3548906;São Carlos;4104808;Cascavel;1;1;2;643
3552403;Sumaré;4104808;Cascavel;1;1;2;663
3552809;Taboão da Serra;4104808;Cascavel;1;1;2;688
4101002;Ampére;4104808;Cascavel;1;1;2;107
4103057;Boa Vista da Aparecida;4104808;Cascavel;1;1;2;55
4104451;Cantagalo;4104808;Cascavel;1;1;2;143
3205309;Vitória;4104709;Carlópolis;1;1;2;1015
3518800;Guarulhos;4104709;Carlópolis;1;1;2;323
3534401;Osasco;4104709;Carlópolis;1;1;2;300
3536307;Patrocínio Paulista;4104709;Carlópolis;1;1;2;394
3553005;Taguaí;4104709;Carlópolis;1;1;2;32
3554003;Tatuí;4104709;Carlópolis;1;1;2;192
4101606;Arapoti;4104709;Carlópolis;1;1;2;82
2611606;Recife;4104659;Carambeí;1;1;2;2365
2905701;Camaçari;4104659;Carambeí;1;1;2;1772
3106200;Belo Horizonte;4104659;Carambeí;1;1;2;823
3148004;Patos de Minas;4104659;Carambeí;1;1;2;786
3505708;Barueri;4104659;Carambeí;1;1;2;359
3525904;Jundiaí;4104659;Carambeí;1;1;2;374
3534401;Osasco;4104659;Carambeí;1;1;2;366
4101606;Arapoti;4104659;Carambeí;1;1;2;88
4101804;Araucária;4104659;Carambeí;1;1;2;102
3534401;Osasco;4104600;Capitão Leônidas Marques;1;1;2;714
4103057;Boa Vista da Aparecida;4104600;Capitão Leônidas Marques;1;1;2;21
3534401;Osasco;4104501;Capanema;1;1;2;738
3550308;São Paulo;4104501;Capanema;1;1;2;747
4101002;Ampére;4104501;Capanema;1;1;2;42
4103057;Boa Vista da Aparecida;4104501;Capanema;1;1;2;49
4103156;Bom Jesus do Sul;4104501;Capanema;1;1;2;60
3534401;Osasco;4104451;Cantagalo;1;1;2;571
4103958;Campina do Simão;4104451;Cantagalo;1;1;2;44
4104303;Campo Mourão;4104451;Cantagalo;1;1;2;150
3534401;Osasco;4104428;Candói;1;1;2;584
3505807;Bastos;4104402;Cândido de Abreu;1;1;2;299
3534401;Osasco;4104402;Cândido de Abreu;1;1;2;472
4104303;Campo Mourão;4104402;Cândido de Abreu;1;1;2;121
2503209;Cabedelo;4104303;Campo Mourão;1;1;2;2540
2601904;Bezerros;4104303;Campo Mourão;1;1;2;2383
2613503;São José do Belmonte;4104303;Campo Mourão;1;1;2;2224
2706307;Palmeira dos Índios;4104303;Campo Mourão;1;1;2;2231
2919553;Luís Eduardo magalhães;4104303;Campo Mourão;1;1;2;1471
3504107;Atibaia;4104303;Campo Mourão;1;1;2;601
3513801;Diadema;4104303;Campo Mourão;1;1;2;588
3516200;Franca;4104303;Campo Mourão;1;1;2;633
3518800;Guarulhos;4104303;Campo Mourão;1;1;2;595
3525102;Jardinópolis;4104303;Campo Mourão;1;1;2;573
3543402;Ribeirão Preto;4104303;Campo Mourão;1;1;2;562
3552403;Sumaré;4104303;Campo Mourão;1;1;2;536
4100459;Altamira do Paraná;4104303;Campo Mourão;1;1;2;90
4100707;Alto Piquiri;4104303;Campo Mourão;1;1;2;107
4101655;Arapuã;4104303;Campo Mourão;1;1;2;68
4101804;Araucária;4104303;Campo Mourão;1;1;2;350
4103370;Brasilândia do Sul;4104303;Campo Mourão;1;1;2;117
4103701;Cambé;4104303;Campo Mourão;1;1;2;140
4104204;Campo Largo;4104303;Campo Mourão;1;1;2;332
2905701;Camaçari;4104253;Campo Magro;1;1;2;1768
3304201;Resende;4104253;Campo Magro;1;1;2;590
3548708;São Bernardo do Campo;4104253;Campo Magro;1;1;2;340
1100049;Cacoal;4104204;Campo Largo;1;1;2;1933
1100122;Ji-Paraná;4104204;Campo Largo;1;1;2;2001
1100205;Porto Velho;4104204;Campo Largo;1;1;2;2302
1200401;Rio Branco;4104204;Campo Largo;1;1;2;2455
2611606;Recife;4104204;Campo Largo;1;1;2;2374
3106705;Betim;4104204;Campo Largo;1;1;2;805
3301702;Duque de Caxias;4104204;Campo Largo;1;1;2;687
3302403;Macaé;4104204;Campo Largo;1;1;2;832
3504008;Assis;4104204;Campo Largo;1;1;2;323
3505708;Barueri;4104204;Campo Largo;1;1;2;341
3511102;Catanduva;4104204;Campo Largo;1;1;2;481
3518800;Guarulhos;4104204;Campo Largo;1;1;2;371
3522406;Itapeva;4104204;Campo Largo;1;1;2;176
3529401;Mauá;4104204;Campo Largo;1;1;2;365
3538709;Piracicaba;4104204;Campo Largo;1;1;2;353
3543402;Ribeirão Preto;4104204;Campo Largo;1;1;2;507
3545209;Salto;4104204;Campo Largo;1;1;2;335
3548807;São Caetano do Sul;4104204;Campo Largo;1;1;2;360
3552205;Sorocaba;4104204;Campo Largo;1;1;2;298
3552502;Suzano;4104204;Campo Largo;1;1;2;385
3550308;São Paulo;4104105;Campo do Tenente;1;1;2;396
4103354;Braganey;4104055;Campo Bonito;1;1;2;27
2408102;Natal;4104006;Campina Grande do Sul;1;1;2;2529
2610707;Paulista;4104006;Campina Grande do Sul;1;1;2;2355
2925204;Pojuca;4104006;Campina Grande do Sul;1;1;2;1763
3106705;Betim;4104006;Campina Grande do Sul;1;1;2;762
3169901;Ubá;4104006;Campina Grande do Sul;1;1;2;762
3304557;Rio de Janeiro;4104006;Campina Grande do Sul;1;1;2;637
3513801;Diadema;4104006;Campina Grande do Sul;1;1;2;303
3516200;Franca;4104006;Campina Grande do Sul;1;1;2;552
3518503;Guareí;4104006;Campina Grande do Sul;1;1;2;231
3534401;Osasco;4104006;Campina Grande do Sul;1;1;2;300
4103701;Cambé;4104006;Campina Grande do Sul;1;1;2;314
3550308;São Paulo;4103958;Campina do Simão;1;1;2;543
3534401;Osasco;4103909;Campina da Lagoa;1;1;2;617
3550308;São Paulo;4103909;Campina da Lagoa;1;1;2;629
4100459;Altamira do Paraná;4103909;Campina da Lagoa;1;1;2;24
4101408;Apucarana;4103800;Cambira;1;1;2;15
1302603;Manaus;4103701;Cambé;1;1;2;2391
1501402;Belém;4103701;Cambé;1;1;2;2440
1721000;Palmas;4103701;Cambé;1;1;2;1460
2211001;Teresina;4103701;Cambé;1;1;2;2178
2408102;Natal;4103701;Cambé;1;1;2;2492
2507507;João Pessoa;4103701;Cambé;1;1;2;2403
2604106;Caruaru;4103701;Cambé;1;1;2;2240
2704302;Maceió;4103701;Cambé;1;1;2;2151
2800308;Aracaju;4103701;Cambé;1;1;2;1962
2910800;Feira de Santana;4103701;Cambé;1;1;2;1724
3106705;Betim;4103701;Cambé;1;1;2;806
3118601;Contagem;4103701;Cambé;1;1;2;817
3136702;Juiz de Fora;4103701;Cambé;1;1;2;826
3148004;Patos de Minas;4103701;Cambé;1;1;2;709
3201704;Conceição do Castelo;4103701;Cambé;1;1;2;1066
3202603;Iconha;4103701;Cambé;1;1;2;1097
3203205;Linhares;4103701;Cambé;1;1;2;1216
3300407;Barra Mansa;4103701;Cambé;1;1;2;727
3303401;Nova Friburgo;4103701;Cambé;1;1;2;893
3303500;Nova Iguaçu;4103701;Cambé;1;1;2;799
3304557;Rio de Janeiro;4103701;Cambé;1;1;2;820
3501608;Americana;4103701;Cambé;1;1;2;407
3515004;Embu;4103701;Cambé;1;1;2;455
3518800;Guarulhos;4103701;Cambé;1;1;2;483
3543402;Ribeirão Preto;4103701;Cambé;1;1;2;425
3549102;São João da Boa Vista;4103701;Cambé;1;1;2;478
3549805;São José do Rio Preto;4103701;Cambé;1;1;2;333
3554003;Tatuí;4103701;Cambé;1;1;2;351
4100509;Altônia;4103701;Cambé;1;1;2;276
4101903;Assaí;4103701;Cambé;1;1;2;45
4102406;Bandeirantes;4103701;Cambé;1;1;2;95
4102802;Bela Vista do Paraíso;4103701;Cambé;1;1;2;34
3504008;Assis;4103602;Cambará;1;1;2;57
3506003;Bauru;4103602;Cambará;1;1;2;128
3510005;Cândido Mota;4103602;Cambará;1;1;2;46
3513801;Diadema;4103602;Cambará;1;1;2;362
3516200;Franca;4103602;Cambará;1;1;2;388
3533601;Nuporanga;4103602;Cambará;1;1;2;350
3534401;Osasco;4103602;Cambará;1;1;2;341
3535309;Palmital;4103602;Cambará;1;1;2;32
3545407;Salto Grande;4103602;Cambará;1;1;2;19
3548708;São Bernardo do Campo;4103602;Cambará;1;1;2;366
3550308;São Paulo;4103602;Cambará;1;1;2;358
3556206;Valinhos;4103602;Cambará;1;1;2;315
4100103;Abatiá;4103602;Cambará;1;1;2;38
4101606;Arapoti;4103602;Cambará;1;1;2;126
4102109;Astorga;4103602;Cambará;1;1;2;165
3550308;São Paulo;4103503;Califórnia;1;1;2;480
4101408;Apucarana;4103503;Califórnia;1;1;2;14
3506102;Bebedouro;4103453;Cafelândia;1;1;2;628
3550308;São Paulo;4103453;Cafelândia;1;1;2;681
3553955;Tarumã;4103453;Cafelândia;1;1;2;345
4102000;Assis Chateaubriand;4103453;Cafelândia;1;1;2;28
4103354;Braganey;4103453;Cafelândia;1;1;2;30
2506301;Guarabira;4103222;Bom Sucesso do Sul;1;1;2;2691
2615300;Timbaúba;4103222;Bom Sucesso do Sul;1;1;2;2646
4101002;Ampére;4103156;Bom Jesus do Sul;1;1;2;33
4102604;Barracão;4103156;Bom Jesus do Sul;1;1;2;6
3534401;Osasco;4103107;Bocaiúva do Sul;1;1;2;297
3550308;São Paulo;4103107;Bocaiúva do Sul;1;1;2;301
3505807;Bastos;4103057;Boa Vista da Aparecida;1;1;2;471
3550308;São Paulo;4103057;Boa Vista da Aparecida;1;1;2;703
3554003;Tatuí;4103040;Boa Ventura de São Roque;1;1;2;416
3534401;Osasco;4102901;Bituruna;1;1;2;554
3534401;Osasco;4102802;Bela Vista do Paraíso;1;1;2;456
4100806;Alvorada do Sul;4102802;Bela Vista do Paraíso;1;1;2;24
4101408;Apucarana;4102802;Bela Vista do Paraíso;1;1;2;68
3516200;Franca;4102604;Barracão;1;1;2;876
4101002;Ampére;4102604;Barracão;1;1;2;39
3505807;Bastos;4102505;Barbosa Ferraz;1;1;2;267
1503457;Ipixuna do Pará;4102406;Bandeirantes;1;1;2;2290
2611606;Recife;4102406;Bandeirantes;1;1;2;2250
3504008;Assis;4102406;Bandeirantes;1;1;2;50
3509205;Cajamar;4102406;Bandeirantes;1;1;2;359
3516200;Franca;4102406;Bandeirantes;1;1;2;414
3534401;Osasco;4102406;Bandeirantes;1;1;2;370
3534609;Osvaldo Cruz;4102406;Bandeirantes;1;1;2;154
3543907;Rio Claro;4102406;Bandeirantes;1;1;2;297
3547601;Santa Rosa de Viterbo;4102406;Bandeirantes;1;1;2;356
3304557;Rio de Janeiro;4102307;Balsa Nova;1;1;2;701
3504008;Assis;4102307;Balsa Nova;1;1;2;333
3505708;Barueri;4102307;Balsa Nova;1;1;2;358
3530706;Mogi Guaçu;4102307;Balsa Nova;1;1;2;448
3534401;Osasco;4102307;Balsa Nova;1;1;2;363
3543402;Ribeirão Preto;4102307;Balsa Nova;1;1;2;523
3554805;Tremembé;4102307;Balsa Nova;1;1;2;500
4101150;Ângulo;4102208;Atalaia;1;1;2;15
3505807;Bastos;4102109;Astorga;1;1;2;173
3522802;Itaporanga;4102109;Astorga;1;1;2;229
3523206;Itararé;4102109;Astorga;1;1;2;257
3534401;Osasco;4102109;Astorga;1;1;2;501
3550308;São Paulo;4102109;Astorga;1;1;2;516
4101150;Ângulo;4102109;Astorga;1;1;2;26
4101606;Arapoti;4102109;Astorga;1;1;2;215
3516200;Franca;4102000;Assis Chateaubriand;1;1;2;748
3525904;Jundiaí;4102000;Assis Chateaubriand;1;1;2;682
3534401;Osasco;4102000;Assis Chateaubriand;1;1;2;687
4100509;Altônia;4102000;Assis Chateaubriand;1;1;2;73
3103504;Araguari;4101903;Assaí;1;1;2;587
3534401;Osasco;4101903;Assaí;1;1;2;415
4100400;Almirante Tamandaré;4101903;Assaí;1;1;2;268
4101606;Arapoti;4101903;Assaí;1;1;2;136
1302603;Manaus;4101804;Araucária;1;1;2;2685
1721000;Palmas;4101804;Araucária;1;1;2;1688
2103000;Caxias;4101804;Araucária;1;1;2;2366
2607901;Jaboatão dos Guararapes;4101804;Araucária;1;1;2;2372
2610707;Paulista;4101804;Araucária;1;1;2;2397
2705200;Messias;4101804;Araucária;1;1;2;2215
2919207;Lauro de Freitas;4101804;Araucária;1;1;2;1766
2922003;Mucuri;4101804;Araucária;1;1;2;1278
2930709;Simões Filho;4101804;Araucária;1;1;2;1770
3106309;Belo Oriente;4101804;Araucária;1;1;2;979
3107901;Bom Repouso;4101804;Araucária;1;1;2;473
3118601;Contagem;4101804;Araucária;1;1;2;817
3132404;Itajubá;4101804;Araucária;1;1;2;525
3145455;Olhos-d'Água;4101804;Araucária;1;1;2;1070
3161809;São Gonçalo do Pará;4101804;Araucária;1;1;2;765
3170107;Uberaba;4101804;Araucária;1;1;2;663
3170206;Uberlândia;4101804;Araucária;1;1;2;749
3201308;Cariacica;4101804;Araucária;1;1;2;1062
3205002;Serra;4101804;Araucária;1;1;2;1080
3205101;Viana;4101804;Araucária;1;1;2;1042
3205309;Vitória;4101804;Araucária;1;1;2;1073
3301702;Duque de Caxias;4101804;Araucária;1;1;2;681
3305554;Seropédica;4101804;Araucária;1;1;2;647
3503208;Araraquara;4101804;Araucária;1;1;2;438
3509205;Cajamar;4101804;Araucária;1;1;2;352
3509254;Cajati;4101804;Araucária;1;1;2;160
3509502;Campinas;4101804;Araucária;1;1;2;378
3510609;Carapicuíba;4101804;Araucária;1;1;2;343
3512803;Cosmópolis;4101804;Araucária;1;1;2;393
3516200;Franca;4101804;Araucária;1;1;2;592
3519071;Hortolândia;4101804;Araucária;1;1;2;372
3521804;Itaí;4101804;Araucária;1;1;2;242
3523206;Itararé;4101804;Araucária;1;1;2;165
3527306;Louveira;4101804;Araucária;1;1;2;369
3531803;Monte Mor;4101804;Araucária;1;1;2;358
3534708;Ourinhos;4101804;Araucária;1;1;2;293
3538006;Pindamonhangaba;4101804;Araucária;1;1;2;490
3542602;Registro;4101804;Araucária;1;1;2;193
3545209;Salto;4101804;Araucária;1;1;2;338
3548500;Santos;4101804;Araucária;1;1;2;357
3548708;São Bernardo do Campo;4101804;Araucária;1;1;2;349
3548807;São Caetano do Sul;4101804;Araucária;1;1;2;357
3549805;São José do Rio Preto;4101804;Araucária;1;1;2;527
3550209;São Miguel Arcanjo;4101804;Araucária;1;1;2;236
3552809;Taboão da Serra;4101804;Araucária;1;1;2;342
3556503;Várzea Paulista;4101804;Araucária;1;1;2;367
4100400;Almirante Tamandaré;4101804;Araucária;1;1;2;30
4101606;Arapoti;4101804;Araucária;1;1;2;164
3534401;Osasco;4101705;Araruna;1;1;2;582
2704302;Maceió;4101606;Arapoti;1;1;2;2114
3136702;Juiz de Fora;4101606;Arapoti;1;1;2;706
3162104;São Gotardo;4101606;Arapoti;1;1;2;657
3515186;Espírito Santo do Pinhal;4101606;Arapoti;1;1;2;380
3516200;Franca;4101606;Arapoti;1;1;2;468
3527603;Luís Antônio;4101606;Arapoti;1;1;2;359
3534401;Osasco;4101606;Arapoti;1;1;2;315
3537909;Pilar do Sul;4101606;Arapoti;1;1;2;218
3553856;Taquarivaí;4101606;Arapoti;1;1;2;118
1100098;Espigão d'Oeste;4101507;Arapongas;1;1;2;1620
1100106;Guajará-Mirim;4101507;Arapongas;1;1;2;1956
1100155;Ouro Preto do Oeste;4101507;Arapongas;1;1;2;1764
1100189;Pimenta Bueno;4101507;Arapongas;1;1;2;1618
1100254;Presidente Médici;4101507;Arapongas;1;1;2;1702
1100288;Rolim de Moura;4101507;Arapongas;1;1;2;1637
1200013;Acrelândia;4101507;Arapongas;1;1;2;2138
1200104;Brasiléia;4101507;Arapongas;1;1;2;2192
1200252;Epitaciolândia;4101507;Arapongas;1;1;2;2185
1200385;Plácido de Castro;4101507;Arapongas;1;1;2;2124
1200450;Senador Guiomard;4101507;Arapongas;1;1;2;2176
2611606;Recife;4101507;Arapongas;1;1;2;2343
2614709;Tacaimbó;4101507;Arapongas;1;1;2;2237
2910800;Feira de Santana;4101507;Arapongas;1;1;2;1743
3106200;Belo Horizonte;4101507;Arapongas;1;1;2;848
3157807;Santa Luzia;4101507;Arapongas;1;1;2;866
3304300;Rio Bonito;4101507;Arapongas;1;1;2;902
3502101;Andradina;4101507;Arapongas;1;1;2;275
3509205;Cajamar;4101507;Arapongas;1;1;2;466
3509502;Campinas;4101507;Arapongas;1;1;2;451
3515004;Embu;4101507;Arapongas;1;1;2;470
3516200;Franca;4101507;Arapongas;1;1;2;517
3518800;Guarulhos;4101507;Arapongas;1;1;2;499
3519600;Ibitinga;4101507;Arapongas;1;1;2;322
3524303;Jaboticabal;4101507;Arapongas;1;1;2;398
3528403;Mairinque;4101507;Arapongas;1;1;2;436
3535507;Paraguaçu Paulista;4101507;Arapongas;1;1;2;139
3536505;Paulínia;4101507;Arapongas;1;1;2;443
3541505;Presidente Venceslau;4101507;Arapongas;1;1;2;179
3542206;Rancharia;4101507;Arapongas;1;1;2;142
3545209;Salto;4101507;Arapongas;1;1;2;425
3547809;Santo André;4101507;Arapongas;1;1;2;503
3549805;São José do Rio Preto;4101507;Arapongas;1;1;2;353
3552403;Sumaré;4101507;Arapongas;1;1;2;431
1100122;Ji-Paraná;4101408;Apucarana;1;1;2;1736
1501402;Belém;4101408;Apucarana;1;1;2;2471
2111300;São Luís;4101408;Apucarana;1;1;2;2430
2211001;Teresina;4101408;Apucarana;1;1;2;2211
2408102;Natal;4101408;Apucarana;1;1;2;2522
2607901;Jaboatão dos Guararapes;4101408;Apucarana;1;1;2;2347
2911105;Formosa do Rio Preto;4101408;Apucarana;1;1;2;1518
2927408;Salvador;4101408;Apucarana;1;1;2;1737
3170206;Uberlândia;4101408;Apucarana;1;1;2;607
3201209;Cachoeiro de Itapemirim;4101408;Apucarana;1;1;2;1091
3205200;Vila Velha;4101408;Apucarana;1;1;2;1175
3301009;Campos dos Goytacazes;4101408;Apucarana;1;1;2;1047
3304904;São Gonçalo;4101408;Apucarana;1;1;2;858
3512407;Cordeirópolis;4101408;Apucarana;1;1;2;423
3513702;Descalvado;4101408;Apucarana;1;1;2;430
3515004;Embu;4101408;Apucarana;1;1;2;470
3516200;Franca;4101408;Apucarana;1;1;2;528
3524006;Itupeva;4101408;Apucarana;1;1;2;450
3524303;Jaboticabal;4101408;Apucarana;1;1;2;408
3527108;Lins;4101408;Apucarana;1;1;2;268
3534401;Osasco;4101408;Apucarana;1;1;2;476
3534708;Ourinhos;4101408;Apucarana;1;1;2;171
3545803;Santa Bárbara d'Oeste;4101408;Apucarana;1;1;2;421
3546405;Santa Cruz do Rio Pardo;4101408;Apucarana;1;1;2;199
3548500;Santos;4101408;Apucarana;1;1;2;523
3548807;São Caetano do Sul;4101408;Apucarana;1;1;2;499
3549805;São José do Rio Preto;4101408;Apucarana;1;1;2;367
3552403;Sumaré;4101408;Apucarana;1;1;2;434
1501303;Barcarena;4101200;Antonina;1;1;2;2640
3128303;Guaranésia;4101200;Antonina;1;1;2;490
3530607;Moji das Cruzes;4101200;Antonina;1;1;2;323
3534401;Osasco;4101200;Antonina;1;1;2;281
3548807;São Caetano do Sul;4101200;Antonina;1;1;2;291
3550308;São Paulo;4101200;Antonina;1;1;2;282
3556701;Vinhedo;4101200;Antonina;1;1;2;313
3510005;Cândido Mota;4101101;Andirá;1;1;2;37
3516200;Franca;4101101;Andirá;1;1;2;399
3534401;Osasco;4101101;Andirá;1;1;2;357
3534906;Pacaembu;4101101;Andirá;1;1;2;196
3545407;Salto Grande;4101101;Andirá;1;1;2;30
2605202;Escada;4101002;Ampére;1;1;2;2609
2610707;Paulista;4101002;Ampére;1;1;2;2664
3504107;Atibaia;4101002;Ampére;1;1;2;753
3505807;Bastos;4101002;Ampére;1;1;2;518
3534401;Osasco;4101002;Ampére;1;1;2;714
3541406;Presidente Prudente;4101002;Ampére;1;1;2;466
3550308;São Paulo;4101002;Ampére;1;1;2;722
1100403;Alto Paraíso;4100806;Alvorada do Sul;1;1;2;1876
1721000;Palmas;4100806;Alvorada do Sul;1;1;2;1403
2211001;Teresina;4100806;Alvorada do Sul;1;1;2;2126
2408102;Natal;4100806;Alvorada do Sul;1;1;2;2450
2611606;Recife;4100806;Alvorada do Sul;1;1;2;2287
3106200;Belo Horizonte;4100806;Alvorada do Sul;1;1;2;803
3122306;Divinópolis;4100806;Alvorada do Sul;1;1;2;708
3205309;Vitória;4100806;Alvorada do Sul;1;1;2;1147
3541406;Presidente Prudente;4100806;Alvorada do Sul;1;1;2;74
3534401;Osasco;4100707;Alto Piquiri;1;1;2;678
3550308;São Paulo;4100707;Alto Piquiri;1;1;2;691
3502804;Araçatuba;4100608;Alto Paraná;1;1;2;283
3534401;Osasco;4100608;Alto Paraná;1;1;2;569
3539202;Pirapozinho;4100608;Alto Paraná;1;1;2;126
3505807;Bastos;4100509;Altônia;1;1;2;386
3534401;Osasco;4100509;Altônia;1;1;2;723
2604106;Caruaru;4100400;Almirante Tamandaré;1;1;2;2279
2612208;Salgueiro;4100400;Almirante Tamandaré;1;1;2;2138
2919207;Lauro de Freitas;4100400;Almirante Tamandaré;1;1;2;1740
3503703;Ariranha;4100400;Almirante Tamandaré;1;1;2;461
3505708;Barueri;4100400;Almirante Tamandaré;1;1;2;316
3524709;Jaguariúna;4100400;Almirante Tamandaré;1;1;2;371
3534401;Osasco;4100400;Almirante Tamandaré;1;1;2;321
3552106;Socorro;4100400;Almirante Tamandaré;1;1;2;410
3550308;São Paulo;4100301;Agudos do Sul;1;1;2;372
3171204;Vespasiano;4100202;Adrianópolis;1;1;2;747
3502705;Apiaí;4100202;Adrianópolis;1;1;2;24
3550308;São Paulo;4100103;Abatiá;1;1;2;377
3109402;Buritizeiro;3557303;Estiva Gerbi;1;1;2;576
3134905;Jacutinga;3557303;Estiva Gerbi;1;1;2;36
3304557;Rio de Janeiro;3557303;Estiva Gerbi;1;1;2;388
3509502;Campinas;3557303;Estiva Gerbi;1;1;2;74
3524709;Jaguariúna;3557303;Estiva Gerbi;1;1;2;52
3534401;Osasco;3557303;Estiva Gerbi;1;1;2;144
3537107;Pedreira;3557303;Estiva Gerbi;1;1;2;56
3552502;Suzano;3557303;Estiva Gerbi;1;1;2;159
3553302;Tambaú;3557303;Estiva Gerbi;1;1;2;68
3506805;Bocaina;3557204;Chavantes;1;1;2;157
3510153;Canitar;3557204;Chavantes;1;1;2;8
3515400;Fartura;3557204;Chavantes;1;1;2;44
3528601;Manduri;3557204;Chavantes;1;1;2;40
3534401;Osasco;3557204;Chavantes;1;1;2;305
3545407;Salto Grande;3557204;Chavantes;1;1;2;33
3547809;Santo André;3557204;Chavantes;1;1;2;333
3508108;Buritama;3557154;Zacarias;1;1;2;10
3531407;Monte Aprazível;3557154;Zacarias;1;1;2;47
3550308;São Paulo;3557154;Zacarias;1;1;2;458
3170404;Unaí;3557105;Votuporanga;1;1;2;548
3302205;Itaperuna;3557105;Votuporanga;1;1;2;851
3304557;Rio de Janeiro;3557105;Votuporanga;1;1;2;757
3502101;Andradina;3557105;Votuporanga;1;1;2;158
3502804;Araçatuba;3557105;Votuporanga;1;1;2;100
3503208;Araraquara;3557105;Votuporanga;1;1;2;241
3504107;Atibaia;3557105;Votuporanga;1;1;2;468
3504602;Bady Bassitt;3557105;Votuporanga;1;1;2;77
3505708;Barueri;3557105;Votuporanga;1;1;2;472
3506003;Bauru;3557105;Votuporanga;1;1;2;231
3508108;Buritama;3557105;Votuporanga;1;1;2;71
3510500;Caraguatatuba;3557105;Votuporanga;1;1;2;592
3516200;Franca;3557105;Votuporanga;1;1;2;269
3518404;Guaratinguetá;3557105;Votuporanga;1;1;2;571
3519808;Icém;3557105;Votuporanga;1;1;2;83
3523008;Itapura;3557105;Votuporanga;1;1;2;161
3527108;Lins;3557105;Votuporanga;1;1;2;139
3528106;Macaubal;3557105;Votuporanga;1;1;2;40
3529401;Mauá;3557105;Votuporanga;1;1;2;516
3531407;Monte Aprazível;3557105;Votuporanga;1;1;2;46
3532108;Murutinga do Sul;3557105;Votuporanga;1;1;2;148
3533007;Nova Granada;3557105;Votuporanga;1;1;2;71
3534203;Orindiúva;3557105;Votuporanga;1;1;2;72
3535002;Palestina;3557105;Votuporanga;1;1;2;53
3536901;Pedranópolis;3557105;Votuporanga;1;1;2;29
3541406;Presidente Prudente;3557105;Votuporanga;1;1;2;239
3541604;Promissão;3557105;Votuporanga;1;1;2;122
3548906;São Carlos;3557105;Votuporanga;1;1;2;281
3553401;Tanabi;3557105;Votuporanga;1;1;2;41
3554904;Três Fronteiras;3557105;Votuporanga;1;1;2;97
3556206;Valinhos;3557105;Votuporanga;1;1;2;421
1302603;Manaus;3557006;Votorantim;1;1;2;2572
2611606;Recife;3557006;Votorantim;1;1;2;2097
3304557;Rio de Janeiro;3557006;Votorantim;1;1;2;427
3501608;Americana;3557006;Votorantim;1;1;2;87
3503208;Araraquara;3557006;Votorantim;1;1;2;208
3503901;Arujá;3557006;Votorantim;1;1;2;110
3506003;Bauru;3557006;Votorantim;1;1;2;216
3508504;Caçapava;3557006;Votorantim;1;1;2;178
3509601;Campo Limpo Paulista;3557006;Votorantim;1;1;2;72
3509700;Campos do Jordão;3557006;Votorantim;1;1;2;206
3510203;Capão Bonito;3557006;Votorantim;1;1;2;111
3510302;Capela do Alto;3557006;Votorantim;1;1;2;35
3517604;Guapiara;3557006;Votorantim;1;1;2;137
3519709;Ibiúna;3557006;Votorantim;1;1;2;23
3522406;Itapeva;3557006;Votorantim;1;1;2;161
3523909;Itu;3557006;Votorantim;1;1;2;29
3524402;Jacareí;3557006;Votorantim;1;1;2;150
3524709;Jaguariúna;3557006;Votorantim;1;1;2;100
3525508;Joanópolis;3557006;Votorantim;1;1;2;132
3526407;Laranjal Paulista;3557006;Votorantim;1;1;2;69
3528403;Mairinque;3557006;Votorantim;1;1;2;22
3537909;Pilar do Sul;3557006;Votorantim;1;1;2;46
3538709;Piracicaba;3557006;Votorantim;1;1;2;89
3545308;Salto de Pirapora;3557006;Votorantim;1;1;2;23
3548708;São Bernardo do Campo;3557006;Votorantim;1;1;2;86
3552502;Suzano;3557006;Votorantim;1;1;2;111
3554508;Tietê;3557006;Votorantim;1;1;2;57
3545605;Santa Adélia;3556958;Vitória Brasil;1;1;2;214
3509304;Cajobi;3556909;Vista Alegre do Alto;1;1;2;37
3510104;Cândido Rodrigues;3556909;Vista Alegre do Alto;1;1;2;17
3512001;Colina;3556909;Vista Alegre do Alto;1;1;2;52
3514957;Embaúba;3556909;Vista Alegre do Alto;1;1;2;33
3515608;Fernando Prestes;3556909;Vista Alegre do Alto;1;1;2;12
3522703;Itápolis;3556909;Vista Alegre do Alto;1;1;2;51
3531506;Monte Azul Paulista;3556909;Vista Alegre do Alto;1;1;2;29
3533502;Novo Horizonte;3556909;Vista Alegre do Alto;1;1;2;70
3535101;Palmares Paulista;3556909;Vista Alegre do Alto;1;1;2;23
3535705;Paraíso;3556909;Vista Alegre do Alto;1;1;2;23
3538105;Pindorama;3556909;Vista Alegre do Alto;1;1;2;29
3539004;Pirangi;3556909;Vista Alegre do Alto;1;1;2;9
3549805;São José do Rio Preto;3556909;Vista Alegre do Alto;1;1;2;88
3553104;Taiaçu;3556909;Vista Alegre do Alto;1;1;2;12
3553708;Taquaritinga;3556909;Vista Alegre do Alto;1;1;2;31
3104007;Araxá;3556800;Viradouro;1;1;2;200
3127107;Frutal;3556800;Viradouro;1;1;2;110
3505906;Batatais;3556800;Viradouro;1;1;2;71
3509502;Campinas;3556800;Viradouro;1;1;2;259
3512001;Colina;3556800;Viradouro;1;1;2;31
3517406;Guaíra;3556800;Viradouro;1;1;2;61
3534401;Osasco;3556800;Viradouro;1;1;2;334
3550308;São Paulo;3556800;Viradouro;1;1;2;353
1302603;Manaus;3556701;Vinhedo;1;1;2;2548
2611606;Recife;3556701;Vinhedo;1;1;2;2032
2611705;Riacho das Almas;3556701;Vinhedo;1;1;2;1978
3125101;Extrema;3556701;Vinhedo;1;1;2;70
3132404;Itajubá;3556701;Vinhedo;1;1;2;168
3162922;São Joaquim de Bicas;3556701;Vinhedo;1;1;2;429
3170206;Uberlândia;3556701;Vinhedo;1;1;2;475
3170701;Varginha;3556701;Vinhedo;1;1;2;233
3205200;Vila Velha;3556701;Vinhedo;1;1;2;734
3302908;Miguel Pereira;3556701;Vinhedo;1;1;2;364
3304144;Queimados;3556701;Vinhedo;1;1;2;349
3501608;Americana;3556701;Vinhedo;1;1;2;49
3503208;Araraquara;3556701;Vinhedo;1;1;2;184
3503802;Artur Nogueira;3556701;Vinhedo;1;1;2;55
3506508;Birigui;3556701;Vinhedo;1;1;2;393
3507001;Boituva;3556701;Vinhedo;1;1;2;77
3508405;Cabreúva;3556701;Vinhedo;1;1;2;35
3509205;Cajamar;3556701;Vinhedo;1;1;2;37
3513009;Cotia;3556701;Vinhedo;1;1;2;64
3522505;Itapevi;3556701;Vinhedo;1;1;2;57
3525003;Jandira;3556701;Vinhedo;1;1;2;56
3526803;Lençóis Paulista;3556701;Vinhedo;1;1;2;195
3526902;Limeira;3556701;Vinhedo;1;1;2;67
3529005;Marília;3556701;Vinhedo;1;1;2;317
3530607;Moji das Cruzes;3556701;Vinhedo;1;1;2;99
3530805;Moji-Mirim;3556701;Vinhedo;1;1;2;67
3536505;Paulínia;3556701;Vinhedo;1;1;2;35
3538709;Piracicaba;3556701;Vinhedo;1;1;2;75
3541406;Presidente Prudente;3556701;Vinhedo;1;1;2;462
3545803;Santa Bárbara d'Oeste;3556701;Vinhedo;1;1;2;54
3547007;Santa Maria da Serra;3556701;Vinhedo;1;1;2;132
3549706;São José do Rio Pardo;3556701;Vinhedo;1;1;2;159
3549805;São José do Rio Preto;3556701;Vinhedo;1;1;2;347
3549904;São José dos Campos;3556701;Vinhedo;1;1;2;113
3552403;Sumaré;3556701;Vinhedo;1;1;2;38
3552809;Taboão da Serra;3556701;Vinhedo;1;1;2;66
3554508;Tietê;3556701;Vinhedo;1;1;2;76
3556453;Vargem Grande Paulista;3556701;Vinhedo;1;1;2;64
3525805;Júlio Mesquita;3556602;Vera Cruz;1;1;2;24
3527801;Lupércio;3556602;Vera Cruz;1;1;2;22
3534401;Osasco;3556602;Vera Cruz;1;1;2;346
3551702;Sertãozinho;3556602;Vera Cruz;1;1;2;223
1302603;Manaus;3556503;Várzea Paulista;1;1;2;2571
1501402;Belém;3556503;Várzea Paulista;1;1;2;2420
2611606;Recife;3556503;Várzea Paulista;1;1;2;2039
2804003;Maruim;3556503;Várzea Paulista;1;1;2;1684
2805901;Riachuelo;3556503;Várzea Paulista;1;1;2;1678
2906501;Candeias;3556503;Várzea Paulista;1;1;2;1427
2910727;Eunápolis;3556503;Várzea Paulista;1;1;2;1048
2927408;Salvador;3556503;Várzea Paulista;1;1;2;1403
3104205;Arcos;3556503;Várzea Paulista;1;1;2;348
3106200;Belo Horizonte;3556503;Várzea Paulista;1;1;2;466
3152501;Pouso Alegre;3556503;Várzea Paulista;1;1;2;142
3170107;Uberaba;3556503;Várzea Paulista;1;1;2;400
3205002;Serra;3556503;Várzea Paulista;1;1;2;743
3302403;Macaé;3556503;Várzea Paulista;1;1;2;512
3303609;Paracambi;3556503;Várzea Paulista;1;1;2;326
3501608;Americana;3556503;Várzea Paulista;1;1;2;74
3505708;Barueri;3556503;Várzea Paulista;1;1;2;34
3507506;Botucatu;3556503;Várzea Paulista;1;1;2;169
3507605;Bragança Paulista;3556503;Várzea Paulista;1;1;2;41
3508405;Cabreúva;3556503;Várzea Paulista;1;1;2;33
3509007;Caieiras;3556503;Várzea Paulista;1;1;2;19
3509205;Cajamar;3556503;Várzea Paulista;1;1;2;17
3516408;Franco da Rocha;3556503;Várzea Paulista;1;1;2;16
3548708;São Bernardo do Campo;3556503;Várzea Paulista;1;1;2;61
3549904;São José dos Campos;3556503;Várzea Paulista;1;1;2;97
3552403;Sumaré;3556503;Várzea Paulista;1;1;2;62
2910800;Feira de Santana;3556453;Vargem Grande Paulista;1;1;2;1484
2927408;Salvador;3556453;Vargem Grande Paulista;1;1;2;1447
3118601;Contagem;3556453;Vargem Grande Paulista;1;1;2;504
3151800;Poços de Caldas;3556453;Vargem Grande Paulista;1;1;2;209
3506003;Bauru;3556453;Vargem Grande Paulista;1;1;2;251
3522505;Itapevi;3556453;Vargem Grande Paulista;1;1;2;11
3525003;Jandira;3556453;Vargem Grande Paulista;1;1;2;15
3530706;Mogi Guaçu;3556453;Vargem Grande Paulista;1;1;2;142
3537800;Piedade;3556453;Vargem Grande Paulista;1;1;2;43
3543402;Ribeirão Preto;3556453;Vargem Grande Paulista;1;1;2;282
3545209;Salto;3556453;Vargem Grande Paulista;1;1;2;52
3548807;São Caetano do Sul;3556453;Vargem Grande Paulista;1;1;2;47
3102605;Andradas;3556404;Vargem Grande do Sul;1;1;2;43
3104007;Araxá;3556404;Vargem Grande do Sul;1;1;2;249
3131505;Ipuiúna;3556404;Vargem Grande do Sul;1;1;2;79
3156908;Sacramento;3556404;Vargem Grande do Sul;1;1;2;226
3500303;Aguaí;3556404;Vargem Grande do Sul;1;1;2;27
3501608;Americana;3556404;Vargem Grande do Sul;1;1;2;111
3502101;Andradina;3556404;Vargem Grande do Sul;1;1;2;475
3514908;Elias Fausto;3556404;Vargem Grande do Sul;1;1;2;143
3522307;Itapetininga;3556404;Vargem Grande do Sul;1;1;2;228
3523800;Itobi;3556404;Vargem Grande do Sul;1;1;2;13
3523909;Itu;3556404;Vargem Grande do Sul;1;1;2;166
3525300;Jaú;3556404;Vargem Grande do Sul;1;1;2;181
3526902;Limeira;3556404;Vargem Grande do Sul;1;1;2;96
3530805;Moji-Mirim;3556404;Vargem Grande do Sul;1;1;2;67
3543402;Ribeirão Preto;3556404;Vargem Grande do Sul;1;1;2;120
3545209;Salto;3556404;Vargem Grande do Sul;1;1;2;157
3548104;Santo Antônio do Jardim;3556404;Vargem Grande do Sul;1;1;2;38
3550704;São Sebastião;3556404;Vargem Grande do Sul;1;1;2;261
3552205;Sorocaba;3556404;Vargem Grande do Sul;1;1;2;193
3553302;Tambaú;3556404;Vargem Grande do Sul;1;1;2;42
3553609;Tapiratiba;3556404;Vargem Grande do Sul;1;1;2;43
3107109;Boa Esperança;3556354;Vargem;1;1;2;217
3110608;Cambuí;3556354;Vargem;1;1;2;46
3505708;Barueri;3556354;Vargem;1;1;2;84
3507605;Bragança Paulista;3556354;Vargem;1;1;2;16
2909406;Cotegipe;3556305;Valparaíso;1;1;2;1218
3106200;Belo Horizonte;3556305;Valparaíso;1;1;2;727
3509502;Campinas;3556305;Valparaíso;1;1;2;439
3512506;Coroados;3556305;Valparaíso;1;1;2;62
3517802;Guaraçaí;3556305;Valparaíso;1;1;2;42
3524105;Ituverava;3556305;Valparaíso;1;1;2;330
3526407;Laranjal Paulista;3556305;Valparaíso;1;1;2;375
3526506;Lavínia;3556305;Valparaíso;1;1;2;19
3534401;Osasco;3556305;Valparaíso;1;1;2;497
3534609;Osvaldo Cruz;3556305;Valparaíso;1;1;2;63
3537701;Piacatu;3556305;Valparaíso;1;1;2;49
3541703;Quatá;3556305;Valparaíso;1;1;2;114
1302603;Manaus;3556206;Valinhos;1;1;2;2542
2211001;Teresina;3556206;Valinhos;1;1;2;2021
2303709;Caucaia;3556206;Valinhos;1;1;2;2280
2607901;Jaboatão dos Guararapes;3556206;Valinhos;1;1;2;2023
2611101;Petrolina;3556206;Valinhos;1;1;2;1641
2611606;Recife;3556206;Valinhos;1;1;2;2029
2704302;Maceió;3556206;Valinhos;1;1;2;1848
2706703;Penedo;3556206;Valinhos;1;1;2;1745
2910057;Dias d'Ávila;3556206;Valinhos;1;1;2;1436
2910800;Feira de Santana;3556206;Valinhos;1;1;2;1426
2919207;Lauro de Freitas;3556206;Valinhos;1;1;2;1411
3104007;Araxá;3556206;Valinhos;1;1;2;375
3116407;Claraval;3556206;Valinhos;1;1;2;286
3118601;Contagem;3556206;Valinhos;1;1;2;449
3126109;Formiga;3556206;Valinhos;1;1;2;320
3143302;Montes Claros;3556206;Valinhos;1;1;2;759
3147907;Passos;3556206;Valinhos;1;1;2;254
3205002;Serra;3556206;Valinhos;1;1;2;749
3205309;Vitória;3556206;Valinhos;1;1;2;743
3304201;Resende;3556206;Valinhos;1;1;2;265
3304904;São Gonçalo;3556206;Valinhos;1;1;2;403
3306008;Três Rios;3556206;Valinhos;1;1;2;397
3503307;Araras;3556206;Valinhos;1;1;2;78
3503802;Artur Nogueira;3556206;Valinhos;1;1;2;48
3507605;Bragança Paulista;3556206;Valinhos;1;1;2;45
3509700;Campos do Jordão;3556206;Valinhos;1;1;2;148
3511508;Cerquilho;3556206;Valinhos;1;1;2;80
3512803;Cosmópolis;3556206;Valinhos;1;1;2;41
3515202;Estrela d'Oeste;3556206;Valinhos;1;1;2;456
3516200;Franca;3556206;Valinhos;1;1;2;272
3518206;Guararapes;3556206;Valinhos;1;1;2;417
3518404;Guaratinguetá;3556206;Valinhos;1;1;2;188
3522208;Itapecerica da Serra;3556206;Valinhos;1;1;2;84
3522307;Itapetininga;3556206;Valinhos;1;1;2;128
3522604;Itapira;3556206;Valinhos;1;1;2;62
3523909;Itu;3556206;Valinhos;1;1;2;46
3524402;Jacareí;3556206;Valinhos;1;1;2;114
3524709;Jaguariúna;3556206;Valinhos;1;1;2;29
3526704;Leme;3556206;Valinhos;1;1;2;96
3527009;Lindóia;3556206;Valinhos;1;1;2;61
3530706;Mogi Guaçu;3556206;Valinhos;1;1;2;71
3531803;Monte Mor;3556206;Valinhos;1;1;2;33
3539301;Pirassununga;3556206;Valinhos;1;1;2;116
3541000;Praia Grande;3556206;Valinhos;1;1;2;130
3543907;Rio Claro;3556206;Valinhos;1;1;2;85
3547304;Santana de Parnaíba;3556206;Valinhos;1;1;2;53
3548906;São Carlos;3556206;Valinhos;1;1;2;139
3549102;São João da Boa Vista;3556206;Valinhos;1;1;2;113
3549805;São José do Rio Preto;3556206;Valinhos;1;1;2;341
3514924;Elisiário;3556107;Valentim Gentil;1;1;2;134
3515202;Estrela d'Oeste;3556107;Valentim Gentil;1;1;2;33
3516903;General Salgado;3556107;Valentim Gentil;1;1;2;37
3534401;Osasco;3556107;Valentim Gentil;1;1;2;492
3543402;Ribeirão Preto;3556107;Valentim Gentil;1;1;2;256
3551306;Sebastianópolis do Sul;3556107;Valentim Gentil;1;1;2;33
3104007;Araxá;3556008;Urupês;1;1;2;301
3503208;Araraquara;3556008;Urupês;1;1;2;133
3506102;Bebedouro;3556008;Urupês;1;1;2;83
3519402;Ibirá;3556008;Urupês;1;1;2;14
3521903;Itajobi;3556008;Urupês;1;1;2;28
3530300;Mirassol;3556008;Urupês;1;1;2;49
3531407;Monte Aprazível;3556008;Urupês;1;1;2;65
3533908;Olímpia;3556008;Urupês;1;1;2;64
3534401;Osasco;3556008;Urupês;1;1;2;368
3540804;Potirendaba;3556008;Urupês;1;1;2;20
3505906;Batatais;3555901;Uru;1;1;2;200
3524303;Jaboticabal;3555901;Uru;1;1;2;118
3528858;Marapoama;3555901;Uru;1;1;2;60
3513801;Diadema;3555802;Urânia;1;1;2;573
3532603;Nhandeara;3555802;Urânia;1;1;2;82
3537404;Pereira Barreto;3555802;Urânia;1;1;2;60
3549805;São José do Rio Preto;3555703;União Paulista;1;1;2;52
3550308;São Paulo;3555703;União Paulista;1;1;2;458
3503703;Ariranha;3555604;Uchoa;1;1;2;48
3534401;Osasco;3555604;Uchoa;1;1;2;380
3501509;Alvinlândia;3555505;Ubirajara;1;1;2;14
3514502;Duartina;3555505;Ubirajara;1;1;2;29
3550308;São Paulo;3555505;Ubirajara;1;1;2;335
3550506;São Pedro do Turvo;3555505;Ubirajara;1;1;2;26
3554706;Torrinha;3555505;Ubirajara;1;1;2;154
2304400;Fortaleza;3555406;Ubatuba;1;1;2;2265
3106200;Belo Horizonte;3555406;Ubatuba;1;1;2;405
3163706;São Lourenço;3555406;Ubatuba;1;1;2;142
3504503;Avaré;3555406;Ubatuba;1;1;2;390
3505708;Barueri;3555406;Ubatuba;1;1;2;179
3506359;Bertioga;3555406;Ubatuba;1;1;2;115
3516200;Franca;3555406;Ubatuba;1;1;2;392
3518701;Guarujá;3555406;Ubatuba;1;1;2;133
3518800;Guarulhos;3555406;Ubatuba;1;1;2;147
3534401;Osasco;3555406;Ubatuba;1;1;2;171
3542602;Registro;3555406;Ubatuba;1;1;2;308
3543402;Ribeirão Preto;3555406;Ubatuba;1;1;2;368
3545209;Salto;3555406;Ubatuba;1;1;2;222
3547304;Santana de Parnaíba;3555406;Ubatuba;1;1;2;183
3550407;São Pedro;3555406;Ubatuba;1;1;2;299
3550704;São Sebastião;3555406;Ubatuba;1;1;2;50
3552502;Suzano;3555406;Ubatuba;1;1;2;122
3554805;Tremembé;3555406;Ubatuba;1;1;2;65
3506102;Bebedouro;3555356;Ubarana;1;1;2;125
3532801;Nova Aliança;3555356;Ubarana;1;1;2;28
3534005;Onda Verde;3555356;Ubarana;1;1;2;76
3549003;São Francisco;3555307;Turmalina;1;1;2;39
3550308;São Paulo;3555307;Turmalina;1;1;2;569
3551306;Sebastianópolis do Sul;3555307;Turmalina;1;1;2;89
3507753;Brejo Alegre;3555208;Turiúba;1;1;2;28
3508108;Buritama;3555208;Turiúba;1;1;2;15
3529302;Matão;3555208;Turiúba;1;1;2;193
3550308;São Paulo;3555208;Turiúba;1;1;2;472
1100122;Ji-Paraná;3555109;Tupi Paulista;1;1;2;1556
3502101;Andradina;3555109;Tupi Paulista;1;1;2;53
3526902;Limeira;3555109;Tupi Paulista;1;1;2;454
3534401;Osasco;3555109;Tupi Paulista;1;1;2;553
3534807;Ouro Verde;3555109;Tupi Paulista;1;1;2;20
3551504;Serrana;3555109;Tupi Paulista;1;1;2;412
3106200;Belo Horizonte;3555000;Tupã;1;1;2;711
3170206;Uberlândia;3555000;Tupã;1;1;2;409
3501608;Americana;3555000;Tupã;1;1;2;344
3503208;Araraquara;3555000;Tupã;1;1;2;246
3506409;Bilac;3555000;Tupã;1;1;2;59
3512506;Coroados;3555000;Tupã;1;1;2;70
3515202;Estrela d'Oeste;3555000;Tupã;1;1;2;183
3516200;Franca;3555000;Tupã;1;1;2;358
3516507;Gabriel Monteiro;3555000;Tupã;1;1;2;45
3518800;Guarulhos;3555000;Tupã;1;1;2;446
3519204;Iacri;3555000;Tupã;1;1;2;17
3519600;Ibitinga;3555000;Tupã;1;1;2;177
3524808;Jales;3555000;Tupã;1;1;2;184
3525300;Jaú;3555000;Tupã;1;1;2;207
3525706;José Bonifácio;3555000;Tupã;1;1;2;132
3526803;Lençóis Paulista;3555000;Tupã;1;1;2;193
3527108;Lins;3555000;Tupã;1;1;2;84
3527405;Lucélia;3555000;Tupã;1;1;2;54
3529302;Matão;3555000;Tupã;1;1;2;225
3530805;Moji-Mirim;3555000;Tupã;1;1;2;374
3534708;Ourinhos;3555000;Tupã;1;1;2;134
3536406;Paulicéia;3555000;Tupã;1;1;2;149
3540002;Pompéia;3555000;Tupã;1;1;2;43
3541802;Queiroz;3555000;Tupã;1;1;2;35
3542206;Rancharia;3555000;Tupã;1;1;2;48
3547809;Santo André;3555000;Tupã;1;1;2;458
3549805;São José do Rio Preto;3555000;Tupã;1;1;2;171
1302603;Manaus;3554953;Tuiuti;1;1;2;2543
3504107;Atibaia;3554953;Tuiuti;1;1;2;36
3507605;Bragança Paulista;3554953;Tuiuti;1;1;2;20
3522307;Itapetininga;3554953;Tuiuti;1;1;2;163
3524709;Jaguariúna;3554953;Tuiuti;1;1;2;32
3530508;Mococa;3554953;Tuiuti;1;1;2;153
3536802;Pedra Bela;3554953;Tuiuti;1;1;2;26
3549706;São José do Rio Pardo;3554953;Tuiuti;1;1;2;137
3504008;Assis;3554904;Três Fronteiras;1;1;2;273
3519808;Icém;3554904;Três Fronteiras;1;1;2;178
3523008;Itapura;3554904;Três Fronteiras;1;1;2;79
3529005;Marília;3554904;Três Fronteiras;1;1;2;241
3543808;Rinópolis;3554904;Três Fronteiras;1;1;2;166
3544202;Riolândia;3554904;Três Fronteiras;1;1;2;129
3152501;Pouso Alegre;3554805;Tremembé;1;1;2;92
3304557;Rio de Janeiro;3554805;Tremembé;1;1;2;235
3509957;Canas;3554805;Tremembé;1;1;2;58
3510500;Caraguatatuba;3554805;Tremembé;1;1;2;73
3518404;Guaratinguetá;3554805;Tremembé;1;1;2;42
3524402;Jacareí;3554805;Tremembé;1;1;2;57
3525904;Jundiaí;3554805;Tremembé;1;1;2;141
3527207;Lorena;3554805;Tremembé;1;1;2;54
3534401;Osasco;3554805;Tremembé;1;1;2;143
3536505;Paulínia;3554805;Tremembé;1;1;2;166
3545209;Salto;3554805;Tremembé;1;1;2;180
3552205;Sorocaba;3554805;Tremembé;1;1;2;209
3503208;Araraquara;3554755;Trabiju;1;1;2;33
3506805;Bocaina;3554755;Trabiju;1;1;2;21
3550308;São Paulo;3554755;Trabiju;1;1;2;250
3509502;Campinas;3554706;Torrinha;1;1;2;126
3511706;Charqueada;3554706;Torrinha;1;1;2;41
3525300;Jaú;3554706;Torrinha;1;1;2;45
3534401;Osasco;3554706;Torrinha;1;1;2;188
3547007;Santa Maria da Serra;3554706;Torrinha;1;1;2;16
3548906;São Carlos;3554706;Torrinha;1;1;2;53
3550308;São Paulo;3554656;Torre de Pedra;1;1;2;165
3554003;Tatuí;3554656;Torre de Pedra;1;1;2;37
3550308;São Paulo;3554607;Timburi;1;1;2;307
1302603;Manaus;3554508;Tietê;1;1;2;2519
1505536;Parauapebas;3554508;Tietê;1;1;2;1903
1721000;Palmas;3554508;Tietê;1;1;2;1412
2307650;Maracanaú;3554508;Tietê;1;1;2;2307
2507507;João Pessoa;3554508;Tietê;1;1;2;2168
2607901;Jaboatão dos Guararapes;3554508;Tietê;1;1;2;2076
2801504;Carmópolis;3554508;Tietê;1;1;2;1739
2928901;São Desidério;3554508;Tietê;1;1;2;1219
3140001;Mariana;3554508;Tietê;1;1;2;531
3205309;Vitória;3554508;Tietê;1;1;2;815
3301900;Itaboraí;3554508;Tietê;1;1;2;498
3304557;Rio de Janeiro;3554508;Tietê;1;1;2;456
3500105;Adamantina;3554508;Tietê;1;1;2;378
3500709;Agudos;3554508;Tietê;1;1;2;148
3501707;Américo Brasiliense;3554508;Tietê;1;1;2;158
3501905;Amparo;3554508;Tietê;1;1;2;107
3502200;Angatuba;3554508;Tietê;1;1;2;84
3502754;Araçariguama;3554508;Tietê;1;1;2;77
3503307;Araras;3554508;Tietê;1;1;2;89
3503604;Areiópolis;3554508;Tietê;1;1;2;108
3503802;Artur Nogueira;3554508;Tietê;1;1;2;81
3504503;Avaré;3554508;Tietê;1;1;2;125
3505203;Bariri;3554508;Tietê;1;1;2;155
3506003;Bauru;3554508;Tietê;1;1;2;163
3506508;Birigui;3554508;Tietê;1;1;2;333
3508405;Cabreúva;3554508;Tietê;1;1;2;64
3510203;Capão Bonito;3554508;Tietê;1;1;2;120
3511409;Cerqueira César;3554508;Tietê;1;1;2;149
3511706;Charqueada;3554508;Tietê;1;1;2;66
3512209;Conchal;3554508;Tietê;1;1;2;102
3512407;Cordeirópolis;3554508;Tietê;1;1;2;74
3512803;Cosmópolis;3554508;Tietê;1;1;2;73
3513009;Cotia;3554508;Tietê;1;1;2;99
3514403;Dracena;3554508;Tietê;1;1;2;428
3515400;Fartura;3554508;Tietê;1;1;2;187
3518206;Guararapes;3554508;Tietê;1;1;2;361
3519303;Ibaté;3554508;Tietê;1;1;2;130
3519600;Ibitinga;3554508;Tietê;1;1;2;188
3519709;Ibiúna;3554508;Tietê;1;1;2;79
3520509;Indaiatuba;3554508;Tietê;1;1;2;48
3521002;Iperó;3554508;Tietê;1;1;2;28
3521408;Iracemápolis;3554508;Tietê;1;1;2;61
3521804;Itaí;3554508;Tietê;1;1;2;145
3522406;Itapeva;3554508;Tietê;1;1;2;155
3522604;Itapira;3554508;Tietê;1;1;2;117
3523404;Itatiba;3554508;Tietê;1;1;2;90
3524709;Jaguariúna;3554508;Tietê;1;1;2;87
3525300;Jaú;3554508;Tietê;1;1;2;127
3526704;Leme;3554508;Tietê;1;1;2;106
3526803;Lençóis Paulista;3554508;Tietê;1;1;2;126
3526902;Limeira;3554508;Tietê;1;1;2;68
3528007;Macatuba;3554508;Tietê;1;1;2;122
3528403;Mairinque;3554508;Tietê;1;1;2;73
3529005;Marília;3554508;Tietê;1;1;2;248
3530508;Mococa;3554508;Tietê;1;1;2;193
3530706;Mogi Guaçu;3554508;Tietê;1;1;2;116
3530805;Moji-Mirim;3554508;Tietê;1;1;2;106
3531803;Monte Mor;3554508;Tietê;1;1;2;44
3533403;Nova Odessa;3554508;Tietê;1;1;2;56
3534401;Osasco;3554508;Tietê;1;1;2;106
3534609;Osvaldo Cruz;3554508;Tietê;1;1;2;354
3535507;Paraguaçu Paulista;3554508;Tietê;1;1;2;306
3536505;Paulínia;3554508;Tietê;1;1;2;69
3536703;Pederneiras;3554508;Tietê;1;1;2;136
3537107;Pedreira;3554508;Tietê;1;1;2;92
3537800;Piedade;3554508;Tietê;1;1;2;74
3537909;Pilar do Sul;3554508;Tietê;1;1;2;79
3538600;Piracaia;3554508;Tietê;1;1;2;139
3538808;Piraju;3554508;Tietê;1;1;2;171
3539103;Pirapora do Bom Jesus;3554508;Tietê;1;1;2;80
3539202;Pirapozinho;3554508;Tietê;1;1;2;397
3539301;Pirassununga;3554508;Tietê;1;1;2;124
3540002;Pompéia;3554508;Tietê;1;1;2;274
3540705;Porto Ferreira;3554508;Tietê;1;1;2;140
3541307;Presidente Epitácio;3554508;Tietê;1;1;2;471
3541406;Presidente Prudente;3554508;Tietê;1;1;2;391
3541505;Presidente Venceslau;3554508;Tietê;1;1;2;448
3542206;Rancharia;3554508;Tietê;1;1;2;339
3544004;Rio das Pedras;3554508;Tietê;1;1;2;31
3545159;Saltinho;3554508;Tietê;1;1;2;28
3545308;Salto de Pirapora;3554508;Tietê;1;1;2;62
3546306;Santa Cruz das Palmeiras;3554508;Tietê;1;1;2;149
3546405;Santa Cruz do Rio Pardo;3554508;Tietê;1;1;2;198
3547809;Santo André;3554508;Tietê;1;1;2;136
3548807;São Caetano do Sul;3554508;Tietê;1;1;2;131
3549805;São José do Rio Preto;3554508;Tietê;1;1;2;305
3550100;São Manuel;3554508;Tietê;1;1;2;97
3550209;São Miguel Arcanjo;3554508;Tietê;1;1;2;91
3550407;São Pedro;3554508;Tietê;1;1;2;65
3550605;São Roque;3554508;Tietê;1;1;2;76
3550704;São Sebastião;3554508;Tietê;1;1;2;245
3551603;Serra Negra;3554508;Tietê;1;1;2;117
3552106;Socorro;3554508;Tietê;1;1;2;134
3552403;Sumaré;3554508;Tietê;1;1;2;55
3553807;Taquarituba;3554508;Tietê;1;1;2;164
3104007;Araxá;3554409;Terra Roxa;1;1;2;196
3531506;Monte Azul Paulista;3554409;Terra Roxa;1;1;2;35
3534401;Osasco;3554409;Terra Roxa;1;1;2;344
3550308;São Paulo;3554409;Terra Roxa;1;1;2;363
2304400;Fortaleza;3554300;Teodoro Sampaio;1;1;2;2475
3117306;Conceição das Alagoas;3554300;Teodoro Sampaio;1;1;2;484
3156908;Sacramento;3554300;Teodoro Sampaio;1;1;2;568
3515301;Estrela do Norte;3554300;Teodoro Sampaio;1;1;2;55
3515350;Euclides da Cunha Paulista;3554300;Teodoro Sampaio;1;1;2;41
3519907;Iepê;3554300;Teodoro Sampaio;1;1;2;115
3534401;Osasco;3554300;Teodoro Sampaio;1;1;2;568
3541505;Presidente Venceslau;3554300;Teodoro Sampaio;1;1;2;83
3545506;Sandovalina;3554300;Teodoro Sampaio;1;1;2;45
1302603;Manaus;3554102;Taubaté;1;1;2;2617
1508100;Tucuruí;3554102;Taubaté;1;1;2;2167
2301000;Aquiraz;3554102;Taubaté;1;1;2;2227
2601904;Bezerros;3554102;Taubaté;1;1;2;1897
2607901;Jaboatão dos Guararapes;3554102;Taubaté;1;1;2;1947
2609600;Olinda;3554102;Taubaté;1;1;2;1965
2611606;Recife;3554102;Taubaté;1;1;2;1952
2704302;Maceió;3554102;Taubaté;1;1;2;1769
2910057;Dias d'Ávila;3554102;Taubaté;1;1;2;1359
2919553;Luís Eduardo magalhães;3554102;Taubaté;1;1;2;1206
2921005;Mata de São João;3554102;Taubaté;1;1;2;1366
3131703;Itabira;3554102;Taubaté;1;1;2;442
3136702;Juiz de Fora;3554102;Taubaté;1;1;2;268
3138203;Lavras;3554102;Taubaté;1;1;2;205
3152501;Pouso Alegre;3554102;Taubaté;1;1;2;95
3162922;São Joaquim de Bicas;3554102;Taubaté;1;1;2;353
3169307;Três Corações;3554102;Taubaté;1;1;2;152
3204906;São Mateus;3554102;Taubaté;1;1;2;743
3300308;Barra do Piraí;3554102;Taubaté;1;1;2;189
3300456;Belford Roxo;3554102;Taubaté;1;1;2;225
3302403;Macaé;3554102;Taubaté;1;1;2;383
3304110;Porto Real;3554102;Taubaté;1;1;2;145
3304201;Resende;3554102;Taubaté;1;1;2;127
3304904;São Gonçalo;3554102;Taubaté;1;1;2;259
3305406;Sapucaia;3554102;Taubaté;1;1;2;294
3503901;Arujá;3554102;Taubaté;1;1;2;88
3504909;Bananal;3554102;Taubaté;1;1;2;134
3506003;Bauru;3554102;Taubaté;1;1;2;365
3506359;Bertioga;3554102;Taubaté;1;1;2;109
3507506;Botucatu;3554102;Taubaté;1;1;2;293
3508603;Cachoeira Paulista;3554102;Taubaté;1;1;2;69
3509205;Cajamar;3554102;Taubaté;1;1;2;139
3516853;Gavião Peixoto;3554102;Taubaté;1;1;2;324
3520400;Ilhabela;3554102;Taubaté;1;1;2;89
3523909;Itu;3554102;Taubaté;1;1;2;179
3526308;Lagoinha;3554102;Taubaté;1;1;2;41
3526902;Limeira;3554102;Taubaté;1;1;2;192
3527306;Louveira;3554102;Taubaté;1;1;2;141
3530706;Mogi Guaçu;3554102;Taubaté;1;1;2;158
3536703;Pederneiras;3554102;Taubaté;1;1;2;334
3537305;Penápolis;3554102;Taubaté;1;1;2;489
3539806;Poá;3554102;Taubaté;1;1;2;98
3542305;Redenção da Serra;3554102;Taubaté;1;1;2;30
3545001;Salesópolis;3554102;Taubaté;1;1;2;65
3545209;Salto;3554102;Taubaté;1;1;2;176
3545803;Santa Bárbara d'Oeste;3554102;Taubaté;1;1;2;190
3549805;São José do Rio Preto;3554102;Taubaté;1;1;2;457
3550704;São Sebastião;3554102;Taubaté;1;1;2;85
3551009;São Vicente;3554102;Taubaté;1;1;2;139
1100304;Vilhena;3554003;Tatuí;1;1;2;1689
2611606;Recife;3554003;Tatuí;1;1;2;2109
3106200;Belo Horizonte;3554003;Tatuí;1;1;2;546
3118304;Conselheiro Lafaiete;3554003;Tatuí;1;1;2;505
3134202;Ituiutaba;3554003;Tatuí;1;1;2;511
3170107;Uberaba;3554003;Tatuí;1;1;2;399
3170701;Varginha;3554003;Tatuí;1;1;2;321
3201308;Cariacica;3554003;Tatuí;1;1;2;823
3301009;Campos dos Goytacazes;3554003;Tatuí;1;1;2;685
3304110;Porto Real;3554003;Tatuí;1;1;2;374
3304904;São Gonçalo;3554003;Tatuí;1;1;2;492
3503307;Araras;3554003;Tatuí;1;1;2;120
3504503;Avaré;3554003;Tatuí;1;1;2;114
3506003;Bauru;3554003;Tatuí;1;1;2;168
3507506;Botucatu;3554003;Tatuí;1;1;2;80
3513009;Cotia;3554003;Tatuí;1;1;2;99
3516200;Franca;3554003;Tatuí;1;1;2;314
3523206;Itararé;3554003;Tatuí;1;1;2;175
3523909;Itu;3554003;Tatuí;1;1;2;57
3524006;Itupeva;3554003;Tatuí;1;1;2;83
3525003;Jandira;3554003;Tatuí;1;1;2;99
3529401;Mauá;3554003;Tatuí;1;1;2;146
3535804;Paranapanema;3554003;Tatuí;1;1;2;94
3537909;Pilar do Sul;3554003;Tatuí;1;1;2;53
3540507;Porangaba;3554003;Tatuí;1;1;2;34
3540705;Porto Ferreira;3554003;Tatuí;1;1;2;170
3541653;Quadra;3554003;Tatuí;1;1;2;22
3543907;Rio Claro;3554003;Tatuí;1;1;2;108
3545803;Santa Bárbara d'Oeste;3554003;Tatuí;1;1;2;79
3546405;Santa Cruz do Rio Pardo;3554003;Tatuí;1;1;2;189
3547809;Santo André;3554003;Tatuí;1;1;2;139
3550605;São Roque;3554003;Tatuí;1;1;2;76
3553708;Taquaritinga;3554003;Tatuí;1;1;2;223
3304557;Rio de Janeiro;3553955;Tarumã;1;1;2;752
3510005;Cândido Mota;3553955;Tarumã;1;1;2;20
3526902;Limeira;3553955;Tarumã;1;1;2;327
3529005;Marília;3553955;Tarumã;1;1;2;87
3534401;Osasco;3553955;Tarumã;1;1;2;400
3534708;Ourinhos;3553955;Tarumã;1;1;2;74
3535309;Palmital;3553955;Tarumã;1;1;2;37
3551702;Sertãozinho;3553955;Tarumã;1;1;2;319
3532207;Narandiba;3553906;Tarabai;1;1;2;11
3541406;Presidente Prudente;3553906;Tarabai;1;1;2;29
3550308;São Paulo;3553906;Tarabai;1;1;2;532
3510203;Capão Bonito;3553856;Taquarivaí;1;1;2;36
3513702;Descalvado;3553856;Taquarivaí;1;1;2;249
3521705;Itaberá;3553856;Taquarivaí;1;1;2;46
3522406;Itapeva;3553856;Taquarivaí;1;1;2;21
3535804;Paranapanema;3553856;Taquarivaí;1;1;2;59
3549904;São José dos Campos;3553856;Taquarivaí;1;1;2;296
2604809;Cortês;3553807;Taquarituba;1;1;2;2141
3170206;Uberlândia;3553807;Taquarituba;1;1;2;522
3502200;Angatuba;3553807;Taquarituba;1;1;2;85
3505005;Barão de Antonina;3553807;Taquarituba;1;1;2;34
3505302;Barra Bonita;3553807;Taquarituba;1;1;2;134
3506003;Bauru;3553807;Taquarituba;1;1;2;133
3521309;Ipuã;3553807;Taquarituba;1;1;2;365
3522307;Itapetininga;3553807;Taquarituba;1;1;2;122
3523107;Itaquaquecetuba;3553807;Taquarituba;1;1;2;296
3523206;Itararé;3553807;Taquarituba;1;1;2;64
3526803;Lençóis Paulista;3553807;Taquarituba;1;1;2;111
3531308;Monte Alto;3553807;Taquarituba;1;1;2;260
3534401;Osasco;3553807;Taquarituba;1;1;2;250
3535804;Paranapanema;3553807;Taquarituba;1;1;2;52
3537909;Pilar do Sul;3553807;Taquarituba;1;1;2;159
3545209;Salto;3553807;Taquarituba;1;1;2;203
3546405;Santa Cruz do Rio Pardo;3553807;Taquarituba;1;1;2;81
3548500;Santos;3553807;Taquarituba;1;1;2;299
3553005;Taguaí;3553807;Taquarituba;1;1;2;19
3106200;Belo Horizonte;3553708;Taquaritinga;1;1;2;501
3118601;Contagem;3553708;Taquaritinga;1;1;2;490
3169604;Tupaciguara;3553708;Taquaritinga;1;1;2;316
3505500;Barretos;3553708;Taquaritinga;1;1;2;99
3506003;Bauru;3553708;Taquaritinga;1;1;2;114
3507407;Borborema;3553708;Taquaritinga;1;1;2;58
3507803;Brodowski;3553708;Taquaritinga;1;1;2;105
3510104;Cândido Rodrigues;3553708;Taquaritinga;1;1;2;16
3513108;Cravinhos;3553708;Taquaritinga;1;1;2;86
3515509;Fernandópolis;3553708;Taquaritinga;1;1;2;218
3522307;Itapetininga;3553708;Taquaritinga;1;1;2;242
3528106;Macaubal;3553708;Taquaritinga;1;1;2;162
3530300;Mirassol;3553708;Taquaritinga;1;1;2;122
3532900;Nova Europa;3553708;Taquaritinga;1;1;2;37
3534401;Osasco;3553708;Taquaritinga;1;1;2;296
3538709;Piracicaba;3553708;Taquaritinga;1;1;2;173
3540705;Porto Ferreira;3553708;Taquaritinga;1;1;2;120
3547304;Santana de Parnaíba;3553708;Taquaritinga;1;1;2;279
3548708;São Bernardo do Campo;3553708;Taquaritinga;1;1;2;325
3503208;Araraquara;3553658;Taquaral;1;1;2;83
3543402;Ribeirão Preto;3553658;Taquaral;1;1;2;64
3553104;Taiaçu;3553658;Taquaral;1;1;2;13
3553203;Taiúva;3553658;Taquaral;1;1;2;7
2909307;Correntina;3553609;Tapiratiba;1;1;2;924
3104007;Araxá;3553609;Tapiratiba;1;1;2;209
3108404;Botelhos;3553609;Tapiratiba;1;1;2;41
3126307;Fortaleza de Minas;3553609;Tapiratiba;1;1;2;68
3143203;Monte Santo de Minas;3553609;Tapiratiba;1;1;2;44
3144102;Muzambinho;3553609;Tapiratiba;1;1;2;25
3506003;Bauru;3553609;Tapiratiba;1;1;2;261
3510807;Casa Branca;3553609;Tapiratiba;1;1;2;49
3523800;Itobi;3553609;Tapiratiba;1;1;2;38
3543907;Rio Claro;3553609;Tapiratiba;1;1;2;134
3546306;Santa Cruz das Palmeiras;3553609;Tapiratiba;1;1;2;65
3505708;Barueri;3553500;Tapiraí;1;1;2;81
3534401;Osasco;3553500;Tapiraí;1;1;2;87
3547502;Santa Rita do Passa Quatro;3553500;Tapiraí;1;1;2;250
3548807;São Caetano do Sul;3553500;Tapiraí;1;1;2;103
3550209;São Miguel Arcanjo;3553500;Tapiraí;1;1;2;51
3104007;Araxá;3553401;Tanabi;1;1;2;303
3504800;Bálsamo;3553401;Tanabi;1;1;2;14
3509502;Campinas;3553401;Tanabi;1;1;2;371
3516200;Franca;3553401;Tanabi;1;1;2;234
3517505;Guapiaçu;3553401;Tanabi;1;1;2;48
3518602;Guariba;3553401;Tanabi;1;1;2;169
3532504;Neves Paulista;3553401;Tanabi;1;1;2;24
3532603;Nhandeara;3553401;Tanabi;1;1;2;41
3533908;Olímpia;3553401;Tanabi;1;1;2;78
3534005;Onda Verde;3553401;Tanabi;1;1;2;37
3534401;Osasco;3553401;Tanabi;1;1;2;441
3546405;Santa Cruz do Rio Pardo;3553401;Tanabi;1;1;2;252
3551306;Sebastianópolis do Sul;3553401;Tanabi;1;1;2;29
3104007;Araxá;3553302;Tambaú;1;1;2;237
3136306;João Pinheiro;3553302;Tambaú;1;1;2;451
3508702;Caconde;3553302;Tambaú;1;1;2;68
3509502;Campinas;3553302;Tambaú;1;1;2;134
3513108;Cravinhos;3553302;Tambaú;1;1;2;62
3515152;Engenheiro Coelho;3553302;Tambaú;1;1;2;87
3515186;Espírito Santo do Pinhal;3553302;Tambaú;1;1;2;77
3526704;Leme;3553302;Tambaú;1;1;2;55
3534401;Osasco;3553302;Tambaú;1;1;2;209
3543402;Ribeirão Preto;3553302;Tambaú;1;1;2;81
3549102;São João da Boa Vista;3553302;Tambaú;1;1;2;56
3550902;São Simão;3553302;Tambaú;1;1;2;38
3551504;Serrana;3553302;Tambaú;1;1;2;64
3506102;Bebedouro;3553203;Taiúva;1;1;2;23
3516200;Franca;3553203;Taiúva;1;1;2;126
3529302;Matão;3553203;Taiúva;1;1;2;53
3534401;Osasco;3553203;Taiúva;1;1;2;319
3539004;Pirangi;3553203;Taiúva;1;1;2;22
3543402;Ribeirão Preto;3553203;Taiúva;1;1;2;68
3550308;São Paulo;3553203;Taiúva;1;1;2;338
3553104;Taiaçu;3553203;Taiúva;1;1;2;7
3506102;Bebedouro;3553104;Taiaçu;1;1;2;23
3512209;Conchal;3553104;Taiaçu;1;1;2;192
3504503;Avaré;3553005;Taguaí;1;1;2;63
3521705;Itaberá;3553005;Taguaí;1;1;2;53
3522406;Itapeva;3553005;Taguaí;1;1;2;79
3523404;Itatiba;3553005;Taguaí;1;1;2;267
3534401;Osasco;3553005;Taguaí;1;1;2;268
3535804;Paranapanema;3553005;Taguaí;1;1;2;66
3546405;Santa Cruz do Rio Pardo;3553005;Taguaí;1;1;2;65
3551207;Sarutaiá;3553005;Taguaí;1;1;2;21
3552205;Sorocaba;3553005;Taguaí;1;1;2;195
3510005;Cândido Mota;3552908;Taciba;1;1;2;101
1501402;Belém;3552809;Taboão da Serra;1;1;2;2462
1504208;Marabá;3552809;Taboão da Serra;1;1;2;2029
1721000;Palmas;3552809;Taboão da Serra;1;1;2;1473
2105302;Imperatriz;3552809;Taboão da Serra;1;1;2;2002
2211001;Teresina;3552809;Taboão da Serra;1;1;2;2083
2305233;Horizonte;3552809;Taboão da Serra;1;1;2;2303
2307304;Juazeiro do Norte;3552809;Taboão da Serra;1;1;2;1953
2312908;Sobral;3552809;Taboão da Serra;1;1;2;2291
2408003;Mossoró;3552809;Taboão da Serra;1;1;2;2235
2504009;Campina Grande;3552809;Taboão da Serra;1;1;2;2102
2602902;Cabo de Santo Agostinho;3552809;Taboão da Serra;1;1;2;2048
2604106;Caruaru;3552809;Taboão da Serra;1;1;2;1997
2606002;Garanhuns;3552809;Taboão da Serra;1;1;2;1916
2609600;Olinda;3552809;Taboão da Serra;1;1;2;2081
2611101;Petrolina;3552809;Taboão da Serra;1;1;2;1696
2700300;Arapiraca;3552809;Taboão da Serra;1;1;2;1823
2800308;Aracaju;3552809;Taboão da Serra;1;1;2;1699
2905701;Camaçari;3552809;Taboão da Serra;1;1;2;1467
2906501;Candeias;3552809;Taboão da Serra;1;1;2;1457
2910727;Eunápolis;3552809;Taboão da Serra;1;1;2;1073
2910800;Feira de Santana;3552809;Taboão da Serra;1;1;2;1470
2919207;Lauro de Freitas;3552809;Taboão da Serra;1;1;2;1450
3102308;Alvinópolis;3552809;Taboão da Serra;1;1;2;539
3106705;Betim;3552809;Taboão da Serra;1;1;2;479
3118601;Contagem;3552809;Taboão da Serra;1;1;2;489
3131307;Ipatinga;3552809;Taboão da Serra;1;1;2;624
3132404;Itajubá;3552809;Taboão da Serra;1;1;2;186
3143302;Montes Claros;3552809;Taboão da Serra;1;1;2;813
3170107;Uberaba;3552809;Taboão da Serra;1;1;2;442
3170206;Uberlândia;3552809;Taboão da Serra;1;1;2;541
3201308;Cariacica;3552809;Taboão da Serra;1;1;2;738
3205101;Viana;3552809;Taboão da Serra;1;1;2;719
3302403;Macaé;3552809;Taboão da Serra;1;1;2;514
3303302;Niterói;3552809;Taboão da Serra;1;1;2;382
3303500;Nova Iguaçu;3552809;Taboão da Serra;1;1;2;349
3304201;Resende;3552809;Taboão da Serra;1;1;2;265
3304904;São Gonçalo;3552809;Taboão da Serra;1;1;2;388
3306305;Volta Redonda;3552809;Taboão da Serra;1;1;2;298
3502754;Araçariguama;3552809;Taboão da Serra;1;1;2;34
3503208;Araraquara;3552809;Taboão da Serra;1;1;2;245
3504107;Atibaia;3552809;Taboão da Serra;1;1;2;58
3504503;Avaré;3552809;Taboão da Serra;1;1;2;226
3507506;Botucatu;3552809;Taboão da Serra;1;1;2;187
3509007;Caieiras;3552809;Taboão da Serra;1;1;2;26
3510500;Caraguatatuba;3552809;Taboão da Serra;1;1;2;134
3510609;Carapicuíba;3552809;Taboão da Serra;1;1;2;10
3511409;Cerqueira César;3552809;Taboão da Serra;1;1;2;251
3513504;Cubatão;3552809;Taboão da Serra;1;1;2;49
3518701;Guarujá;3552809;Taboão da Serra;1;1;2;65
3519071;Hortolândia;3552809;Taboão da Serra;1;1;2;93
3524006;Itupeva;3552809;Taboão da Serra;1;1;2;57
3530805;Moji-Mirim;3552809;Taboão da Serra;1;1;2;130
3536505;Paulínia;3552809;Taboão da Serra;1;1;2;100
3538006;Pindamonhangaba;3552809;Taboão da Serra;1;1;2;153
3538709;Piracicaba;3552809;Taboão da Serra;1;1;2;128
3539806;Poá;3552809;Taboão da Serra;1;1;2;44
3541000;Praia Grande;3552809;Taboão da Serra;1;1;2;59
3541208;Presidente Bernardes;3552809;Taboão da Serra;1;1;2;516
3542602;Registro;3552809;Taboão da Serra;1;1;2;153
3545209;Salto;3552809;Taboão da Serra;1;1;2;68
3547304;Santana de Parnaíba;3552809;Taboão da Serra;1;1;2;22
3549953;São Lourenço da Serra;3552809;Taboão da Serra;1;1;2;33
3503208;Araraquara;3552700;Tabatinga;1;1;2;54
3506102;Bebedouro;3552700;Tabatinga;1;1;2;88
3519105;Iacanga;3552700;Tabatinga;1;1;2;40
3527108;Lins;3552700;Tabatinga;1;1;2;113
3534401;Osasco;3552700;Tabatinga;1;1;2;282
3548906;São Carlos;3552700;Tabatinga;1;1;2;89
1720655;Silvanópolis;3552601;Tabapuã;1;1;2;1090
3104007;Araxá;3552601;Tabapuã;1;1;2;264
3159803;Santa Vitória;3552601;Tabapuã;1;1;2;260
3511201;Catiguá;3552601;Tabapuã;1;1;2;10
3519402;Ibirá;3552601;Tabapuã;1;1;2;25
3533908;Olímpia;3552601;Tabapuã;1;1;2;27
3534401;Osasco;3552601;Tabapuã;1;1;2;369
3549805;São José do Rio Preto;3552601;Tabapuã;1;1;2;41
3537404;Pereira Barreto;3552551;Suzanápolis;1;1;2;14
3550308;São Paulo;3552551;Suzanápolis;1;1;2;578
1500503;Almeirim;3552502;Suzano;1;1;2;2514
2304400;Fortaleza;3552502;Suzano;1;1;2;2315
2312403;São Gonçalo do Amarante;3552502;Suzano;1;1;2;2319
2922003;Mucuri;3552502;Suzano;1;1;2;914
3104007;Araxá;3552502;Suzano;1;1;2;443
3106705;Betim;3552502;Suzano;1;1;2;451
3170206;Uberlândia;3552502;Suzano;1;1;2;550
3170701;Varginha;3552502;Suzano;1;1;2;244
3300456;Belford Roxo;3552502;Suzano;1;1;2;309
3301009;Campos dos Goytacazes;3552502;Suzano;1;1;2;542
3301702;Duque de Caxias;3552502;Suzano;1;1;2;317
3303500;Nova Iguaçu;3552502;Suzano;1;1;2;302
3304201;Resende;3552502;Suzano;1;1;2;221
3506359;Bertioga;3552502;Suzano;1;1;2;35
3506607;Biritiba-Mirim;3552502;Suzano;1;1;2;28
3507605;Bragança Paulista;3552502;Suzano;1;1;2;71
3508504;Caçapava;3552502;Suzano;1;1;2;79
3509205;Cajamar;3552502;Suzano;1;1;2;61
3509700;Campos do Jordão;3552502;Suzano;1;1;2;118
3510609;Carapicuíba;3552502;Suzano;1;1;2;54
3513504;Cubatão;3552502;Suzano;1;1;2;41
3513801;Diadema;3552502;Suzano;1;1;2;35
3522505;Itapevi;3552502;Suzano;1;1;2;65
3523206;Itararé;3552502;Suzano;1;1;2;316
3524402;Jacareí;3552502;Suzano;1;1;2;45
3524709;Jaguariúna;3552502;Suzano;1;1;2;115
3525904;Jundiaí;3552502;Suzano;1;1;2;73
3529005;Marília;3552502;Suzano;1;1;2;398
3534708;Ourinhos;3552502;Suzano;1;1;2;371
3535606;Paraibuna;3552502;Suzano;1;1;2;68
3536505;Paulínia;3552502;Suzano;1;1;2;122
3538006;Pindamonhangaba;3552502;Suzano;1;1;2;110
3542602;Registro;3552502;Suzano;1;1;2;194
3545001;Salesópolis;3552502;Suzano;1;1;2;47
3545209;Salto;3552502;Suzano;1;1;2;106
3546801;Santa Isabel;3552502;Suzano;1;1;2;27
3547304;Santana de Parnaíba;3552502;Suzano;1;1;2;63
3548500;Santos;3552502;Suzano;1;1;2;39
3549805;São José do Rio Preto;3552502;Suzano;1;1;2;434
1200401;Rio Branco;3552403;Sumaré;1;1;2;2485
1400100;Boa Vista;3552403;Sumaré;1;1;2;3131
1500602;Altamira;3552403;Sumaré;1;1;2;2229
1504208;Marabá;3552403;Sumaré;1;1;2;1939
1505304;Oriximiná;3552403;Sumaré;1;1;2;2479
1505437;Ourilândia do Norte;3552403;Sumaré;1;1;2;1816
2111201;São José de Ribamar;3552403;Sumaré;1;1;2;2267
2304400;Fortaleza;3552403;Sumaré;1;1;2;2276
2500601;Alhandra;3552403;Sumaré;1;1;2;2094
2600708;Aliança;3552403;Sumaré;1;1;2;2061
2609600;Olinda;3552403;Sumaré;1;1;2;2045
2905701;Camaçari;3552403;Sumaré;1;1;2;1432
2910057;Dias d'Ávila;3552403;Sumaré;1;1;2;1441
2910800;Feira de Santana;3552403;Sumaré;1;1;2;1429
2927408;Salvador;3552403;Sumaré;1;1;2;1397
3102605;Andradas;3552403;Sumaré;1;1;2;110
3104007;Araxá;3552403;Sumaré;1;1;2;360
3126604;Francisco Dumont;3552403;Sumaré;1;1;2;682
3127701;Governador Valadares;3552403;Sumaré;1;1;2;696
3131307;Ipatinga;3552403;Sumaré;1;1;2;606
3131703;Itabira;3552403;Sumaré;1;1;2;540
3132404;Itajubá;3552403;Sumaré;1;1;2;190
3136702;Juiz de Fora;3552403;Sumaré;1;1;2;419
3143302;Montes Claros;3552403;Sumaré;1;1;2;756
3149309;Pedro Leopoldo;3552403;Sumaré;1;1;2;482
3151800;Poços de Caldas;3552403;Sumaré;1;1;2;138
3167202;Sete Lagoas;3552403;Sumaré;1;1;2;485
3169307;Três Corações;3552403;Sumaré;1;1;2;245
3171204;Vespasiano;3552403;Sumaré;1;1;2;484
3201308;Cariacica;3552403;Sumaré;1;1;2;750
3202504;Ibiraçu;3552403;Sumaré;1;1;2;775
3205002;Serra;3552403;Sumaré;1;1;2;768
3205200;Vila Velha;3552403;Sumaré;1;1;2;754
3205309;Vitória;3552403;Sumaré;1;1;2;763
3301702;Duque de Caxias;3552403;Sumaré;1;1;2;406
3301900;Itaboraí;3552403;Sumaré;1;1;2;453
3302007;Itaguaí;3552403;Sumaré;1;1;2;355
3302403;Macaé;3552403;Sumaré;1;1;2;553
3304904;São Gonçalo;3552403;Sumaré;1;1;2;431
3501905;Amparo;3552403;Sumaré;1;1;2;53
3503208;Araraquara;3552403;Sumaré;1;1;2;147
3503307;Araras;3552403;Sumaré;1;1;2;53
3503802;Artur Nogueira;3552403;Sumaré;1;1;2;29
3503901;Arujá;3552403;Sumaré;1;1;2;115
3509205;Cajamar;3552403;Sumaré;1;1;2;71
3513009;Cotia;3552403;Sumaré;1;1;2;94
3514908;Elias Fausto;3552403;Sumaré;1;1;2;27
3517406;Guaíra;3552403;Sumaré;1;1;2;297
3517703;Guará;3552403;Sumaré;1;1;2;271
3518701;Guarujá;3552403;Sumaré;1;1;2;162
3521200;Iporanga;3552403;Sumaré;1;1;2;239
3522406;Itapeva;3552403;Sumaré;1;1;2;211
3527207;Lorena;3552403;Sumaré;1;1;2;224
3530607;Moji das Cruzes;3552403;Sumaré;1;1;2;137
3530805;Moji-Mirim;3552403;Sumaré;1;1;2;53
3531308;Monte Alto;3552403;Sumaré;1;1;2;210
3540606;Porto Feliz;3552403;Sumaré;1;1;2;51
3540705;Porto Ferreira;3552403;Sumaré;1;1;2;109
3541307;Presidente Epitácio;3552403;Sumaré;1;1;2;508
3542206;Rancharia;3552403;Sumaré;1;1;2;377
3543303;Ribeirão Pires;3552403;Sumaré;1;1;2;130
3545209;Salto;3552403;Sumaré;1;1;2;42
3547304;Santana de Parnaíba;3552403;Sumaré;1;1;2;78
3549102;São João da Boa Vista;3552403;Sumaré;1;1;2;106
3550100;São Manuel;3552403;Sumaré;1;1;2;134
3550407;São Pedro;3552403;Sumaré;1;1;2;73
3551009;São Vicente;3552403;Sumaré;1;1;2;151
3502101;Andradina;3552304;Sud Mennucci;1;1;2;57
3503208;Araraquara;3552304;Sud Mennucci;1;1;2;312
3504206;Auriflama;3552304;Sud Mennucci;1;1;2;38
3518909;Guzolândia;3552304;Sud Mennucci;1;1;2;28
3522307;Itapetininga;3552304;Sud Mennucci;1;1;2;440
3529302;Matão;3552304;Sud Mennucci;1;1;2;283
3534401;Osasco;3552304;Sud Mennucci;1;1;2;537
3535200;Palmeira d'Oeste;3552304;Sud Mennucci;1;1;2;35
1100304;Vilhena;3552205;Sorocaba;1;1;2;1723
1200401;Rio Branco;3552205;Sorocaba;1;1;2;2497
1303536;Presidente Figueiredo;3552205;Sorocaba;1;1;2;2669
1400100;Boa Vista;3552205;Sorocaba;1;1;2;3185
1505536;Parauapebas;3552205;Sorocaba;1;1;2;1947
1703867;Cariri do Tocantins;3552205;Sorocaba;1;1;2;1293
2105302;Imperatriz;3552205;Sorocaba;1;1;2;1988
2207702;Parnaíba;3552205;Sorocaba;1;1;2;2346
2303709;Caucaia;3552205;Sorocaba;1;1;2;2349
2403103;Currais Novos;3552205;Sorocaba;1;1;2;2188
2408953;Rio do Fogo;3552205;Sorocaba;1;1;2;2331
2501807;Bayeux;3552205;Sorocaba;1;1;2;2189
2504009;Campina Grande;3552205;Sorocaba;1;1;2;2129
2509305;Mataraca;3552205;Sorocaba;1;1;2;2230
2607208;Ipojuca;3552205;Sorocaba;1;1;2;2068
2607901;Jaboatão dos Guararapes;3552205;Sorocaba;1;1;2;2094
2906501;Candeias;3552205;Sorocaba;1;1;2;1489
2919553;Luís Eduardo magalhães;3552205;Sorocaba;1;1;2;1271
2924009;Paulo Afonso;3552205;Sorocaba;1;1;2;1799
2925303;Porto Seguro;3552205;Sorocaba;1;1;2;1143
3110509;Camanducaia;3552205;Sorocaba;1;1;2;160
3117876;Confins;3552205;Sorocaba;1;1;2;554
3120102;Couto de Magalhães de Minas;3552205;Sorocaba;1;1;2;723
3131307;Ipatinga;3552205;Sorocaba;1;1;2;669
3144805;Nova Lima;3552205;Sorocaba;1;1;2;531
3147204;Paraguaçu;3552205;Sorocaba;1;1;2;279
3147303;Paraisópolis;3552205;Sorocaba;1;1;2;203
3151800;Poços de Caldas;3552205;Sorocaba;1;1;2;213
3157807;Santa Luzia;3552205;Sorocaba;1;1;2;552
3171204;Vespasiano;3552205;Sorocaba;1;1;2;552
3200607;Aracruz;3552205;Sorocaba;1;1;2;834
3300258;Arraial do Cabo;3552205;Sorocaba;1;1;2;561
3300456;Belford Roxo;3552205;Sorocaba;1;1;2;425
3302205;Itaperuna;3552205;Sorocaba;1;1;2;625
3303302;Niterói;3552205;Sorocaba;1;1;2;453
3305802;Teresópolis;3552205;Sorocaba;1;1;2;472
3500709;Agudos;3552205;Sorocaba;1;1;2;189
3501905;Amparo;3552205;Sorocaba;1;1;2;115
3502507;Aparecida;3552205;Sorocaba;1;1;2;242
3502804;Araçatuba;3552205;Sorocaba;1;1;2;390
3504008;Assis;3552205;Sorocaba;1;1;2;313
3504404;Avanhandava;3552205;Sorocaba;1;1;2;335
3505302;Barra Bonita;3552205;Sorocaba;1;1;2;154
3506508;Birigui;3552205;Sorocaba;1;1;2;376
3508009;Buri;3552205;Sorocaba;1;1;2;117
3508504;Caçapava;3552205;Sorocaba;1;1;2;188
3510302;Capela do Alto;3552205;Sorocaba;1;1;2;24
3510401;Capivari;3552205;Sorocaba;1;1;2;54
3510609;Carapicuíba;3552205;Sorocaba;1;1;2;68
3511102;Catanduva;3552205;Sorocaba;1;1;2;299
3511409;Cerqueira César;3552205;Sorocaba;1;1;2;177
3512308;Conchas;3552205;Sorocaba;1;1;2;74
3512803;Cosmópolis;3552205;Sorocaba;1;1;2;98
3515103;Embu-Guaçu;3552205;Sorocaba;1;1;2;80
3515186;Espírito Santo do Pinhal;3552205;Sorocaba;1;1;2;163
3519709;Ibiúna;3552205;Sorocaba;1;1;2;34
3522109;Itanhaém;3552205;Sorocaba;1;1;2;106
3523206;Itararé;3552205;Sorocaba;1;1;2;201
3523503;Itatinga;3552205;Sorocaba;1;1;2;121
3524006;Itupeva;3552205;Sorocaba;1;1;2;58
3524600;Jacupiranga;3552205;Sorocaba;1;1;2;144
3530300;Mirassol;3552205;Sorocaba;1;1;2;359
3530805;Moji-Mirim;3552205;Sorocaba;1;1;2;129
3535804;Paranapanema;3552205;Sorocaba;1;1;2;129
3536703;Pederneiras;3552205;Sorocaba;1;1;2;180
3537602;Peruíbe;3552205;Sorocaba;1;1;2;103
3538105;Pindorama;3552205;Sorocaba;1;1;2;292
3540507;Porangaba;3552205;Sorocaba;1;1;2;72
3542404;Regente Feijó;3552205;Sorocaba;1;1;2;411
3544301;Roseira;3552205;Sorocaba;1;1;2;233
3550100;São Manuel;3552205;Sorocaba;1;1;2;137
3550506;São Pedro do Turvo;3552205;Sorocaba;1;1;2;242
3551108;Sarapuí;3552205;Sorocaba;1;1;2;38
3107901;Bom Repouso;3552106;Socorro;1;1;2;42
3118601;Contagem;3552106;Socorro;1;1;2;387
3124401;Espírito Santo do Dourado;3552106;Socorro;1;1;2;85
3152501;Pouso Alegre;3552106;Socorro;1;1;2;73
3152907;Pratápolis;3552106;Socorro;1;1;2;207
3501608;Americana;3552106;Socorro;1;1;2;85
3503307;Araras;3552106;Socorro;1;1;2;91
3505708;Barueri;3552106;Socorro;1;1;2;108
3520509;Indaiatuba;3552106;Socorro;1;1;2;92
3522604;Itapira;3552106;Socorro;1;1;2;35
3523404;Itatiba;3552106;Socorro;1;1;2;56
3524709;Jaguariúna;3552106;Socorro;1;1;2;49
3530706;Mogi Guaçu;3552106;Socorro;1;1;2;52
3530805;Moji-Mirim;3552106;Socorro;1;1;2;49
3534401;Osasco;3552106;Socorro;1;1;2;108
3538709;Piracicaba;3552106;Socorro;1;1;2;116
3543907;Rio Claro;3552106;Socorro;1;1;2;108
3545209;Salto;3552106;Socorro;1;1;2;103
3546306;Santa Cruz das Palmeiras;3552106;Socorro;1;1;2;112
3547809;Santo André;3552106;Socorro;1;1;2;117
3548500;Santos;3552106;Socorro;1;1;2;146
3508603;Cachoeira Paulista;3552007;Silveiras;1;1;2;16
3513603;Cunha;3552007;Silveiras;1;1;2;47
2918753;Lagoa Real;3551900;Severínia;1;1;2;1012
3104007;Araxá;3551900;Severínia;1;1;2;235
3517901;Guaraci;3551900;Severínia;1;1;2;37
3534401;Osasco;3551900;Severínia;1;1;2;368
3535101;Palmares Paulista;3551900;Severínia;1;1;2;31
3535705;Paraíso;3551900;Severínia;1;1;2;23
3547809;Santo André;3551900;Severínia;1;1;2;395
3536208;Pariquera-Açu;3551801;Sete Barras;1;1;2;37
2408102;Natal;3551702;Sertãozinho;1;1;2;2123
2602902;Cabo de Santo Agostinho;3551702;Sertãozinho;1;1;2;1930
2607901;Jaboatão dos Guararapes;3551702;Sertãozinho;1;1;2;1943
2610707;Paulista;3551702;Sertãozinho;1;1;2;1967
2927408;Salvador;3551702;Sertãozinho;1;1;2;1322
3111408;Campo Florido;3551702;Sertãozinho;1;1;2;164
3118601;Contagem;3551702;Sertãozinho;1;1;2;426
3127107;Frutal;3551702;Sertãozinho;1;1;2;153
3128303;Guaranésia;3551702;Sertãozinho;1;1;2;125
3138203;Lavras;3551702;Sertãozinho;1;1;2;310
3170206;Uberlândia;3551702;Sertãozinho;1;1;2;249
3171105;Veríssimo;3551702;Sertãozinho;1;1;2;167
3205002;Serra;3551702;Sertãozinho;1;1;2;803
3301702;Duque de Caxias;3551702;Sertãozinho;1;1;2;520
3305802;Teresópolis;3551702;Sertãozinho;1;1;2;539
3505807;Bastos;3551702;Sertãozinho;1;1;2;299
3506003;Bauru;3551702;Sertãozinho;1;1;2;175
3509304;Cajobi;3551702;Sertãozinho;1;1;2;90
3509403;Cajuru;3551702;Sertãozinho;1;1;2;73
3512100;Colômbia;3551702;Sertãozinho;1;1;2;126
3513009;Cotia;3551702;Sertãozinho;1;1;2;295
3513207;Cristais Paulista;3551702;Sertãozinho;1;1;2;101
3515004;Embu;3551702;Sertãozinho;1;1;2;303
3518602;Guariba;3551702;Sertãozinho;1;1;2;35
3519600;Ibitinga;3551702;Sertãozinho;1;1;2;112
3522703;Itápolis;3551702;Sertãozinho;1;1;2;100
3523404;Itatiba;3551702;Sertãozinho;1;1;2;239
3523909;Itu;3551702;Sertãozinho;1;1;2;248
3524204;Jaborandi;3551702;Sertãozinho;1;1;2;66
3525300;Jaú;3551702;Sertãozinho;1;1;2;140
3527603;Luís Antônio;3551702;Sertãozinho;1;1;2;55
3529005;Marília;3551702;Sertãozinho;1;1;2;237
3529708;Miguelópolis;3551702;Sertãozinho;1;1;2;106
3530607;Moji das Cruzes;3551702;Sertãozinho;1;1;2;328
3531308;Monte Alto;3551702;Sertãozinho;1;1;2;54
3533700;Ocauçu;3551702;Sertãozinho;1;1;2;248
3533908;Olímpia;3551702;Sertãozinho;1;1;2;105
3543907;Rio Claro;3551702;Sertãozinho;1;1;2;147
3547502;Santa Rita do Passa Quatro;3551702;Sertãozinho;1;1;2;83
3547700;Santo Anastácio;3551702;Sertãozinho;1;1;2;393
3548708;São Bernardo do Campo;3551702;Sertãozinho;1;1;2;321
3548906;São Carlos;3551702;Sertãozinho;1;1;2;99
3549102;São João da Boa Vista;3551702;Sertãozinho;1;1;2;153
3549409;São Joaquim da Barra;3551702;Sertãozinho;1;1;2;61
3549706;São José do Rio Pardo;3551702;Sertãozinho;1;1;2;125
3550902;São Simão;3551702;Sertãozinho;1;1;2;59
3110509;Camanducaia;3551603;Serra Negra;1;1;2;59
3134905;Jacutinga;3551603;Serra Negra;1;1;2;37
3503703;Ariranha;3551603;Serra Negra;1;1;2;265
3507605;Bragança Paulista;3551603;Serra Negra;1;1;2;40
3520509;Indaiatuba;3551603;Serra Negra;1;1;2;77
3523404;Itatiba;3551603;Serra Negra;1;1;2;46
3524709;Jaguariúna;3551603;Serra Negra;1;1;2;31
3530607;Moji das Cruzes;3551603;Serra Negra;1;1;2;117
3530706;Mogi Guaçu;3551603;Serra Negra;1;1;2;41
3530805;Moji-Mirim;3551603;Serra Negra;1;1;2;34
3534401;Osasco;3551603;Serra Negra;1;1;2;103
3538204;Pinhalzinho;3551603;Serra Negra;1;1;2;22
3548500;Santos;3551603;Serra Negra;1;1;2;147
1501808;Breves;3551504;Serrana;1;1;2;2184
3104007;Araxá;3551504;Serrana;1;1;2;192
3106705;Betim;3551504;Serrana;1;1;2;378
3159803;Santa Vitória;3551504;Serrana;1;1;2;369
3303500;Nova Iguaçu;3551504;Serrana;1;1;2;463
3502101;Andradina;3551504;Serrana;1;1;2;396
3503000;Aramina;3551504;Serrana;1;1;2;127
3509502;Campinas;3551504;Serrana;1;1;2;195
3510906;Cássia dos Coqueiros;3551504;Serrana;1;1;2;45
3511003;Castilho;3551504;Serrana;1;1;2;405
3513207;Cristais Paulista;3551504;Serrana;1;1;2;92
3517802;Guaraçaí;3551504;Serrana;1;1;2;375
3520103;Igarapava;3551504;Serrana;1;1;2;130
3524105;Ituverava;3551504;Serrana;1;1;2;99
3525409;Jeriquara;3551504;Serrana;1;1;2;100
3526001;Junqueirópolis;3551504;Serrana;1;1;2;400
3529708;Miguelópolis;3551504;Serrana;1;1;2;123
3530102;Mirandópolis;3551504;Serrana;1;1;2;364
3531605;Monte Castelo;3551504;Serrana;1;1;2;413
3532108;Murutinga do Sul;3551504;Serrana;1;1;2;383
3533106;Nova Guataporanga;3551504;Serrana;1;1;2;422
3534401;Osasco;3551504;Serrana;1;1;2;271
3536406;Paulicéia;3551504;Serrana;1;1;2;440
3537008;Pedregulho;3551504;Serrana;1;1;2;106
3540705;Porto Ferreira;3551504;Serrana;1;1;2;72
3543105;Ribeirão Corrente;3551504;Serrana;1;1;2;83
3546256;Santa Cruz da Esperança;3551504;Serrana;1;1;2;19
3547908;Santo Antônio da Alegria;3551504;Serrana;1;1;2;48
3549300;São João do Pau d'Alho;3551504;Serrana;1;1;2;423
3104007;Araxá;3551405;Serra Azul;1;1;2;201
3509403;Cajuru;3551405;Serra Azul;1;1;2;27
3513108;Cravinhos;3551405;Serra Azul;1;1;2;17
3534401;Osasco;3551405;Serra Azul;1;1;2;259
3550308;São Paulo;3551405;Serra Azul;1;1;2;276
2919553;Luís Eduardo magalhães;3551306;Sebastianópolis do Sul;1;1;2;1035
3101607;Alfenas;3551306;Sebastianópolis do Sul;1;1;2;422
3205002;Serra;3551306;Sebastianópolis do Sul;1;1;2;1002
3501202;Álvares Florence;3551306;Sebastianópolis do Sul;1;1;2;37
3501806;Américo de Campos;3551306;Sebastianópolis do Sul;1;1;2;44
3504206;Auriflama;3551306;Sebastianópolis do Sul;1;1;2;66
3510708;Cardoso;3551306;Sebastianópolis do Sul;1;1;2;63
3513850;Dirce Reis;3551306;Sebastianópolis do Sul;1;1;2;77
3515202;Estrela d'Oeste;3551306;Sebastianópolis do Sul;1;1;2;64
3515509;Fernandópolis;3551306;Sebastianópolis do Sul;1;1;2;54
3515905;Floreal;3551306;Sebastianópolis do Sul;1;1;2;23
3516903;General Salgado;3551306;Sebastianópolis do Sul;1;1;2;46
3520004;Igaraçu do Tietê;3551306;Sebastianópolis do Sul;1;1;2;250
3524808;Jales;3551306;Sebastianópolis do Sul;1;1;2;78
3528205;Macedônia;3551306;Sebastianópolis do Sul;1;1;2;63
3528304;Magda;3551306;Sebastianópolis do Sul;1;1;2;32
3531001;Monções;3551306;Sebastianópolis do Sul;1;1;2;28
3536257;Parisi;3551306;Sebastianópolis do Sul;1;1;2;43
3536901;Pedranópolis;3551306;Sebastianópolis do Sul;1;1;2;53
3540259;Pontalinda;3551306;Sebastianópolis do Sul;1;1;2;67
3540309;Pontes Gestal;3551306;Sebastianópolis do Sul;1;1;2;57
3548500;Santos;3551306;Sebastianópolis do Sul;1;1;2;520
3549003;São Francisco;3551306;Sebastianópolis do Sul;1;1;2;89
3549201;São João das Duas Pontes;3551306;Sebastianópolis do Sul;1;1;2;56
3549250;São João de Iracema;3551306;Sebastianópolis do Sul;1;1;2;48
3549805;São José do Rio Preto;3551306;Sebastianópolis do Sul;1;1;2;58
3500758;Alambari;3551108;Sarapuí;1;1;2;13
3522307;Itapetininga;3551108;Sarapuí;1;1;2;24
2412005;São Gonçalo do Amarante;3551009;São Vicente;1;1;2;2282
2917508;Jacobina;3551009;São Vicente;1;1;2;1523
2927408;Salvador;3551009;São Vicente;1;1;2;1445
3106705;Betim;3551009;São Vicente;1;1;2;497
3136900;Juruaia;3551009;São Vicente;1;1;2;300
3149309;Pedro Leopoldo;3551009;São Vicente;1;1;2;537
3170206;Uberlândia;3551009;São Vicente;1;1;2;588
3507506;Botucatu;3551009;São Vicente;1;1;2;234
3513009;Cotia;3551009;São Vicente;1;1;2;62
3516200;Franca;3551009;São Vicente;1;1;2;390
3518305;Guararema;3551009;São Vicente;1;1;2;72
3520400;Ilhabela;3551009;São Vicente;1;1;2;113
3520509;Indaiatuba;3551009;São Vicente;1;1;2;125
3523107;Itaquaquecetuba;3551009;São Vicente;1;1;2;54
3523305;Itariri;3551009;São Vicente;1;1;2;82
3524402;Jacareí;3551009;São Vicente;1;1;2;87
3529401;Mauá;3551009;São Vicente;1;1;2;32
3529906;Miracatu;3551009;São Vicente;1;1;2;109
3530607;Moji das Cruzes;3551009;São Vicente;1;1;2;51
3531100;Mongaguá;3551009;São Vicente;1;1;2;23
3531704;Monteiro Lobato;3551009;São Vicente;1;1;2;127
3537206;Pedro de Toledo;3551009;São Vicente;1;1;2;87
3537602;Peruíbe;3551009;São Vicente;1;1;2;68
3542602;Registro;3551009;São Vicente;1;1;2;158
3543303;Ribeirão Pires;3551009;São Vicente;1;1;2;29
3548906;São Carlos;3551009;São Vicente;1;1;2;259
3549102;São João da Boa Vista;3551009;São Vicente;1;1;2;224
3549805;São José do Rio Preto;3551009;São Vicente;1;1;2;456
3550704;São Sebastião;3551009;São Vicente;1;1;2;106
3104007;Araxá;3550902;São Simão;1;1;2;218
3104205;Arcos;3550902;São Simão;1;1;2;245
3170206;Uberlândia;3550902;São Simão;1;1;2;295
3513108;Cravinhos;3550902;São Simão;1;1;2;24
3530706;Mogi Guaçu;3550902;São Simão;1;1;2;113
3534401;Osasco;3550902;São Simão;1;1;2;241
3536307;Patrocínio Paulista;3550902;São Simão;1;1;2;96
3540705;Porto Ferreira;3550902;São Simão;1;1;2;42
3128709;Guaxupé;3550803;São Sebastião da Grama;1;1;2;46
3503208;Araraquara;3550803;São Sebastião da Grama;1;1;2;140
3524709;Jaguariúna;3550803;São Sebastião da Grama;1;1;2;112
3530508;Mococa;3550803;São Sebastião da Grama;1;1;2;35
3534401;Osasco;3550803;São Sebastião da Grama;1;1;2;202
3539301;Pirassununga;3550803;São Sebastião da Grama;1;1;2;72
3546306;Santa Cruz das Palmeiras;3550803;São Sebastião da Grama;1;1;2;46
3549102;São João da Boa Vista;3550803;São Sebastião da Grama;1;1;2;28
3550308;São Paulo;3550803;São Sebastião da Grama;1;1;2;216
1302603;Manaus;3550704;São Sebastião;1;1;2;2689
2111300;São Luís;3550704;São Sebastião;1;1;2;2350
2304400;Fortaleza;3550704;São Sebastião;1;1;2;2310
2927408;Salvador;3550704;São Sebastião;1;1;2;1375
3106200;Belo Horizonte;3550704;São Sebastião;1;1;2;451
3110509;Camanducaia;3550704;São Sebastião;1;1;2;132
3132404;Itajubá;3550704;São Sebastião;1;1;2;149
3143302;Montes Claros;3550704;São Sebastião;1;1;2;793
3168606;Teófilo Otoni;3550704;São Sebastião;1;1;2;762
3301702;Duque de Caxias;3550704;São Sebastião;1;1;2;242
3303302;Niterói;3550704;São Sebastião;1;1;2;256
3501608;Americana;3550704;São Sebastião;1;1;2;223
3505708;Barueri;3550704;São Sebastião;1;1;2;149
3508504;Caçapava;3550704;São Sebastião;1;1;2;77
3508702;Caconde;3550704;São Sebastião;1;1;2;275
3509502;Campinas;3550704;São Sebastião;1;1;2;190
3515004;Embu;3550704;São Sebastião;1;1;2;145
3515509;Fernandópolis;3550704;São Sebastião;1;1;2;619
3518404;Guaratinguetá;3550704;São Sebastião;1;1;2;107
3518800;Guarulhos;3550704;São Sebastião;1;1;2;120
3523909;Itu;3550704;São Sebastião;1;1;2;197
3524402;Jacareí;3550704;São Sebastião;1;1;2;71
3525904;Jundiaí;3550704;São Sebastião;1;1;2;162
3527306;Louveira;3550704;São Sebastião;1;1;2;172
3529401;Mauá;3550704;São Sebastião;1;1;2;105
3530607;Moji das Cruzes;3550704;São Sebastião;1;1;2;80
3539806;Poá;3550704;São Sebastião;1;1;2;97
3541000;Praia Grande;3550704;São Sebastião;1;1;2;103
3545209;Salto;3550704;São Sebastião;1;1;2;198
2607901;Jaboatão dos Guararapes;3550605;São Roque;1;1;2;2077
2927408;Salvador;3550605;São Roque;1;1;2;1447
3118601;Contagem;3550605;São Roque;1;1;2;504
3205002;Serra;3550605;São Roque;1;1;2;785
3506102;Bebedouro;3550605;São Roque;1;1;2;320
3516200;Franca;3550605;São Roque;1;1;2;332
3518800;Guarulhos;3550605;São Roque;1;1;2;59
3522307;Itapetininga;3550605;São Roque;1;1;2;94
3522406;Itapeva;3550605;São Roque;1;1;2;186
3522505;Itapevi;3550605;São Roque;1;1;2;20
3523909;Itu;3550605;São Roque;1;1;2;32
3524006;Itupeva;3550605;São Roque;1;1;2;42
3525904;Jundiaí;3550605;São Roque;1;1;2;45
3538709;Piracicaba;3550605;São Roque;1;1;2;100
3545209;Salto;3550605;São Roque;1;1;2;39
3548708;São Bernardo do Campo;3550605;São Roque;1;1;2;60
3548906;São Carlos;3550605;São Roque;1;1;2;184
3549805;São José do Rio Preto;3550605;São Roque;1;1;2;377
3509809;Campos Novos Paulista;3550506;São Pedro do Turvo;1;1;2;31
3534401;Osasco;3550506;São Pedro do Turvo;1;1;2;316
3545407;Salto Grande;3550506;São Pedro do Turvo;1;1;2;30
3504107;Atibaia;3550407;São Pedro;1;1;2;154
3507902;Brotas;3550407;São Pedro;1;1;2;37
3511706;Charqueada;3550407;São Pedro;1;1;2;15
3534401;Osasco;3550407;São Pedro;1;1;2;159
3540705;Porto Ferreira;3550407;São Pedro;1;1;2;89
3544004;Rio das Pedras;3550407;São Pedro;1;1;2;45
3545209;Salto;3550407;São Pedro;1;1;2;97
3545803;Santa Bárbara d'Oeste;3550407;São Pedro;1;1;2;56
3547809;Santo André;3550407;São Pedro;1;1;2;188
1100015;Alta Floresta d'Oeste;3550308;São Paulo;1;1;2;1994
1100056;Cerejeiras;3550308;São Paulo;1;1;2;1819
1100320;São Miguel do Guaporé;3550308;São Paulo;1;1;2;2065
1100452;Buritis;3550308;São Paulo;1;1;2;2250
1200104;Brasiléia;3550308;São Paulo;1;1;2;2587
1200500;Sena Madureira;3550308;São Paulo;1;1;2;2697
1200609;Tarauacá;3550308;São Paulo;1;1;2;2921
1301100;Careiro;3550308;São Paulo;1;1;2;2571
1301704;Humaitá;3550308;São Paulo;1;1;2;2399
1303403;Parintins;3550308;São Paulo;1;1;2;2520
1303536;Presidente Figueiredo;3550308;São Paulo;1;1;2;2723
1303569;Rio Preto da Eva;3550308;São Paulo;1;1;2;2639
1304062;Tabatinga;3550308;São Paulo;1;1;2;3123
1304203;Tefé;3550308;São Paulo;1;1;2;2846
1400159;Bonfim;3550308;São Paulo;1;1;2;3251
1400407;Normandia;3550308;São Paulo;1;1;2;3295
1400506;São João da Baliza;3550308;São Paulo;1;1;2;3010
1400605;São Luiz;3550308;São Paulo;1;1;2;3022
1500347;Água Azul do Norte;3550308;São Paulo;1;1;2;1902
1500404;Alenquer;3550308;São Paulo;1;1;2;2528
1500909;Augusto Corrêa;3550308;São Paulo;1;1;2;2503
1501204;Baião;3550308;São Paulo;1;1;2;2327
1501576;Bom Jesus do Tocantins;3550308;São Paulo;1;1;2;2067
1501709;Bragança;3550308;São Paulo;1;1;2;2499
1501782;Breu Branco;3550308;São Paulo;1;1;2;2190
1501808;Breves;3550308;São Paulo;1;1;2;2464
1502103;Cametá;3550308;São Paulo;1;1;2;2388
1502301;Capitão Poço;3550308;São Paulo;1;1;2;2423
1502806;Curralinho;3550308;São Paulo;1;1;2;2441
1502905;Curuçá;3550308;São Paulo;1;1;2;2536
1502939;Dom Eliseu;3550308;São Paulo;1;1;2;2141
1503093;Goianésia do Pará;3550308;São Paulo;1;1;2;2204
1503200;Igarapé-Açu;3550308;São Paulo;1;1;2;2492
1503309;Igarapé-Miri;3550308;São Paulo;1;1;2;2408
1503457;Ipixuna do Pará;3550308;São Paulo;1;1;2;2335
1503507;Irituia;3550308;São Paulo;1;1;2;2421
1503804;Jacundá;3550308;São Paulo;1;1;2;2141
1503903;Juruti;3550308;São Paulo;1;1;2;2544
1504307;Maracanã;3550308;São Paulo;1;1;2;2527
1504406;Marapanim;3550308;São Paulo;1;1;2;2539
1504455;Medicilândia;3550308;São Paulo;1;1;2;2318
1504604;Mocajuba;3550308;São Paulo;1;1;2;2348
1505205;Oeiras do Pará;3550308;São Paulo;1;1;2;2417
1506161;Rio Maria;3550308;São Paulo;1;1;2;1838
1506187;Rondon do Pará;3550308;São Paulo;1;1;2;2090
1506203;Salinópolis;3550308;São Paulo;1;1;2;2542
1506500;Santa Isabel do Pará;3550308;São Paulo;1;1;2;2477
1507003;Santo Antônio do Tauá;3550308;São Paulo;1;1;2;2493
1507151;São Domingos do Araguaia;3550308;São Paulo;1;1;2;2014
1507409;São Francisco do Pará;3550308;São Paulo;1;1;2;2489
1507607;São Miguel do Guamá;3550308;São Paulo;1;1;2;2440
1508001;Tomé-Açu;3550308;São Paulo;1;1;2;2357
1508126;Ulianópolis;3550308;São Paulo;1;1;2;2204
1508159;Uruará;3550308;São Paulo;1;1;2;2313
1508357;Vitória do Xingu;3550308;São Paulo;1;1;2;2356
1700301;Aguiarnópolis;3550308;São Paulo;1;1;2;1892
1700707;Alvorada;3550308;São Paulo;1;1;2;1262
1702000;Araguaçu;3550308;São Paulo;1;1;2;1228
1702307;Arapoema;3550308;São Paulo;1;1;2;1786
1703008;Babaçulândia;3550308;São Paulo;1;1;2;1824
1703073;Barra do Ouro;3550308;São Paulo;1;1;2;1766
1703842;Campos Lindos;3550308;São Paulo;1;1;2;1728
1703909;Caseara;3550308;São Paulo;1;1;2;1623
1705508;Colinas do Tocantins;3550308;São Paulo;1;1;2;1734
1705607;Conceição do Tocantins;3550308;São Paulo;1;1;2;1267
1706506;Darcinópolis;3550308;São Paulo;1;1;2;1877
1707652;Figueirópolis;3550308;São Paulo;1;1;2;1299
1707702;Filadélfia;3550308;São Paulo;1;1;2;1807
1708254;Fortaleza do Tabocão;3550308;São Paulo;1;1;2;1625
1709302;Guaraí;3550308;São Paulo;1;1;2;1645
1714880;Nova Olinda;3550308;São Paulo;1;1;2;1781
1716703;Colméia;3550308;São Paulo;1;1;2;1664
1717503;Pium;3550308;São Paulo;1;1;2;1483
1718840;Sandolândia;3550308;São Paulo;1;1;2;1272
1718907;Santa Rosa do Tocantins;3550308;São Paulo;1;1;2;1358
1720655;Silvanópolis;3550308;São Paulo;1;1;2;1392
1721208;Tocantinópolis;3550308;São Paulo;1;1;2;1919
1721257;Tupirama;3550308;São Paulo;1;1;2;1631
1722107;Xambioá;3550308;São Paulo;1;1;2;1915
2101251;Bacabeira;3550308;São Paulo;1;1;2;2299
2101608;Barra do Corda;3550308;São Paulo;1;1;2;2011
2101707;Barreirinhas;3550308;São Paulo;1;1;2;2338
2102507;Cajari;3550308;São Paulo;1;1;2;2255
2103208;Chapadinha;3550308;São Paulo;1;1;2;2227
2107506;Paço do Lumiar;3550308;São Paulo;1;1;2;2349
2108207;Pedreiras;3550308;São Paulo;1;1;2;2122
2109106;Presidente Dutra;3550308;São Paulo;1;1;2;2040
2109452;Raposa;3550308;São Paulo;1;1;2;2361
2109502;Riachão;3550308;São Paulo;1;1;2;1801
2109700;Sambaíba;3550308;São Paulo;1;1;2;1831
2110203;Santa Rita;3550308;São Paulo;1;1;2;2290
2111409;São Luís Gonzaga do Maranhão;3550308;São Paulo;1;1;2;2141
2200103;Agricolândia;3550308;São Paulo;1;1;2;2013
2200459;Alvorada do Gurguéia;3550308;São Paulo;1;1;2;1708
2202406;Capitão de Campos;3550308;São Paulo;1;1;2;2172
2202901;Corrente;3550308;São Paulo;1;1;2;1469
2203420;Domingos Mourão;3550308;São Paulo;1;1;2;2209
2203800;Flores do Piauí;3550308;São Paulo;1;1;2;1792
2205904;Manoel Emídio;3550308;São Paulo;1;1;2;1751
2206654;Morro Cabeça no Tempo;3550308;São Paulo;1;1;2;1565
2208205;Pio IX;3550308;São Paulo;1;1;2;1952
2209005;Rio Grande do Piauí;3550308;São Paulo;1;1;2;1789
2210631;Sebastião Leal;3550308;São Paulo;1;1;2;1798
2210904;Socorro do Piauí;3550308;São Paulo;1;1;2;1793
2211100;União;3550308;São Paulo;1;1;2;2141
2211209;Uruçuí;3550308;São Paulo;1;1;2;1830
2300754;Amontada;3550308;São Paulo;1;1;2;2341
2302107;Baturité;3550308;São Paulo;1;1;2;2268
2303501;Cascavel;3550308;São Paulo;1;1;2;2310
2303600;Catarina;3550308;São Paulo;1;1;2;2048
2304202;Crato;3550308;São Paulo;1;1;2;1952
2306553;Itarema;3550308;São Paulo;1;1;2;2385
2306900;Jaguaribe;3550308;São Paulo;1;1;2;2114
2307254;Jijoca de Jericoacoara;3550308;São Paulo;1;1;2;2381
2308302;Milagres;3550308;São Paulo;1;1;2;1958
2309607;Pacajus;3550308;São Paulo;1;1;2;2298
2310209;Paracuru;3550308;São Paulo;1;1;2;2359
2310308;Parambu;3550308;São Paulo;1;1;2;2016
2311405;Quixeramobim;3550308;São Paulo;1;1;2;2165
2313500;Trairi;3550308;São Paulo;1;1;2;2369
2400703;Alto do Rodrigues;3550308;São Paulo;1;1;2;2249
2401206;Arês;3550308;São Paulo;1;1;2;2234
2401909;Caiçara do Rio do Vento;3550308;São Paulo;1;1;2;2236
2402600;Ceará-Mirim;3550308;São Paulo;1;1;2;2274
2403608;Extremoz;3550308;São Paulo;1;1;2;2273
2404200;Goianinha;3550308;São Paulo;1;1;2;2220
2404507;Guamaré;3550308;São Paulo;1;1;2;2286
2405108;Jandaíra;3550308;São Paulo;1;1;2;2270
2408300;Nova Cruz;3550308;São Paulo;1;1;2;2193
2409100;Passa e Fica;3550308;São Paulo;1;1;2;2187
2409506;Pedra Grande;3550308;São Paulo;1;1;2;2301
2409605;Pedra Preta;3550308;São Paulo;1;1;2;2248
2410504;Rafael Fernandes;3550308;São Paulo;1;1;2;2099
2411502;Santo Antônio;3550308;São Paulo;1;1;2;2207
2414100;Tenente Ananias;3550308;São Paulo;1;1;2;2074
2500403;Alagoa Nova;3550308;São Paulo;1;1;2;2121
2500601;Alhandra;3550308;São Paulo;1;1;2;2130
2501005;Araruna;3550308;São Paulo;1;1;2;2172
2501302;Aroeiras;3550308;São Paulo;1;1;2;2079
2503308;Cachoeira dos Índios;3550308;São Paulo;1;1;2;2008
2503704;Cajazeiras;3550308;São Paulo;1;1;2;2015
2504702;Congo;3550308;São Paulo;1;1;2;2008
2506400;Gurinhém;3550308;São Paulo;1;1;2;2133
2506806;Ingá;3550308;São Paulo;1;1;2;2110
2508109;Lagoa;3550308;São Paulo;1;1;2;2073
2509107;Mari;3550308;São Paulo;1;1;2;2144
2509404;Mogeiro;3550308;São Paulo;1;1;2;2114
2510105;Nova Floresta;3550308;São Paulo;1;1;2;2159
2511004;Pedra Branca;3550308;São Paulo;1;1;2;1982
2511202;Pedras de Fogo;3550308;São Paulo;1;1;2;2124
2511806;Pirpirituba;3550308;São Paulo;1;1;2;2162
2511905;Pitimbu;3550308;São Paulo;1;1;2;2131
2512507;Queimadas;3550308;São Paulo;1;1;2;2090
2513505;Santana de Mangueira;3550308;São Paulo;1;1;2;1958
2515708;Serra Grande;3550308;São Paulo;1;1;2;1991
2515807;Serra Redonda;3550308;São Paulo;1;1;2;2115
2601102;Araripina;3550308;São Paulo;1;1;2;1880
2601201;Arcoverde;3550308;São Paulo;1;1;2;1926
2602308;Bonito;3550308;São Paulo;1;1;2;1991
2603900;Carnaíba;3550308;São Paulo;1;1;2;1956
2605202;Escada;3550308;São Paulo;1;1;2;2029
2606408;Gravatá;3550308;São Paulo;1;1;2;2025
2607802;Itaquitinga;3550308;São Paulo;1;1;2;2099
2608750;Lagoa Grande;3550308;São Paulo;1;1;2;1738
2608800;Lajedo;3550308;São Paulo;1;1;2;1943
2610905;Pesqueira;3550308;São Paulo;1;1;2;1952
2611533;Quixaba;3550308;São Paulo;1;1;2;1962
2611705;Riacho das Almas;3550308;São Paulo;1;1;2;2015
2611903;Rio Formoso;3550308;São Paulo;1;1;2;2004
2612604;Santa Maria da Boa Vista;3550308;São Paulo;1;1;2;1779
2613602;São José do Egito;3550308;São Paulo;1;1;2;2010
2613701;São Lourenço da Mata;3550308;São Paulo;1;1;2;2071
2615300;Timbaúba;3550308;São Paulo;1;1;2;2103
2615607;Trindade;3550308;São Paulo;1;1;2;1862
2700607;Barra de São Miguel;3550308;São Paulo;1;1;2;1857
2702207;Coqueiro Seco;3550308;São Paulo;1;1;2;1881
2702306;Coruripe;3550308;São Paulo;1;1;2;1816
2702702;Feliz Deserto;3550308;São Paulo;1;1;2;1793
2706208;Palestina;3550308;São Paulo;1;1;2;1797
2707503;Porto Real do Colégio;3550308;São Paulo;1;1;2;1779
2709301;União dos Palmares;3550308;São Paulo;1;1;2;1906
2801504;Carmópolis;3550308;São Paulo;1;1;2;1724
2803401;Japoatã;3550308;São Paulo;1;1;2;1762
2803807;Malhada dos Bois;3550308;São Paulo;1;1;2;1755
2805703;Propriá;3550308;São Paulo;1;1;2;1771
2901502;Anguera;3550308;São Paulo;1;1;2;1467
2901908;Aporá;3550308;São Paulo;1;1;2;1573
2903904;Bom Jesus da Lapa;3550308;São Paulo;1;1;2;1193
2905404;Cairu;3550308;São Paulo;1;1;2;1357
2906808;Cansanção;3550308;São Paulo;1;1;2;1599
2906907;Caravelas;3550308;São Paulo;1;1;2;988
2910701;Euclides da Cunha;3550308;São Paulo;1;1;2;1636
2915502;Itajuípe;3550308;São Paulo;1;1;2;1228
2916104;Itaparica;3550308;São Paulo;1;1;2;1423
2917706;Jaguarari;3550308;São Paulo;1;1;2;1612
2918506;Jussara;3550308;São Paulo;1;1;2;1469
2920700;Maraú;3550308;São Paulo;1;1;2;1300
2921500;Monte Santo;3550308;São Paulo;1;1;2;1630
2921708;Morro do Chapéu;3550308;São Paulo;1;1;2;1444
2922607;Nilo Peçanha;3550308;São Paulo;1;1;2;1338
2924306;Piatã;3550308;São Paulo;1;1;2;1258
2924504;Pindaí;3550308;São Paulo;1;1;2;1087
2925204;Pojuca;3550308;São Paulo;1;1;2;1489
2925501;Prado;3550308;São Paulo;1;1;2;1018
2925907;Quijingue;3550308;São Paulo;1;1;2;1604
2928109;Santa Maria da Vitória;3550308;São Paulo;1;1;2;1166
2929305;São Gonçalo dos Campos;3550308;São Paulo;1;1;2;1455
2929909;Seabra;3550308;São Paulo;1;1;2;1331
2930154;Serra do Ramalho;3550308;São Paulo;1;1;2;1156
2930501;Serrinha;3550308;São Paulo;1;1;2;1527
2930774;Sobradinho;3550308;São Paulo;1;1;2;1668
2932200;Ubaitaba;3550308;São Paulo;1;1;2;1267
2932705;Uruçuca;3550308;São Paulo;1;1;2;1241
3100203;Abaeté;3550308;São Paulo;1;1;2;514
3100609;Água Boa;3550308;São Paulo;1;1;2;758
3100708;Água Comprida;3550308;São Paulo;1;1;2;424
3100906;Águas Formosas;3550308;São Paulo;1;1;2;921
3101102;Aimorés;3550308;São Paulo;1;1;2;724
3101300;Alagoa;3550308;São Paulo;1;1;2;262
3102001;Alterosa;3550308;São Paulo;1;1;2;271
3102100;Alto Rio Doce;3550308;São Paulo;1;1;2;438
3102308;Alvinópolis;3550308;São Paulo;1;1;2;535
3102704;Cachoeira de Pajeú;3550308;São Paulo;1;1;2;993
3103405;Araçuaí;3550308;São Paulo;1;1;2;879
3103702;Araponga;3550308;São Paulo;1;1;2;532
3104106;Arceburgo;3550308;São Paulo;1;1;2;255
3104809;Augusto de Lima;3550308;São Paulo;1;1;2;659
3104908;Baependi;3550308;São Paulo;1;1;2;260
3106002;Bela Vista de Minas;3550308;São Paulo;1;1;2;555
3106507;Berilo;3550308;São Paulo;1;1;2;851
3106903;Bicas;3550308;São Paulo;1;1;2;420
3107307;Bocaiúva;3550308;São Paulo;1;1;2;775
3107406;Bom Despacho;3550308;São Paulo;1;1;2;456
3107505;Bom Jardim de Minas;3550308;São Paulo;1;1;2;313
3107703;Bom Jesus do Amparo;3550308;São Paulo;1;1;2;542
3107802;Bom Jesus do Galho;3550308;São Paulo;1;1;2;608
3108107;Bonfim;3550308;São Paulo;1;1;2;441
3109600;Cachoeira da Prata;3550308;São Paulo;1;1;2;508
3109808;Cachoeira Dourada;3550308;São Paulo;1;1;2;637
3110707;Cambuquira;3550308;São Paulo;1;1;2;242
3110806;Campanário;3550308;São Paulo;1;1;2;775
3110905;Campanha;3550308;São Paulo;1;1;2;238
3111002;Campestre;3550308;São Paulo;1;1;2;219
3111507;Campos Altos;3550308;São Paulo;1;1;2;441
3111804;Canápolis;3550308;São Paulo;1;1;2;603
3112703;Capitão Enéas;3550308;São Paulo;1;1;2;864
3113305;Carangola;3550308;São Paulo;1;1;2;568
3113909;Carmo da Cachoeira;3550308;São Paulo;1;1;2;282
3114006;Carmo da Mata;3550308;São Paulo;1;1;2;387
3114501;Carmópolis de Minas;3550308;São Paulo;1;1;2;400
3114808;Carvalhos;3550308;São Paulo;1;1;2;288
3114907;Casa Grande;3550308;São Paulo;1;1;2;419
3115003;Cascalho Rico;3550308;São Paulo;1;1;2;575
3116407;Claraval;3550308;São Paulo;1;1;2;366
3116506;Claro dos Poções;3550308;São Paulo;1;1;2;767
3116803;Coluna;3550308;São Paulo;1;1;2;711
3117504;Conceição do Mato Dentro;3550308;São Paulo;1;1;2;606
3118205;Conquista;3550308;São Paulo;1;1;2;421
3118403;Conselheiro Pena;3550308;São Paulo;1;1;2;717
3119104;Corinto;3550308;São Paulo;1;1;2;625
3119500;Coronel Murta;3550308;São Paulo;1;1;2;897
3119609;Coronel Pacheco;3550308;São Paulo;1;1;2;412
3119906;Córrego do Bom Jesus;3550308;São Paulo;1;1;2;130
3120102;Couto de Magalhães de Minas;3550308;São Paulo;1;1;2;695
3120409;Cristiano Otoni;3550308;São Paulo;1;1;2;424
3120706;Cruzeiro da Fortaleza;3550308;São Paulo;1;1;2;521
3121001;Datas;3550308;São Paulo;1;1;2;650
3121209;Delfinópolis;3550308;São Paulo;1;1;2;367
3121704;Diogo de Vasconcelos;3550308;São Paulo;1;1;2;494
3122009;Divino;3550308;São Paulo;1;1;2;565
3122355;Divisa Alegre;3550308;São Paulo;1;1;2;1024
3122454;Divisópolis;3550308;São Paulo;1;1;2;1042
3122504;Dom Cavati;3550308;São Paulo;1;1;2;658
3122900;Dona Eusébia;3550308;São Paulo;1;1;2;467
3123007;Dores de Campos;3550308;São Paulo;1;1;2;387
3123205;Dores do Indaiá;3550308;São Paulo;1;1;2;476
3123403;Doresópolis;3550308;São Paulo;1;1;2;380
3123502;Douradoquara;3550308;São Paulo;1;1;2;586
3123809;Engenheiro Navarro;3550308;São Paulo;1;1;2;756
3123858;Entre Folhas;3550308;São Paulo;1;1;2;628
3123908;Entre Rios de Minas;3550308;São Paulo;1;1;2;421
3124302;Espinosa;3550308;São Paulo;1;1;2;1039
3124401;Espírito Santo do Dourado;3550308;São Paulo;1;1;2;192
3124708;Estrela do Indaiá;3550308;São Paulo;1;1;2;466
3124906;Eugenópolis;3550308;São Paulo;1;1;2;533
3125200;Fama;3550308;São Paulo;1;1;2;259
3125606;Felisburgo;3550308;São Paulo;1;1;2;973
3126703;Francisco Sá;3550308;São Paulo;1;1;2;851
3126901;Frei Inocêncio;3550308;São Paulo;1;1;2;738
3127800;Grão Mogol;3550308;São Paulo;1;1;2;870
3128006;Guanhães;3550308;São Paulo;1;1;2;660
3128402;Guarani;3550308;São Paulo;1;1;2;445
3128600;Guarda-Mor;3550308;São Paulo;1;1;2;653
3128907;Guimarânia;3550308;São Paulo;1;1;2;533
3129103;Gurinhatã;3550308;São Paulo;1;1;2;584
3129202;Heliodora;3550308;São Paulo;1;1;2;209
3129608;Ibiaí;3550308;São Paulo;1;1;2;773
3130804;Ingaí;3550308;São Paulo;1;1;2;305
3130903;Inhapim;3550308;São Paulo;1;1;2;641
3131000;Inhaúma;3550308;São Paulo;1;1;2;514
3131208;Ipanema;3550308;São Paulo;1;1;2;656
3131406;Ipiaçu;3550308;São Paulo;1;1;2;641
3131604;Iraí de Minas;3550308;São Paulo;1;1;2;523
3132206;Itaguara;3550308;São Paulo;1;1;2;422
3132305;Itaipé;3550308;São Paulo;1;1;2;852
3132701;Itambacuri;3550308;São Paulo;1;1;2;796
3132909;Itamogi;3550308;São Paulo;1;1;2;288
3133709;Itatiaiuçu;3550308;São Paulo;1;1;2;444
3134103;Itueta;3550308;São Paulo;1;1;2;725
3134301;Itumirim;3550308;São Paulo;1;1;2;315
3134509;Itutinga;3550308;São Paulo;1;1;2;330
3135050;Jaíba;3550308;São Paulo;1;1;2;968
3135407;Jeceaba;3550308;São Paulo;1;1;2;438
3135704;Jequitibá;3550308;São Paulo;1;1;2;556
3135803;Jequitinhonha;3550308;São Paulo;1;1;2;974
3135902;Jesuânia;3550308;São Paulo;1;1;2;229
3136009;Joaíma;3550308;São Paulo;1;1;2;953
3136108;Joanésia;3550308;São Paulo;1;1;2;637
3136405;Joaquim Felício;3550308;São Paulo;1;1;2;698
3136603;Nova União;3550308;São Paulo;1;1;2;537
3136652;Juatuba;3550308;São Paulo;1;1;2;471
3137106;Lagamar;3550308;São Paulo;1;1;2;606
3137502;Lagoa Formosa;3550308;São Paulo;1;1;2;540
3137536;Lagoa Grande;3550308;São Paulo;1;1;2;644
3137700;Lajinha;3550308;São Paulo;1;1;2;637
3138005;Laranjal;3550308;São Paulo;1;1;2;492
3138302;Leandro Ferreira;3550308;São Paulo;1;1;2;465
3138682;Luislândia;3550308;São Paulo;1;1;2;859
3138906;Machacalis;3550308;São Paulo;1;1;2;939
3139201;Malacacheta;3550308;São Paulo;1;1;2;789
3139508;Manhumirim;3550308;São Paulo;1;1;2;598
3139805;Mar de Espanha;3550308;São Paulo;1;1;2;419
3139904;Maria da Fé;3550308;São Paulo;1;1;2;197
3140407;Marmelópolis;3550308;São Paulo;1;1;2;201
3140506;Martinho Campos;3550308;São Paulo;1;1;2;499
3140555;Mata Verde;3550308;São Paulo;1;1;2;1055
3140605;Materlândia;3550308;São Paulo;1;1;2;677
3140902;Matipó;3550308;São Paulo;1;1;2;573
3141009;Mato Verde;3550308;São Paulo;1;1;2;988
3141207;Matutina;3550308;São Paulo;1;1;2;495
3141504;Mendes Pimentel;3550308;São Paulo;1;1;2;763
3142403;Moema;3550308;São Paulo;1;1;2;440
3144003;Mutum;3550308;São Paulo;1;1;2;676
3144359;Naque;3550308;São Paulo;1;1;2;655
3144409;Natércia;3550308;São Paulo;1;1;2;205
3144706;Nova Era;3550308;São Paulo;1;1;2;563
3144904;Nova Módica;3550308;São Paulo;1;1;2;775
3145109;Nova Resende;3550308;São Paulo;1;1;2;281
3145356;Novo Oriente de Minas;3550308;São Paulo;1;1;2;879
3146404;Paineiras;3550308;São Paulo;1;1;2;537
3146503;Pains;3550308;São Paulo;1;1;2;377
3146701;Palma;3550308;São Paulo;1;1;2;506
3146750;Palmópolis;3550308;São Paulo;1;1;2;986
3146909;Papagaios;3550308;São Paulo;1;1;2;503
3147402;Paraopeba;3550308;São Paulo;1;1;2;536
3148707;Pedra Azul;3550308;São Paulo;1;1;2;996
3149606;Pequi;3550308;São Paulo;1;1;2;488
3149705;Perdigão;3550308;São Paulo;1;1;2;439
3150109;Piau;3550308;São Paulo;1;1;2;412
3150307;Piedade do Rio Grande;3550308;São Paulo;1;1;2;347
3150604;Piracema;3550308;São Paulo;1;1;2;411
3150703;Pirajuba;3550308;São Paulo;1;1;2;463
3151404;Pitangui;3550308;São Paulo;1;1;2;478
3151909;Pocrane;3550308;São Paulo;1;1;2;674
3152907;Pratápolis;3550308;São Paulo;1;1;2;323
3153509;Alto Jequitibá;3550308;São Paulo;1;1;2;593
3153608;Prudente de Morais;3550308;São Paulo;1;1;2;526
3153806;Queluzito;3550308;São Paulo;1;1;2;427
3154002;Raul Soares;3550308;São Paulo;1;1;2;579
3154101;Recreio;3550308;São Paulo;1;1;2;485
3154309;Resplendor;3550308;São Paulo;1;1;2;730
3154903;Rio Casca;3550308;São Paulo;1;1;2;552
3155108;Rio do Prado;3550308;São Paulo;1;1;2;988
3155405;Rio Novo;3550308;São Paulo;1;1;2;432
3155702;Rio Piracicaba;3550308;São Paulo;1;1;2;540
3155801;Rio Pomba;3550308;São Paulo;1;1;2;439
3156007;Rio Vermelho;3550308;São Paulo;1;1;2;696
3156452;Rosário da Limeira;3550308;São Paulo;1;1;2;512
3156502;Rubelita;3550308;São Paulo;1;1;2;913
3157005;Salinas;3550308;São Paulo;1;1;2;934
3157203;Santa Bárbara;3550308;São Paulo;1;1;2;523
3158508;Santana de Pirapama;3550308;São Paulo;1;1;2;577
3159902;Santo Antônio do Amparo;3550308;São Paulo;1;1;2;347
3160405;Santo Antônio do Monte;3550308;São Paulo;1;1;2;418
3160900;São Brás do Suaçuí;3550308;São Paulo;1;1;2;430
3161007;São Domingos do Prata;3550308;São Paulo;1;1;2;560
3161809;São Gonçalo do Pará;3550308;São Paulo;1;1;2;445
3162575;São João do Manteninha;3550308;São Paulo;1;1;2;776
3162807;São João Evangelista;3550308;São Paulo;1;1;2;688
3162922;São Joaquim de Bicas;3550308;São Paulo;1;1;2;465
3162948;São José da Barra;3550308;São Paulo;1;1;2;327
3163300;São José do Divino;3550308;São Paulo;1;1;2;779
3163409;São José do Goiabal;3550308;São Paulo;1;1;2;573
3163508;São José do Jacuri;3550308;São Paulo;1;1;2;717
3163805;São Miguel do Anta;3550308;São Paulo;1;1;2;514
3164209;São Romão;3550308;São Paulo;1;1;2;822
3164407;São Sebastião da Bela Vista;3550308;São Paulo;1;1;2;189
3164506;São Sebastião do Maranhão;3550308;São Paulo;1;1;2;740
3165008;São Tiago;3550308;São Paulo;1;1;2;373
3165206;São Thomé das Letras;3550308;São Paulo;1;1;2;272
3165537;Sarzedo;3550308;São Paulo;1;1;2;473
3165552;Setubinha;3550308;São Paulo;1;1;2;789
3165578;Senador Amaral;3550308;São Paulo;1;1;2;127
3165909;Senador Modestino Gonçalves;3550308;São Paulo;1;1;2;719
3166204;Senhora dos Remédios;3550308;São Paulo;1;1;2;425
3166709;Serra dos Aimorés;3550308;São Paulo;1;1;2;912
3166808;Serra do Salitre;3550308;São Paulo;1;1;2;503
3167103;Serro;3550308;São Paulo;1;1;2;649
3167400;Silvianópolis;3550308;São Paulo;1;1;2;198
3167608;Simonésia;3550308;São Paulo;1;1;2;609
3167806;Soledade de Minas;3550308;São Paulo;1;1;2;240
3168002;Taiobeiras;3550308;São Paulo;1;1;2;973
3168309;Taquaraçu de Minas;3550308;São Paulo;1;1;2;532
3168804;Tiradentes;3550308;São Paulo;1;1;2;377
3169208;Tombos;3550308;São Paulo;1;1;2;558
3169505;Tumiritinga;3550308;São Paulo;1;1;2;721
3169802;Turvolândia;3550308;São Paulo;1;1;2;215
3170057;Ubaporanga;3550308;São Paulo;1;1;2;638
3170503;Urucânia;3550308;São Paulo;1;1;2;538
3170602;Vargem Bonita;3550308;São Paulo;1;1;2;365
3171501;Mathias Lobato;3550308;São Paulo;1;1;2;735
3171600;Virgem da Lapa;3550308;São Paulo;1;1;2;871
3200300;Alfredo Chaves;3550308;São Paulo;1;1;2;683
3200904;Barra de São Francisco;3550308;São Paulo;1;1;2;790
3201407;Castelo;3550308;São Paulo;1;1;2;641
3201605;Conceição da Barra;3550308;São Paulo;1;1;2;888
3202454;Ibatiba;3550308;São Paulo;1;1;2;642
3202504;Ibiraçu;3550308;São Paulo;1;1;2;761
3202652;Irupi;3550308;São Paulo;1;1;2;624
3203007;Iúna;3550308;São Paulo;1;1;2;633
3203130;João Neiva;3550308;São Paulo;1;1;2;763
3204203;Piúma;3550308;São Paulo;1;1;2;674
3204500;Santa Leopoldina;3550308;São Paulo;1;1;2;731
3205036;Vargem Alta;3550308;São Paulo;1;1;2;659
3300159;Aperibé;3550308;São Paulo;1;1;2;508
3300605;Bom Jesus do Itabapoana;3550308;São Paulo;1;1;2;575
3300902;Cambuci;3550308;São Paulo;1;1;2;532
3300936;Carapebus;3550308;São Paulo;1;1;2;532
3300951;Comendador Levy Gasparian;3550308;São Paulo;1;1;2;391
3301157;Cardoso Moreira;3550308;São Paulo;1;1;2;563
3301207;Carmo;3550308;São Paulo;1;1;2;452
3301405;Conceição de Macabu;3550308;São Paulo;1;1;2;515
3301603;Duas Barras;3550308;São Paulo;1;1;2;455
3301801;Engenheiro Paulo de Frontin;3550308;São Paulo;1;1;2;326
3302056;Italva;3550308;São Paulo;1;1;2;560
3302106;Itaocara;3550308;São Paulo;1;1;2;512
3302270;Japeri;3550308;São Paulo;1;1;2;325
3302304;Laje do Muriaé;3550308;São Paulo;1;1;2;532
3302452;Macuco;3550308;São Paulo;1;1;2;483
3302809;Mendes;3550308;São Paulo;1;1;2;320
3303005;Miracema;3550308;São Paulo;1;1;2;512
3303104;Natividade;3550308;São Paulo;1;1;2;554
3304128;Quatis;3550308;São Paulo;1;1;2;279
3304409;Rio Claro;3550308;São Paulo;1;1;2;276
3304706;Santo Antônio de Pádua;3550308;São Paulo;1;1;2;510
3304805;São Fidélis;3550308;São Paulo;1;1;2;542
3305133;São José de Ubá;3550308;São Paulo;1;1;2;540
3305158;São José do Vale do Rio Preto;3550308;São Paulo;1;1;2;413
3305703;Sumidouro;3550308;São Paulo;1;1;2;441
3306156;Varre-Sai;3550308;São Paulo;1;1;2;569
3306206;Vassouras;3550308;São Paulo;1;1;2;333
3500204;Adolfo;3550308;São Paulo;1;1;2;404
3501202;Álvares Florence;3550308;São Paulo;1;1;2;494
3501400;Álvaro de Carvalho;3550308;São Paulo;1;1;2;356
3501509;Alvinlândia;3550308;São Paulo;1;1;2;343
3502408;Anhumas;3550308;São Paulo;1;1;2;504
3502606;Aparecida d'Oeste;3550308;São Paulo;1;1;2;557
3503158;Arapeí;3550308;São Paulo;1;1;2;249
3503505;Areias;3550308;São Paulo;1;1;2;231
3504602;Bady Bassitt;3550308;São Paulo;1;1;2;414
3504701;Balbinos;3550308;São Paulo;1;1;2;336
3505351;Barra do Chapéu;3550308;São Paulo;1;1;2;259
3505401;Barra do Turvo;3550308;São Paulo;1;1;2;226
3506201;Bento de Abreu;3550308;São Paulo;1;1;2;497
3506409;Bilac;3550308;São Paulo;1;1;2;461
3508900;Caiabu;3550308;São Paulo;1;1;2;499
3509908;Cananéia;3550308;São Paulo;1;1;2;203
3510708;Cardoso;3550308;São Paulo;1;1;2;517
3511904;Clementina;3550308;São Paulo;1;1;2;449
3513306;Cruzália;3550308;São Paulo;1;1;2;433
3514957;Embaúba;3550308;São Paulo;1;1;2;371
3515129;Emilianópolis;3550308;São Paulo;1;1;2;530
3515194;Espírito Santo do Turvo;3550308;São Paulo;1;1;2;302
3515202;Estrela d'Oeste;3550308;São Paulo;1;1;2;531
3515350;Euclides da Cunha Paulista;3550308;São Paulo;1;1;2;616
3515657;Fernão;3550308;São Paulo;1;1;2;325
3515806;Flora Rica;3550308;São Paulo;1;1;2;527
3515905;Floreal;3550308;São Paulo;1;1;2;483
3516507;Gabriel Monteiro;3550308;São Paulo;1;1;2;460
3516804;Gastão Vidigal;3550308;São Paulo;1;1;2;477
3516903;General Salgado;3550308;São Paulo;1;1;2;501
3518008;Guarani d'Oeste;3550308;São Paulo;1;1;2;544
3518909;Guzolândia;3550308;São Paulo;1;1;2;524
3519006;Herculândia;3550308;São Paulo;1;1;2;420
3520426;Ilha Comprida;3550308;São Paulo;1;1;2;151
3520608;Indiana;3550308;São Paulo;1;1;2;495
3520707;Indiaporã;3550308;São Paulo;1;1;2;547
3521150;Ipiguá;3550308;São Paulo;1;1;2;435
3521200;Iporanga;3550308;São Paulo;1;1;2;224
3521507;Irapuã;3550308;São Paulo;1;1;2;383
3523701;Itirapuã;3550308;São Paulo;1;1;2;338
3523800;Itobi;3550308;São Paulo;1;1;2;215
3524204;Jaborandi;3550308;São Paulo;1;1;2;373
3525805;Júlio Mesquita;3550308;São Paulo;1;1;2;366
3526308;Lagoinha;3550308;São Paulo;1;1;2;161
3527009;Lindóia;3550308;São Paulo;1;1;2;127
3527702;Luiziânia;3550308;São Paulo;1;1;2;432
3528205;Macedônia;3550308;São Paulo;1;1;2;527
3528304;Magda;3550308;São Paulo;1;1;2;491
3528700;Marabá Paulista;3550308;São Paulo;1;1;2;565
3528858;Marapoama;3550308;São Paulo;1;1;2;365
3528908;Mariápolis;3550308;São Paulo;1;1;2;503
3529104;Marinópolis;3550308;São Paulo;1;1;2;552
3529609;Meridiano;3550308;São Paulo;1;1;2;509
3529658;Mesópolis;3550308;São Paulo;1;1;2;573
3529708;Miguelópolis;3550308;São Paulo;1;1;2;409
3530003;Mira Estrela;3550308;São Paulo;1;1;2;537
3532058;Motuca;3550308;São Paulo;1;1;2;282
3532108;Murutinga do Sul;3550308;São Paulo;1;1;2;553
3532702;Nipoã;3550308;São Paulo;1;1;2;438
3532801;Nova Aliança;3550308;São Paulo;1;1;2;410
3532843;Nova Canaã Paulista;3550308;São Paulo;1;1;2;565
3533007;Nova Granada;3550308;São Paulo;1;1;2;438
3533205;Nova Independência;3550308;São Paulo;1;1;2;565
3533304;Nova Luzitânia;3550308;São Paulo;1;1;2;479
3534203;Orindiúva;3550308;São Paulo;1;1;2;471
3534807;Ouro Verde;3550308;São Paulo;1;1;2;566
3535101;Palmares Paulista;3550308;São Paulo;1;1;2;360
3535200;Palmeira d'Oeste;3550308;São Paulo;1;1;2;548
3536307;Patrocínio Paulista;3550308;São Paulo;1;1;2;340
3536406;Paulicéia;3550308;São Paulo;1;1;2;584
3536901;Pedranópolis;3550308;São Paulo;1;1;2;518
3537206;Pedro de Toledo;3550308;São Paulo;1;1;2;91
3537701;Piacatu;3550308;São Paulo;1;1;2;460
3539509;Pitangueiras;3550308;São Paulo;1;1;2;333
3539707;Platina;3550308;São Paulo;1;1;2;378
3539905;Poloni;3550308;São Paulo;1;1;2;451
3540101;Pongaí;3550308;São Paulo;1;1;2;347
3540309;Pontes Gestal;3550308;São Paulo;1;1;2;496
3540408;Populina;3550308;São Paulo;1;1;2;566
3540754;Potim;3550308;São Paulo;1;1;2;167
3541802;Queiroz;3550308;São Paulo;1;1;2;418
3543105;Ribeirão Corrente;3550308;São Paulo;1;1;2;366
3543238;Ribeirão dos Índios;3550308;São Paulo;1;1;2;541
3544202;Riolândia;3550308;São Paulo;1;1;2;508
3544400;Rubiácea;3550308;São Paulo;1;1;2;488
3544707;Sagres;3550308;São Paulo;1;1;2;478
3544806;Sales;3550308;São Paulo;1;1;2;384
3544905;Sales Oliveira;3550308;São Paulo;1;1;2;341
3545100;Salmourão;3550308;São Paulo;1;1;2;482
3545704;Santa Albertina;3550308;São Paulo;1;1;2;574
3546108;Santa Clara d'Oeste;3550308;São Paulo;1;1;2;586
3547205;Santana da Ponte Pensa;3550308;São Paulo;1;1;2;562
3547908;Santo Antônio da Alegria;3550308;São Paulo;1;1;2;289
3548054;Santo Antônio do Aracanguá;3550308;São Paulo;1;1;2;491
3548302;Santo Expedito;3550308;São Paulo;1;1;2;520
3548401;Santópolis do Aguapeí;3550308;São Paulo;1;1;2;449
3549003;São Francisco;3550308;São Paulo;1;1;2;549
3549201;São João das Duas Pontes;3550308;São Paulo;1;1;2;521
3502200;Angatuba;3550209;São Miguel Arcanjo;1;1;2;60
3508009;Buri;3550209;São Miguel Arcanjo;1;1;2;61
3518503;Guareí;3550209;São Miguel Arcanjo;1;1;2;59
3526407;Laranjal Paulista;3550209;São Miguel Arcanjo;1;1;2;93
3532827;Nova Campina;3550209;São Miguel Arcanjo;1;1;2;96
3534401;Osasco;3550209;São Miguel Arcanjo;1;1;2;128
3545308;Salto de Pirapora;3550209;São Miguel Arcanjo;1;1;2;50
2301901;Barbalha;3550100;São Manuel;1;1;2;1935
2602902;Cabo de Santo Agostinho;3550100;São Manuel;1;1;2;2086
3170701;Varginha;3550100;São Manuel;1;1;2;351
3505203;Bariri;3550100;São Manuel;1;1;2;75
3507902;Brotas;3550100;São Manuel;1;1;2;67
3516200;Franca;3550100;São Manuel;1;1;2;270
3520004;Igaraçu do Tietê;3550100;São Manuel;1;1;2;25
3523404;Itatiba;3550100;São Manuel;1;1;2;181
3523503;Itatinga;3550100;São Manuel;1;1;2;41
3523909;Itu;3550100;São Manuel;1;1;2;145
3527108;Lins;3550100;São Manuel;1;1;2;169
3529302;Matão;3550100;São Manuel;1;1;2;127
3534401;Osasco;3550100;São Manuel;1;1;2;204
3536109;Pardinho;3550100;São Manuel;1;1;2;44
3536703;Pederneiras;3550100;São Manuel;1;1;2;47
3541604;Promissão;3550100;São Manuel;1;1;2;187
3546702;Santa Gertrudes;3550100;São Manuel;1;1;2;111
3549805;São José do Rio Preto;3550100;São Manuel;1;1;2;227
3304557;Rio de Janeiro;3550001;São Luís do Paraitinga;1;1;2;213
3520301;Iguape;3550001;São Luís do Paraitinga;1;1;2;284
3532405;Nazaré Paulista;3550001;São Luís do Paraitinga;1;1;2;111
3543907;Rio Claro;3550001;São Luís do Paraitinga;1;1;2;247
3547809;Santo André;3550001;São Luís do Paraitinga;1;1;2;134
1501303;Barcarena;3549953;São Lourenço da Serra;1;1;2;2477
2910057;Dias d'Ávila;3549953;São Lourenço da Serra;1;1;2;1507
2928604;Santo Amaro;3549953;São Lourenço da Serra;1;1;2;1491
3106705;Betim;3549953;São Lourenço da Serra;1;1;2;512
3128709;Guaxupé;3549953;São Lourenço da Serra;1;1;2;283
3301702;Duque de Caxias;3549953;São Lourenço da Serra;1;1;2;387
3513009;Cotia;3549953;São Lourenço da Serra;1;1;2;28
3515103;Embu-Guaçu;3549953;São Lourenço da Serra;1;1;2;14
3526209;Juquitiba;3549953;São Lourenço da Serra;1;1;2;15
3534401;Osasco;3549953;São Lourenço da Serra;1;1;2;39
3548500;Santos;3549953;São Lourenço da Serra;1;1;2;61
1100106;Guajará-Mirim;3549904;São José dos Campos;1;1;2;2363
1400100;Boa Vista;3549904;São José dos Campos;1;1;2;3225
1501402;Belém;3549904;São José dos Campos;1;1;2;2426
2100204;Alcântara;3549904;São José dos Campos;1;1;2;2307
2310803;Pereiro;3549904;São José dos Campos;1;1;2;2034
2507507;João Pessoa;3549904;São José dos Campos;1;1;2;2076
2602902;Cabo de Santo Agostinho;3549904;São José dos Campos;1;1;2;1966
2604106;Caruaru;3549904;São José dos Campos;1;1;2;1916
2607901;Jaboatão dos Guararapes;3549904;São José dos Campos;1;1;2;1981
2609600;Olinda;3549904;São José dos Campos;1;1;2;1999
2904605;Brumado;3549904;São José dos Campos;1;1;2;1081
2910800;Feira de Santana;3549904;São José dos Campos;1;1;2;1389
2922003;Mucuri;3549904;São José dos Campos;1;1;2;858
3104007;Araxá;3549904;São José dos Campos;1;1;2;414
3110509;Camanducaia;3549904;São José dos Campos;1;1;2;56
3122702;Dom Silvério;3549904;São José dos Campos;1;1;2;448
3131307;Ipatinga;3549904;São José dos Campos;1;1;2;533
3136702;Juiz de Fora;3549904;São José dos Campos;1;1;2;305
3138203;Lavras;3549904;São José dos Campos;1;1;2;236
3146107;Ouro Preto;3549904;São José dos Campos;1;1;2;392
3149309;Pedro Leopoldo;3549904;São José dos Campos;1;1;2;438
3151800;Poços de Caldas;3549904;São José dos Campos;1;1;2;172
3159605;Santa Rita do Sapucaí;3549904;São José dos Campos;1;1;2;106
3168606;Teófilo Otoni;3549904;São José dos Campos;1;1;2;737
3171204;Vespasiano;3549904;São José dos Campos;1;1;2;435
3202603;Iconha;3549904;São José dos Campos;1;1;2;580
3205200;Vila Velha;3549904;São José dos Campos;1;1;2;643
3205309;Vitória;3549904;São José dos Campos;1;1;2;653
3300308;Barra do Piraí;3549904;São José dos Campos;1;1;2;225
3301900;Itaboraí;3549904;São José dos Campos;1;1;2;313
3302254;Itatiaia;3549904;São José dos Campos;1;1;2;154
3303203;Nilópolis;3549904;São José dos Campos;1;1;2;254
3303807;Parati;3549904;São José dos Campos;1;1;2;119
3304110;Porto Real;3549904;São José dos Campos;1;1;2;182
3503208;Araraquara;3549904;São José dos Campos;1;1;2;280
3504008;Assis;3549904;São José dos Campos;1;1;2;470
3505302;Barra Bonita;3549904;São José dos Campos;1;1;2;284
3505500;Barretos;3549904;São José dos Campos;1;1;2;401
3507001;Boituva;3549904;São José dos Campos;1;1;2;183
3508603;Cachoeira Paulista;3549904;São José dos Campos;1;1;2;107
3511409;Cerqueira César;3549904;São José dos Campos;1;1;2;336
3520004;Igaraçu do Tietê;3549904;São José dos Campos;1;1;2;283
3520202;Igaratá;3549904;São José dos Campos;1;1;2;28
3520400;Ilhabela;3549904;São José dos Campos;1;1;2;84
3522406;Itapeva;3549904;São José dos Campos;1;1;2;320
3522604;Itapira;3549904;São José dos Campos;1;1;2;128
3524006;Itupeva;3549904;São José dos Campos;1;1;2;120
3527306;Louveira;3549904;São José dos Campos;1;1;2;111
3527603;Luís Antônio;3549904;São José dos Campos;1;1;2;260
3530300;Mirassol;3549904;São José dos Campos;1;1;2;453
3530805;Moji-Mirim;3549904;São José dos Campos;1;1;2;140
3534609;Osvaldo Cruz;3549904;São José dos Campos;1;1;2;532
3536208;Pariquera-Açu;3549904;São José dos Campos;1;1;2;265
3538709;Piracicaba;3549904;São José dos Campos;1;1;2;187
3541406;Presidente Prudente;3549904;São José dos Campos;1;1;2;574
3542305;Redenção da Serra;3549904;São José dos Campos;1;1;2;36
3544301;Roseira;3549904;São José dos Campos;1;1;2;68
3545803;Santa Bárbara d'Oeste;3549904;São José dos Campos;1;1;2;164
3546009;Santa Branca;3549904;São José dos Campos;1;1;2;22
3546801;Santa Isabel;3549904;São José dos Campos;1;1;2;37
3549102;São João da Boa Vista;3549904;São José dos Campos;1;1;2;166
3549607;São José do Barreiro;3549904;São José dos Campos;1;1;2;147
1100023;Ariquemes;3549805;São José do Rio Preto;1;1;2;1833
1100106;Guajará-Mirim;3549805;São José do Rio Preto;1;1;2;1960
1100122;Ji-Paraná;3549805;São José do Rio Preto;1;1;2;1676
1200401;Rio Branco;3549805;São José do Rio Preto;1;1;2;2218
1500602;Altamira;3549805;São José do Rio Preto;1;1;2;1974
1504208;Marabá;3549805;São José do Rio Preto;1;1;2;1710
1504422;Marituba;3549805;São José do Rio Preto;1;1;2;2156
1505536;Parauapebas;3549805;São José do Rio Preto;1;1;2;1640
1508357;Vitória do Xingu;3549805;São José do Rio Preto;1;1;2;2002
1600303;Macapá;3549805;São José do Rio Preto;1;1;2;2318
1702109;Araguaína;3549805;São José do Rio Preto;1;1;2;1513
1721000;Palmas;3549805;São José do Rio Preto;1;1;2;1163
2101400;Balsas;3549805;São José do Rio Preto;1;1;2;1512
2105302;Imperatriz;3549805;São José do Rio Preto;1;1;2;1705
2109007;Porto Franco;3549805;São José do Rio Preto;1;1;2;1614
2304400;Fortaleza;3549805;São José do Rio Preto;1;1;2;2179
2412005;São Gonçalo do Amarante;3549805;São José do Rio Preto;1;1;2;2184
2504009;Campina Grande;3549805;São José do Rio Preto;1;1;2;2030
2704302;Maceió;3549805;São José do Rio Preto;1;1;2;1855
2800308;Aracaju;3549805;São José do Rio Preto;1;1;2;1663
2804805;Nossa Senhora do Socorro;3549805;São José do Rio Preto;1;1;2;1662
2917359;Jaborandi;3549805;São José do Rio Preto;1;1;2;944
2927408;Salvador;3549805;São José do Rio Preto;1;1;2;1411
3106705;Betim;3549805;São José do Rio Preto;1;1;2;549
3127008;Fronteira;3549805;São José do Rio Preto;1;1;2;65
3136702;Juiz de Fora;3549805;São José do Rio Preto;1;1;2;641
3138625;Limeira do Oeste;3549805;São José do Rio Preto;1;1;2;187
3151800;Poços de Caldas;3549805;São José do Rio Preto;1;1;2;316
3152501;Pouso Alegre;3549805;São José do Rio Preto;1;1;2;392
3164704;São Sebastião do Paraíso;3549805;São José do Rio Preto;1;1;2;251
3171204;Vespasiano;3549805;São José do Rio Preto;1;1;2;580
3201506;Colatina;3549805;São José do Rio Preto;1;1;2;921
3301702;Duque de Caxias;3549805;São José do Rio Preto;1;1;2;672
3303302;Niterói;3549805;São José do Rio Preto;1;1;2;698
3303906;Petrópolis;3549805;São José do Rio Preto;1;1;2;674
3304508;Rio das Flores;3549805;São José do Rio Preto;1;1;2;626
3305505;Saquarema;3549805;São José do Rio Preto;1;1;2;760
3500105;Adamantina;3549805;São José do Rio Preto;1;1;2;201
3501806;Américo de Campos;3549805;São José do Rio Preto;1;1;2;68
3504107;Atibaia;3549805;São José do Rio Preto;1;1;2;392
3504800;Bálsamo;3549805;São José do Rio Preto;1;1;2;22
3505302;Barra Bonita;3549805;São José do Rio Preto;1;1;2;205
3507407;Borborema;3549805;São José do Rio Preto;1;1;2;94
3507803;Brodowski;3549805;São José do Rio Preto;1;1;2;182
3508108;Buritama;3549805;São José do Rio Preto;1;1;2;83
3508306;Cabrália Paulista;3549805;São José do Rio Preto;1;1;2;181
3510401;Capivari;3549805;São José do Rio Preto;1;1;2;311
3510708;Cardoso;3549805;São José do Rio Preto;1;1;2;101
3511409;Cerqueira César;3549805;São José do Rio Preto;1;1;2;246
3515905;Floreal;3549805;São José do Rio Preto;1;1;2;80
3516903;General Salgado;3549805;São José do Rio Preto;1;1;2;102
3518602;Guariba;3549805;São José do Rio Preto;1;1;2;136
3518701;Guarujá;3549805;São José do Rio Preto;1;1;2;478
3518909;Guzolândia;3549805;São José do Rio Preto;1;1;2;133
3520400;Ilhabela;3549805;São José do Rio Preto;1;1;2;536
3520442;Ilha Solteira;3549805;São José do Rio Preto;1;1;2;207
3522406;Itapeva;3549805;São José do Rio Preto;1;1;2;353
3522505;Itapevi;3549805;São José do Rio Preto;1;1;2;396
3523107;Itaquaquecetuba;3549805;São José do Rio Preto;1;1;2;435
3523404;Itatiba;3549805;São José do Rio Preto;1;1;2;361
3523602;Itirapina;3549805;São José do Rio Preto;1;1;2;228
3525201;Jarinu;3549805;São José do Rio Preto;1;1;2;377
3527405;Lucélia;3549805;São José do Rio Preto;1;1;2;196
3528403;Mairinque;3549805;São José do Rio Preto;1;1;2;381
3529203;Martinópolis;3549805;São José do Rio Preto;1;1;2;236
3530409;Mirassolândia;3549805;São José do Rio Preto;1;1;2;27
3530805;Moji-Mirim;3549805;São José do Rio Preto;1;1;2;310
3531506;Monte Azul Paulista;3549805;São José do Rio Preto;1;1;2;79
3532504;Neves Paulista;3549805;São José do Rio Preto;1;1;2;24
3532603;Nhandeara;3549805;São José do Rio Preto;1;1;2;68
3532801;Nova Aliança;3549805;São José do Rio Preto;1;1;2;24
3535101;Palmares Paulista;3549805;São José do Rio Preto;1;1;2;65
3535903;Paranapuã;3549805;São José do Rio Preto;1;1;2;151
3536901;Pedranópolis;3549805;São José do Rio Preto;1;1;2;103
3538006;Pindamonhangaba;3549805;São José do Rio Preto;1;1;2;474
3540309;Pontes Gestal;3549805;São José do Rio Preto;1;1;2;81
3541000;Praia Grande;3549805;São José do Rio Preto;1;1;2;473
3542008;Quintana;3549805;São José do Rio Preto;1;1;2;168
3546108;Santa Clara d'Oeste;3549805;São José do Rio Preto;1;1;2;181
3546405;Santa Cruz do Rio Pardo;3549805;São José do Rio Preto;1;1;2;231
3549102;São João da Boa Vista;3549805;São José do Rio Preto;1;1;2;298
2607901;Jaboatão dos Guararapes;3549706;São José do Rio Pardo;1;1;2;1906
2910800;Feira de Santana;3549706;São José do Rio Pardo;1;1;2;1304
2930709;Simões Filho;3549706;São José do Rio Pardo;1;1;2;1298
3101607;Alfenas;3549706;São José do Rio Pardo;1;1;2;99
3104007;Araxá;3549706;São José do Rio Pardo;1;1;2;222
3104106;Arceburgo;3549706;São José do Rio Pardo;1;1;2;26
3104205;Arcos;3549706;São José do Rio Pardo;1;1;2;200
3106200;Belo Horizonte;3549706;São José do Rio Pardo;1;1;2;354
3108404;Botelhos;3549706;São José do Rio Pardo;1;1;2;51
3111002;Campestre;3549706;São José do Rio Pardo;1;1;2;68
3128303;Guaranésia;3549706;São José do Rio Pardo;1;1;2;34
3132404;Itajubá;3549706;São José do Rio Pardo;1;1;2;173
3138203;Lavras;3549706;São José do Rio Pardo;1;1;2;199
3143302;Montes Claros;3549706;São José do Rio Pardo;1;1;2;620
3152501;Pouso Alegre;3549706;São José do Rio Pardo;1;1;2;119
3164704;São Sebastião do Paraíso;3549706;São José do Rio Pardo;1;1;2;75
3501004;Altinópolis;3549706;São José do Rio Pardo;1;1;2;81
3501905;Amparo;3549706;São José do Rio Pardo;1;1;2;123
3502804;Araçatuba;3549706;São José do Rio Pardo;1;1;2;371
3505708;Barueri;3549706;São José do Rio Pardo;1;1;2;212
3520509;Indaiatuba;3549706;São José do Rio Pardo;1;1;2;170
3522307;Itapetininga;3549706;São José do Rio Pardo;1;1;2;251
3525904;Jundiaí;3549706;São José do Rio Pardo;1;1;2;175
3527108;Lins;3549706;São José do Rio Pardo;1;1;2;299
3527306;Louveira;3549706;São José do Rio Pardo;1;1;2;164
3529302;Matão;3549706;São José do Rio Pardo;1;1;2;156
3534401;Osasco;3549706;São José do Rio Pardo;1;1;2;215
3538709;Piracicaba;3549706;São José do Rio Pardo;1;1;2;150
3538808;Piraju;3549706;São José do Rio Pardo;1;1;2;314
3543402;Ribeirão Preto;3549706;São José do Rio Pardo;1;1;2;106
3543907;Rio Claro;3549706;São José do Rio Pardo;1;1;2;114
3547601;Santa Rosa de Viterbo;3549706;São José do Rio Pardo;1;1;2;51
3513405;Cruzeiro;3549607;São José do Barreiro;1;1;2;40
3505906;Batatais;3549508;São José da Bela Vista;1;1;2;33
3543402;Ribeirão Preto;3549508;São José da Bela Vista;1;1;2;64
3549409;São Joaquim da Barra;3549508;São José da Bela Vista;1;1;2;24
2506301;Guarabira;3549409;São Joaquim da Barra;1;1;2;1969
2604106;Caruaru;3549409;São Joaquim da Barra;1;1;2;1817
2919553;Luís Eduardo magalhães;3549409;São Joaquim da Barra;1;1;2;963
3104007;Araxá;3549409;São Joaquim da Barra;1;1;2;147
3127107;Frutal;3549409;São Joaquim da Barra;1;1;2;127
3152808;Prata;3549409;São Joaquim da Barra;1;1;2;183
3156908;Sacramento;3549409;São Joaquim da Barra;1;1;2;93
3162708;São João do Paraíso;3549409;São Joaquim da Barra;1;1;2;838
3169307;Três Corações;3549409;São Joaquim da Barra;1;1;2;301
3505708;Barueri;3549409;São Joaquim da Barra;1;1;2;339
3507803;Brodowski;3549409;São Joaquim da Barra;1;1;2;49
3513108;Cravinhos;3549409;São Joaquim da Barra;1;1;2;84
3531407;Monte Aprazível;3549409;São Joaquim da Barra;1;1;2;193
3534401;Osasco;3549409;São Joaquim da Barra;1;1;2;345
3537008;Pedregulho;3549409;São Joaquim da Barra;1;1;2;56
3540200;Pontal;3549409;São Joaquim da Barra;1;1;2;50
3540705;Porto Ferreira;3549409;São Joaquim da Barra;1;1;2;145
3545209;Salto;3549409;São Joaquim da Barra;1;1;2;295
3547502;Santa Rita do Passa Quatro;3549409;São Joaquim da Barra;1;1;2;130
3533502;Novo Horizonte;3549300;São João do Pau d'Alho;1;1;2;255
2604106;Caruaru;3549102;São João da Boa Vista;1;1;2;1859
2611606;Recife;3549102;São João da Boa Vista;1;1;2;1936
3101409;Albertina;3549102;São João da Boa Vista;1;1;2;33
3104007;Araxá;3549102;São João da Boa Vista;1;1;2;263
3104106;Arceburgo;3549102;São João da Boa Vista;1;1;2;68
3106200;Belo Horizonte;3549102;São João da Boa Vista;1;1;2;369
3107109;Boa Esperança;3549102;São João da Boa Vista;1;1;2;160
3108404;Botelhos;3549102;São João da Boa Vista;1;1;2;56
3111002;Campestre;3549102;São João da Boa Vista;1;1;2;65
3118601;Contagem;3549102;São João da Boa Vista;1;1;2;360
3131505;Ipuiúna;3549102;São João da Boa Vista;1;1;2;66
3143401;Monte Sião;3549102;São João da Boa Vista;1;1;2;58
3152501;Pouso Alegre;3549102;São João da Boa Vista;1;1;2;93
3170206;Uberlândia;3549102;São João da Boa Vista;1;1;2;370
3200904;Barra de São Francisco;3549102;São João da Boa Vista;1;1;2;699
3201308;Cariacica;3549102;São João da Boa Vista;1;1;2;681
3205002;Serra;3549102;São João da Boa Vista;1;1;2;698
3501905;Amparo;3549102;São João da Boa Vista;1;1;2;82
3502804;Araçatuba;3549102;São João da Boa Vista;1;1;2;385
3511102;Catanduva;3549102;São João da Boa Vista;1;1;2;242
3525904;Jundiaí;3549102;São João da Boa Vista;1;1;2;135
3526704;Leme;3549102;São João da Boa Vista;1;1;2;66
3536505;Paulínia;3549102;São João da Boa Vista;1;1;2;95
3538105;Pindorama;3549102;São João da Boa Vista;1;1;2;233
3545209;Salto;3549102;São João da Boa Vista;1;1;2;146
3545803;Santa Bárbara d'Oeste;3549102;São João da Boa Vista;1;1;2;108
3547809;Santo André;3549102;São João da Boa Vista;1;1;2;189
3514205;Dolcinópolis;3549003;São Francisco;1;1;2;31
3524808;Jales;3549003;São Francisco;1;1;2;20
2611606;Recife;3548906;São Carlos;1;1;2;2009
3126109;Formiga;3548906;São Carlos;1;1;2;307
3134202;Ituiutaba;3548906;São Carlos;1;1;2;374
3143302;Montes Claros;3548906;São Carlos;1;1;2;714
3147204;Paraguaçu;3548906;São Carlos;1;1;2;229
3148004;Patos de Minas;3548906;São Carlos;1;1;2;407
3156908;Sacramento;3548906;São Carlos;1;1;2;244
3167202;Sete Lagoas;3548906;São Carlos;1;1;2;472
3205002;Serra;3548906;São Carlos;1;1;2;806
3301702;Duque de Caxias;3548906;São Carlos;1;1;2;481
3304904;São Gonçalo;3548906;São Carlos;1;1;2;507
3305109;São João de Meriti;3548906;São Carlos;1;1;2;475
3500501;Águas de Lindóia;3548906;São Carlos;1;1;2;140
3504107;Atibaia;3548906;São Carlos;1;1;2;185
3505500;Barretos;3548906;São Carlos;1;1;2;178
3507605;Bragança Paulista;3548906;São Carlos;1;1;2;172
3507704;Braúna;3548906;São Carlos;1;1;2;256
3507803;Brodowski;3548906;São Carlos;1;1;2;117
3508405;Cabreúva;3548906;São Carlos;1;1;2;163
3509205;Cajamar;3548906;São Carlos;1;1;2;181
3510401;Capivari;3548906;São Carlos;1;1;2;115
3512001;Colina;3548906;São Carlos;1;1;2;160
3512407;Cordeirópolis;3548906;São Carlos;1;1;2;68
3514106;Dois Córregos;3548906;São Carlos;1;1;2;63
3517109;Glicério;3548906;São Carlos;1;1;2;249
3517208;Guaiçara;3548906;São Carlos;1;1;2;201
3518602;Guariba;3548906;São Carlos;1;1;2;81
3519071;Hortolândia;3548906;São Carlos;1;1;2;116
3520509;Indaiatuba;3548906;São Carlos;1;1;2;136
3521903;Itajobi;3548906;São Carlos;1;1;2;143
3522307;Itapetininga;3548906;São Carlos;1;1;2;173
3522703;Itápolis;3548906;São Carlos;1;1;2;106
3523206;Itararé;3548906;São Carlos;1;1;2;275
3524303;Jaboticabal;3548906;São Carlos;1;1;2;95
3524709;Jaguariúna;3548906;São Carlos;1;1;2;121
3527207;Lorena;3548906;São Carlos;1;1;2;301
3529005;Marília;3548906;São Carlos;1;1;2;213
3530706;Mogi Guaçu;3548906;São Carlos;1;1;2;103
3534708;Ourinhos;3548906;São Carlos;1;1;2;233
3539806;Poá;3548906;São Carlos;1;1;2;230
3542404;Regente Feijó;3548906;São Carlos;1;1;2;353
3545803;Santa Bárbara d'Oeste;3548906;São Carlos;1;1;2;95
1505536;Parauapebas;3548807;São Caetano do Sul;1;1;2;1974
2111300;São Luís;3548807;São Caetano do Sul;1;1;2;2343
2211001;Teresina;3548807;São Caetano do Sul;1;1;2;2082
2303709;Caucaia;3548807;São Caetano do Sul;1;1;2;2330
2304285;Eusébio;3548807;São Caetano do Sul;1;1;2;2320
2407104;Macaíba;3548807;São Caetano do Sul;1;1;2;2249
2408003;Mossoró;3548807;São Caetano do Sul;1;1;2;2228
2607208;Ipojuca;3548807;São Caetano do Sul;1;1;2;2026
2609600;Olinda;3548807;São Caetano do Sul;1;1;2;2071
2900702;Alagoinhas;3548807;São Caetano do Sul;1;1;2;1503
2906501;Candeias;3548807;São Caetano do Sul;1;1;2;1447
2908408;Conceição do Coité;3548807;São Caetano do Sul;1;1;2;1523
2911709;Guanambi;3548807;São Caetano do Sul;1;1;2;1098
2918001;Jequié;3548807;São Caetano do Sul;1;1;2;1261
2918407;Juazeiro;3548807;São Caetano do Sul;1;1;2;1673
2924009;Paulo Afonso;3548807;São Caetano do Sul;1;1;2;1767
2930501;Serrinha;3548807;São Caetano do Sul;1;1;2;1519
2930709;Simões Filho;3548807;São Caetano do Sul;1;1;2;1444
3103504;Araguari;3548807;São Caetano do Sul;1;1;2;574
3115508;Caxambu;3548807;São Caetano do Sul;1;1;2;244
3117801;Conceição dos Ouros;3548807;São Caetano do Sul;1;1;2;154
3120904;Curvelo;3548807;São Caetano do Sul;1;1;2;577
3126109;Formiga;3548807;São Caetano do Sul;1;1;2;367
3131901;Itabirito;3548807;São Caetano do Sul;1;1;2;459
3133808;Itaúna;3548807;São Caetano do Sul;1;1;2;437
3134202;Ituiutaba;3548807;São Caetano do Sul;1;1;2;590
3134905;Jacutinga;3548807;São Caetano do Sul;1;1;2;147
3136207;João Monlevade;3548807;São Caetano do Sul;1;1;2;542
3144805;Nova Lima;3548807;São Caetano do Sul;1;1;2;483
3147105;Pará de Minas;3548807;São Caetano do Sul;1;1;2;460
3152105;Ponte Nova;3548807;São Caetano do Sul;1;1;2;512
3162500;São João del Rei;3548807;São Caetano do Sul;1;1;2;358
3162922;São Joaquim de Bicas;3548807;São Caetano do Sul;1;1;2;457
3165206;São Thomé das Letras;3548807;São Caetano do Sul;1;1;2;264
3171204;Vespasiano;3548807;São Caetano do Sul;1;1;2;508
3202405;Guarapari;3548807;São Caetano do Sul;1;1;2;690
3204906;São Mateus;3548807;São Caetano do Sul;1;1;2;860
3302700;Maricá;3548807;São Caetano do Sul;1;1;2;389
3302858;Mesquita;3548807;São Caetano do Sul;1;1;2;330
3303807;Parati;3548807;São Caetano do Sul;1;1;2;193
3304300;Rio Bonito;3548807;São Caetano do Sul;1;1;2;413
3306206;Vassouras;3548807;São Caetano do Sul;1;1;2;324
3501152;Alumínio;3548807;São Caetano do Sul;1;1;2;71
3502507;Aparecida;3548807;São Caetano do Sul;1;1;2;160
3503802;Artur Nogueira;3548807;São Caetano do Sul;1;1;2;130
3507407;Borborema;3548807;São Caetano do Sul;1;1;2;336
3508504;Caçapava;3548807;São Caetano do Sul;1;1;2;104
3515186;Espírito Santo do Pinhal;3548807;São Caetano do Sul;1;1;2;158
3518305;Guararema;3548807;São Caetano do Sul;1;1;2;57
3520400;Ilhabela;3548807;São Caetano do Sul;1;1;2;125
3524006;Itupeva;3548807;São Caetano do Sul;1;1;2;71
3524709;Jaguariúna;3548807;São Caetano do Sul;1;1;2;109
3524907;Jambeiro;3548807;São Caetano do Sul;1;1;2;98
3526209;Juquitiba;3548807;São Caetano do Sul;1;1;2;62
3527603;Luís Antônio;3548807;São Caetano do Sul;1;1;2;255
3530508;Mococa;3548807;São Caetano do Sul;1;1;2;242
3537107;Pedreira;3548807;São Caetano do Sul;1;1;2;102
3540606;Porto Feliz;3548807;São Caetano do Sul;1;1;2;107
3547007;Santa Maria da Serra;3548807;São Caetano do Sul;1;1;2;199
1100205;Porto Velho;3548708;São Bernardo do Campo;1;1;2;2367
1200401;Rio Branco;3548708;São Bernardo do Campo;1;1;2;2581
1502400;Castanhal;3548708;São Bernardo do Campo;1;1;2;2483
1507102;São Caetano de Odivelas;3548708;São Bernardo do Campo;1;1;2;2544
1721000;Palmas;3548708;São Bernardo do Campo;1;1;2;1489
2211001;Teresina;3548708;São Bernardo do Campo;1;1;2;2093
2300200;Acaraú;3548708;São Bernardo do Campo;1;1;2;2387
2305233;Horizonte;3548708;São Bernardo do Campo;1;1;2;2309
2307304;Juazeiro do Norte;3548708;São Bernardo do Campo;1;1;2;1958
2307650;Maracanaú;3548708;São Bernardo do Campo;1;1;2;2329
2312403;São Gonçalo do Amarante;3548708;São Bernardo do Campo;1;1;2;2345
2312908;Sobral;3548708;São Bernardo do Campo;1;1;2;2299
2403251;Parnamirim;3548708;São Bernardo do Campo;1;1;2;2258
2408003;Mossoró;3548708;São Bernardo do Campo;1;1;2;2239
2504009;Campina Grande;3548708;São Bernardo do Campo;1;1;2;2104
2600054;Abreu e Lima;3548708;São Bernardo do Campo;1;1;2;2090
2602902;Cabo de Santo Agostinho;3548708;São Bernardo do Campo;1;1;2;2048
2606200;Goiana;3548708;São Bernardo do Campo;1;1;2;2116
2609600;Olinda;3548708;São Bernardo do Campo;1;1;2;2081
2910057;Dias d'Ávila;3548708;São Bernardo do Campo;1;1;2;1476
2923209;Oliveira dos Brejinhos;3548708;São Bernardo do Campo;1;1;2;1312
2930709;Simões Filho;3548708;São Bernardo do Campo;1;1;2;1455
3115300;Cataguases;3548708;São Bernardo do Campo;1;1;2;473
3117702;Conceição do Rio Verde;3548708;São Bernardo do Campo;1;1;2;254
3120805;Cruzília;3548708;São Bernardo do Campo;1;1;2;275
3129806;Ibirité;3548708;São Bernardo do Campo;1;1;2;482
3131307;Ipatinga;3548708;São Bernardo do Campo;1;1;2;621
3131703;Itabira;3548708;São Bernardo do Campo;1;1;2;564
3133600;Itapeva;3548708;São Bernardo do Campo;1;1;2;112
3140704;Mateus Leme;3548708;São Bernardo do Campo;1;1;2;467
3141108;Matozinhos;3548708;São Bernardo do Campo;1;1;2;525
3144805;Nova Lima;3548708;São Bernardo do Campo;1;1;2;493
3145901;Ouro Branco;3548708;São Bernardo do Campo;1;1;2;459
3151800;Poços de Caldas;3548708;São Bernardo do Campo;1;1;2;216
3152600;Pouso Alto;3548708;São Bernardo do Campo;1;1;2;235
3154606;Ribeirão das Neves;3548708;São Bernardo do Campo;1;1;2;504
3167004;Serranos;3548708;São Bernardo do Campo;1;1;2;291
3171204;Vespasiano;3548708;São Bernardo do Campo;1;1;2;519
3200904;Barra de São Francisco;3548708;São Bernardo do Campo;1;1;2;790
3203320;Marataízes;3548708;São Bernardo do Campo;1;1;2;647
3302007;Itaguaí;3548708;São Bernardo do Campo;1;1;2;299
3302254;Itatiaia;3548708;São Bernardo do Campo;1;1;2;244
3302403;Macaé;3548708;São Bernardo do Campo;1;1;2;499
3304904;São Gonçalo;3548708;São Bernardo do Campo;1;1;2;372
3305802;Teresópolis;3548708;São Bernardo do Campo;1;1;2;390
3306107;Valença;3548708;São Bernardo do Campo;1;1;2;332
3503307;Araras;3548708;São Bernardo do Campo;1;1;2;171
3504107;Atibaia;3548708;São Bernardo do Campo;1;1;2;67
3504503;Avaré;3548708;São Bernardo do Campo;1;1;2;248
3506359;Bertioga;3548708;São Bernardo do Campo;1;1;2;45
3509452;Campina do Monte Alegre;3548708;São Bernardo do Campo;1;1;2;193
3509601;Campo Limpo Paulista;3548708;São Bernardo do Campo;1;1;2;60
3509809;Campos Novos Paulista;3548708;São Bernardo do Campo;1;1;2;369
3510401;Capivari;3548708;São Bernardo do Campo;1;1;2;123
3510500;Caraguatatuba;3548708;São Bernardo do Campo;1;1;2;115
3511409;Cerqueira César;3548708;São Bernardo do Campo;1;1;2;273
3512803;Cosmópolis;3548708;São Bernardo do Campo;1;1;2;134
3513108;Cravinhos;3548708;São Bernardo do Campo;1;1;2;288
3515103;Embu-Guaçu;3548708;São Bernardo do Campo;1;1;2;26
3515707;Ferraz de Vasconcelos;3548708;São Bernardo do Campo;1;1;2;29
3519600;Ibitinga;3548708;São Bernardo do Campo;1;1;2;315
3522208;Itapecerica da Serra;3548708;São Bernardo do Campo;1;1;2;27
3522307;Itapetininga;3548708;São Bernardo do Campo;1;1;2;150
3523206;Itararé;3548708;São Bernardo do Campo;1;1;2;285
3523602;Itirapina;3548708;São Bernardo do Campo;1;1;2;205
3524600;Jacupiranga;3548708;São Bernardo do Campo;1;1;2;181
3524709;Jaguariúna;3548708;São Bernardo do Campo;1;1;2;119
3525102;Jardinópolis;3548708;São Bernardo do Campo;1;1;2;322
3526803;Lençóis Paulista;3548708;São Bernardo do Campo;1;1;2;258
3527108;Lins;3548708;São Bernardo do Campo;1;1;2;394
3527207;Lorena;3548708;São Bernardo do Campo;1;1;2;187
3528403;Mairinque;3548708;São Bernardo do Campo;1;1;2;64
3529500;Mendonça;3548708;São Bernardo do Campo;1;1;2;414
3531209;Monte Alegre do Sul;3548708;São Bernardo do Campo;1;1;2;115
3531803;Monte Mor;3548708;São Bernardo do Campo;1;1;2;113
3531902;Morro Agudo;3548708;São Bernardo do Campo;1;1;2;363
3534609;Osvaldo Cruz;3548708;São Bernardo do Campo;1;1;2;484
3537305;Penápolis;3548708;São Bernardo do Campo;1;1;2;434
3537404;Pereira Barreto;3548708;São Bernardo do Campo;1;1;2;570
3538808;Piraju;3548708;São Bernardo do Campo;1;1;2;291
3539301;Pirassununga;3548708;São Bernardo do Campo;1;1;2;208
3541406;Presidente Prudente;3548708;São Bernardo do Campo;1;1;2;518
3544103;Rio Grande da Serra;3548708;São Bernardo do Campo;1;1;2;19
3548609;São Bento do Sapucaí;3548708;São Bernardo do Campo;1;1;2;143
3152501;Pouso Alegre;3548609;São Bento do Sapucaí;1;1;2;57
3159605;Santa Rita do Sapucaí;3548609;São Bento do Sapucaí;1;1;2;48
3508504;Caçapava;3548609;São Bento do Sapucaí;1;1;2;46
3522208;Itapecerica da Serra;3548609;São Bento do Sapucaí;1;1;2;162
3534401;Osasco;3548609;São Bento do Sapucaí;1;1;2;144
1501303;Barcarena;3548500;Santos;1;1;2;2486
1502400;Castanhal;3548500;Santos;1;1;2;2504
1600303;Macapá;3548500;Santos;1;1;2;2691
2211001;Teresina;3548500;Santos;1;1;2;2109
2304285;Eusébio;3548500;Santos;1;1;2;2342
2312403;São Gonçalo do Amarante;3548500;Santos;1;1;2;2356
2408003;Mossoró;3548500;Santos;1;1;2;2247
2408102;Natal;3548500;Santos;1;1;2;2273
2602902;Cabo de Santo Agostinho;3548500;Santos;1;1;2;2051
2607208;Ipojuca;3548500;Santos;1;1;2;2038
2609600;Olinda;3548500;Santos;1;1;2;2084
2800605;Barra dos Coqueiros;3548500;Santos;1;1;2;1708
2903201;Barreiras;3548500;Santos;1;1;2;1300
2905701;Camaçari;3548500;Santos;1;1;2;1470
2910057;Dias d'Ávila;3548500;Santos;1;1;2;1479
3101607;Alfenas;3548500;Santos;1;1;2;279
3103504;Araguari;3548500;Santos;1;1;2;611
3113404;Caratinga;3548500;Santos;1;1;2;615
3114303;Carmo do Paranaíba;3548500;Santos;1;1;2;541
3115003;Cascalho Rico;3548500;Santos;1;1;2;608
3116605;Cláudio;3548500;Santos;1;1;2;414
3118601;Contagem;3548500;Santos;1;1;2;496
3121258;Delta;3548500;Santos;1;1;2;462
3136702;Juiz de Fora;3548500;Santos;1;1;2;386
3139508;Manhumirim;3548500;Santos;1;1;2;590
3145604;Oliveira;3548500;Santos;1;1;2;385
3147907;Passos;3548500;Santos;1;1;2;355
3148004;Patos de Minas;3548500;Santos;1;1;2;589
3149309;Pedro Leopoldo;3548500;Santos;1;1;2;527
3151503;Piumhi;3548500;Santos;1;1;2;381
3159605;Santa Rita do Sapucaí;3548500;Santos;1;1;2;193
3200607;Aracruz;3548500;Santos;1;1;2;759
3203205;Linhares;3548500;Santos;1;1;2;808
3203908;Nova Venécia;3548500;Santos;1;1;2;827
3205069;Venda Nova do Imigrante;3548500;Santos;1;1;2;656
3300407;Barra Mansa;3548500;Santos;1;1;2;265
3301850;Guapimirim;3548500;Santos;1;1;2;373
3303302;Niterói;3548500;Santos;1;1;2;348
3303500;Nova Iguaçu;3548500;Santos;1;1;2;318
3304904;São Gonçalo;3548500;Santos;1;1;2;355
3306305;Volta Redonda;3548500;Santos;1;1;2;275
3502754;Araçariguama;3548500;Santos;1;1;2;88
3504008;Assis;3548500;Santos;1;1;2;437
3505906;Batatais;3548500;Santos;1;1;2;356
3506201;Bento de Abreu;3548500;Santos;1;1;2;536
3506805;Bocaina;3548500;Santos;1;1;2;293
3506904;Bofete;3548500;Santos;1;1;2;213
3507902;Brotas;3548500;Santos;1;1;2;253
3508405;Cabreúva;3548500;Santos;1;1;2;103
3511102;Catanduva;3548500;Santos;1;1;2;404
3512803;Cosmópolis;3548500;Santos;1;1;2;163
3516705;Garça;3548500;Santos;1;1;2;382
3518305;Guararema;3548500;Santos;1;1;2;61
3519303;Ibaté;3548500;Santos;1;1;2;272
3522307;Itapetininga;3548500;Santos;1;1;2;176
3523305;Itariri;3548500;Santos;1;1;2;95
3523404;Itatiba;3548500;Santos;1;1;2;110
3524808;Jales;3548500;Santos;1;1;2;582
3526100;Juquiá;3548500;Santos;1;1;2;143
3530300;Mirassol;3548500;Santos;1;1;2;467
3531803;Monte Mor;3548500;Santos;1;1;2;144
3532009;Morungaba;3548500;Santos;1;1;2;121
3533403;Nova Odessa;3548500;Santos;1;1;2;158
3536505;Paulínia;3548500;Santos;1;1;2;150
3538600;Piracaia;3548500;Santos;1;1;2;93
3541059;Pratânia;3548500;Santos;1;1;2;264
3541406;Presidente Prudente;3548500;Santos;1;1;2;546
3545209;Salto;3548500;Santos;1;1;2;122
3545308;Salto de Pirapora;3548500;Santos;1;1;2;127
3545803;Santa Bárbara d'Oeste;3548500;Santos;1;1;2;166
3546801;Santa Isabel;3548500;Santos;1;1;2;66
3547007;Santa Maria da Serra;3548500;Santos;1;1;2;235
3547502;Santa Rita do Passa Quatro;3548500;Santos;1;1;2;268
3506508;Birigui;3548401;Santópolis do Aguapeí;1;1;2;40
3534609;Osvaldo Cruz;3548401;Santópolis do Aguapeí;1;1;2;43
3547809;Santo André;3548401;Santópolis do Aguapeí;1;1;2;470
3548054;Santo Antônio do Aracanguá;3548401;Santópolis do Aguapeí;1;1;2;78
3152501;Pouso Alegre;3548104;Santo Antônio do Jardim;1;1;2;76
3501608;Americana;3548104;Santo Antônio do Jardim;1;1;2;97
3520509;Indaiatuba;3548104;Santo Antônio do Jardim;1;1;2;123
3534401;Osasco;3548104;Santo Antônio do Jardim;1;1;2;157
3543402;Ribeirão Preto;3548104;Santo Antônio do Jardim;1;1;2;157
3106705;Betim;3548054;Santo Antônio do Aracanguá;1;1;2;663
3122306;Divinópolis;3548054;Santo Antônio do Aracanguá;1;1;2;589
3170701;Varginha;3548054;Santo Antônio do Aracanguá;1;1;2;535
3304557;Rio de Janeiro;3548054;Santo Antônio do Aracanguá;1;1;2;788
3514403;Dracena;3548054;Santo Antônio do Aracanguá;1;1;2;128
3525706;José Bonifácio;3548054;Santo Antônio do Aracanguá;1;1;2;85
3537305;Penápolis;3548054;Santo Antônio do Aracanguá;1;1;2;71
3538006;Pindamonhangaba;3548054;Santo Antônio do Aracanguá;1;1;2;571
3539004;Pirangi;3548054;Santo Antônio do Aracanguá;1;1;2;192
2304400;Fortaleza;3548005;Santo Antônio de Posse;1;1;2;2241
2401453;Baraúna;3548005;Santo Antônio de Posse;1;1;2;2145
2927408;Salvador;3548005;Santo Antônio de Posse;1;1;2;1358
3106200;Belo Horizonte;3548005;Santo Antônio de Posse;1;1;2;424
3106705;Betim;3548005;Santo Antônio de Posse;1;1;2;404
3135050;Jaíba;3548005;Santo Antônio de Posse;1;1;2;869
3303906;Petrópolis;3548005;Santo Antônio de Posse;1;1;2;380
3503703;Ariranha;3548005;Santo Antônio de Posse;1;1;2;247
3510401;Capivari;3548005;Santo Antônio de Posse;1;1;2;74
3510807;Casa Branca;3548005;Santo Antônio de Posse;1;1;2;94
3512209;Conchal;3548005;Santo Antônio de Posse;1;1;2;40
3515152;Engenheiro Coelho;3548005;Santo Antônio de Posse;1;1;2;33
3522604;Itapira;3548005;Santo Antônio de Posse;1;1;2;21
3538709;Piracicaba;3548005;Santo Antônio de Posse;1;1;2;76
3145109;Nova Resende;3547908;Santo Antônio da Alegria;1;1;2;76
3505906;Batatais;3547908;Santo Antônio da Alegria;1;1;2;53
3540200;Pontal;3547908;Santo Antônio da Alegria;1;1;2;92
1501303;Barcarena;3547809;Santo André;1;1;2;2457
1501402;Belém;3547809;Santo André;1;1;2;2470
1505536;Parauapebas;3547809;Santo André;1;1;2;1979
1721000;Palmas;3547809;Santo André;1;1;2;1482
2111300;São Luís;3547809;Santo André;1;1;2;2346
2304400;Fortaleza;3547809;Santo André;1;1;2;2333
2305233;Horizonte;3547809;Santo André;1;1;2;2300
2402600;Ceará-Mirim;3547809;Santo André;1;1;2;2268
2503704;Cajazeiras;3547809;Santo André;1;1;2;2010
2602902;Cabo de Santo Agostinho;3547809;Santo André;1;1;2;2040
2607802;Itaquitinga;3547809;Santo André;1;1;2;2092
2612208;Salgueiro;3547809;Santo André;1;1;2;1863
2903201;Barreiras;3547809;Santo André;1;1;2;1275
2906501;Candeias;3547809;Santo André;1;1;2;1448
2913903;Ipiaú;3547809;Santo André;1;1;2;1256
2929503;São Sebastião do Passé;3547809;Santo André;1;1;2;1465
2933307;Vitória da Conquista;3547809;Santo André;1;1;2;1124
3101607;Alfenas;3547809;Santo André;1;1;2;255
3107901;Bom Repouso;3547809;Santo André;1;1;2;136
3111200;Campo Belo;3547809;Santo André;1;1;2;331
3119401;Coronel Fabriciano;3547809;Santo André;1;1;2;603
3127701;Governador Valadares;3547809;Santo André;1;1;2;704
3131307;Ipatinga;3547809;Santo André;1;1;2;612
3134905;Jacutinga;3547809;Santo André;1;1;2;151
3136207;João Monlevade;3547809;Santo André;1;1;2;543
3138625;Limeira do Oeste;3547809;Santo André;1;1;2;610
3143401;Monte Sião;3547809;Santo André;1;1;2;135
3145000;Nova Ponte;3547809;Santo André;1;1;2;513
3147303;Paraisópolis;3547809;Santo André;1;1;2;143
3147907;Passos;3547809;Santo André;1;1;2;326
3151800;Poços de Caldas;3547809;Santo André;1;1;2;208
3163706;São Lourenço;3547809;Santo André;1;1;2;228
3167202;Sete Lagoas;3547809;Santo André;1;1;2;520
3170107;Uberaba;3547809;Santo André;1;1;2;454
3201209;Cachoeiro de Itapemirim;3547809;Santo André;1;1;2;632
3205309;Vitória;3547809;Santo André;1;1;2;732
3300308;Barra do Piraí;3547809;Santo André;1;1;2;304
3301009;Campos dos Goytacazes;3547809;Santo André;1;1;2;566
3301900;Itaboraí;3547809;Santo André;1;1;2;387
3302254;Itatiaia;3547809;Santo André;1;1;2;236
3303302;Niterói;3547809;Santo André;1;1;2;359
3304110;Porto Real;3547809;Santo André;1;1;2;263
3304524;Rio das Ostras;3547809;Santo André;1;1;2;483
3304904;São Gonçalo;3547809;Santo André;1;1;2;365
3305109;São João de Meriti;3547809;Santo André;1;1;2;334
3306305;Volta Redonda;3547809;Santo André;1;1;2;278
3502309;Anhembi;3547809;Santo André;1;1;2;189
3502705;Apiaí;3547809;Santo André;1;1;2;255
3503307;Araras;3547809;Santo André;1;1;2;167
3504008;Assis;3547809;Santo André;1;1;2;412
3504503;Avaré;3547809;Santo André;1;1;2;252
3506359;Bertioga;3547809;Santo André;1;1;2;43
3507001;Boituva;3547809;Santo André;1;1;2;123
3509007;Caieiras;3547809;Santo André;1;1;2;38
3510203;Capão Bonito;3547809;Santo André;1;1;2;190
3515004;Embu;3547809;Santo André;1;1;2;33
3515202;Estrela d'Oeste;3547809;Santo André;1;1;2;539
3515509;Fernandópolis;3547809;Santo André;1;1;2;529
3516200;Franca;3547809;Santo André;1;1;2;355
3521101;Ipeúna;3547809;Santo André;1;1;2;180
3521705;Itaberá;3547809;Santo André;1;1;2;267
3522109;Itanhaém;3547809;Santo André;1;1;2;65
3522208;Itapecerica da Serra;3547809;Santo André;1;1;2;33
3522505;Itapevi;3547809;Santo André;1;1;2;44
3523107;Itaquaquecetuba;3547809;Santo André;1;1;2;26
3523909;Itu;3547809;Santo André;1;1;2;88
3524006;Itupeva;3547809;Santo André;1;1;2;77
3525300;Jaú;3547809;Santo André;1;1;2;257
3527306;Louveira;3547809;Santo André;1;1;2;77
3527603;Luís Antônio;3547809;Santo André;1;1;2;260
3530706;Mogi Guaçu;3547809;Santo André;1;1;2;152
3531308;Monte Alto;3547809;Santo André;1;1;2;328
3532009;Morungaba;3547809;Santo André;1;1;2;89
3533502;Novo Horizonte;3547809;Santo André;1;1;2;364
3537909;Pilar do Sul;3547809;Santo André;1;1;2;122
3539301;Pirassununga;3547809;Santo André;1;1;2;204
3540606;Porto Feliz;3547809;Santo André;1;1;2;112
3541406;Presidente Prudente;3547809;Santo André;1;1;2;521
3542602;Registro;3547809;Santo André;1;1;2;168
3546405;Santa Cruz do Rio Pardo;3547809;Santo André;1;1;2;326
3547007;Santa Maria da Serra;3547809;Santo André;1;1;2;204
3547304;Santana de Parnaíba;3547809;Santo André;1;1;2;45
3104106;Arceburgo;3547700;Santo Anastácio;1;1;2;490
3532207;Narandiba;3547700;Santo Anastácio;1;1;2;49
3534401;Osasco;3547700;Santo Anastácio;1;1;2;534
3537701;Piacatu;3547700;Santo Anastácio;1;1;2;117
2605202;Escada;3547601;Santa Rosa de Viterbo;1;1;2;1894
2927408;Salvador;3547601;Santa Rosa de Viterbo;1;1;2;1300
3104007;Araxá;3547601;Santa Rosa de Viterbo;1;1;2;213
3304557;Rio de Janeiro;3547601;Santa Rosa de Viterbo;1;1;2;455
3509502;Campinas;3547601;Santa Rosa de Viterbo;1;1;2;161
3513108;Cravinhos;3547601;Santa Rosa de Viterbo;1;1;2;41
3516200;Franca;3547601;Santa Rosa de Viterbo;1;1;2;103
3518800;Guarulhos;3547601;Santa Rosa de Viterbo;1;1;2;233
3525102;Jardinópolis;3547601;Santa Rosa de Viterbo;1;1;2;65
3527603;Luís Antônio;3547601;Santa Rosa de Viterbo;1;1;2;36
3534401;Osasco;3547601;Santa Rosa de Viterbo;1;1;2;236
3539301;Pirassununga;3547601;Santa Rosa de Viterbo;1;1;2;60
3540705;Porto Ferreira;3547601;Santa Rosa de Viterbo;1;1;2;44
3546306;Santa Cruz das Palmeiras;3547601;Santa Rosa de Viterbo;1;1;2;41
3547304;Santana de Parnaíba;3547601;Santa Rosa de Viterbo;1;1;2;223
1302603;Manaus;3547502;Santa Rita do Passa Quatro;1;1;2;2406
1500800;Ananindeua;3547502;Santa Rita do Passa Quatro;1;1;2;2252
2107506;Paço do Lumiar;3547502;Santa Rita do Passa Quatro;1;1;2;2147
2704302;Maceió;3547502;Santa Rita do Passa Quatro;1;1;2;1780
2927408;Salvador;3547502;Santa Rita do Passa Quatro;1;1;2;1326
2933307;Vitória da Conquista;3547502;Santa Rita do Passa Quatro;1;1;2;1013
3134905;Jacutinga;3547502;Santa Rita do Passa Quatro;1;1;2;110
3506102;Bebedouro;3547502;Santa Rita do Passa Quatro;1;1;2;139
3512001;Colina;3547502;Santa Rita do Passa Quatro;1;1;2;156
3512100;Colômbia;3547502;Santa Rita do Passa Quatro;1;1;2;208
3513108;Cravinhos;3547502;Santa Rita do Passa Quatro;1;1;2;48
3516200;Franca;3547502;Santa Rita do Passa Quatro;1;1;2;130
3517406;Guaíra;3547502;Santa Rita do Passa Quatro;1;1;2;176
3518602;Guariba;3547502;Santa Rita do Passa Quatro;1;1;2;87
3524303;Jaboticabal;3547502;Santa Rita do Passa Quatro;1;1;2;99
3526902;Limeira;3547502;Santa Rita do Passa Quatro;1;1;2;95
3529302;Matão;3547502;Santa Rita do Passa Quatro;1;1;2;96
3529708;Miguelópolis;3547502;Santa Rita do Passa Quatro;1;1;2;179
3531506;Monte Azul Paulista;3547502;Santa Rita do Passa Quatro;1;1;2;149
3534401;Osasco;3547502;Santa Rita do Passa Quatro;1;1;2;214
3543907;Rio Claro;3547502;Santa Rita do Passa Quatro;1;1;2;78
3534401;Osasco;3547403;Santa Rita d'Oeste;1;1;2;569
3541604;Promissão;3547403;Santa Rita d'Oeste;1;1;2;185
1200401;Rio Branco;3547304;Santana de Parnaíba;1;1;2;2541
1303536;Presidente Figueiredo;3547304;Santana de Parnaíba;1;1;2;2692
1500602;Altamira;3547304;Santana de Parnaíba;1;1;2;2302
1501303;Barcarena;3547304;Santana de Parnaíba;1;1;2;2432
1501501;Benevides;3547304;Santana de Parnaíba;1;1;2;2446
1600303;Macapá;3547304;Santana de Parnaíba;1;1;2;2633
2105302;Imperatriz;3547304;Santana de Parnaíba;1;1;2;1985
2301901;Barbalha;3547304;Santana de Parnaíba;1;1;2;1933
2306256;Itaitinga;3547304;Santana de Parnaíba;1;1;2;2305
2307304;Juazeiro do Norte;3547304;Santana de Parnaíba;1;1;2;1943
2307650;Maracanaú;3547304;Santana de Parnaíba;1;1;2;2312
2312403;São Gonçalo do Amarante;3547304;Santana de Parnaíba;1;1;2;2327
2403251;Parnamirim;3547304;Santana de Parnaíba;1;1;2;2250
2404507;Guamaré;3547304;Santana de Parnaíba;1;1;2;2278
2408003;Mossoró;3547304;Santana de Parnaíba;1;1;2;2226
2412005;São Gonçalo do Amarante;3547304;Santana de Parnaíba;1;1;2;2258
2503209;Cabedelo;3547304;Santana de Parnaíba;1;1;2;2165
2504603;Conde;3547304;Santana de Parnaíba;1;1;2;2143
2604106;Caruaru;3547304;Santana de Parnaíba;1;1;2;1991
2606804;Igarassu;3547304;Santana de Parnaíba;1;1;2;2088
2611101;Petrolina;3547304;Santana de Parnaíba;1;1;2;1686
2803807;Malhada dos Bois;3547304;Santana de Parnaíba;1;1;2;1752
2804805;Nossa Senhora do Socorro;3547304;Santana de Parnaíba;1;1;2;1694
2804904;Pacatuba;3547304;Santana de Parnaíba;1;1;2;1758
2913606;Ilhéus;3547304;Santana de Parnaíba;1;1;2;1232
2919207;Lauro de Freitas;3547304;Santana de Parnaíba;1;1;2;1446
2922003;Mucuri;3547304;Santana de Parnaíba;1;1;2;953
2925303;Porto Seguro;3547304;Santana de Parnaíba;1;1;2;1099
3122306;Divinópolis;3547304;Santana de Parnaíba;1;1;2;417
3126307;Fortaleza de Minas;3547304;Santana de Parnaíba;1;1;2;288
3127602;Gouveia;3547304;Santana de Parnaíba;1;1;2;640
3128709;Guaxupé;3547304;Santana de Parnaíba;1;1;2;238
3131307;Ipatinga;3547304;Santana de Parnaíba;1;1;2;623
3140704;Mateus Leme;3547304;Santana de Parnaíba;1;1;2;458
3143302;Montes Claros;3547304;Santana de Parnaíba;1;1;2;803
3145059;Nova Porteirinha;3547304;Santana de Parnaíba;1;1;2;919
3148004;Patos de Minas;3547304;Santana de Parnaíba;1;1;2;540
3152501;Pouso Alegre;3547304;Santana de Parnaíba;1;1;2;168
3171204;Vespasiano;3547304;Santana de Parnaíba;1;1;2;512
3200607;Aracruz;3547304;Santana de Parnaíba;1;1;2;781
3201209;Cachoeiro de Itapemirim;3547304;Santana de Parnaíba;1;1;2;658
3201506;Colatina;3547304;Santana de Parnaíba;1;1;2;767
3202405;Guarapari;3547304;Santana de Parnaíba;1;1;2;714
3204906;São Mateus;3547304;Santana de Parnaíba;1;1;2;878
3300100;Angra dos Reis;3547304;Santana de Parnaíba;1;1;2;274
3300209;Araruama;3547304;Santana de Parnaíba;1;1;2;470
3300407;Barra Mansa;3547304;Santana de Parnaíba;1;1;2;295
3301900;Itaboraí;3547304;Santana de Parnaíba;1;1;2;421
3302007;Itaguaí;3547304;Santana de Parnaíba;1;1;2;324
3302502;Magé;3547304;Santana de Parnaíba;1;1;2;403
3303302;Niterói;3547304;Santana de Parnaíba;1;1;2;394
3304300;Rio Bonito;3547304;Santana de Parnaíba;1;1;2;445
3304524;Rio das Ostras;3547304;Santana de Parnaíba;1;1;2;517
3304904;São Gonçalo;3547304;Santana de Parnaíba;1;1;2;399
3305208;São Pedro da Aldeia;3547304;Santana de Parnaíba;1;1;2;495
3305802;Teresópolis;3547304;Santana de Parnaíba;1;1;2;413
3503208;Araraquara;3547304;Santana de Parnaíba;1;1;2;223
3503307;Araras;3547304;Santana de Parnaíba;1;1;2;129
3504107;Atibaia;3547304;Santana de Parnaíba;1;1;2;52
3507605;Bragança Paulista;3547304;Santana de Parnaíba;1;1;2;67
3509601;Campo Limpo Paulista;3547304;Santana de Parnaíba;1;1;2;30
3509700;Campos do Jordão;3547304;Santana de Parnaíba;1;1;2;159
3510104;Cândido Rodrigues;3547304;Santana de Parnaíba;1;1;2;292
3513108;Cravinhos;3547304;Santana de Parnaíba;1;1;2;247
3515186;Espírito Santo do Pinhal;3547304;Santana de Parnaíba;1;1;2;140
3518305;Guararema;3547304;Santana de Parnaíba;1;1;2;89
3518404;Guaratinguetá;3547304;Santana de Parnaíba;1;1;2;191
3522307;Itapetininga;3547304;Santana de Parnaíba;1;1;2;117
3522505;Itapevi;3547304;Santana de Parnaíba;1;1;2;11
3523909;Itu;3547304;Santana de Parnaíba;1;1;2;43
3524006;Itupeva;3547304;Santana de Parnaíba;1;1;2;35
3526803;Lençóis Paulista;3547304;Santana de Parnaíba;1;1;2;215
3527306;Louveira;3547304;Santana de Parnaíba;1;1;2;41
3530300;Mirassol;3547304;Santana de Parnaíba;1;1;2;392
3530706;Mogi Guaçu;3547304;Santana de Parnaíba;1;1;2;124
3533908;Olímpia;3547304;Santana de Parnaíba;1;1;2;360
3534609;Osvaldo Cruz;3547304;Santana de Parnaíba;1;1;2;442
3536505;Paulínia;3547304;Santana de Parnaíba;1;1;2;79
3541653;Quadra;3547304;Santana de Parnaíba;1;1;2;117
3545209;Salto;3547304;Santana de Parnaíba;1;1;2;46
3545605;Santa Adélia;3547205;Santana da Ponte Pensa;1;1;2;236
3533502;Novo Horizonte;3547106;Santa Mercedes;1;1;2;263
3205200;Vila Velha;3547007;Santa Maria da Serra;1;1;2;833
3205309;Vitória;3547007;Santa Maria da Serra;1;1;2;842
3304557;Rio de Janeiro;3547007;Santa Maria da Serra;1;1;2;506
3503307;Araras;3547007;Santa Maria da Serra;1;1;2;84
3507902;Brotas;3547007;Santa Maria da Serra;1;1;2;32
3510401;Capivari;3547007;Santa Maria da Serra;1;1;2;82
3525300;Jaú;3547007;Santa Maria da Serra;1;1;2;53
1721000;Palmas;3546801;Santa Isabel;1;1;2;1449
3106200;Belo Horizonte;3546801;Santa Isabel;1;1;2;441
3304201;Resende;3546801;Santa Isabel;1;1;2;201
3505708;Barueri;3546801;Santa Isabel;1;1;2;70
3507001;Boituva;3546801;Santa Isabel;1;1;2;148
3509452;Campina do Monte Alegre;3546801;Santa Isabel;1;1;2;233
3518404;Guaratinguetá;3546801;Santa Isabel;1;1;2;121
3522703;Itápolis;3546801;Santa Isabel;1;1;2;325
3524402;Jacareí;3546801;Santa Isabel;1;1;2;28
3529401;Mauá;3546801;Santa Isabel;1;1;2;46
3539806;Poá;3546801;Santa Isabel;1;1;2;26
3544301;Roseira;3546801;Santa Isabel;1;1;2;104
3545209;Salto;3546801;Santa Isabel;1;1;2;110
3501608;Americana;3546702;Santa Gertrudes;1;1;2;37
3502002;Analândia;3546702;Santa Gertrudes;1;1;2;39
3503307;Araras;3546702;Santa Gertrudes;1;1;2;19
3509502;Campinas;3546702;Santa Gertrudes;1;1;2;69
3518602;Guariba;3546702;Santa Gertrudes;1;1;2;141
3530706;Mogi Guaçu;3546702;Santa Gertrudes;1;1;2;61
3534401;Osasco;3546702;Santa Gertrudes;1;1;2;142
3540903;Pradópolis;3546702;Santa Gertrudes;1;1;2;133
3541000;Praia Grande;3546702;Santa Gertrudes;1;1;2;207
1718204;Porto Nacional;3546603;Santa Fé do Sul;1;1;2;1084
3170107;Uberaba;3546603;Santa Fé do Sul;1;1;2;324
3500105;Adamantina;3546603;Santa Fé do Sul;1;1;2;165
3505500;Barretos;3546603;Santa Fé do Sul;1;1;2;254
3505708;Barueri;3546603;Santa Fé do Sul;1;1;2;568
3506102;Bebedouro;3546603;Santa Fé do Sul;1;1;2;268
3508108;Buritama;3546603;Santa Fé do Sul;1;1;2;130
3513801;Diadema;3546603;Santa Fé do Sul;1;1;2;601
3515608;Fernando Prestes;3546603;Santa Fé do Sul;1;1;2;268
3516200;Franca;3546603;Santa Fé do Sul;1;1;2;376
3530300;Mirassol;3546603;Santa Fé do Sul;1;1;2;167
3534401;Osasco;3546603;Santa Fé do Sul;1;1;2;576
3535200;Palmeira d'Oeste;3546603;Santa Fé do Sul;1;1;2;33
3544509;Rubinéia;3546603;Santa Fé do Sul;1;1;2;6
3518602;Guariba;3546504;Santa Ernestina;1;1;2;20
2304400;Fortaleza;3546405;Santa Cruz do Rio Pardo;1;1;2;2380
3164704;São Sebastião do Paraíso;3546405;Santa Cruz do Rio Pardo;1;1;2;347
3170107;Uberaba;3546405;Santa Cruz do Rio Pardo;1;1;2;390
3502200;Angatuba;3546405;Santa Cruz do Rio Pardo;1;1;2;141
3505708;Barueri;3546405;Santa Cruz do Rio Pardo;1;1;2;292
3506003;Bauru;3546405;Santa Cruz do Rio Pardo;1;1;2;84
3508009;Buri;3546405;Santa Cruz do Rio Pardo;1;1;2;146
3509502;Campinas;3546405;Santa Cruz do Rio Pardo;1;1;2;264
3511409;Cerqueira César;3546405;Santa Cruz do Rio Pardo;1;1;2;50
3511607;Cesário Lange;3546405;Santa Cruz do Rio Pardo;1;1;2;176
3513009;Cotia;3546405;Santa Cruz do Rio Pardo;1;1;2;290
3515194;Espírito Santo do Turvo;3546405;Santa Cruz do Rio Pardo;1;1;2;31
3516200;Franca;3546405;Santa Cruz do Rio Pardo;1;1;2;346
3516705;Garça;3546405;Santa Cruz do Rio Pardo;1;1;2;75
3521705;Itaberá;3546405;Santa Cruz do Rio Pardo;1;1;2;118
3521804;Itaí;3546405;Santa Cruz do Rio Pardo;1;1;2;80
3522406;Itapeva;3546405;Santa Cruz do Rio Pardo;1;1;2;142
3522802;Itaporanga;3546405;Santa Cruz do Rio Pardo;1;1;2;91
3523206;Itararé;3546405;Santa Cruz do Rio Pardo;1;1;2;137
3523503;Itatinga;3546405;Santa Cruz do Rio Pardo;1;1;2;107
3526803;Lençóis Paulista;3546405;Santa Cruz do Rio Pardo;1;1;2;89
3528007;Macatuba;3546405;Santa Cruz do Rio Pardo;1;1;2;104
3528601;Manduri;3546405;Santa Cruz do Rio Pardo;1;1;2;34
3528700;Marabá Paulista;3546405;Santa Cruz do Rio Pardo;1;1;2;254
3528809;Maracaí;3546405;Santa Cruz do Rio Pardo;1;1;2;111
3529302;Matão;3546405;Santa Cruz do Rio Pardo;1;1;2;191
3529906;Miracatu;3546405;Santa Cruz do Rio Pardo;1;1;2;271
3535309;Palmital;3546405;Santa Cruz do Rio Pardo;1;1;2;61
3543204;Ribeirão do Sul;3546405;Santa Cruz do Rio Pardo;1;1;2;33
3545209;Salto;3546405;Santa Cruz do Rio Pardo;1;1;2;243
3104007;Araxá;3546306;Santa Cruz das Palmeiras;1;1;2;250
3500402;Águas da Prata;3546306;Santa Cruz das Palmeiras;1;1;2;56
3501905;Amparo;3546306;Santa Cruz das Palmeiras;1;1;2;109
3502002;Analândia;3546306;Santa Cruz das Palmeiras;1;1;2;54
3508702;Caconde;3546306;Santa Cruz das Palmeiras;1;1;2;71
3509403;Cajuru;3546306;Santa Cruz das Palmeiras;1;1;2;61
3509502;Campinas;3546306;Santa Cruz das Palmeiras;1;1;2;120
3513900;Divinolândia;3546306;Santa Cruz das Palmeiras;1;1;2;56
3514601;Dumont;3546306;Santa Cruz das Palmeiras;1;1;2;99
3515186;Espírito Santo do Pinhal;3546306;Santa Cruz das Palmeiras;1;1;2;66
3518602;Guariba;3546306;Santa Cruz das Palmeiras;1;1;2;114
3522604;Itapira;3546306;Santa Cruz das Palmeiras;1;1;2;81
3523800;Itobi;3546306;Santa Cruz das Palmeiras;1;1;2;30
3523909;Itu;3546306;Santa Cruz das Palmeiras;1;1;2;161
3524709;Jaguariúna;3546306;Santa Cruz das Palmeiras;1;1;2;101
3526704;Leme;3546306;Santa Cruz das Palmeiras;1;1;2;43
3526902;Limeira;3546306;Santa Cruz das Palmeiras;1;1;2;83
3530805;Moji-Mirim;3546306;Santa Cruz das Palmeiras;1;1;2;73
3537107;Pedreira;3546306;Santa Cruz das Palmeiras;1;1;2;108
3539400;Piratininga;3546306;Santa Cruz das Palmeiras;1;1;2;206
3543402;Ribeirão Preto;3546306;Santa Cruz das Palmeiras;1;1;2;94
3543907;Rio Claro;3546306;Santa Cruz das Palmeiras;1;1;2;72
3545209;Salto;3546306;Santa Cruz das Palmeiras;1;1;2;152
3144805;Nova Lima;3546207;Santa Cruz da Conceição;1;1;2;438
3513702;Descalvado;3546207;Santa Cruz da Conceição;1;1;2;29
3503703;Ariranha;3546108;Santa Clara d'Oeste;1;1;2;258
3524006;Itupeva;3546108;Santa Clara d'Oeste;1;1;2;533
3545605;Santa Adélia;3546108;Santa Clara d'Oeste;1;1;2;259
3150307;Piedade do Rio Grande;3546009;Santa Branca;1;1;2;274
3513801;Diadema;3546009;Santa Branca;1;1;2;81
3530607;Moji das Cruzes;3546009;Santa Branca;1;1;2;36
3534401;Osasco;3546009;Santa Branca;1;1;2;94
1302603;Manaus;3545803;Santa Bárbara d'Oeste;1;1;2;2502
1600303;Macapá;3545803;Santa Bárbara d'Oeste;1;1;2;2551
2304400;Fortaleza;3545803;Santa Bárbara d'Oeste;1;1;2;2274
2503209;Cabedelo;3545803;Santa Bárbara d'Oeste;1;1;2;2135
2607752;Itapissuma;3545803;Santa Bárbara d'Oeste;1;1;2;2066
2927408;Salvador;3545803;Santa Bárbara d'Oeste;1;1;2;1401
3106705;Betim;3545803;Santa Bárbara d'Oeste;1;1;2;451
3118601;Contagem;3545803;Santa Bárbara d'Oeste;1;1;2;462
3143401;Monte Sião;3545803;Santa Bárbara d'Oeste;1;1;2;93
3146008;Ouro Fino;3545803;Santa Bárbara d'Oeste;1;1;2;119
3170206;Uberlândia;3545803;Santa Bárbara d'Oeste;1;1;2;435
3171204;Vespasiano;3545803;Santa Bárbara d'Oeste;1;1;2;490
3203908;Nova Venécia;3545803;Santa Bárbara d'Oeste;1;1;2;840
3205200;Vila Velha;3545803;Santa Bárbara d'Oeste;1;1;2;766
3306107;Valença;3545803;Santa Bárbara d'Oeste;1;1;2;381
3306305;Volta Redonda;3545803;Santa Bárbara d'Oeste;1;1;2;341
3502309;Anhembi;3545803;Santa Bárbara d'Oeste;1;1;2;75
3503208;Araraquara;3545803;Santa Bárbara d'Oeste;1;1;2;132
3507506;Botucatu;3545803;Santa Bárbara d'Oeste;1;1;2;106
3511607;Cesário Lange;3545803;Santa Bárbara d'Oeste;1;1;2;76
3511706;Charqueada;3545803;Santa Bárbara d'Oeste;1;1;2;46
3512308;Conchas;3545803;Santa Bárbara d'Oeste;1;1;2;68
3512407;Cordeirópolis;3545803;Santa Bárbara d'Oeste;1;1;2;30
3514908;Elias Fausto;3545803;Santa Bárbara d'Oeste;1;1;2;32
3516309;Francisco Morato;3545803;Santa Bárbara d'Oeste;1;1;2;90
3518800;Guarulhos;3545803;Santa Bárbara d'Oeste;1;1;2;116
3519600;Ibitinga;3545803;Santa Bárbara d'Oeste;1;1;2;183
3521002;Iperó;3545803;Santa Bárbara d'Oeste;1;1;2;72
3523602;Itirapina;3545803;Santa Bárbara d'Oeste;1;1;2;70
3524006;Itupeva;3545803;Santa Bárbara d'Oeste;1;1;2;57
3524709;Jaguariúna;3545803;Santa Bárbara d'Oeste;1;1;2;44
3528403;Mairinque;3545803;Santa Bárbara d'Oeste;1;1;2;91
3530300;Mirassol;3545803;Santa Bárbara d'Oeste;1;1;2;303
3530706;Mogi Guaçu;3545803;Santa Bárbara d'Oeste;1;1;2;67
3533908;Olímpia;3545803;Santa Bárbara d'Oeste;1;1;2;269
3538006;Pindamonhangaba;3545803;Santa Bárbara d'Oeste;1;1;2;201
3540002;Pompéia;3545803;Santa Bárbara d'Oeste;1;1;2;292
3544004;Rio das Pedras;3545803;Santa Bárbara d'Oeste;1;1;2;22
3114550;Carneirinho;3545704;Santa Albertina;1;1;2;37
3503703;Ariranha;3545704;Santa Albertina;1;1;2;241
3524808;Jales;3545704;Santa Albertina;1;1;2;33
3304557;Rio de Janeiro;3545605;Santa Adélia;1;1;2;606
3510104;Cândido Rodrigues;3545605;Santa Adélia;1;1;2;20
3515202;Estrela d'Oeste;3545605;Santa Adélia;1;1;2;196
3522307;Itapetininga;3545605;Santa Adélia;1;1;2;271
3529302;Matão;3545605;Santa Adélia;1;1;2;58
3533254;Novais;3545605;Santa Adélia;1;1;2;30
3534401;Osasco;3545605;Santa Adélia;1;1;2;330
3535705;Paraíso;3545605;Santa Adélia;1;1;2;25
3540408;Populina;3545605;Santa Adélia;1;1;2;229
3544509;Rubinéia;3545605;Santa Adélia;1;1;2;258
3515350;Euclides da Cunha Paulista;3545506;Sandovalina;1;1;2;86
3532207;Narandiba;3545506;Sandovalina;1;1;2;25
3304557;Rio de Janeiro;3545407;Salto Grande;1;1;2;690
3502804;Araçatuba;3545407;Salto Grande;1;1;2;191
3510005;Cândido Mota;3545407;Salto Grande;1;1;2;44
2304400;Fortaleza;3545308;Salto de Pirapora;1;1;2;2369
2600054;Abreu e Lima;3545308;Salto de Pirapora;1;1;2;2139
2918407;Juazeiro;3545308;Salto de Pirapora;1;1;2;1714
2927408;Salvador;3545308;Salto de Pirapora;1;1;2;1483
3205200;Vila Velha;3545308;Salto de Pirapora;1;1;2;814
3505708;Barueri;3545308;Salto de Pirapora;1;1;2;73
3522307;Itapetininga;3545308;Salto de Pirapora;1;1;2;49
3527207;Lorena;3545308;Salto de Pirapora;1;1;2;273
3535804;Paranapanema;3545308;Salto de Pirapora;1;1;2;124
3538709;Piracicaba;3545308;Salto de Pirapora;1;1;2;100
3545209;Salto;3545308;Salto de Pirapora;1;1;2;58
1501303;Barcarena;3545209;Salto;1;1;2;2403
1501402;Belém;3545209;Salto;1;1;2;2416
2208650;Queimada Nova;3545209;Salto;1;1;2;1718
2602902;Cabo de Santo Agostinho;3545209;Salto;1;1;2;2045
2606804;Igarassu;3545209;Salto;1;1;2;2088
2607208;Ipojuca;3545209;Salto;1;1;2;2032
2607901;Jaboatão dos Guararapes;3545209;Salto;1;1;2;2059
2610707;Paulista;3545209;Salto;1;1;2;2083
2905701;Camaçari;3545209;Salto;1;1;2;1464
3101607;Alfenas;3545209;Salto;1;1;2;241
3102605;Andradas;3545209;Salto;1;1;2;145
3104205;Arcos;3545209;Salto;1;1;2;367
3110608;Cambuí;3545209;Salto;1;1;2;140
3125101;Extrema;3545209;Salto;1;1;2;106
3128709;Guaxupé;3545209;Salto;1;1;2;218
3131307;Ipatinga;3545209;Salto;1;1;2;633
3132404;Itajubá;3545209;Salto;1;1;2;205
3137205;Lagoa da Prata;3545209;Salto;1;1;2;395
3138203;Lavras;3545209;Salto;1;1;2;319
3139003;Machado;3545209;Salto;1;1;2;219
3146008;Ouro Fino;3545209;Salto;1;1;2;138
3147907;Passos;3545209;Salto;1;1;2;284
3148905;Pedra do Indaiá;3545209;Salto;1;1;2;388
3151800;Poços de Caldas;3545209;Salto;1;1;2;176
3152501;Pouso Alegre;3545209;Salto;1;1;2;175
3159605;Santa Rita do Sapucaí;3545209;Salto;1;1;2;193
3163706;São Lourenço;3545209;Salto;1;1;2;260
3164704;São Sebastião do Paraíso;3545209;Salto;1;1;2;254
3168002;Taiobeiras;3545209;Salto;1;1;2;961
3169307;Três Corações;3545209;Salto;1;1;2;270
3170206;Uberlândia;3545209;Salto;1;1;2;486
3205309;Vitória;3545209;Salto;1;1;2;779
3300100;Angra dos Reis;3545209;Salto;1;1;2;308
3300308;Barra do Piraí;3545209;Salto;1;1;2;363
3300407;Barra Mansa;3545209;Salto;1;1;2;324
3300456;Belford Roxo;3545209;Salto;1;1;2;400
3301900;Itaboraí;3545209;Salto;1;1;2;455
3302007;Itaguaí;3545209;Salto;1;1;2;358
3302858;Mesquita;3545209;Salto;1;1;2;395
3303203;Nilópolis;3545209;Salto;1;1;2;396
3303500;Nova Iguaçu;3545209;Salto;1;1;2;393
3303906;Petrópolis;3545209;Salto;1;1;2;422
3304144;Queimados;3545209;Salto;1;1;2;382
3304201;Resende;3545209;Salto;1;1;2;299
3304904;São Gonçalo;3545209;Salto;1;1;2;434
3305554;Seropédica;3545209;Salto;1;1;2;369
3305802;Teresópolis;3545209;Salto;1;1;2;445
3306008;Três Rios;3545209;Salto;1;1;2;432
3306107;Valença;3545209;Salto;1;1;2;377
3500550;Águas de Santa Bárbara;3545209;Salto;1;1;2;203
3500709;Agudos;3545209;Salto;1;1;2;192
3501905;Amparo;3545209;Salto;1;1;2;77
3502507;Aparecida;3545209;Salto;1;1;2;214
3503208;Araraquara;3545209;Salto;1;1;2;181
3503307;Araras;3545209;Salto;1;1;2;94
3503802;Artur Nogueira;3545209;Salto;1;1;2;71
3503901;Arujá;3545209;Salto;1;1;2;101
3504107;Atibaia;3545209;Salto;1;1;2;76
3505203;Bariri;3545209;Salto;1;1;2;194
3505500;Barretos;3545209;Salto;1;1;2;321
3505708;Barueri;3545209;Salto;1;1;2;54
3505906;Batatais;3545209;Salto;1;1;2;258
3506003;Bauru;3545209;Salto;1;1;2;206
3506102;Bebedouro;3545209;Salto;1;1;2;281
3507902;Brotas;3545209;Salto;1;1;2;133
3508504;Caçapava;3545209;Salto;1;1;2;162
3508603;Cachoeira Paulista;3545209;Salto;1;1;2;240
3509007;Caieiras;3545209;Salto;1;1;2;59
3509254;Cajati;3545209;Salto;1;1;2;189
3509601;Campo Limpo Paulista;3545209;Salto;1;1;2;51
3510500;Caraguatatuba;3545209;Salto;1;1;2;193
3511102;Catanduva;3545209;Salto;1;1;2;286
3511508;Cerquilho;3545209;Salto;1;1;2;47
3512803;Cosmópolis;3545209;Salto;1;1;2;62
3513009;Cotia;3545209;Salto;1;1;2;58
3513405;Cruzeiro;3545209;Salto;1;1;2;247
3513702;Descalvado;3545209;Salto;1;1;2;148
3513801;Diadema;3545209;Salto;1;1;2;87
3515004;Embu;3545209;Salto;1;1;2;67
3515103;Embu-Guaçu;3545209;Salto;1;1;2;85
3515186;Espírito Santo do Pinhal;3545209;Salto;1;1;2;125
3516309;Francisco Morato;3545209;Salto;1;1;2;58
3516408;Franco da Rocha;3545209;Salto;1;1;2;59
3518404;Guaratinguetá;3545209;Salto;1;1;2;221
3518602;Guariba;3545209;Salto;1;1;2;225
3518701;Guarujá;3545209;Salto;1;1;2;133
3519303;Ibaté;3545209;Salto;1;1;2;156
3519709;Ibiúna;3545209;Salto;1;1;2;51
3520004;Igaraçu do Tietê;3545209;Salto;1;1;2;151
3522109;Itanhaém;3545209;Salto;1;1;2;120
3522604;Itapira;3545209;Salto;1;1;2;97
3523107;Itaquaquecetuba;3545209;Salto;1;1;2;101
3523206;Itararé;3545209;Salto;1;1;2;233
3523404;Itatiba;3545209;Salto;1;1;2;51
3524303;Jaboticabal;3545209;Salto;1;1;2;239
3524709;Jaguariúna;3545209;Salto;1;1;2;63
3525003;Jandira;3545209;Salto;1;1;2;53
3525102;Jardinópolis;3545209;Salto;1;1;2;247
3526407;Laranjal Paulista;3545209;Salto;1;1;2;59
3526704;Leme;3545209;Salto;1;1;2;113
3528403;Mairinque;3545209;Salto;1;1;2;40
3528502;Mairiporã;3545209;Salto;1;1;2;73
3528601;Manduri;3545209;Salto;1;1;2;209
3529005;Marília;3545209;Salto;1;1;2;292
3529302;Matão;3545209;Salto;1;1;2;210
3530300;Mirassol;3545209;Salto;1;1;2;348
3530508;Mococa;3545209;Salto;1;1;2;193
3530805;Moji-Mirim;3545209;Salto;1;1;2;91
3531100;Mongaguá;3545209;Salto;1;1;2;119
3531308;Monte Alto;3545209;Salto;1;1;2;244
3531803;Monte Mor;3545209;Salto;1;1;2;28
3533403;Nova Odessa;3545209;Salto;1;1;2;48
3533502;Novo Horizonte;3545209;Salto;1;1;2;275
3534708;Ourinhos;3545209;Salto;1;1;2;268
3536703;Pederneiras;3545209;Salto;1;1;2;179
3537107;Pedreira;3545209;Salto;1;1;2;64
3537602;Peruíbe;3545209;Salto;1;1;2;125
3537800;Piedade;3545209;Salto;1;1;2;58
3537909;Pilar do Sul;3545209;Salto;1;1;2;81
3538006;Pindamonhangaba;3545209;Salto;1;1;2;189
3539301;Pirassununga;3545209;Salto;1;1;2;133
3539806;Poá;3545209;Salto;1;1;2;102
3540705;Porto Ferreira;3545209;Salto;1;1;2;150
3542602;Registro;3545209;Salto;1;1;2;158
3543303;Ribeirão Pires;3545209;Salto;1;1;2;104
3543402;Ribeirão Preto;3545209;Salto;1;1;2;233
3168002;Taiobeiras;3545159;Saltinho;1;1;2;952
3534401;Osasco;3545159;Saltinho;1;1;2;120
3536000;Parapuã;3545100;Salmourão;1;1;2;19
3534401;Osasco;3545001;Salesópolis;1;1;2;97
3535606;Paraibuna;3545001;Salesópolis;1;1;2;25
3539806;Poá;3545001;Salesópolis;1;1;2;52
2312403;São Gonçalo do Amarante;3544905;Sales Oliveira;1;1;2;2097
2408102;Natal;3544905;Sales Oliveira;1;1;2;2084
2606200;Goiana;3544905;Sales Oliveira;1;1;2;1953
3101508;Além Paraíba;3544905;Sales Oliveira;1;1;2;548
3104007;Araxá;3544905;Sales Oliveira;1;1;2;160
3147105;Pará de Minas;3544905;Sales Oliveira;1;1;2;349
3509403;Cajuru;3544905;Sales Oliveira;1;1;2;79
3534401;Osasco;3544905;Sales Oliveira;1;1;2;325
3536307;Patrocínio Paulista;3544905;Sales Oliveira;1;1;2;58
2902708;Barra;3544806;Sales;1;1;2;1309
3504602;Bady Bassitt;3544806;Sales;1;1;2;47
3521507;Irapuã;3544806;Sales;1;1;2;10
3525706;José Bonifácio;3544806;Sales;1;1;2;38
3544608;Sabino;3544806;Sales;1;1;2;16
3505807;Bastos;3544707;Sagres;1;1;2;23
3527405;Lucélia;3544707;Sagres;1;1;2;19
3529005;Marília;3544707;Sagres;1;1;2;111
3534609;Osvaldo Cruz;3544707;Sagres;1;1;2;12
3536000;Parapuã;3544707;Sagres;1;1;2;20
3538907;Pirajuí;3544608;Sabino;1;1;2;61
3503703;Ariranha;3544509;Rubinéia;1;1;2;260
3506201;Bento de Abreu;3544400;Rubiácea;1;1;2;9
3133006;Itamonte;3544301;Roseira;1;1;2;81
3518800;Guarulhos;3544301;Roseira;1;1;2;142
3527306;Louveira;3544301;Roseira;1;1;2;171
3537701;Piacatu;3544301;Roseira;1;1;2;560
3540754;Potim;3544301;Roseira;1;1;2;9
3304557;Rio de Janeiro;3544251;Rosana;1;1;2;1010
3509502;Campinas;3544251;Rosana;1;1;2;619
3516200;Franca;3544251;Rosana;1;1;2;620
3541505;Presidente Venceslau;3544251;Rosana;1;1;2;145
3104007;Araxá;3544202;Riolândia;1;1;2;289
3503802;Artur Nogueira;3544202;Riolândia;1;1;2;390
3508108;Buritama;3544202;Riolândia;1;1;2;129
3510708;Cardoso;3544202;Riolândia;1;1;2;31
3510807;Casa Branca;3544202;Riolândia;1;1;2;337
3515509;Fernandópolis;3544202;Riolândia;1;1;2;68
3529302;Matão;3544202;Riolândia;1;1;2;224
3534401;Osasco;3544202;Riolândia;1;1;2;498
3536604;Paulo de Faria;3544202;Riolândia;1;1;2;32
2611606;Recife;3544103;Rio Grande da Serra;1;1;2;2059
3141108;Matozinhos;3544103;Rio Grande da Serra;1;1;2;517
3205002;Serra;3544103;Rio Grande da Serra;1;1;2;731
3505708;Barueri;3544103;Rio Grande da Serra;1;1;2;54
3515707;Ferraz de Vasconcelos;3544103;Rio Grande da Serra;1;1;2;21
3534401;Osasco;3544103;Rio Grande da Serra;1;1;2;46
2607208;Ipojuca;3544004;Rio das Pedras;1;1;2;2023
2607901;Jaboatão dos Guararapes;3544004;Rio das Pedras;1;1;2;2049
2611606;Recife;3544004;Rio das Pedras;1;1;2;2054
3118601;Contagem;3544004;Rio das Pedras;1;1;2;483
3152501;Pouso Alegre;3544004;Rio das Pedras;1;1;2;183
3157807;Santa Luzia;3544004;Rio das Pedras;1;1;2;511
3501608;Americana;3544004;Rio das Pedras;1;1;2;30
3503208;Araraquara;3544004;Rio das Pedras;1;1;2;131
3507605;Bragança Paulista;3544004;Rio das Pedras;1;1;2;108
3510807;Casa Branca;3544004;Rio das Pedras;1;1;2;130
3513504;Cubatão;3544004;Rio das Pedras;1;1;2;168
3514007;Dobrada;3544004;Rio das Pedras;1;1;2;167
3514908;Elias Fausto;3544004;Rio das Pedras;1;1;2;33
3520509;Indaiatuba;3544004;Rio das Pedras;1;1;2;47
3524006;Itupeva;3544004;Rio das Pedras;1;1;2;66
3525201;Jarinu;3544004;Rio das Pedras;1;1;2;95
3525904;Jundiaí;3544004;Rio das Pedras;1;1;2;81
3526407;Laranjal Paulista;3544004;Rio das Pedras;1;1;2;33
3534401;Osasco;3544004;Rio das Pedras;1;1;2;113
1302603;Manaus;3543907;Rio Claro;1;1;2;2463
2304400;Fortaleza;3543907;Rio Claro;1;1;2;2246
2309607;Pacajus;3543907;Rio Claro;1;1;2;2208
2313302;Tauá;3543907;Rio Claro;1;1;2;1951
2611606;Recife;3543907;Rio Claro;1;1;2;2017
2704302;Maceió;3543907;Rio Claro;1;1;2;1838
2905701;Camaçari;3543907;Rio Claro;1;1;2;1418
2910800;Feira de Santana;3543907;Rio Claro;1;1;2;1412
2919207;Lauro de Freitas;3543907;Rio Claro;1;1;2;1403
3106705;Betim;3543907;Rio Claro;1;1;2;438
3118601;Contagem;3543907;Rio Claro;1;1;2;449
3126109;Formiga;3543907;Rio Claro;1;1;2;307
3128303;Guaranésia;3543907;Rio Claro;1;1;2;145
3138203;Lavras;3543907;Rio Claro;1;1;2;293
3147006;Paracatu;3543907;Rio Claro;1;1;2;577
3148103;Patrocínio;3543907;Rio Claro;1;1;2;387
3165107;São Tomás de Aquino;3543907;Rio Claro;1;1;2;186
3169406;Três Pontas;3543907;Rio Claro;1;1;2;239
3170206;Uberlândia;3543907;Rio Claro;1;1;2;395
3171105;Veríssimo;3543907;Rio Claro;1;1;2;313
3201308;Cariacica;3543907;Rio Claro;1;1;2;766
3302254;Itatiaia;3543907;Rio Claro;1;1;2;307
3303302;Niterói;3543907;Rio Claro;1;1;2;463
3305109;São João de Meriti;3543907;Rio Claro;1;1;2;434
3501905;Amparo;3543907;Rio Claro;1;1;2;89
3502002;Analândia;3543907;Rio Claro;1;1;2;33
3502804;Araçatuba;3543907;Rio Claro;1;1;2;324
3503802;Artur Nogueira;3543907;Rio Claro;1;1;2;44
3505302;Barra Bonita;3543907;Rio Claro;1;1;2;103
3507506;Botucatu;3543907;Rio Claro;1;1;2;104
3507605;Bragança Paulista;3543907;Rio Claro;1;1;2;120
3507902;Brotas;3543907;Rio Claro;1;1;2;59
3508603;Cachoeira Paulista;3543907;Rio Claro;1;1;2;265
3509007;Caieiras;3543907;Rio Claro;1;1;2;136
3511102;Catanduva;3543907;Rio Claro;1;1;2;202
3511300;Cedral;3543907;Rio Claro;1;1;2;241
3511706;Charqueada;3543907;Rio Claro;1;1;2;25
3512407;Cordeirópolis;3543907;Rio Claro;1;1;2;14
3512803;Cosmópolis;3543907;Rio Claro;1;1;2;46
3513504;Cubatão;3543907;Rio Claro;1;1;2;203
3513702;Descalvado;3543907;Rio Claro;1;1;2;56
3515608;Fernando Prestes;3543907;Rio Claro;1;1;2;171
3517406;Guaíra;3543907;Rio Claro;1;1;2;243
3518701;Guarujá;3543907;Rio Claro;1;1;2;217
3519303;Ibaté;3543907;Rio Claro;1;1;2;67
3519709;Ibiúna;3543907;Rio Claro;1;1;2;143
3520509;Indaiatuba;3543907;Rio Claro;1;1;2;83
3522307;Itapetininga;3543907;Rio Claro;1;1;2;139
3522604;Itapira;3543907;Rio Claro;1;1;2;77
3523503;Itatinga;3543907;Rio Claro;1;1;2;133
3523909;Itu;3543907;Rio Claro;1;1;2;101
3524402;Jacareí;3543907;Rio Claro;1;1;2;195
3529005;Marília;3543907;Rio Claro;1;1;2;246
3530300;Mirassol;3543907;Rio Claro;1;1;2;267
3530607;Moji das Cruzes;3543907;Rio Claro;1;1;2;191
3534302;Orlândia;3543907;Rio Claro;1;1;2;190
3535002;Palestina;3543907;Rio Claro;1;1;2;297
3536505;Paulínia;3543907;Rio Claro;1;1;2;58
3540903;Pradópolis;3543907;Rio Claro;1;1;2;127
3541406;Presidente Prudente;3543907;Rio Claro;1;1;2;395
3542305;Redenção da Serra;3543907;Rio Claro;1;1;2;230
3500105;Adamantina;3543808;Rinópolis;1;1;2;38
3511904;Clementina;3543808;Rinópolis;1;1;2;34
3518206;Guararapes;3543808;Rinópolis;1;1;2;52
3519204;Iacri;3543808;Rinópolis;1;1;2;15
3527405;Lucélia;3543808;Rinópolis;1;1;2;31
3534401;Osasco;3543808;Rinópolis;1;1;2;456
3537701;Piacatu;3543808;Rinópolis;1;1;2;20
3539202;Pirapozinho;3543808;Rinópolis;1;1;2;101
3509502;Campinas;3543709;Rincão;1;1;2;180
3518602;Guariba;3543709;Rincão;1;1;2;30
3527603;Luís Antônio;3543709;Rincão;1;1;2;38
3529302;Matão;3543709;Rincão;1;1;2;34
3534401;Osasco;3543709;Rincão;1;1;2;254
3539004;Pirangi;3543709;Rincão;1;1;2;82
3104007;Araxá;3543600;Rifaina;1;1;2;76
3509700;Campos do Jordão;3543600;Rifaina;1;1;2;350
3543402;Ribeirão Preto;3543600;Rifaina;1;1;2;123
3521804;Itaí;3543501;Riversul;1;1;2;57
3523206;Itararé;3543501;Riversul;1;1;2;32
1100023;Ariquemes;3543402;Ribeirão Preto;1;1;2;1976
1100122;Ji-Paraná;3543402;Ribeirão Preto;1;1;2;1820
1200401;Rio Branco;3543402;Ribeirão Preto;1;1;2;2370
1500602;Altamira;3543402;Ribeirão Preto;1;1;2;2039
1504208;Marabá;3543402;Ribeirão Preto;1;1;2;1751
1506138;Redenção;3543402;Ribeirão Preto;1;1;2;1471
2100055;Açailândia;3543402;Ribeirão Preto;1;1;2;1792
2105302;Imperatriz;3543402;Ribeirão Preto;1;1;2;1731
2307650;Maracanaú;3543402;Ribeirão Preto;1;1;2;2121
2403251;Parnamirim;3543402;Ribeirão Preto;1;1;2;2102
2408102;Natal;3543402;Ribeirão Preto;1;1;2;2112
2500601;Alhandra;3543402;Ribeirão Preto;1;1;2;1994
2501807;Bayeux;3543402;Ribeirão Preto;1;1;2;2019
2504009;Campina Grande;3543402;Ribeirão Preto;1;1;2;1951
2515302;Sapé;3543402;Ribeirão Preto;1;1;2;2004
2601409;Barreiros;3543402;Ribeirão Preto;1;1;2;1863
2602902;Cabo de Santo Agostinho;3543402;Ribeirão Preto;1;1;2;1918
2604809;Cortês;3543402;Ribeirão Preto;1;1;2;1868
2605202;Escada;3543402;Ribeirão Preto;1;1;2;1898
2607208;Ipojuca;3543402;Ribeirão Preto;1;1;2;1906
2609204;Maraial;3543402;Ribeirão Preto;1;1;2;1822
2609402;Moreno;3543402;Ribeirão Preto;1;1;2;1926
2609600;Olinda;3543402;Ribeirão Preto;1;1;2;1949
2610004;Palmares;3543402;Ribeirão Preto;1;1;2;1847
2611804;Ribeirão;3543402;Ribeirão Preto;1;1;2;1876
2614857;Tamandaré;3543402;Ribeirão Preto;1;1;2;1872
2615300;Timbaúba;3543402;Ribeirão Preto;1;1;2;1963
2707701;Rio Largo;3543402;Ribeirão Preto;1;1;2;1766
2800308;Aracaju;3543402;Ribeirão Preto;1;1;2;1568
2804805;Nossa Senhora do Socorro;3543402;Ribeirão Preto;1;1;2;1568
2903201;Barreiras;3543402;Ribeirão Preto;1;1;2;1030
2905206;Caetité;3543402;Ribeirão Preto;1;1;2;950
2913606;Ilhéus;3543402;Ribeirão Preto;1;1;2;1130
2922003;Mucuri;3543402;Ribeirão Preto;1;1;2;916
2933307;Vitória da Conquista;3543402;Ribeirão Preto;1;1;2;993
3100302;Abre Campo;3543402;Ribeirão Preto;1;1;2;559
3101904;Alpinópolis;3543402;Ribeirão Preto;1;1;2;150
3110400;Camacho;3543402;Ribeirão Preto;1;1;2;280
3112406;Capetinga;3543402;Ribeirão Preto;1;1;2;97
3118205;Conquista;3543402;Ribeirão Preto;1;1;2;137
3120805;Cruzília;3543402;Ribeirão Preto;1;1;2;320
3121258;Delta;3543402;Ribeirão Preto;1;1;2;134
3126109;Formiga;3543402;Ribeirão Preto;1;1;2;257
3126604;Francisco Dumont;3543402;Ribeirão Preto;1;1;2;560
3127107;Frutal;3543402;Ribeirão Preto;1;1;2;168
3127701;Governador Valadares;3543402;Ribeirão Preto;1;1;2;653
3129707;Ibiraci;3543402;Ribeirão Preto;1;1;2;104
3131307;Ipatinga;3543402;Ribeirão Preto;1;1;2;574
3132909;Itamogi;3543402;Ribeirão Preto;1;1;2;78
3136306;João Pinheiro;3543402;Ribeirão Preto;1;1;2;410
3143302;Montes Claros;3543402;Ribeirão Preto;1;1;2;633
3148103;Patrocínio;3543402;Ribeirão Preto;1;1;2;258
3154606;Ribeirão das Neves;3543402;Ribeirão Preto;1;1;2;413
3159605;Santa Rita do Sapucaí;3543402;Ribeirão Preto;1;1;2;250
3159803;Santa Vitória;3543402;Ribeirão Preto;1;1;2;350
3167202;Sete Lagoas;3543402;Ribeirão Preto;1;1;2;414
3169356;Três Marias;3543402;Ribeirão Preto;1;1;2;419
3170602;Vargem Bonita;3543402;Ribeirão Preto;1;1;2;172
3170701;Varginha;3543402;Ribeirão Preto;1;1;2;252
3171204;Vespasiano;3543402;Ribeirão Preto;1;1;2;431
3201209;Cachoeiro de Itapemirim;3543402;Ribeirão Preto;1;1;2;697
3205002;Serra;3543402;Ribeirão Preto;1;1;2;784
3205101;Viana;3543402;Ribeirão Preto;1;1;2;753
3301900;Itaboraí;3543402;Ribeirão Preto;1;1;2;545
3302403;Macaé;3543402;Ribeirão Preto;1;1;2;630
3303302;Niterói;3543402;Ribeirão Preto;1;1;2;526
3303906;Petrópolis;3543402;Ribeirão Preto;1;1;2;501
3305505;Saquarema;3543402;Ribeirão Preto;1;1;2;588
3305802;Teresópolis;3543402;Ribeirão Preto;1;1;2;519
3500709;Agudos;3543402;Ribeirão Preto;1;1;2;194
3501905;Amparo;3543402;Ribeirão Preto;1;1;2;202
3503901;Arujá;3543402;Ribeirão Preto;1;1;2;291
3506508;Birigui;3543402;Ribeirão Preto;1;1;2;265
3507100;Bom Jesus dos Perdões;3543402;Ribeirão Preto;1;1;2;260
3508207;Buritizal;3543402;Ribeirão Preto;1;1;2;107
3509007;Caieiras;3543402;Ribeirão Preto;1;1;2;269
3510500;Caraguatatuba;3543402;Ribeirão Preto;1;1;2;366
3510708;Cardoso;3543402;Ribeirão Preto;1;1;2;253
3510807;Casa Branca;3543402;Ribeirão Preto;1;1;2;101
3513207;Cristais Paulista;3543402;Ribeirão Preto;1;1;2;92
3513504;Cubatão;3543402;Ribeirão Preto;1;1;2;336
3513702;Descalvado;3543402;Ribeirão Preto;1;1;2;85
3514304;Dourado;3543402;Ribeirão Preto;1;1;2;118
3514403;Dracena;3543402;Ribeirão Preto;1;1;2;393
3515004;Embu;3543402;Ribeirão Preto;1;1;2;294
3516705;Garça;3543402;Ribeirão Preto;1;1;2;227
3517703;Guará;3543402;Ribeirão Preto;1;1;2;80
3518305;Guararema;3543402;Ribeirão Preto;1;1;2;311
3520004;Igaraçu do Tietê;3543402;Ribeirão Preto;1;1;2;170
3521309;Ipuã;3543402;Ribeirão Preto;1;1;2;82
3522109;Itanhaém;3543402;Ribeirão Preto;1;1;2;352
3522208;Itapecerica da Serra;3543402;Ribeirão Preto;1;1;2;301
3522703;Itápolis;3543402;Ribeirão Preto;1;1;2;117
3523404;Itatiba;3543402;Ribeirão Preto;1;1;2;228
3523503;Itatinga;3543402;Ribeirão Preto;1;1;2;232
3523602;Itirapina;3543402;Ribeirão Preto;1;1;2;122
3523701;Itirapuã;3543402;Ribeirão Preto;1;1;2;82
3523909;Itu;3543402;Ribeirão Preto;1;1;2;242
3524006;Itupeva;3543402;Ribeirão Preto;1;1;2;235
3524402;Jacareí;3543402;Ribeirão Preto;1;1;2;308
3525706;José Bonifácio;3543402;Ribeirão Preto;1;1;2;197
3526209;Juquitiba;3543402;Ribeirão Preto;1;1;2;317
3527108;Lins;3543402;Ribeirão Preto;1;1;2;214
3528502;Mairiporã;3543402;Ribeirão Preto;1;1;2;271
3529708;Miguelópolis;3543402;Ribeirão Preto;1;1;2;111
3530102;Mirandópolis;3543402;Ribeirão Preto;1;1;2;343
3530300;Mirassol;3543402;Ribeirão Preto;1;1;2;183
3532009;Morungaba;3543402;Ribeirão Preto;1;1;2;218
3533601;Nuporanga;3543402;Ribeirão Preto;1;1;2;47
3533908;Olímpia;3543402;Ribeirão Preto;1;1;2;124
3535804;Paranapanema;3543402;Ribeirão Preto;1;1;2;268
3537602;Peruíbe;3543402;Ribeirão Preto;1;1;2;358
3539806;Poá;3543402;Ribeirão Preto;1;1;2;302
3541000;Praia Grande;3543402;Ribeirão Preto;1;1;2;348
3541109;Presidente Alves;3543402;Ribeirão Preto;1;1;2;201
3543303;Ribeirão Pires;3543402;Ribeirão Preto;1;1;2;316
2800308;Aracaju;3543303;Ribeirão Pires;1;1;2;1689
3133600;Itapeva;3543303;Ribeirão Pires;1;1;2;106
3143203;Monte Santo de Minas;3543303;Ribeirão Pires;1;1;2;286
3168705;Timóteo;3543303;Ribeirão Pires;1;1;2;593
3170206;Uberlândia;3543303;Ribeirão Pires;1;1;2;562
3200706;Atilio Vivacqua;3543303;Ribeirão Pires;1;1;2;611
3205002;Serra;3543303;Ribeirão Pires;1;1;2;732
3503208;Araraquara;3543303;Ribeirão Pires;1;1;2;276
3506359;Bertioga;3543303;Ribeirão Pires;1;1;2;31
3513009;Cotia;3543303;Ribeirão Pires;1;1;2;51
3515707;Ferraz de Vasconcelos;3543303;Ribeirão Pires;1;1;2;18
3527306;Louveira;3543303;Ribeirão Pires;1;1;2;87
3530607;Moji das Cruzes;3543303;Ribeirão Pires;1;1;2;29
3537602;Peruíbe;3543303;Ribeirão Pires;1;1;2;89
3541000;Praia Grande;3543303;Ribeirão Pires;1;1;2;34
2606200;Goiana;3543253;Ribeirão Grande;1;1;2;2245
3201209;Cachoeiro de Itapemirim;3543253;Ribeirão Grande;1;1;2;816
3510005;Cândido Mota;3543204;Ribeirão do Sul;1;1;2;47
3534401;Osasco;3543204;Ribeirão do Sul;1;1;2;334
3535507;Paraguaçu Paulista;3543204;Ribeirão do Sul;1;1;2;81
2908101;Cocos;3543105;Ribeirão Corrente;1;1;2;762
3170206;Uberlândia;3543105;Ribeirão Corrente;1;1;2;186
3505906;Batatais;3543105;Ribeirão Corrente;1;1;2;48
3106200;Belo Horizonte;3543006;Ribeirão Branco;1;1;2;677
3502705;Apiaí;3543006;Ribeirão Branco;1;1;2;33
3508009;Buri;3543006;Ribeirão Branco;1;1;2;50
3517604;Guapiara;3543006;Ribeirão Branco;1;1;2;24
3522802;Itaporanga;3543006;Ribeirão Branco;1;1;2;93
3524006;Itupeva;3543006;Ribeirão Branco;1;1;2;209
3534401;Osasco;3543006;Ribeirão Branco;1;1;2;214
3503307;Araras;3542909;Ribeirão Bonito;1;1;2;89
3505807;Bastos;3542909;Ribeirão Bonito;1;1;2;264
3506805;Bocaina;3542909;Ribeirão Bonito;1;1;2;36
3507902;Brotas;3542909;Ribeirão Bonito;1;1;2;25
3534401;Osasco;3542909;Ribeirão Bonito;1;1;2;217
1500503;Almeirim;3542800;Ribeira;1;1;2;2585
3518503;Guareí;3542800;Ribeira;1;1;2;165
3116407;Claraval;3542701;Restinga;1;1;2;32
3505906;Batatais;3542701;Restinga;1;1;2;35
3540200;Pontal;3542701;Restinga;1;1;2;74
3106200;Belo Horizonte;3542602;Registro;1;1;2;642
3501905;Amparo;3542602;Registro;1;1;2;231
3505401;Barra do Turvo;3542602;Registro;1;1;2;69
3513009;Cotia;3542602;Registro;1;1;2;140
3514809;Eldorado;3542602;Registro;1;1;2;23
3515004;Embu;3542602;Registro;1;1;2;142
3518800;Guarulhos;3542602;Registro;1;1;2;179
3521200;Iporanga;3542602;Registro;1;1;2;73
3522109;Itanhaém;3542602;Registro;1;1;2;116
3522307;Itapetininga;3542602;Registro;1;1;2;106
3523305;Itariri;3542602;Registro;1;1;2;76
3523909;Itu;3542602;Registro;1;1;2;149
3526902;Limeira;3542602;Registro;1;1;2;222
3537909;Pilar do Sul;3542602;Registro;1;1;2;80
3541000;Praia Grande;3542602;Registro;1;1;2;160
3503208;Araraquara;3542503;Reginópolis;1;1;2;110
3504305;Avaí;3542503;Reginópolis;1;1;2;31
3506003;Bauru;3542503;Reginópolis;1;1;2;52
3526803;Lençóis Paulista;3542503;Reginópolis;1;1;2;90
3540101;Pongaí;3542503;Reginópolis;1;1;2;22
3501301;Álvares Machado;3542404;Regente Feijó;1;1;2;23
3502804;Araçatuba;3542404;Regente Feijó;1;1;2;140
3516200;Franca;3542404;Regente Feijó;1;1;2;441
3534401;Osasco;3542404;Regente Feijó;1;1;2;490
3534708;Ourinhos;3542404;Regente Feijó;1;1;2;168
3526308;Lagoinha;3542305;Redenção da Serra;1;1;2;40
2412302;São José do Campestre;3542206;Rancharia;1;1;2;2315
2608909;Limoeiro;3542206;Rancharia;1;1;2;2209
3121258;Delta;3542206;Rancharia;1;1;2;403
3170206;Uberlândia;3542206;Rancharia;1;1;2;455
3205309;Vitória;3542206;Rancharia;1;1;2;1107
3304557;Rio de Janeiro;3542206;Rancharia;1;1;2;792
3500105;Adamantina;3542206;Rancharia;1;1;2;64
3506904;Bofete;3542206;Rancharia;1;1;2;289
3509502;Campinas;3542206;Rancharia;1;1;2;403
3516200;Franca;3542206;Rancharia;1;1;2;403
3517406;Guaíra;3542206;Rancharia;1;1;2;339
3519907;Iepê;3542206;Rancharia;1;1;2;51
3523602;Itirapina;3542206;Rancharia;1;1;2;317
3528809;Maracaí;3542206;Rancharia;1;1;2;48
3535309;Palmital;3542206;Rancharia;1;1;2;93
3536000;Parapuã;3542206;Rancharia;1;1;2;50
1505536;Parauapebas;3542107;Rafard;1;1;2;1895
3522505;Itapevi;3542107;Rafard;1;1;2;86
3538709;Piracicaba;3542107;Rafard;1;1;2;30
3113404;Caratinga;3541901;Queluz;1;1;2;399
3201209;Cachoeiro de Itapemirim;3541901;Queluz;1;1;2;421
3304201;Resende;3541901;Queluz;1;1;2;33
3306305;Volta Redonda;3541901;Queluz;1;1;2;69
3503505;Areias;3541901;Queluz;1;1;2;10
3508603;Cachoeira Paulista;3541901;Queluz;1;1;2;29
3518800;Guarulhos;3541901;Queluz;1;1;2;210
3534401;Osasco;3541901;Queluz;1;1;2;236
3511904;Clementina;3541802;Queiroz;1;1;2;34
3512506;Coroados;3541802;Queiroz;1;1;2;50
3530607;Moji das Cruzes;3541802;Queiroz;1;1;2;464
3533502;Novo Horizonte;3541703;Quatá;1;1;2;175
3534401;Osasco;3541703;Quatá;1;1;2;429
3510401;Capivari;3541653;Quadra;1;1;2;65
3540606;Porto Feliz;3541653;Quadra;1;1;2;55
2604106;Caruaru;3541604;Promissão;1;1;2;2020
3114550;Carneirinho;3541604;Promissão;1;1;2;221
3500204;Adolfo;3541604;Promissão;1;1;2;40
3503208;Araraquara;3541604;Promissão;1;1;2;177
3506409;Bilac;3541604;Promissão;1;1;2;67
3506508;Birigui;3541604;Promissão;1;1;2;56
3507753;Brejo Alegre;3541604;Promissão;1;1;2;56
3509502;Campinas;3541604;Promissão;1;1;2;328
3516200;Franca;3541604;Promissão;1;1;2;276
3517000;Getulina;3541604;Promissão;1;1;2;30
3517208;Guaiçara;3541604;Promissão;1;1;2;11
3517505;Guapiaçu;3541604;Promissão;1;1;2;105
3520509;Indaiatuba;3541604;Promissão;1;1;2;322
3523909;Itu;3541604;Promissão;1;1;2;330
3529005;Marília;3541604;Promissão;1;1;2;76
3530300;Mirassol;3541604;Promissão;1;1;2;87
3534401;Osasco;3541604;Promissão;1;1;2;389
3537404;Pereira Barreto;3541604;Promissão;1;1;2;163
3537701;Piacatu;3541604;Promissão;1;1;2;77
3540606;Porto Feliz;3541604;Promissão;1;1;2;306
1100106;Guajará-Mirim;3541505;Presidente Venceslau;1;1;2;1821
1600303;Macapá;3541505;Presidente Venceslau;1;1;2;2426
2408003;Mossoró;3541505;Presidente Venceslau;1;1;2;2343
3200607;Aracruz;3541505;Presidente Venceslau;1;1;2;1214
3204708;São Gabriel da Palha;3541505;Presidente Venceslau;1;1;2;1202
3509205;Cajamar;3541505;Presidente Venceslau;1;1;2;547
3513504;Cubatão;3541505;Presidente Venceslau;1;1;2;612
3516200;Franca;3541505;Presidente Venceslau;1;1;2;483
3518206;Guararapes;3541505;Presidente Venceslau;1;1;2;144
3526001;Junqueirópolis;3541505;Presidente Venceslau;1;1;2;60
3534401;Osasco;3541505;Presidente Venceslau;1;1;2;562
3535507;Paraguaçu Paulista;3541505;Presidente Venceslau;1;1;2;146
3536000;Parapuã;3541505;Presidente Venceslau;1;1;2;113
1717909;Ponte Alta do Tocantins;3541406;Presidente Prudente;1;1;2;1313
2910800;Feira de Santana;3541406;Presidente Prudente;1;1;2;1656
2919207;Lauro de Freitas;3541406;Presidente Prudente;1;1;2;1665
2919553;Luís Eduardo magalhães;3541406;Presidente Prudente;1;1;2;1243
2933307;Vitória da Conquista;3541406;Presidente Prudente;1;1;2;1335
3106705;Betim;3541406;Presidente Prudente;1;1;2;776
3170107;Uberaba;3541406;Presidente Prudente;1;1;2;443
3205200;Vila Velha;3541406;Presidente Prudente;1;1;2;1149
3300407;Barra Mansa;3541406;Presidente Prudente;1;1;2;745
3302502;Magé;3541406;Presidente Prudente;1;1;2;863
3305505;Saquarema;3541406;Presidente Prudente;1;1;2;927
3500709;Agudos;3541406;Presidente Prudente;1;1;2;250
3501608;Americana;3541406;Presidente Prudente;1;1;2;425
3503307;Araras;3541406;Presidente Prudente;1;1;2;416
3505500;Barretos;3541406;Presidente Prudente;1;1;2;337
3508900;Caiabu;3541406;Presidente Prudente;1;1;2;21
3515129;Emilianópolis;3541406;Presidente Prudente;1;1;2;35
3515301;Estrela do Norte;3541406;Presidente Prudente;1;1;2;48
3516002;Flórida Paulista;3541406;Presidente Prudente;1;1;2;62
3519204;Iacri;3541406;Presidente Prudente;1;1;2;79
3521408;Iracemápolis;3541406;Presidente Prudente;1;1;2;403
3522505;Itapevi;3541406;Presidente Prudente;1;1;2;487
3524808;Jales;3541406;Presidente Prudente;1;1;2;223
3525607;João Ramalho;3541406;Presidente Prudente;1;1;2;66
3526001;Junqueirópolis;3541406;Presidente Prudente;1;1;2;69
3526803;Lençóis Paulista;3541406;Presidente Prudente;1;1;2;271
3528007;Macatuba;3541406;Presidente Prudente;1;1;2;280
3528304;Magda;3541406;Presidente Prudente;1;1;2;204
3528700;Marabá Paulista;3541406;Presidente Prudente;1;1;2;59
3529401;Mauá;3541406;Presidente Prudente;1;1;2;539
3530201;Mirante do Paranapanema;3541406;Presidente Prudente;1;1;2;56
3530706;Mogi Guaçu;3541406;Presidente Prudente;1;1;2;459
3530805;Moji-Mirim;3541406;Presidente Prudente;1;1;2;458
3531407;Monte Aprazível;3541406;Presidente Prudente;1;1;2;229
3533403;Nova Odessa;3541406;Presidente Prudente;1;1;2;429
3536307;Patrocínio Paulista;3541406;Presidente Prudente;1;1;2;451
3536406;Paulicéia;3541406;Presidente Prudente;1;1;2;101
3538006;Pindamonhangaba;3541406;Presidente Prudente;1;1;2;620
3538303;Piquerobi;3541406;Presidente Prudente;1;1;2;45
3539707;Platina;3541406;Presidente Prudente;1;1;2;135
2802809;Indiaroba;3541307;Presidente Epitácio;1;1;2;1856
3110400;Camacho;3541307;Presidente Epitácio;1;1;2;727
3501905;Amparo;3541307;Presidente Epitácio;1;1;2;564
3504008;Assis;3541307;Presidente Epitácio;1;1;2;198
3505203;Bariri;3541307;Presidente Epitácio;1;1;2;350
3513009;Cotia;3541307;Presidente Epitácio;1;1;2;577
3516200;Franca;3541307;Presidente Epitácio;1;1;2;503
3530201;Mirante do Paranapanema;3541307;Presidente Epitácio;1;1;2;61
3534401;Osasco;3541307;Presidente Epitácio;1;1;2;586
3539202;Pirapozinho;3541307;Presidente Epitácio;1;1;2;84
3526001;Junqueirópolis;3541208;Presidente Bernardes;1;1;2;56
3528700;Marabá Paulista;3541208;Presidente Bernardes;1;1;2;44
3534401;Osasco;3541208;Presidente Bernardes;1;1;2;523
3539202;Pirapozinho;3541208;Presidente Bernardes;1;1;2;30
1100304;Vilhena;3541109;Presidente Alves;1;1;2;1490
3509502;Campinas;3541109;Presidente Alves;1;1;2;262
3505302;Barra Bonita;3541059;Pratânia;1;1;2;36
3507506;Botucatu;3541059;Pratânia;1;1;2;24
3521804;Itaí;3541059;Pratânia;1;1;2;80
3526803;Lençóis Paulista;3541059;Pratânia;1;1;2;27
3534401;Osasco;3541059;Pratânia;1;1;2;209
3541000;Praia Grande;3541059;Pratânia;1;1;2;268
1302603;Manaus;3541000;Praia Grande;1;1;2;2663
2919207;Lauro de Freitas;3541000;Praia Grande;1;1;2;1465
3304201;Resende;3541000;Praia Grande;1;1;2;258
3506359;Bertioga;3541000;Praia Grande;1;1;2;32
3509700;Campos do Jordão;3541000;Praia Grande;1;1;2;165
3513405;Cruzeiro;3541000;Praia Grande;1;1;2;215
3515004;Embu;3541000;Praia Grande;1;1;2;60
3516200;Franca;3541000;Praia Grande;1;1;2;397
3518305;Guararema;3541000;Praia Grande;1;1;2;75
3518404;Guaratinguetá;3541000;Praia Grande;1;1;2;181
3523404;Itatiba;3541000;Praia Grande;1;1;2;119
3524402;Jacareí;3541000;Praia Grande;1;1;2;89
3525904;Jundiaí;3541000;Praia Grande;1;1;2;105
3527207;Lorena;3541000;Praia Grande;1;1;2;194
3529005;Marília;3541000;Praia Grande;1;1;2;409
3104007;Araxá;3540903;Pradópolis;1;1;2;228
3501707;Américo Brasiliense;3540903;Pradópolis;1;1;2;41
3502002;Analândia;3540903;Pradópolis;1;1;2;95
3503208;Araraquara;3540903;Pradópolis;1;1;2;48
3512407;Cordeirópolis;3540903;Pradópolis;1;1;2;140
3512704;Corumbataí;3540903;Pradópolis;1;1;2;106
3513108;Cravinhos;3540903;Pradópolis;1;1;2;35
3521101;Ipeúna;3540903;Pradópolis;1;1;2;125
3523602;Itirapina;3540903;Pradópolis;1;1;2;102
3526902;Limeira;3540903;Pradópolis;1;1;2;151
3527108;Lins;3540903;Pradópolis;1;1;2;181
3527603;Luís Antônio;3540903;Pradópolis;1;1;2;43
3529302;Matão;3540903;Pradópolis;1;1;2;43
3534401;Osasco;3540903;Pradópolis;1;1;2;275
3538709;Piracicaba;3540903;Pradópolis;1;1;2;160
3540705;Porto Ferreira;3540903;Pradópolis;1;1;2;82
3527405;Lucélia;3540853;Pracinha;1;1;2;16
3104007;Araxá;3540804;Potirendaba;1;1;2;299
3517505;Guapiaçu;3540804;Potirendaba;1;1;2;32
3524808;Jales;3540804;Potirendaba;1;1;2;149
3529302;Matão;3540804;Potirendaba;1;1;2;119
3532801;Nova Aliança;3540804;Potirendaba;1;1;2;13
3533908;Olímpia;3540804;Potirendaba;1;1;2;59
3534401;Osasco;3540804;Potirendaba;1;1;2;387
3502507;Aparecida;3540754;Potim;1;1;2;6
3509502;Campinas;3540754;Potim;1;1;2;183
3509700;Campos do Jordão;3540754;Potim;1;1;2;32
3513603;Cunha;3540754;Potim;1;1;2;43
3518800;Guarulhos;3540754;Potim;1;1;2;148
3527207;Lorena;3540754;Potim;1;1;2;22
3534401;Osasco;3540754;Potim;1;1;2;174
3102605;Andradas;3540705;Porto Ferreira;1;1;2;97
3106705;Betim;3540705;Porto Ferreira;1;1;2;398
3128709;Guaxupé;3540705;Porto Ferreira;1;1;2;99
3300258;Arraial do Cabo;3540705;Porto Ferreira;1;1;2;579
3500303;Aguaí;3540705;Porto Ferreira;1;1;2;56
3501707;Américo Brasiliense;3540705;Porto Ferreira;1;1;2;66
3504107;Atibaia;3540705;Porto Ferreira;1;1;2;170
3505609;Barrinha;3540705;Porto Ferreira;1;1;2;102
3505708;Barueri;3540705;Porto Ferreira;1;1;2;194
3505906;Batatais;3540705;Porto Ferreira;1;1;2;108
3507803;Brodowski;3540705;Porto Ferreira;1;1;2;97
3508702;Caconde;3540705;Porto Ferreira;1;1;2;93
3509403;Cajuru;3540705;Porto Ferreira;1;1;2;67
3509601;Campo Limpo Paulista;3540705;Porto Ferreira;1;1;2;166
3512209;Conchal;3540705;Porto Ferreira;1;1;2;61
3513108;Cravinhos;3540705;Porto Ferreira;1;1;2;62
3515186;Espírito Santo do Pinhal;3540705;Porto Ferreira;1;1;2;85
3517406;Guaíra;3540705;Porto Ferreira;1;1;2;190
3519600;Ibitinga;3540705;Porto Ferreira;1;1;2;141
3522703;Itápolis;3540705;Porto Ferreira;1;1;2;141
3524105;Ituverava;3540705;Porto Ferreira;1;1;2;171
3524303;Jaboticabal;3540705;Porto Ferreira;1;1;2;108
3525102;Jardinópolis;3540705;Porto Ferreira;1;1;2;97
3525904;Jundiaí;3540705;Porto Ferreira;1;1;2;158
3526407;Laranjal Paulista;3540705;Porto Ferreira;1;1;2;138
3527603;Luís Antônio;3540705;Porto Ferreira;1;1;2;40
3529302;Matão;3540705;Porto Ferreira;1;1;2;99
3530508;Mococa;3540705;Porto Ferreira;1;1;2;62
3530706;Mogi Guaçu;3540705;Porto Ferreira;1;1;2;76
3530805;Moji-Mirim;3540705;Porto Ferreira;1;1;2;83
3531506;Monte Azul Paulista;3540705;Porto Ferreira;1;1;2;159
3531902;Morro Agudo;3540705;Porto Ferreira;1;1;2;138
3534302;Orlândia;3540705;Porto Ferreira;1;1;2;132
3534401;Osasco;3540705;Porto Ferreira;1;1;2;199
3539509;Pitangueiras;3540705;Porto Ferreira;1;1;2;121
3540200;Pontal;3540705;Porto Ferreira;1;1;2;109
1504059;Mãe do Rio;3540606;Porto Feliz;1;1;2;2343
3106200;Belo Horizonte;3540606;Porto Feliz;1;1;2;513
3134905;Jacutinga;3540606;Porto Feliz;1;1;2;139
3304557;Rio de Janeiro;3540606;Porto Feliz;1;1;2;437
3510302;Capela do Alto;3540606;Porto Feliz;1;1;2;36
3511508;Cerquilho;3540606;Porto Feliz;1;1;2;23
3513009;Cotia;3540606;Porto Feliz;1;1;2;76
3513504;Cubatão;3540606;Porto Feliz;1;1;2;136
3516200;Franca;3540606;Porto Feliz;1;1;2;296
3518503;Guareí;3540606;Porto Feliz;1;1;2;70
3525003;Jandira;3540606;Porto Feliz;1;1;2;72
3537503;Pereiras;3540606;Porto Feliz;1;1;2;49
3538709;Piracicaba;3540606;Porto Feliz;1;1;2;53
3502200;Angatuba;3540507;Porangaba;1;1;2;46
3511508;Cerquilho;3540507;Porangaba;1;1;2;39
3518503;Guareí;3540507;Porangaba;1;1;2;23
3534401;Osasco;3540507;Porangaba;1;1;2;142
3515509;Fernandópolis;3540408;Populina;1;1;2;47
3524808;Jales;3540408;Populina;1;1;2;36
3534757;Ouroeste;3540408;Populina;1;1;2;13
3537404;Pereira Barreto;3540408;Populina;1;1;2;93
3536901;Pedranópolis;3540309;Pontes Gestal;1;1;2;45
3518909;Guzolândia;3540259;Pontalinda;1;1;2;27
3537404;Pereira Barreto;3540259;Pontalinda;1;1;2;62
3104007;Araxá;3540200;Pontal;1;1;2;195
3505500;Barretos;3540200;Pontal;1;1;2;77
3513108;Cravinhos;3540200;Pontal;1;1;2;48
3514601;Dumont;3540200;Pontal;1;1;2;25
3515509;Fernandópolis;3540200;Pontal;1;1;2;244
3516200;Franca;3540200;Pontal;1;1;2;84
3517406;Guaíra;3540200;Pontal;1;1;2;83
3531407;Monte Aprazível;3540200;Pontal;1;1;2;176
3534401;Osasco;3540200;Pontal;1;1;2;307
3539509;Pitangueiras;3540200;Pontal;1;1;2;19
3507407;Borborema;3540101;Pongaí;1;1;2;33
3538907;Pirajuí;3540101;Pongaí;1;1;2;31
3506003;Bauru;3540002;Pompéia;1;1;2;116
3509502;Campinas;3540002;Pompéia;1;1;2;334
3516200;Franca;3540002;Pompéia;1;1;2;333
3529401;Mauá;3540002;Pompéia;1;1;2;422
3531506;Monte Azul Paulista;3540002;Pompéia;1;1;2;206
3533502;Novo Horizonte;3540002;Pompéia;1;1;2;121
3534104;Oriente;3540002;Pompéia;1;1;2;10
3534401;Osasco;3540002;Pompéia;1;1;2;385
3534609;Osvaldo Cruz;3540002;Pompéia;1;1;2;81
3535507;Paraguaçu Paulista;3540002;Pompéia;1;1;2;56
3536505;Paulínia;3540002;Pompéia;1;1;2;320
3517505;Guapiaçu;3539905;Poloni;1;1;2;63
3530300;Mirassol;3539905;Poloni;1;1;2;32
3532603;Nhandeara;3539905;Poloni;1;1;2;24
3533908;Olímpia;3539905;Poloni;1;1;2;95
1100205;Porto Velho;3539806;Poá;1;1;2;2371
2111300;São Luís;3539806;Poá;1;1;2;2330
2211001;Teresina;3539806;Poá;1;1;2;2068
2507507;João Pessoa;3539806;Poá;1;1;2;2128
2903201;Barreiras;3539806;Poá;1;1;2;1258
2910800;Feira de Santana;3539806;Poá;1;1;2;1441
2914802;Itabuna;3539806;Poá;1;1;2;1194
2919207;Lauro de Freitas;3539806;Poá;1;1;2;1420
3143302;Montes Claros;3539806;Poá;1;1;2;791
3151404;Pitangui;3539806;Poá;1;1;2;453
3170206;Uberlândia;3539806;Poá;1;1;2;546
3201308;Cariacica;3539806;Poá;1;1;2;697
3205200;Vila Velha;3539806;Poá;1;1;2;699
3306305;Volta Redonda;3539806;Poá;1;1;2;255
3503208;Araraquara;3539806;Poá;1;1;2;266
3505708;Barueri;3539806;Poá;1;1;2;54
3506003;Bauru;3539806;Poá;1;1;2;307
3507506;Botucatu;3539806;Poá;1;1;2;224
3510203;Capão Bonito;3539806;Poá;1;1;2;212
3510500;Caraguatatuba;3539806;Poá;1;1;2;92
3516200;Franca;3539806;Poá;1;1;2;346
3521408;Iracemápolis;3539806;Poá;1;1;2;158
3522109;Itanhaém;3539806;Poá;1;1;2;86
3522406;Itapeva;3539806;Poá;1;1;2;265
3524402;Jacareí;3539806;Poá;1;1;2;47
3528502;Mairiporã;3539806;Poá;1;1;2;33
3538006;Pindamonhangaba;3539806;Poá;1;1;2;112
3538709;Piracicaba;3539806;Poá;1;1;2;157
3114550;Carneirinho;3539608;Planalto;1;1;2;167
3532603;Nhandeara;3539608;Planalto;1;1;2;39
3104007;Araxá;3539509;Pitangueiras;1;1;2;205
3127107;Frutal;3539509;Pitangueiras;1;1;2;126
3500907;Altair;3539509;Pitangueiras;1;1;2;102
3502804;Araçatuba;3539509;Pitangueiras;1;1;2;234
3509205;Cajamar;3539509;Pitangueiras;1;1;2;296
3509502;Campinas;3539509;Pitangueiras;1;1;2;242
3511003;Castilho;3539509;Pitangueiras;1;1;2;340
3513108;Cravinhos;3539509;Pitangueiras;1;1;2;63
3516200;Franca;3539509;Pitangueiras;1;1;2;99
3517901;Guaraci;3539509;Pitangueiras;1;1;2;94
3518602;Guariba;3539509;Pitangueiras;1;1;2;39
3522703;Itápolis;3539509;Pitangueiras;1;1;2;90
3530300;Mirassol;3539509;Pitangueiras;1;1;2;137
3531308;Monte Alto;3539509;Pitangueiras;1;1;2;41
3531407;Monte Aprazível;3539509;Pitangueiras;1;1;2;157
3506300;Bernardino de Campos;3539400;Piratininga;1;1;2;75
3514502;Duartina;3539400;Piratininga;1;1;2;28
3526803;Lençóis Paulista;3539400;Piratininga;1;1;2;39
3530805;Moji-Mirim;3539400;Piratininga;1;1;2;223
3534401;Osasco;3539400;Piratininga;1;1;2;272
1302603;Manaus;3539301;Pirassununga;1;1;2;2434
1400100;Boa Vista;3539301;Pirassununga;1;1;2;3047
1500800;Ananindeua;3539301;Pirassununga;1;1;2;2285
1501402;Belém;3539301;Pirassununga;1;1;2;2284
2602902;Cabo de Santo Agostinho;3539301;Pirassununga;1;1;2;1959
2611606;Recife;3539301;Pirassununga;1;1;2;1979
3104007;Araxá;3539301;Pirassununga;1;1;2;273
3106200;Belo Horizonte;3539301;Pirassununga;1;1;2;425
3133758;Itaú de Minas;3539301;Pirassununga;1;1;2;156
3170107;Uberaba;3539301;Pirassununga;1;1;2;256
3170206;Uberlândia;3539301;Pirassununga;1;1;2;354
3501608;Americana;3539301;Pirassununga;1;1;2;82
3502804;Araçatuba;3539301;Pirassununga;1;1;2;323
3507902;Brotas;3539301;Pirassununga;1;1;2;77
3508702;Caconde;3539301;Pirassununga;1;1;2;98
3513108;Cravinhos;3539301;Pirassununga;1;1;2;80
3516200;Franca;3539301;Pirassununga;1;1;2;163
3518800;Guarulhos;3539301;Pirassununga;1;1;2;182
3522307;Itapetininga;3539301;Pirassununga;1;1;2;185
3523909;Itu;3539301;Pirassununga;1;1;2;142
3524709;Jaguariúna;3539301;Pirassununga;1;1;2;90
3525300;Jaú;3539301;Pirassununga;1;1;2;121
3525904;Jundiaí;3539301;Pirassununga;1;1;2;141
3526902;Limeira;3539301;Pirassununga;1;1;2;62
3527108;Lins;3539301;Pirassununga;1;1;2;244
3529302;Matão;3539301;Pirassununga;1;1;2;109
3534401;Osasco;3539301;Pirassununga;1;1;2;182
3501301;Álvares Machado;3539202;Pirapozinho;1;1;2;22
3513009;Cotia;3539202;Pirapozinho;1;1;2;497
3519907;Iepê;3539202;Pirapozinho;1;1;2;61
3526001;Junqueirópolis;3539202;Pirapozinho;1;1;2;84
3527405;Lucélia;3539202;Pirapozinho;1;1;2;79
3532207;Narandiba;3539202;Pirapozinho;1;1;2;15
3534203;Orindiúva;3539202;Pirapozinho;1;1;2;319
3534401;Osasco;3539202;Pirapozinho;1;1;2;507
3534609;Osvaldo Cruz;3539202;Pirapozinho;1;1;2;83
3535507;Paraguaçu Paulista;3539202;Pirapozinho;1;1;2;93
1302603;Manaus;3539103;Pirapora do Bom Jesus;1;1;2;2579
1303536;Presidente Figueiredo;3539103;Pirapora do Bom Jesus;1;1;2;2684
3515004;Embu;3539103;Pirapora do Bom Jesus;1;1;2;32
3534401;Osasco;3539103;Pirapora do Bom Jesus;1;1;2;26
2925501;Prado;3539004;Pirangi;1;1;2;1051
3104007;Araxá;3539004;Pirangi;1;1;2;243
3505500;Barretos;3539004;Pirangi;1;1;2;60
3509304;Cajobi;3539004;Pirangi;1;1;2;28
3509502;Campinas;3539004;Pirangi;1;1;2;261
3514924;Elisiário;3539004;Pirangi;1;1;2;48
3519402;Ibirá;3539004;Pirangi;1;1;2;61
3524303;Jaboticabal;3539004;Pirangi;1;1;2;41
3528858;Marapoama;3539004;Pirangi;1;1;2;52
3529302;Matão;3539004;Pirangi;1;1;2;62
3533908;Olímpia;3539004;Pirangi;1;1;2;46
3534401;Osasco;3539004;Pirangi;1;1;2;334
3535101;Palmares Paulista;3539004;Pirangi;1;1;2;18
3535705;Paraíso;3539004;Pirangi;1;1;2;15
1500107;Abaetetuba;3538907;Pirajuí;1;1;2;2241
3504701;Balbinos;3538907;Pirajuí;1;1;2;15
3508801;Cafelândia;3538907;Pirajuí;1;1;2;27
3512506;Coroados;3538907;Pirajuí;1;1;2;111
3514502;Duartina;3538907;Pirajuí;1;1;2;46
3515194;Espírito Santo do Turvo;3538907;Pirajuí;1;1;2;77
3516705;Garça;3538907;Pirajuí;1;1;2;32
3533502;Novo Horizonte;3538907;Pirajuí;1;1;2;64
3534401;Osasco;3538907;Pirajuí;1;1;2;325
2611606;Recife;3538808;Piraju;1;1;2;2192
3504008;Assis;3538808;Piraju;1;1;2;123
3504107;Atibaia;3538808;Piraju;1;1;2;290
3506003;Bauru;3538808;Piraju;1;1;2;99
3507902;Brotas;3538808;Piraju;1;1;2;163
3522703;Itápolis;3538808;Piraju;1;1;2;186
3528601;Manduri;3538808;Piraju;1;1;2;22
3529302;Matão;3538808;Piraju;1;1;2;203
3535804;Paranapanema;3538808;Piraju;1;1;2;67
3538709;Piracicaba;3538808;Piraju;1;1;2;184
1504422;Marituba;3538709;Piracicaba;1;1;2;2367
1505536;Parauapebas;3538709;Piracicaba;1;1;2;1866
2105302;Imperatriz;3538709;Piracicaba;1;1;2;1907
2303709;Caucaia;3538709;Piracicaba;1;1;2;2282
2307304;Juazeiro do Norte;3538709;Piracicaba;1;1;2;1905
2307650;Maracanaú;3538709;Piracicaba;1;1;2;2270
2411056;Tibau;3538709;Piracicaba;1;1;2;2227
2507507;João Pessoa;3538709;Piracicaba;1;1;2;2135
2602902;Cabo de Santo Agostinho;3538709;Piracicaba;1;1;2;2030
2609600;Olinda;3538709;Piracicaba;1;1;2;2062
2610707;Paulista;3538709;Piracicaba;1;1;2;2068
2611101;Petrolina;3538709;Piracicaba;1;1;2;1646
2611606;Recife;3538709;Piracicaba;1;1;2;2050
2707701;Rio Largo;3538709;Piracicaba;1;1;2;1877
2803609;Laranjeiras;3538709;Piracicaba;1;1;2;1682
2910727;Eunápolis;3538709;Piracicaba;1;1;2;1075
2924009;Paulo Afonso;3538709;Piracicaba;1;1;2;1741
2926608;Ribeira do Pombal;3538709;Piracicaba;1;1;2;1600
2929602;Sapeaçu;3538709;Piracicaba;1;1;2;1394
2932903;Valença;3538709;Piracicaba;1;1;2;1345
3102605;Andradas;3538709;Piracicaba;1;1;2;134
3106705;Betim;3538709;Piracicaba;1;1;2;468
3134905;Jacutinga;3538709;Piracicaba;1;1;2;118
3135050;Jaíba;3538709;Piracicaba;1;1;2;913
3136207;João Monlevade;3538709;Piracicaba;1;1;2;559
3144805;Nova Lima;3538709;Piracicaba;1;1;2;490
3147303;Paraisópolis;3538709;Piracicaba;1;1;2;193
3151800;Poços de Caldas;3538709;Piracicaba;1;1;2;157
3152501;Pouso Alegre;3538709;Piracicaba;1;1;2;184
3152808;Prata;3538709;Piracicaba;1;1;2;404
3159605;Santa Rita do Sapucaí;3538709;Piracicaba;1;1;2;207
3169307;Três Corações;3538709;Piracicaba;1;1;2;275
3171303;Viçosa;3538709;Piracicaba;1;1;2;531
3201308;Cariacica;3538709;Piracicaba;1;1;2;784
3204906;São Mateus;3538709;Piracicaba;1;1;2;903
3205101;Viana;3538709;Piracicaba;1;1;2;766
3205200;Vila Velha;3538709;Piracicaba;1;1;2;788
3302254;Itatiaia;3538709;Piracicaba;1;1;2;315
3303401;Nova Friburgo;3538709;Piracicaba;1;1;2;522
3303906;Petrópolis;3538709;Piracicaba;1;1;2;455
3304201;Resende;3538709;Piracicaba;1;1;2;329
3306305;Volta Redonda;3538709;Piracicaba;1;1;2;365
3502101;Andradina;3538709;Piracicaba;1;1;2;433
3502200;Angatuba;3538709;Piracicaba;1;1;2;114
3502754;Araçariguama;3538709;Piracicaba;1;1;2;97
3502903;Araçoiaba da Serra;3538709;Piracicaba;1;1;2;83
3504008;Assis;3538709;Piracicaba;1;1;2;288
3506201;Bento de Abreu;3538709;Piracicaba;1;1;2;363
3507001;Boituva;3538709;Piracicaba;1;1;2;59
3508009;Buri;3538709;Piracicaba;1;1;2;151
3511102;Catanduva;3538709;Piracicaba;1;1;2;224
3511607;Cesário Lange;3538709;Piracicaba;1;1;2;61
3512407;Cordeirópolis;3538709;Piracicaba;1;1;2;36
3513702;Descalvado;3538709;Piracicaba;1;1;2;94
3514908;Elias Fausto;3538709;Piracicaba;1;1;2;43
3515509;Fernandópolis;3538709;Piracicaba;1;1;2;381
3516002;Flórida Paulista;3538709;Piracicaba;1;1;2;382
3518602;Guariba;3538709;Piracicaba;1;1;2;165
3519303;Ibaté;3538709;Piracicaba;1;1;2;95
3519600;Ibitinga;3538709;Piracicaba;1;1;2;165
3520400;Ilhabela;3538709;Piracicaba;1;1;2;262
3522109;Itanhaém;3538709;Piracicaba;1;1;2;181
3522307;Itapetininga;3538709;Piracicaba;1;1;2;101
3522604;Itapira;3538709;Piracicaba;1;1;2;91
3523404;Itatiba;3538709;Piracicaba;1;1;2;87
3523602;Itirapina;3538709;Piracicaba;1;1;2;58
3525003;Jandira;3538709;Piracicaba;1;1;2;115
3525706;José Bonifácio;3538709;Piracicaba;1;1;2;281
3526803;Lençóis Paulista;3538709;Piracicaba;1;1;2;122
3527108;Lins;3538709;Piracicaba;1;1;2;248
3528403;Mairinque;3538709;Piracicaba;1;1;2;100
3530102;Mirandópolis;3538709;Piracicaba;1;1;2;396
3530300;Mirassol;3538709;Piracicaba;1;1;2;287
3531308;Monte Alto;3538709;Piracicaba;1;1;2;184
3531803;Monte Mor;3538709;Piracicaba;1;1;2;40
3535804;Paranapanema;3538709;Piracicaba;1;1;2;135
3537305;Penápolis;3538709;Piracicaba;1;1;2;288
3537404;Pereira Barreto;3538709;Piracicaba;1;1;2;424
3537602;Peruíbe;3538709;Piracicaba;1;1;2;183
3112000;Candeias;3538600;Piracaia;1;1;2;276
3125101;Extrema;3538600;Piracaia;1;1;2;22
3504107;Atibaia;3538600;Piracaia;1;1;2;21
3509502;Campinas;3538600;Piracaia;1;1;2;74
3518800;Guarulhos;3538600;Piracaia;1;1;2;47
3523404;Itatiba;3538600;Piracaia;1;1;2;50
3525508;Joanópolis;3538600;Piracaia;1;1;2;16
3532405;Nazaré Paulista;3538600;Piracaia;1;1;2;15
3534401;Osasco;3538600;Piracaia;1;1;2;69
3132404;Itajubá;3538501;Piquete;1;1;2;38
3136702;Juiz de Fora;3538501;Piquete;1;1;2;211
3302502;Magé;3538501;Piquete;1;1;2;217
3304557;Rio de Janeiro;3538501;Piquete;1;1;2;199
3513405;Cruzeiro;3538501;Piquete;1;1;2;22
3513801;Diadema;3538501;Piquete;1;1;2;190
3518404;Guaratinguetá;3538501;Piquete;1;1;2;23
3110509;Camanducaia;3538204;Pinhalzinho;1;1;2;46
3143401;Monte Sião;3538204;Pinhalzinho;1;1;2;38
3504107;Atibaia;3538204;Pinhalzinho;1;1;2;38
3520509;Indaiatuba;3538204;Pinhalzinho;1;1;2;75
3524709;Jaguariúna;3538204;Pinhalzinho;1;1;2;41
3531209;Monte Alegre do Sul;3538204;Pinhalzinho;1;1;2;14
3534401;Osasco;3538204;Pinhalzinho;1;1;2;86
1501402;Belém;3538105;Pindorama;1;1;2;2191
3304557;Rio de Janeiro;3538105;Pindorama;1;1;2;619
3506003;Bauru;3538105;Pindorama;1;1;2;129
3506102;Bebedouro;3538105;Pindorama;1;1;2;47
3521903;Itajobi;3538105;Pindorama;1;1;2;21
3534401;Osasco;3538105;Pindorama;1;1;2;342
1721000;Palmas;3538006;Pindamonhangaba;1;1;2;1420
2304400;Fortaleza;3538006;Pindamonhangaba;1;1;2;2225
2602902;Cabo de Santo Agostinho;3538006;Pindamonhangaba;1;1;2;1920
2607208;Ipojuca;3538006;Pindamonhangaba;1;1;2;1907
2927408;Salvador;3538006;Pindamonhangaba;1;1;2;1301
2929206;São Francisco do Conde;3538006;Pindamonhangaba;1;1;2;1324
3113305;Carangola;3538006;Pindamonhangaba;1;1;2;425
3113602;Careaçu;3538006;Pindamonhangaba;1;1;2;101
3118700;Coqueiral;3538006;Pindamonhangaba;1;1;2;192
3132404;Itajubá;3538006;Pindamonhangaba;1;1;2;57
3200409;Anchieta;3538006;Pindamonhangaba;1;1;2;536
3200607;Aracruz;3538006;Pindamonhangaba;1;1;2;629
3202603;Iconha;3538006;Pindamonhangaba;1;1;2;529
3300100;Angra dos Reis;3538006;Pindamonhangaba;1;1;2;120
3302205;Itaperuna;3538006;Pindamonhangaba;1;1;2;414
3304110;Porto Real;3538006;Pindamonhangaba;1;1;2;130
3306206;Vassouras;3538006;Pindamonhangaba;1;1;2;193
3501608;Americana;3538006;Pindamonhangaba;1;1;2;193
3506003;Bauru;3538006;Pindamonhangaba;1;1;2;376
3513504;Cubatão;3538006;Pindamonhangaba;1;1;2;146
3513801;Diadema;3538006;Pindamonhangaba;1;1;2;146
3516200;Franca;3538006;Pindamonhangaba;1;1;2;330
3518701;Guarujá;3538006;Pindamonhangaba;1;1;2;141
3520509;Indaiatuba;3538006;Pindamonhangaba;1;1;2;184
3520905;Ipaussu;3538006;Pindamonhangaba;1;1;2;428
3521408;Iracemápolis;3538006;Pindamonhangaba;1;1;2;214
3523909;Itu;3538006;Pindamonhangaba;1;1;2;193
3525904;Jundiaí;3538006;Pindamonhangaba;1;1;2;151
3526902;Limeira;3538006;Pindamonhangaba;1;1;2;202
3534609;Osvaldo Cruz;3538006;Pindamonhangaba;1;1;2;567
3536505;Paulínia;3538006;Pindamonhangaba;1;1;2;174
3502754;Araçariguama;3537909;Pilar do Sul;1;1;2;78
3504503;Avaré;3537909;Pilar do Sul;1;1;2;147
3505708;Barueri;3537909;Pilar do Sul;1;1;2;92
3508009;Buri;3537909;Pilar do Sul;1;1;2;89
3509809;Campos Novos Paulista;3537909;Pilar do Sul;1;1;2;268
3510203;Capão Bonito;3537909;Pilar do Sul;1;1;2;68
3517604;Guapiara;3537909;Pilar do Sul;1;1;2;93
3534401;Osasco;3537909;Pilar do Sul;1;1;2;99
3535309;Palmital;3537909;Pilar do Sul;1;1;2;278
3535804;Paranapanema;3537909;Pilar do Sul;1;1;2;116
3537701;Piacatu;3537909;Pilar do Sul;1;1;2;381
1501402;Belém;3537800;Piedade;1;1;2;2472
2602308;Bonito;3537800;Piedade;1;1;2;2038
2919553;Luís Eduardo magalhães;3537800;Piedade;1;1;2;1295
3106200;Belo Horizonte;3537800;Piedade;1;1;2;546
3513009;Cotia;3537800;Piedade;1;1;2;53
3522406;Itapeva;3537800;Piedade;1;1;2;152
3523909;Itu;3537800;Piedade;1;1;2;49
3524006;Itupeva;3537800;Piedade;1;1;2;72
3524600;Jacupiranga;3537800;Piedade;1;1;2;124
3528403;Mairinque;3537800;Piedade;1;1;2;31
3534401;Osasco;3537800;Piedade;1;1;2;68
3535804;Paranapanema;3537800;Piedade;1;1;2;140
1721000;Palmas;3537701;Piacatu;1;1;2;1263
2104800;Grajaú;3537701;Piacatu;1;1;2;1802
3500709;Agudos;3537701;Piacatu;1;1;2;193
3502804;Araçatuba;3537701;Piacatu;1;1;2;43
3502903;Araçoiaba da Serra;3537701;Piacatu;1;1;2;376
3503307;Araras;3537701;Piacatu;1;1;2;345
3506508;Birigui;3537701;Piacatu;1;1;2;41
3509502;Campinas;3537701;Piacatu;1;1;2;396
3512407;Cordeirópolis;3537701;Piacatu;1;1;2;341
3514700;Echaporã;3537701;Piacatu;1;1;2;101
3527405;Lucélia;3537701;Piacatu;1;1;2;46
3530201;Mirante do Paranapanema;3537701;Piacatu;1;1;2;156
3534401;Osasco;3537701;Piacatu;1;1;2;452
3534609;Osvaldo Cruz;3537701;Piacatu;1;1;2;37
1721000;Palmas;3537602;Peruíbe;1;1;2;1548
3106200;Belo Horizonte;3537602;Peruíbe;1;1;2;573
3501608;Americana;3537602;Peruíbe;1;1;2;176
3506359;Bertioga;3537602;Peruíbe;1;1;2;101
3509502;Campinas;3537602;Peruíbe;1;1;2;155
3510401;Capivari;3537602;Peruíbe;1;1;2;153
3513009;Cotia;3537602;Peruíbe;1;1;2;77
3513702;Descalvado;3537602;Peruíbe;1;1;2;272
3516200;Franca;3537602;Peruíbe;1;1;2;418
3520426;Ilha Comprida;3537602;Peruíbe;1;1;2;73
3529401;Mauá;3537602;Peruíbe;1;1;2;89
3536505;Paulínia;3537602;Peruíbe;1;1;2;171
3537206;Pedro de Toledo;3537602;Peruíbe;1;1;2;23
3505302;Barra Bonita;3537503;Pereiras;1;1;2;88
3511508;Cerquilho;3537503;Pereiras;1;1;2;26
3511607;Cesário Lange;3537503;Pereiras;1;1;2;17
3526902;Limeira;3537503;Pereiras;1;1;2;82
3534401;Osasco;3537503;Pereiras;1;1;2;132
3134400;Iturama;3537404;Pereira Barreto;1;1;2;134
3504206;Auriflama;3537404;Pereira Barreto;1;1;2;56
3515202;Estrela d'Oeste;3537404;Pereira Barreto;1;1;2;80
3516200;Franca;3537404;Pereira Barreto;1;1;2;384
3519600;Ibitinga;3537404;Pereira Barreto;1;1;2;267
3523008;Itapura;3537404;Pereira Barreto;1;1;2;44
3530102;Mirandópolis;3537404;Pereira Barreto;1;1;2;58
3531407;Monte Aprazível;3537404;Pereira Barreto;1;1;2;144
3536307;Patrocínio Paulista;3537404;Pereira Barreto;1;1;2;395
2916401;Itapetinga;3537305;Penápolis;1;1;2;1209
2930709;Simões Filho;3537305;Penápolis;1;1;2;1519
3114550;Carneirinho;3537305;Penápolis;1;1;2;202
3121605;Diamantina;3537305;Penápolis;1;1;2;752
3170206;Uberlândia;3537305;Penápolis;1;1;2;336
3504206;Auriflama;3537305;Penápolis;1;1;2;97
3504404;Avanhandava;3537305;Penápolis;1;1;2;12
3505708;Barueri;3537305;Penápolis;1;1;2;405
3505807;Bastos;3537305;Penápolis;1;1;2;88
3506102;Bebedouro;3537305;Penápolis;1;1;2;167
3506409;Bilac;3537305;Penápolis;1;1;2;44
3507753;Brejo Alegre;3537305;Penápolis;1;1;2;34
3508801;Cafelândia;3537305;Penápolis;1;1;2;63
3511904;Clementina;3537305;Penápolis;1;1;2;42
3513009;Cotia;3537305;Penápolis;1;1;2;407
3516200;Franca;3537305;Penápolis;1;1;2;292
3516705;Garça;3537305;Penápolis;1;1;2;98
3520509;Indaiatuba;3537305;Penápolis;1;1;2;347
3525300;Jaú;3537305;Penápolis;1;1;2;181
3528403;Mairinque;3537305;Penápolis;1;1;2;381
3529302;Matão;3537305;Penápolis;1;1;2;174
3534401;Osasco;3537305;Penápolis;1;1;2;414
3534609;Osvaldo Cruz;3537305;Penápolis;1;1;2;94
3535705;Paraíso;3537305;Penápolis;1;1;2;141
3514809;Eldorado;3537206;Pedro de Toledo;1;1;2;93
3522109;Itanhaém;3537206;Pedro de Toledo;1;1;2;46
3516101;Florínia;3537156;Pedrinhas Paulista;1;1;2;10
3528809;Maracaí;3537156;Pedrinhas Paulista;1;1;2;26
2516102;Soledade;3537107;Pedreira;1;1;2;2023
3162922;São Joaquim de Bicas;3537107;Pedreira;1;1;2;400
3500501;Águas de Lindóia;3537107;Pedreira;1;1;2;40
3504107;Atibaia;3537107;Pedreira;1;1;2;55
3507605;Bragança Paulista;3537107;Pedreira;1;1;2;42
3510807;Casa Branca;3537107;Pedreira;1;1;2;109
3512209;Conchal;3537107;Pedreira;1;1;2;53
3512803;Cosmópolis;3537107;Pedreira;1;1;2;32
3516200;Franca;3537107;Pedreira;1;1;2;249
3520509;Indaiatuba;3537107;Pedreira;1;1;2;52
3523909;Itu;3537107;Pedreira;1;1;2;72
3525508;Joanópolis;3537107;Pedreira;1;1;2;68
3527306;Louveira;3537107;Pedreira;1;1;2;37
3534401;Osasco;3537107;Pedreira;1;1;2;88
3104007;Araxá;3537008;Pedregulho;1;1;2;92
3170107;Uberaba;3537008;Pedregulho;1;1;2;73
3507803;Brodowski;3537008;Pedregulho;1;1;2;83
3508207;Buritizal;3537008;Pedregulho;1;1;2;25
3509502;Campinas;3537008;Pedregulho;1;1;2;296
3524105;Ituverava;3537008;Pedregulho;1;1;2;38
3526902;Limeira;3537008;Pedregulho;1;1;2;256
3534401;Osasco;3537008;Pedregulho;1;1;2;370
3536307;Patrocínio Paulista;3537008;Pedregulho;1;1;2;46
3536257;Parisi;3536901;Pedranópolis;1;1;2;12
3169109;Toledo;3536802;Pedra Bela;1;1;2;11
3504107;Atibaia;3536802;Pedra Bela;1;1;2;38
3507605;Bragança Paulista;3536802;Pedra Bela;1;1;2;20
3534401;Osasco;3536802;Pedra Bela;1;1;2;90
3118601;Contagem;3536703;Pederneiras;1;1;2;550
3500709;Agudos;3536703;Pederneiras;1;1;2;28
3502309;Anhembi;3536703;Pederneiras;1;1;2;82
3505203;Bariri;3536703;Pederneiras;1;1;2;31
3507506;Botucatu;3536703;Pederneiras;1;1;2;68
3509502;Campinas;3536703;Pederneiras;1;1;2;187
3516200;Franca;3536703;Pederneiras;1;1;2;245
3519105;Iacanga;3536703;Pederneiras;1;1;2;57
3520509;Indaiatuba;3536703;Pederneiras;1;1;2;178
3525904;Jundiaí;3536703;Pederneiras;1;1;2;214
3526407;Laranjal Paulista;3536703;Pederneiras;1;1;2;124
3526902;Limeira;3536703;Pederneiras;1;1;2;144
3528007;Macatuba;3536703;Pederneiras;1;1;2;18
3534401;Osasco;3536703;Pederneiras;1;1;2;243
3534708;Ourinhos;3536703;Pederneiras;1;1;2;136
3536505;Paulínia;3536703;Pederneiras;1;1;2;173
3509502;Campinas;3536604;Paulo de Faria;1;1;2;402
3517505;Guapiaçu;3536604;Paulo de Faria;1;1;2;86
3524105;Ituverava;3536604;Paulo de Faria;1;1;2;167
3524303;Jaboticabal;3536604;Paulo de Faria;1;1;2;177
3529302;Matão;3536604;Paulo de Faria;1;1;2;202
3534302;Orlândia;3536604;Paulo de Faria;1;1;2;174
3534401;Osasco;3536604;Paulo de Faria;1;1;2;475
3526803;Lençóis Paulista;3536570;Paulistânia;1;1;2;60
1100205;Porto Velho;3536505;Paulínia;1;1;2;2266
1100304;Vilhena;3536505;Paulínia;1;1;2;1703
1500503;Almeirim;3536505;Paulínia;1;1;2;2412
1505536;Parauapebas;3536505;Paulínia;1;1;2;1873
1721000;Palmas;3536505;Paulínia;1;1;2;1378
2105302;Imperatriz;3536505;Paulínia;1;1;2;1909
2111300;São Luís;3536505;Paulínia;1;1;2;2256
2202505;Caracol;3536505;Paulínia;1;1;2;1539
2304285;Eusébio;3536505;Paulínia;1;1;2;2256
2312205;Santa Quitéria;3536505;Paulínia;1;1;2;2152
2602902;Cabo de Santo Agostinho;3536505;Paulínia;1;1;2;2001
2606200;Goiana;3536505;Paulínia;1;1;2;2066
2607208;Ipojuca;3536505;Paulínia;1;1;2;1989
2613701;São Lourenço da Mata;3536505;Paulínia;1;1;2;2025
2704708;Marechal Deodoro;3536505;Paulínia;1;1;2;1825
2707503;Porto Real do Colégio;3536505;Paulínia;1;1;2;1732
2803807;Malhada dos Bois;3536505;Paulínia;1;1;2;1708
2804003;Maruim;3536505;Paulínia;1;1;2;1666
2905909;Campo Alegre de Lourdes;3536505;Paulínia;1;1;2;1522
2914604;Irecê;3536505;Paulínia;1;1;2;1368
2914802;Itabuna;3536505;Paulínia;1;1;2;1184
2918001;Jequié;3536505;Paulínia;1;1;2;1217
2919553;Luís Eduardo magalhães;3536505;Paulínia;1;1;2;1187
3101607;Alfenas;3536505;Paulínia;1;1;2;194
3114204;Carmo do Cajuru;3536505;Paulínia;1;1;2;375
3125101;Extrema;3536505;Paulínia;1;1;2;87
3127107;Frutal;3536505;Paulínia;1;1;2;347
3128709;Guaxupé;3536505;Paulínia;1;1;2;167
3131307;Ipatinga;3536505;Paulínia;1;1;2;593
3136702;Juiz de Fora;3536505;Paulínia;1;1;2;406
3152501;Pouso Alegre;3536505;Paulínia;1;1;2;138
3166808;Serra do Salitre;3536505;Paulínia;1;1;2;407
3205101;Viana;3536505;Paulínia;1;1;2;720
3300803;Cachoeiras de Macacu;3536505;Paulínia;1;1;2;463
3301900;Itaboraí;3536505;Paulínia;1;1;2;441
3302254;Itatiaia;3536505;Paulínia;1;1;2;265
3306008;Três Rios;3536505;Paulínia;1;1;2;409
3501905;Amparo;3536505;Paulínia;1;1;2;41
3504107;Atibaia;3536505;Paulínia;1;1;2;74
3506904;Bofete;3536505;Paulínia;1;1;2;120
3509601;Campo Limpo Paulista;3536505;Paulínia;1;1;2;62
3510203;Capão Bonito;3536505;Paulínia;1;1;2;185
3511508;Cerquilho;3536505;Paulínia;1;1;2;75
3513504;Cubatão;3536505;Paulínia;1;1;2;146
3513801;Diadema;3536505;Paulínia;1;1;2;116
3514908;Elias Fausto;3536505;Paulínia;1;1;2;39
3516200;Franca;3536505;Paulínia;1;1;2;247
3519055;Holambra;3536505;Paulínia;1;1;2;17
3520509;Indaiatuba;3536505;Paulínia;1;1;2;38
3523206;Itararé;3536505;Paulínia;1;1;2;270
3525102;Jardinópolis;3536505;Paulínia;1;1;2;203
3525201;Jarinu;3536505;Paulínia;1;1;2;58
3527306;Louveira;3536505;Paulínia;1;1;2;40
3529401;Mauá;3536505;Paulínia;1;1;2;123
3530102;Mirandópolis;3536505;Paulínia;1;1;2;442
3530805;Moji-Mirim;3536505;Paulínia;1;1;2;41
1500602;Altamira;3536406;Paulicéia;1;1;2;2008
2704005;Junqueiro;3536406;Paulicéia;1;1;2;1996
2704302;Maceió;3536406;Paulicéia;1;1;2;2072
3514403;Dracena;3536406;Paulicéia;1;1;2;37
1100122;Ji-Paraná;3536307;Patrocínio Paulista;1;1;2;1832
1702109;Araguaína;3536307;Patrocínio Paulista;1;1;2;1490
2310704;Pentecoste;3536307;Patrocínio Paulista;1;1;2;2031
2414407;Touros;3536307;Patrocínio Paulista;1;1;2;2079
2708808;São Sebastião;3536307;Patrocínio Paulista;1;1;2;1609
2804409;Neópolis;3536307;Patrocínio Paulista;1;1;2;1573
2910503;Entre Rios;3536307;Patrocínio Paulista;1;1;2;1345
2918803;Laje;3536307;Patrocínio Paulista;1;1;2;1152
2919207;Lauro de Freitas;3536307;Patrocínio Paulista;1;1;2;1255
2919553;Luís Eduardo magalhães;3536307;Patrocínio Paulista;1;1;2;957
3101904;Alpinópolis;3536307;Patrocínio Paulista;1;1;2;99
3104007;Araxá;3536307;Patrocínio Paulista;1;1;2;122
3105103;Bambuí;3536307;Patrocínio Paulista;1;1;2;153
3108008;Bom Sucesso;3536307;Patrocínio Paulista;1;1;2;269
3109907;Caetanópolis;3536307;Patrocínio Paulista;1;1;2;334
3115102;Cássia;3536307;Patrocínio Paulista;1;1;2;40
3116407;Claraval;3536307;Patrocínio Paulista;1;1;2;27
3120904;Curvelo;3536307;Patrocínio Paulista;1;1;2;359
3127701;Governador Valadares;3536307;Patrocínio Paulista;1;1;2;587
3134400;Iturama;3536307;Patrocínio Paulista;1;1;2;317
3134905;Jacutinga;3536307;Patrocínio Paulista;1;1;2;196
3144102;Muzambinho;3536307;Patrocínio Paulista;1;1;2;115
3147402;Paraopeba;3536307;Patrocínio Paulista;1;1;2;337
3152907;Pratápolis;3536307;Patrocínio Paulista;1;1;2;47
3156403;Romaria;3536307;Patrocínio Paulista;1;1;2;197
3165107;São Tomás de Aquino;3536307;Patrocínio Paulista;1;1;2;27
3170107;Uberaba;3536307;Patrocínio Paulista;1;1;2;118
3513207;Cristais Paulista;3536307;Patrocínio Paulista;1;1;2;30
3517406;Guaíra;3536307;Patrocínio Paulista;1;1;2;111
3518909;Guzolândia;3536307;Patrocínio Paulista;1;1;2;350
3525102;Jardinópolis;3536307;Patrocínio Paulista;1;1;2;64
3531605;Monte Castelo;3536307;Patrocínio Paulista;1;1;2;452
3534401;Osasco;3536307;Patrocínio Paulista;1;1;2;325
3106705;Betim;3536208;Pariquera-Açu;1;1;2;642
3152501;Pouso Alegre;3536208;Pariquera-Açu;1;1;2;338
3201209;Cachoeiro de Itapemirim;3536208;Pariquera-Açu;1;1;2;803
3304557;Rio de Janeiro;3536208;Pariquera-Açu;1;1;2;507
3513504;Cubatão;3536208;Pariquera-Açu;1;1;2;173
3521200;Iporanga;3536208;Pariquera-Açu;1;1;2;73
3526100;Juquiá;3536208;Pariquera-Açu;1;1;2;49
2927408;Salvador;3536109;Pardinho;1;1;2;1489
3522307;Itapetininga;3536109;Pardinho;1;1;2;64
3500105;Adamantina;3536000;Parapuã;1;1;2;33
3529203;Martinópolis;3536000;Parapuã;1;1;2;56
3534401;Osasco;3536000;Parapuã;1;1;2;459
3524808;Jales;3535903;Paranapuã;1;1;2;21
3504503;Avaré;3535804;Paranapanema;1;1;2;37
3508009;Buri;3535804;Paranapanema;1;1;2;48
3509502;Campinas;3535804;Paranapanema;1;1;2;182
3522802;Itaporanga;3535804;Paranapanema;1;1;2;82
3534401;Osasco;3535804;Paranapanema;1;1;2;202
3157708;Santa Juliana;3535705;Paraíso;1;1;2;229
3500204;Adolfo;3535705;Paraíso;1;1;2;94
3505104;Barbosa;3535705;Paraíso;1;1;2;126
3506102;Bebedouro;3535705;Paraíso;1;1;2;26
3509304;Cajobi;3535705;Paraíso;1;1;2;15
3511102;Catanduva;3535705;Paraíso;1;1;2;26
3512001;Colina;3535705;Paraíso;1;1;2;41
3525706;José Bonifácio;3535705;Paraíso;1;1;2;95
3529302;Matão;3535705;Paraíso;1;1;2;76
3529500;Mendonça;3535705;Paraíso;1;1;2;86
3533254;Novais;3535705;Paraíso;1;1;2;15
3533908;Olímpia;3535705;Paraíso;1;1;2;33
3534401;Osasco;3535705;Paraíso;1;1;2;348
3535101;Palmares Paulista;3535705;Paraíso;1;1;2;10
3508504;Caçapava;3535606;Paraibuna;1;1;2;32
3510500;Caraguatatuba;3535606;Paraibuna;1;1;2;32
3520400;Ilhabela;3535606;Paraibuna;1;1;2;53
3530607;Moji das Cruzes;3535606;Paraibuna;1;1;2;57
3534401;Osasco;3535606;Paraibuna;1;1;2;117
3501301;Álvares Machado;3535507;Paraguaçu Paulista;1;1;2;96
3501608;Americana;3535507;Paraguaçu Paulista;1;1;2;340
3505807;Bastos;3535507;Paraguaçu Paulista;1;1;2;56
3507209;Borá;3535507;Paraguaçu Paulista;1;1;2;18
3510005;Cândido Mota;3535507;Paraguaçu Paulista;1;1;2;44
3516101;Florínia;3535507;Paraguaçu Paulista;1;1;2;55
3516200;Franca;3535507;Paraguaçu Paulista;1;1;2;388
3516606;Gália;3535507;Paraguaçu Paulista;1;1;2;110
3516705;Garça;3535507;Paraguaçu Paulista;1;1;2;101
3519907;Iepê;3535507;Paraguaçu Paulista;1;1;2;55
3526803;Lençóis Paulista;3535507;Paraguaçu Paulista;1;1;2;186
3530706;Mogi Guaçu;3535507;Paraguaçu Paulista;1;1;2;377
3532207;Narandiba;3535507;Paraguaçu Paulista;1;1;2;94
3534401;Osasco;3535507;Paraguaçu Paulista;1;1;2;414
3535408;Panorama;3535507;Paraguaçu Paulista;1;1;2;169
3500105;Adamantina;3535408;Panorama;1;1;2;85
3509502;Campinas;3535408;Panorama;1;1;2;526
3534401;Osasco;3535408;Panorama;1;1;2;579
3534401;Osasco;3535309;Palmital;1;1;2;362
3534708;Ourinhos;3535309;Palmital;1;1;2;39
3504206;Auriflama;3535200;Palmeira d'Oeste;1;1;2;37
3509502;Campinas;3535200;Palmeira d'Oeste;1;1;2;477
3524808;Jales;3535200;Palmeira d'Oeste;1;1;2;27
3534401;Osasco;3535200;Palmeira d'Oeste;1;1;2;543
3104007;Araxá;3535101;Palmares Paulista;1;1;2;256
3511102;Catanduva;3535101;Palmares Paulista;1;1;2;17
3512803;Cosmópolis;3535101;Palmares Paulista;1;1;2;243
3529005;Marília;3535101;Palmares Paulista;1;1;2;172
3531506;Monte Azul Paulista;3535101;Palmares Paulista;1;1;2;28
3534401;Osasco;3535101;Palmares Paulista;1;1;2;346
3104007;Araxá;3535002;Palestina;1;1;2;278
3503703;Ariranha;3535002;Palestina;1;1;2;115
3529302;Matão;3535002;Palestina;1;1;2;176
3534401;Osasco;3535002;Palestina;1;1;2;449
3170107;Uberaba;3534906;Pacaembu;1;1;2;399
3509502;Campinas;3534906;Pacaembu;1;1;2;462
3513504;Cubatão;3534906;Pacaembu;1;1;2;567
3516002;Flórida Paulista;3534906;Pacaembu;1;1;2;11
3527405;Lucélia;3534906;Pacaembu;1;1;2;31
3534401;Osasco;3534906;Pacaembu;1;1;2;515
3534401;Osasco;3534807;Ouro Verde;1;1;2;562
3104007;Araxá;3534757;Ouroeste;1;1;2;367
3514205;Dolcinópolis;3534757;Ouroeste;1;1;2;20
3525706;José Bonifácio;3534757;Ouroeste;1;1;2;140
3205101;Viana;3534708;Ourinhos;1;1;2;991
3503208;Araraquara;3534708;Ourinhos;1;1;2;221
3504107;Atibaia;3534708;Ourinhos;1;1;2;344
3505302;Barra Bonita;3534708;Ourinhos;1;1;2;148
3505807;Bastos;3534708;Ourinhos;1;1;2;145
3509809;Campos Novos Paulista;3534708;Ourinhos;1;1;2;43
3513009;Cotia;3534708;Ourinhos;1;1;2;314
3514502;Duartina;3534708;Ourinhos;1;1;2;81
3515400;Fartura;3534708;Ourinhos;1;1;2;60
3516705;Garça;3534708;Ourinhos;1;1;2;88
3519501;Ibirarema;3534708;Ourinhos;1;1;2;25
3521804;Itaí;3534708;Ourinhos;1;1;2;96
3522307;Itapetininga;3534708;Ourinhos;1;1;2;201
3522802;Itaporanga;3534708;Ourinhos;1;1;2;91
3523206;Itararé;3534708;Ourinhos;1;1;2;137
3527405;Lucélia;3534708;Ourinhos;1;1;2;181
3528601;Manduri;3534708;Ourinhos;1;1;2;59
3502101;Andradina;3534609;Osvaldo Cruz;1;1;2;110
3503208;Araraquara;3534609;Osvaldo Cruz;1;1;2;280
3504503;Avaré;3534609;Osvaldo Cruz;1;1;2;248
3506102;Bebedouro;3534609;Osvaldo Cruz;1;1;2;259
3510500;Caraguatatuba;3534609;Osvaldo Cruz;1;1;2;599
3516200;Franca;3534609;Osvaldo Cruz;1;1;2;384
3519600;Ibitinga;3534609;Osvaldo Cruz;1;1;2;211
3520806;Inúbia Paulista;3534609;Osvaldo Cruz;1;1;2;9
3521606;Irapuru;3534609;Osvaldo Cruz;1;1;2;54
3527108;Lins;3534609;Osvaldo Cruz;1;1;2;115
1100015;Alta Floresta d'Oeste;3534401;Osasco;1;1;2;1976
1100023;Ariquemes;3534401;Osasco;1;1;2;2195
1100049;Cacoal;3534401;Osasco;1;1;2;1972
1100056;Cerejeiras;3534401;Osasco;1;1;2;1802
1100064;Colorado do Oeste;3534401;Osasco;1;1;2;1785
1100098;Espigão d'Oeste;3534401;Osasco;1;1;2;1933
1100106;Guajará-Mirim;3534401;Osasco;1;1;2;2307
1100130;Machadinho d'Oeste;3534401;Osasco;1;1;2;2162
1100148;Nova Brasilândia d'Oeste;3534401;Osasco;1;1;2;2017
1100155;Ouro Preto do Oeste;3534401;Osasco;1;1;2;2083
1100189;Pimenta Bueno;3534401;Osasco;1;1;2;1936
1100288;Rolim de Moura;3534401;Osasco;1;1;2;1963
1100304;Vilhena;3534401;Osasco;1;1;2;1778
1100320;São Miguel do Guaporé;3534401;Osasco;1;1;2;2048
1100338;Nova Mamoré;3534401;Osasco;1;1;2;2333
1100346;Alvorada d'Oeste;3534401;Osasco;1;1;2;2041
1100403;Alto Paraíso;3534401;Osasco;1;1;2;2229
1100452;Buritis;3534401;Osasco;1;1;2;2233
1100809;Candeias do Jamari;3534401;Osasco;1;1;2;2325
1100940;Cujubim;3534401;Osasco;1;1;2;2206
1101203;Ministro Andreazza;3534401;Osasco;1;1;2;2002
1101401;Monte Negro;3534401;Osasco;1;1;2;2192
1101492;São Francisco do Guaporé;3534401;Osasco;1;1;2;2088
1101500;Seringueiras;3534401;Osasco;1;1;2;2062
1101708;Urupá;3534401;Osasco;1;1;2;2061
1200104;Brasiléia;3534401;Osasco;1;1;2;2571
1200203;Cruzeiro do Sul;3534401;Osasco;1;1;2;3088
1200336;Mâncio Lima;3534401;Osasco;1;1;2;3107
1200385;Plácido de Castro;3534401;Osasco;1;1;2;2485
1200450;Senador Guiomard;3534401;Osasco;1;1;2;2539
1200708;Xapuri;3534401;Osasco;1;1;2;2571
1300144;Apuí;3534401;Osasco;1;1;2;2217
1300300;Autazes;3534401;Osasco;1;1;2;2509
1300409;Barcelos;3534401;Osasco;1;1;2;2949
1300508;Barreirinha;3534401;Osasco;1;1;2;2502
1300607;Benjamin Constant;3534401;Osasco;1;1;2;3106
1300631;Beruri;3534401;Osasco;1;1;2;2591
1300706;Boca do Acre;3534401;Osasco;1;1;2;2600
1300805;Borba;3534401;Osasco;1;1;2;2456
1300904;Canutama;3534401;Osasco;1;1;2;2552
1301001;Carauari;3534401;Osasco;1;1;2;2846
1301100;Careiro;3534401;Osasco;1;1;2;2553
1301209;Coari;3534401;Osasco;1;1;2;2674
1301308;Codajás;3534401;Osasco;1;1;2;2640
1301407;Eirunepé;3534401;Osasco;1;1;2;2935
1301506;Envira;3534401;Osasco;1;1;2;2892
1301605;Fonte Boa;3534401;Osasco;1;1;2;2991
1301704;Humaitá;3534401;Osasco;1;1;2;2382
1301803;Ipixuna;3534401;Osasco;1;1;2;3052
1301852;Iranduba;3534401;Osasco;1;1;2;2597
1301902;Itacoatiara;3534401;Osasco;1;1;2;2531
1302306;Jutaí;3534401;Osasco;1;1;2;3012
1302405;Lábrea;3534401;Osasco;1;1;2;2513
1302504;Manacapuru;3534401;Osasco;1;1;2;2616
1302553;Manaquiri;3534401;Osasco;1;1;2;2588
1302702;Manicoré;3534401;Osasco;1;1;2;2416
1302900;Maués;3534401;Osasco;1;1;2;2470
1303007;Nhamundá;3534401;Osasco;1;1;2;2551
1303106;Nova Olinda do Norte;3534401;Osasco;1;1;2;2480
1303205;Novo Airão;3534401;Osasco;1;1;2;2686
1303304;Novo Aripuanã;3534401;Osasco;1;1;2;2428
1303403;Parintins;3534401;Osasco;1;1;2;2503
1303502;Pauini;3534401;Osasco;1;1;2;2644
1303536;Presidente Figueiredo;3534401;Osasco;1;1;2;2706
1303569;Rio Preto da Eva;3534401;Osasco;1;1;2;2622
1303700;Santo Antônio do Içá;3534401;Osasco;1;1;2;3064
1303809;São Gabriel da Cachoeira;3534401;Osasco;1;1;2;3262
1303908;São Paulo de Olivença;3534401;Osasco;1;1;2;3099
1304062;Tabatinga;3534401;Osasco;1;1;2;3106
1304104;Tapauá;3534401;Osasco;1;1;2;2548
1304203;Tefé;3534401;Osasco;1;1;2;2829
1304302;Urucará;3534401;Osasco;1;1;2;2556
1400209;Caracaraí;3534401;Osasco;1;1;2;3136
1400308;Mucajaí;3534401;Osasco;1;1;2;3182
1400472;Rorainópolis;3534401;Osasco;1;1;2;3015
1500107;Abaetetuba;3534401;Osasco;1;1;2;2418
1500206;Acará;3534401;Osasco;1;1;2;2395
1500305;Afuá;3534401;Osasco;1;1;2;2607
1500404;Alenquer;3534401;Osasco;1;1;2;2512
1500701;Anajás;3534401;Osasco;1;1;2;2506
1500859;Anapu;3534401;Osasco;1;1;2;2260
1500909;Augusto Corrêa;3534401;Osasco;1;1;2;2490
1500958;Aurora do Pará;3534401;Osasco;1;1;2;2368
1501303;Barcarena;3534401;Osasco;1;1;2;2443
1501501;Benevides;3534401;Osasco;1;1;2;2456
1501576;Bom Jesus do Tocantins;3534401;Osasco;1;1;2;2052
1501709;Bragança;3534401;Osasco;1;1;2;2485
1501808;Breves;3534401;Osasco;1;1;2;2449
1502103;Cametá;3534401;Osasco;1;1;2;2374
1502152;Canaã dos Carajás;3534401;Osasco;1;1;2;1909
1502202;Capanema;3534401;Osasco;1;1;2;2461
1502301;Capitão Poço;3534401;Osasco;1;1;2;2410
1502707;Conceição do Araguaia;3534401;Osasco;1;1;2;1709
1502756;Concórdia do Pará;3534401;Osasco;1;1;2;2386
1502772;Curionópolis;3534401;Osasco;1;1;2;1951
1502905;Curuçá;3534401;Osasco;1;1;2;2523
1502939;Dom Eliseu;3534401;Osasco;1;1;2;2127
1502954;Eldorado dos Carajás;3534401;Osasco;1;1;2;1944
1503200;Igarapé-Açu;3534401;Osasco;1;1;2;2478
1503309;Igarapé-Miri;3534401;Osasco;1;1;2;2393
1503457;Ipixuna do Pará;3534401;Osasco;1;1;2;2321
1503507;Irituia;3534401;Osasco;1;1;2;2408
1503606;Itaituba;3534401;Osasco;1;1;2;2317
1503705;Itupiranga;3534401;Osasco;1;1;2;2051
1503804;Jacundá;3534401;Osasco;1;1;2;2127
1503903;Juruti;3534401;Osasco;1;1;2;2528
1504059;Mãe do Rio;3534401;Osasco;1;1;2;2379
1504406;Marapanim;3534401;Osasco;1;1;2;2525
1504455;Medicilândia;3534401;Osasco;1;1;2;2302
1504604;Mocajuba;3534401;Osasco;1;1;2;2334
1504703;Moju;3534401;Osasco;1;1;2;2397
1504802;Monte Alegre;3534401;Osasco;1;1;2;2490
1504901;Muaná;3534401;Osasco;1;1;2;2446
1504950;Nova Esperança do Piriá;3534401;Osasco;1;1;2;2352
1505007;Nova Timboteua;3534401;Osasco;1;1;2;2470
1505031;Novo Progresso;3534401;Osasco;1;1;2;1999
1505064;Novo Repartimento;3534401;Osasco;1;1;2;2155
1505106;Óbidos;3534401;Osasco;1;1;2;2544
1505304;Oriximiná;3534401;Osasco;1;1;2;2566
1505403;Ourém;3534401;Osasco;1;1;2;2432
1505437;Ourilândia do Norte;3534401;Osasco;1;1;2;1903
1505486;Pacajá;3534401;Osasco;1;1;2;2205
1505502;Paragominas;3534401;Osasco;1;1;2;2269
1505809;Portel;3534401;Osasco;1;1;2;2418
1505908;Porto de Moz;3534401;Osasco;1;1;2;2468
1506005;Prainha;3534401;Osasco;1;1;2;2494
1506138;Redenção;3534401;Osasco;1;1;2;1746
1506161;Rio Maria;3534401;Osasco;1;1;2;1823
1506187;Rondon do Pará;3534401;Osasco;1;1;2;2076
1506195;Rurópolis;3534401;Osasco;1;1;2;2291
1506203;Salinópolis;3534401;Osasco;1;1;2;2528
1506500;Santa Isabel do Pará;3534401;Osasco;1;1;2;2463
1506708;Santana do Araguaia;3534401;Osasco;1;1;2;1611
1507151;São Domingos do Araguaia;3534401;Osasco;1;1;2;2000
1507201;São Domingos do Capim;3534401;Osasco;1;1;2;2419
1507300;São Félix do Xingu;3534401;Osasco;1;1;2;1932
1507409;São Francisco do Pará;3534401;Osasco;1;1;2;2475
1507458;São Geraldo do Araguaia;3534401;Osasco;1;1;2;1908
1507607;São Miguel do Guamá;3534401;Osasco;1;1;2;2426
1507904;Soure;3534401;Osasco;1;1;2;2529
1507953;Tailândia;3534401;Osasco;1;1;2;2286
1507979;Terra Santa;3534401;Osasco;1;1;2;2552
1508001;Tomé-Açu;3534401;Osasco;1;1;2;2344
1508035;Tracuateua;3534401;Osasco;1;1;2;2484
1508084;Tucumã;3534401;Osasco;1;1;2;1906
1508100;Tucuruí;3534401;Osasco;1;1;2;2207
1508126;Ulianópolis;3534401;Osasco;1;1;2;2190
1508159;Uruará;3534401;Osasco;1;1;2;2297
1508209;Vigia;3534401;Osasco;1;1;2;2509
1508308;Viseu;3534401;Osasco;1;1;2;2472
1508407;Xinguara;3534401;Osasco;1;1;2;1845
1600238;Ferreira Gomes;3534401;Osasco;1;1;2;2729
1600402;Mazagão;3534401;Osasco;1;1;2;2625
1600501;Oiapoque;3534401;Osasco;1;1;2;3060
1600535;Porto Grande;3534401;Osasco;1;1;2;2717
1600550;Pracuúba;3534401;Osasco;1;1;2;2822
1701903;Araguacema;3534401;Osasco;1;1;2;1649
1702000;Araguaçu;3534401;Osasco;1;1;2;1211
1702208;Araguatins;3534401;Osasco;1;1;2;1982
1702406;Arraias;3534401;Osasco;1;1;2;1171
1702554;Augustinópolis;3534401;Osasco;1;1;2;2004
1705508;Colinas do Tocantins;3534401;Osasco;1;1;2;1720
1708205;Formoso do Araguaia;3534401;Osasco;1;1;2;1327
1709302;Guaraí;3534401;Osasco;1;1;2;1630
1709500;Gurupi;3534401;Osasco;1;1;2;1328
1710706;Itaguatins;3534401;Osasco;1;1;2;1968
1713205;Miracema do Tocantins;3534401;Osasco;1;1;2;1555
1715754;Palmeirópolis;3534401;Osasco;1;1;2;1171
1716109;Paraíso do Tocantins;3534401;Osasco;1;1;2;1494
1716703;Colméia;3534401;Osasco;1;1;2;1649
1718204;Porto Nacional;3534401;Osasco;1;1;2;1428
1720903;Taguatinga;3534401;Osasco;1;1;2;1232
1721208;Tocantinópolis;3534401;Osasco;1;1;2;1905
1722107;Xambioá;3534401;Osasco;1;1;2;1901
2100055;Açailândia;3534401;Osasco;1;1;2;2056
2100204;Alcântara;3534401;Osasco;1;1;2;2351
2100477;Alto Alegre do Pindaré;3534401;Osasco;1;1;2;2197
2100501;Alto Parnaíba;3534401;Osasco;1;1;2;1600
2100600;Amarante do Maranhão;3534401;Osasco;1;1;2;1984
2100709;Anajatuba;3534401;Osasco;1;1;2;2252
2100832;Apicum-Açu;3534401;Osasco;1;1;2;2438
2100907;Araioses;3534401;Osasco;1;1;2;2331
2100956;Arame;3534401;Osasco;1;1;2;2065
2101004;Arari;3534401;Osasco;1;1;2;2230
2101202;Bacabal;3534401;Osasco;1;1;2;2147
2101301;Bacuri;3534401;Osasco;1;1;2;2419
2101400;Balsas;3534401;Osasco;1;1;2;1775
2101608;Barra do Corda;3534401;Osasco;1;1;2;1999
2101707;Barreirinhas;3534401;Osasco;1;1;2;2327
2101905;Bequimão;3534401;Osasco;1;1;2;2340
2102002;Bom Jardim;3534401;Osasco;1;1;2;2215
2102101;Brejo;3534401;Osasco;1;1;2;2231
2102309;Buriti Bravo;3534401;Osasco;1;1;2;1971
2102325;Buriticupu;3534401;Osasco;1;1;2;2123
2102556;Campestre do Maranhão;3534401;Osasco;1;1;2;1922
2102705;Cantanhede;3534401;Osasco;1;1;2;2214
2102804;Carolina;3534401;Osasco;1;1;2;1790
2102903;Carutapera;3534401;Osasco;1;1;2;2469
2103000;Caxias;3534401;Osasco;1;1;2;2094
2103208;Chapadinha;3534401;Osasco;1;1;2;2216
2103307;Codó;3534401;Osasco;1;1;2;2126
2103406;Coelho Neto;3534401;Osasco;1;1;2;2164
2103505;Colinas;3534401;Osasco;1;1;2;1949
2103604;Coroatá;3534401;Osasco;1;1;2;2158
2103703;Cururupu;3534401;Osasco;1;1;2;2409
2103802;Dom Pedro;3534401;Osasco;1;1;2;2058
2103901;Duque Bacelar;3534401;Osasco;1;1;2;2176
2104008;Esperantinópolis;3534401;Osasco;1;1;2;2074
2104057;Estreito;3534401;Osasco;1;1;2;1878
2104099;Formosa da Serra Negra;3534401;Osasco;1;1;2;1893
2104107;Fortaleza dos Nogueiras;3534401;Osasco;1;1;2;1834
2104206;Fortuna;3534401;Osasco;1;1;2;1987
2104404;Gonçalves Dias;3534401;Osasco;1;1;2;2046
2104800;Grajaú;3534401;Osasco;1;1;2;1962
2105104;Icatu;3534401;Osasco;1;1;2;2311
2105203;Igarapé Grande;3534401;Osasco;1;1;2;2105
2105401;Itapecuru Mirim;3534401;Osasco;1;1;2;2240
2105427;Itinga do Maranhão;3534401;Osasco;1;1;2;2112
2105500;João Lisboa;3534401;Osasco;1;1;2;2002
2105708;Lago da Pedra;3534401;Osasco;1;1;2;2105
2105906;Lago Verde;3534401;Osasco;1;1;2;2174
2106326;Maracaçumé;3534401;Osasco;1;1;2;2378
2106409;Mata Roma;3534401;Osasco;1;1;2;2231
2106508;Matinha;3534401;Osasco;1;1;2;2267
2106904;Monção;3534401;Osasco;1;1;2;2227
2107357;Nova Olinda do Maranhão;3534401;Osasco;1;1;2;2291
2107506;Paço do Lumiar;3534401;Osasco;1;1;2;2338
2107704;Paraibano;3534401;Osasco;1;1;2;1916
2107803;Parnarama;3534401;Osasco;1;1;2;2006
2108108;Paulo Ramos;3534401;Osasco;1;1;2;2118
2108207;Pedreiras;3534401;Osasco;1;1;2;2111
2108306;Penalva;3534401;Osasco;1;1;2;2247
2108504;Pindaré-Mirim;3534401;Osasco;1;1;2;2207
2108603;Pinheiro;3534401;Osasco;1;1;2;2331
2109007;Porto Franco;3534401;Osasco;1;1;2;1901
2109106;Presidente Dutra;3534401;Osasco;1;1;2;2029
2109270;Presidente Sarney;3534401;Osasco;1;1;2;2321
2109304;Presidente Vargas;3534401;Osasco;1;1;2;2243
2109601;Rosário;3534401;Osasco;1;1;2;2294
2109809;Santa Helena;3534401;Osasco;1;1;2;2357
2109908;Santa Inês;3534401;Osasco;1;1;2;2183
2110005;Santa Luzia;3534401;Osasco;1;1;2;2166
2110039;Santa Luzia do Paruá;3534401;Osasco;1;1;2;2314
2110104;Santa Quitéria do Maranhão;3534401;Osasco;1;1;2;2254
2110203;Santa Rita;3534401;Osasco;1;1;2;2278
2110302;Santo Antônio dos Lopes;3534401;Osasco;1;1;2;2078
2110401;São Benedito do Rio Preto;3534401;Osasco;1;1;2;2257
2110500;São Bento;3534401;Osasco;1;1;2;2313
2110609;São Bernardo;3534401;Osasco;1;1;2;2272
2111003;São João Batista;3534401;Osasco;1;1;2;2284
2111029;São João do Carú;3534401;Osasco;1;1;2;2211
2111052;São João do Paraíso;3534401;Osasco;1;1;2;1889
2111102;São João dos Patos;3534401;Osasco;1;1;2;1911
2111201;São José de Ribamar;3534401;Osasco;1;1;2;2339
2111409;São Luís Gonzaga do Maranhão;3534401;Osasco;1;1;2;2129
2111508;São Mateus do Maranhão;3534401;Osasco;1;1;2;2168
2111706;São Vicente Ferrer;3534401;Osasco;1;1;2;2290
2111748;Senador Alexandre Costa;3534401;Osasco;1;1;2;2040
2111763;Senador La Rocque;3534401;Osasco;1;1;2;2002
2111805;Sítio Novo;3534401;Osasco;1;1;2;1951
2112100;Timbiras;3534401;Osasco;1;1;2;2153
2112209;Timon;3534401;Osasco;1;1;2;2072
2112407;Turiaçu;3534401;Osasco;1;1;2;2424
2112506;Tutóia;3534401;Osasco;1;1;2;2335
2112605;Urbano Santos;3534401;Osasco;1;1;2;2272
2112704;Vargem Grande;3534401;Osasco;1;1;2;2230
2112803;Viana;3534401;Osasco;1;1;2;2259
2112852;Vila Nova dos Martírios;3534401;Osasco;1;1;2;2055
2112902;Vitória do Mearim;3534401;Osasco;1;1;2;2228
2113009;Vitorino Freire;3534401;Osasco;1;1;2;2158
2114007;Zé Doca;3534401;Osasco;1;1;2;2246
2200400;Altos;3534401;Osasco;1;1;2;2088
2200509;Amarante;3534401;Osasco;1;1;2;1949
2201200;Barras;3534401;Osasco;1;1;2;2178
2201903;Bom Jesus;3534401;Osasco;1;1;2;1619
2202208;Campo Maior;3534401;Osasco;1;1;2;2115
2202307;Canto do Buriti;3534401;Osasco;1;1;2;1753
2202604;Castelo do Piauí;3534401;Osasco;1;1;2;2077
2202901;Corrente;3534401;Osasco;1;1;2;1457
2203503;Elesbão Veloso;3534401;Osasco;1;1;2;1969
2203701;Esperantina;3534401;Osasco;1;1;2;2219
2203909;Floriano;3534401;Osasco;1;1;2;1887
2204303;Fronteiras;3534401;Osasco;1;1;2;1918
2204501;Guadalupe;3534401;Osasco;1;1;2;1880
2205102;Itaueira;3534401;Osasco;1;1;2;1799
2206209;Miguel Alves;3534401;Osasco;1;1;2;2174
2207009;Oeiras;3534401;Osasco;1;1;2;1886
2207702;Parnaíba;3534401;Osasco;1;1;2;2336
2207801;Paulistana;3534401;Osasco;1;1;2;1785
2207900;Pedro II;3534401;Osasco;1;1;2;2176
2208007;Picos;3534401;Osasco;1;1;2;1893
2208304;Piracuruca;3534401;Osasco;1;1;2;2223
2208403;Piripiri;3534401;Osasco;1;1;2;2185
2210003;São João do Piauí;3534401;Osasco;1;1;2;1736
2210607;São Raimundo Nonato;3534401;Osasco;1;1;2;1660
2211100;União;3534401;Osasco;1;1;2;2130
2211209;Uruçuí;3534401;Osasco;1;1;2;1818
2211308;Valença do Piauí;3534401;Osasco;1;1;2;1958
2300200;Acaraú;3534401;Osasco;1;1;2;2373
2300309;Acopiara;3534401;Osasco;1;1;2;2059
2300705;Alto Santo;3534401;Osasco;1;1;2;2160
2300754;Amontada;3534401;Osasco;1;1;2;2332
2301000;Aquiraz;3534401;Osasco;1;1;2;2321
2301109;Aracati;3534401;Osasco;1;1;2;2276
2301208;Aracoiaba;3534401;Osasco;1;1;2;2258
2301604;Assaré;3534401;Osasco;1;1;2;1965
2301703;Aurora;3534401;Osasco;1;1;2;1990
2301901;Barbalha;3534401;Osasco;1;1;2;1938
2302008;Barro;3534401;Osasco;1;1;2;1972
2302107;Baturité;3534401;Osasco;1;1;2;2260
2302206;Beberibe;3534401;Osasco;1;1;2;2302
2302305;Bela Cruz;3534401;Osasco;1;1;2;2355
2302404;Boa Viagem;3534401;Osasco;1;1;2;2143
2302503;Brejo Santo;3534401;Osasco;1;1;2;1932
2302602;Camocim;3534401;Osasco;1;1;2;2351
2302701;Campos Sales;3534401;Osasco;1;1;2;1926
2302800;Canindé;3534401;Osasco;1;1;2;2244
2303006;Caridade;3534401;Osasco;1;1;2;2260
2303105;Cariré;3534401;Osasco;1;1;2;2252
2303501;Cascavel;3534401;Osasco;1;1;2;2303
2303600;Catarina;3534401;Osasco;1;1;2;2040
2303709;Caucaia;3534401;Osasco;1;1;2;2330
2303808;Cedro;3534401;Osasco;1;1;2;2020
2304004;Coreaú;3534401;Osasco;1;1;2;2292
2304103;Crateús;3534401;Osasco;1;1;2;2118
2304301;Farias Brito;3534401;Osasco;1;1;2;1968
2304509;Frecheirinha;3534401;Osasco;1;1;2;2264
2304707;Granja;3534401;Osasco;1;1;2;2329
2305001;Guaraciaba do Norte;3534401;Osasco;1;1;2;2222
2305209;Hidrolândia;3534401;Osasco;1;1;2;2205
2305308;Ibiapina;3534401;Osasco;1;1;2;2244
2305407;Icó;3534401;Osasco;1;1;2;2047
2305506;Iguatu;3534401;Osasco;1;1;2;2036
2305605;Independência;3534401;Osasco;1;1;2;2102
2305704;Ipaumirim;3534401;Osasco;1;1;2;2014
2305803;Ipu;3534401;Osasco;1;1;2;2208
2305902;Ipueiras;3534401;Osasco;1;1;2;2187
2306306;Itapagé;3534401;Osasco;1;1;2;2305
2306405;Itapipoca;3534401;Osasco;1;1;2;2325
2306900;Jaguaribe;3534401;Osasco;1;1;2;2107
2307007;Jaguaruana;3534401;Osasco;1;1;2;2248
2307502;Lavras da Mangabeira;3534401;Osasco;1;1;2;2008
2307601;Limoeiro do Norte;3534401;Osasco;1;1;2;2205
2307700;Maranguape;3534401;Osasco;1;1;2;2312
2307809;Marco;3534401;Osasco;1;1;2;2349
2308005;Massapê;3534401;Osasco;1;1;2;2301
2308104;Mauriti;3534401;Osasco;1;1;2;1952
2308302;Milagres;3534401;Osasco;1;1;2;1952
2308401;Missão Velha;3534401;Osasco;1;1;2;1951
2308500;Mombaça;3534401;Osasco;1;1;2;2093
2308708;Morada Nova;3534401;Osasco;1;1;2;2195
2308906;Morrinhos;3534401;Osasco;1;1;2;2338
2309300;Nova Russas;3534401;Osasco;1;1;2;2170
2309409;Novo Oriente;3534401;Osasco;1;1;2;2077
2309508;Orós;3534401;Osasco;1;1;2;2060
2309607;Pacajus;3534401;Osasco;1;1;2;2291
2309706;Pacatuba;3534401;Osasco;1;1;2;2305
2310209;Paracuru;3534401;Osasco;1;1;2;2351
2310258;Paraipaba;3534401;Osasco;1;1;2;2344
2310308;Parambu;3534401;Osasco;1;1;2;2008
2310506;Pedra Branca;3534401;Osasco;1;1;2;2116
2310704;Pentecoste;3534401;Osasco;1;1;2;2304
2311108;Porteiras;3534401;Osasco;1;1;2;1923
2311306;Quixadá;3534401;Osasco;1;1;2;2190
2311405;Quixeramobim;3534401;Osasco;1;1;2;2157
2311603;Redenção;3534401;Osasco;1;1;2;2278
2311702;Reriutaba;3534401;Osasco;1;1;2;2229
2311801;Russas;3534401;Osasco;1;1;2;2231
2311959;Salitre;3534401;Osasco;1;1;2;1902
2312007;Santana do Acaraú;3534401;Osasco;1;1;2;2311
2312106;Santana do Cariri;3534401;Osasco;1;1;2;1936
2312205;Santa Quitéria;3534401;Osasco;1;1;2;2221
2312304;São Benedito;3534401;Osasco;1;1;2;2232
2312403;São Gonçalo do Amarante;3534401;Osasco;1;1;2;2333
2312700;Senador Pompeu;3534401;Osasco;1;1;2;2114
2313005;Solonópole;3534401;Osasco;1;1;2;2111
2313104;Tabuleiro do Norte;3534401;Osasco;1;1;2;2193
2313203;Tamboril;3534401;Osasco;1;1;2;2166
2313302;Tauá;3534401;Osasco;1;1;2;2040
2313401;Tianguá;3534401;Osasco;1;1;2;2262
2313500;Trairi;3534401;Osasco;1;1;2;2361
2313609;Ubajara;3534401;Osasco;1;1;2;2251
2313955;Varjota;3534401;Osasco;1;1;2;2227
2314003;Várzea Alegre;3534401;Osasco;1;1;2;1992
2314102;Viçosa do Ceará;3534401;Osasco;1;1;2;2278
2400208;Açu;3534401;Osasco;1;1;2;2209
2401008;Apodi;3534401;Osasco;1;1;2;2149
2401453;Baraúna;3534401;Osasco;1;1;2;2229
2402006;Caicó;3534401;Osasco;1;1;2;2113
2402204;Canguaretama;3534401;Osasco;1;1;2;2214
2402303;Caraúbas;3534401;Osasco;1;1;2;2161
2402600;Ceará-Mirim;3534401;Osasco;1;1;2;2270
2403103;Currais Novos;3534401;Osasco;1;1;2;2159
2403251;Parnamirim;3534401;Osasco;1;1;2;2251
2404200;Goianinha;3534401;Osasco;1;1;2;2216
2405801;João Câmara;3534401;Osasco;1;1;2;2261
2407104;Macaíba;3534401;Osasco;1;1;2;2252
2407203;Macau;3534401;Osasco;1;1;2;2266
2407807;Monte Alegre;3534401;Osasco;1;1;2;2234
2408300;Nova Cruz;3534401;Osasco;1;1;2;2190
2408904;Parelhas;3534401;Osasco;1;1;2;2111
2409407;Pau dos Ferros;3534401;Osasco;1;1;2;2102
2411205;Santa Cruz;3534401;Osasco;1;1;2;2184
2411502;Santo Antônio;3534401;Osasco;1;1;2;2203
2412005;São Gonçalo do Amarante;3534401;Osasco;1;1;2;2260
2412203;São José de Mipibu;3534401;Osasco;1;1;2;2235
2412609;São Paulo do Potengi;3534401;Osasco;1;1;2;2229
2500304;Alagoa Grande;3534401;Osasco;1;1;2;2127
2500601;Alhandra;3534401;Osasco;1;1;2;2127
2500700;São João do Rio do Peixe;3534401;Osasco;1;1;2;2030
2501104;Areia;3534401;Osasco;1;1;2;2131
2501807;Bayeux;3534401;Osasco;1;1;2;2155
2501906;Belém;3534401;Osasco;1;1;2;2160
2502805;Brejo do Cruz;3534401;Osasco;1;1;2;2107
2503001;Caaporã;3534401;Osasco;1;1;2;2120
2503209;Cabedelo;3534401;Osasco;1;1;2;2166
2503704;Cajazeiras;3534401;Osasco;1;1;2;2008
2504306;Catolé do Rocha;3534401;Osasco;1;1;2;2097
2504405;Conceição;3534401;Osasco;1;1;2;1946
2505105;Cuité;3534401;Osasco;1;1;2;2155
2506004;Esperança;3534401;Osasco;1;1;2;2119
2506301;Guarabira;3534401;Osasco;1;1;2;2152
2506905;Itabaiana;3534401;Osasco;1;1;2;2114
2507002;Itaporanga;3534401;Osasco;1;1;2;1986
2508307;Lagoa Seca;3534401;Osasco;1;1;2;2103
2508604;Lucena;3534401;Osasco;1;1;2;2174
2508901;Mamanguape;3534401;Osasco;1;1;2;2169
2509107;Mari;3534401;Osasco;1;1;2;2141
2509701;Monteiro;3534401;Osasco;1;1;2;1972
2510808;Patos;3534401;Osasco;1;1;2;2051
2512101;Pombal;3534401;Osasco;1;1;2;2050
2512309;Princesa Isabel;3534401;Osasco;1;1;2;1949
2512507;Queimadas;3534401;Osasco;1;1;2;2087
2513406;Santa Luzia;3534401;Osasco;1;1;2;2082
2513901;São Bento;3534401;Osasco;1;1;2;2096
2515302;Sapé;3534401;Osasco;1;1;2;2143
2516003;Solânea;3534401;Osasco;1;1;2;2148
2516201;Sousa;3534401;Osasco;1;1;2;2033
2600054;Abreu e Lima;3534401;Osasco;1;1;2;2085
2600104;Afogados da Ingazeira;3534401;Osasco;1;1;2;1961
2600500;Águas Belas;3534401;Osasco;1;1;2;1855
2601102;Araripina;3534401;Osasco;1;1;2;1873
2601201;Arcoverde;3534401;Osasco;1;1;2;1922
2601409;Barreiros;3534401;Osasco;1;1;2;1986
2601904;Bezerros;3534401;Osasco;1;1;2;2007
2602001;Bodocó;3534401;Osasco;1;1;2;1868
2602100;Bom Conselho;3534401;Osasco;1;1;2;1870
2602308;Bonito;3534401;Osasco;1;1;2;1988
2602605;Brejo da Madre de Deus;3534401;Osasco;1;1;2;1986
2603009;Cabrobó;3534401;Osasco;1;1;2;1824
2603108;Cachoeirinha;3534401;Osasco;1;1;2;1960
2603207;Caetés;3534401;Osasco;1;1;2;1914
2603454;Camaragibe;3534401;Osasco;1;1;2;2068
2604007;Carpina;3534401;Osasco;1;1;2;2073
2604205;Catende;3534401;Osasco;1;1;2;1971
2605004;Cupira;3534401;Osasco;1;1;2;1964
2605103;Custódia;3534401;Osasco;1;1;2;1928
2605202;Escada;3534401;Osasco;1;1;2;2026
2605707;Floresta;3534401;Osasco;1;1;2;1839
2605905;Gameleira;3534401;Osasco;1;1;2;1997
2606002;Garanhuns;3534401;Osasco;1;1;2;1911
2606200;Goiana;3534401;Osasco;1;1;2;2111
2606408;Gravatá;3534401;Osasco;1;1;2;2022
2606804;Igarassu;3534401;Osasco;1;1;2;2088
2607208;Ipojuca;3534401;Osasco;1;1;2;2032
2607307;Ipubi;3534401;Osasco;1;1;2;1874
2607653;Itambé;3534401;Osasco;1;1;2;2119
2607752;Itapissuma;3534401;Osasco;1;1;2;2096
2608107;João Alfredo;3534401;Osasco;1;1;2;2053
2608750;Lagoa Grande;3534401;Osasco;1;1;2;1731
2608909;Limoeiro;3534401;Osasco;1;1;2;2058
2609402;Moreno;3534401;Osasco;1;1;2;2055
2609501;Nazaré da Mata;3534401;Osasco;1;1;2;2082
2609907;Ouricuri;3534401;Osasco;1;1;2;1851
2610004;Palmares;3534401;Osasco;1;1;2;1976
2610608;Paudalho;3534401;Osasco;1;1;2;2071
2610707;Paulista;3534401;Osasco;1;1;2;2083
2610905;Pesqueira;3534401;Osasco;1;1;2;1949
2611002;Petrolândia;3534401;Osasco;1;1;2;1804
2611804;Ribeirão;3534401;Osasco;1;1;2;2004
2611903;Rio Formoso;3534401;Osasco;1;1;2;2001
2612505;Santa Cruz do Capibaribe;3534401;Osasco;1;1;2;2012
2612604;Santa Maria da Boa Vista;3534401;Osasco;1;1;2;1773
2613008;São Bento do Una;3534401;Osasco;1;1;2;1941
2613503;São José do Belmonte;3534401;Osasco;1;1;2;1898
2613602;São José do Egito;3534401;Osasco;1;1;2;2005
2613701;São Lourenço da Mata;3534401;Osasco;1;1;2;2069
2613909;Serra Talhada;3534401;Osasco;1;1;2;1914
2614105;Sertânia;3534401;Osasco;1;1;2;1950
2614204;Sirinhaém;3534401;Osasco;1;1;2;2010
2614501;Surubim;3534401;Osasco;1;1;2;2048
2614600;Tabira;3534401;Osasco;1;1;2;1983
2615300;Timbaúba;3534401;Osasco;1;1;2;2100
2615409;Toritama;3534401;Osasco;1;1;2;2016
2615607;Trindade;3534401;Osasco;1;1;2;1854
2616407;Vitória de Santo Antão;3534401;Osasco;1;1;2;2045
2700300;Arapiraca;3534401;Osasco;1;1;2;1818
2700409;Atalaia;3534401;Osasco;1;1;2;1879
2700706;Batalha;3534401;Osasco;1;1;2;1804
2701001;Boca da Mata;3534401;Osasco;1;1;2;1855
2701407;Campo Alegre;3534401;Osasco;1;1;2;1835
2701605;Canapi;3534401;Osasco;1;1;2;1832
2702306;Coruripe;3534401;Osasco;1;1;2;1814
2702355;Craíbas;3534401;Osasco;1;1;2;1828
2702405;Delmiro Gouveia;3534401;Osasco;1;1;2;1791
2702900;Girau do Ponciano;3534401;Osasco;1;1;2;1800
2703106;Igaci;3534401;Osasco;1;1;2;1842
2703205;Igreja Nova;3534401;Osasco;1;1;2;1787
2703809;Joaquim Gomes;3534401;Osasco;1;1;2;1927
2704005;Junqueiro;3534401;Osasco;1;1;2;1816
2704104;Lagoa da Canoa;3534401;Osasco;1;1;2;1810
2704500;Maragogi;3534401;Osasco;1;1;2;1968
2704708;Marechal Deodoro;3534401;Osasco;1;1;2;1867
2705507;Murici;3534401;Osasco;1;1;2;1901
2706307;Palmeira dos Índios;3534401;Osasco;1;1;2;1851
2706406;Pão de Açúcar;3534401;Osasco;1;1;2;1781
2706703;Penedo;3534401;Osasco;1;1;2;1781
2706901;Pilar;3534401;Osasco;1;1;2;1874
2707107;Piranhas;3534401;Osasco;1;1;2;1777
2707305;Porto Calvo;3534401;Osasco;1;1;2;1955
2707701;Rio Largo;3534401;Osasco;1;1;2;1890
2707800;Roteiro;3534401;Osasco;1;1;2;1852
2708006;Santana do Ipanema;3534401;Osasco;1;1;2;1828
2708402;São José da Tapera;3534401;Osasco;1;1;2;1802
2708501;São Luís do Quitunde;3534401;Osasco;1;1;2;1921
2708600;São Miguel dos Campos;3534401;Osasco;1;1;2;1849
2708808;São Sebastião;3534401;Osasco;1;1;2;1810
2709152;Teotônio Vilela;3534401;Osasco;1;1;2;1824
2709301;União dos Palmares;3534401;Osasco;1;1;2;1903
2709400;Viçosa;3534401;Osasco;1;1;2;1879
2800209;Aquidabã;3534401;Osasco;1;1;2;1755
2800605;Barra dos Coqueiros;3534401;Osasco;1;1;2;1701
2800670;Boquim;3534401;Osasco;1;1;2;1642
2801207;Canindé de São Francisco;3534401;Osasco;1;1;2;1771
2801306;Capela;3534401;Osasco;1;1;2;1729
2801702;Cristinápolis;3534401;Osasco;1;1;2;1605
2802106;Estância;3534401;Osasco;1;1;2;1641
2802908;Itabaiana;3534401;Osasco;1;1;2;1699
2803005;Itabaianinha;3534401;Osasco;1;1;2;1621
2803500;Lagarto;3534401;Osasco;1;1;2;1662
2804508;Nossa Senhora da Glória;3534401;Osasco;1;1;2;1738
2804805;Nossa Senhora do Socorro;3534401;Osasco;1;1;2;1695
2805406;Poço Redondo;3534401;Osasco;1;1;2;1763
2805604;Porto da Folha;3534401;Osasco;1;1;2;1773
2805703;Propriá;3534401;Osasco;1;1;2;1768
2806206;Salgado;3534401;Osasco;1;1;2;1660
2806701;São Cristóvão;3534401;Osasco;1;1;2;1681
2807105;Simão Dias;3534401;Osasco;1;1;2;1675
2807402;Tobias Barreto;3534401;Osasco;1;1;2;1622
2900207;Abaré;3534401;Osasco;1;1;2;1804
2900405;Água Fria;3534401;Osasco;1;1;2;1515
2900801;Alcobaça;3534401;Osasco;1;1;2;1010
2901007;Amargosa;3534401;Osasco;1;1;2;1363
2901106;Amélia Rodrigues;3534401;Osasco;1;1;2;1465
2901205;Anagé;3534401;Osasco;1;1;2;1130
2901304;Andaraí;3534401;Osasco;1;1;2;1303
2901403;Angical;3534401;Osasco;1;1;2;1292
2902104;Araci;3534401;Osasco;1;1;2;1556
2902500;Baianópolis;3534401;Osasco;1;1;2;1262
2902708;Barra;3534401;Osasco;1;1;2;1432
2902807;Barra da Estiva;3534401;Osasco;1;1;2;1224
2902906;Barra do Choça;3534401;Osasco;1;1;2;1139
2903508;Belo Campo;3534401;Osasco;1;1;2;1090
2903607;Biritinga;3534401;Osasco;1;1;2;1536
2903805;Boa Vista do Tupim;3534401;Osasco;1;1;2;1350
2903904;Bom Jesus da Lapa;3534401;Osasco;1;1;2;1185
2904050;Bonito;3534401;Osasco;1;1;2;1391
2904100;Boquira;3534401;Osasco;1;1;2;1252
2904308;Brejões;3534401;Osasco;1;1;2;1346
2904506;Brotas de Macaúbas;3534401;Osasco;1;1;2;1341
2904605;Brumado;3534401;Osasco;1;1;2;1152
2904704;Buerarema;3534401;Osasco;1;1;2;1206
2904753;Buritirama;3534401;Osasco;1;1;2;1453
2904803;Caatiba;3534401;Osasco;1;1;2;1140
2904902;Cachoeira;3534401;Osasco;1;1;2;1435
2905008;Caculé;3534401;Osasco;1;1;2;1095
2905206;Caetité;3534401;Osasco;1;1;2;1129
2905602;Camacan;3534401;Osasco;1;1;2;1153
2905800;Camamu;3534401;Osasco;1;1;2;1305
2906006;Campo Formoso;3534401;Osasco;1;1;2;1576
2906303;Canavieiras;3534401;Osasco;1;1;2;1165
2906600;Candiba;3534401;Osasco;1;1;2;1082
2906709;Cândido Sales;3534401;Osasco;1;1;2;1048
2906808;Cansanção;3534401;Osasco;1;1;2;1594
2906873;Capim Grosso;3534401;Osasco;1;1;2;1502
2906907;Caravelas;3534401;Osasco;1;1;2;990
2907509;Catu;3534401;Osasco;1;1;2;1491
2907707;Chorrochó;3534401;Osasco;1;1;2;1779
2907806;Cícero Dantas;3534401;Osasco;1;1;2;1650
2908002;Coaraci;3534401;Osasco;1;1;2;1224
2908101;Cocos;3534401;Osasco;1;1;2;1059
2908309;Conceição do Almeida;3534401;Osasco;1;1;2;1406
2908408;Conceição do Coité;3534401;Osasco;1;1;2;1526
2908507;Conceição do Jacuípe;3534401;Osasco;1;1;2;1471
2908705;Condeúba;3534401;Osasco;1;1;2;1068
2909109;Coribe;3534401;Osasco;1;1;2;1099
2909307;Correntina;3534401;Osasco;1;1;2;1148
2909604;Crisópolis;3534401;Osasco;1;1;2;1580
2909802;Cruz das Almas;3534401;Osasco;1;1;2;1420
2910008;Dário Meira;3534401;Osasco;1;1;2;1216
2910057;Dias d'Ávila;3534401;Osasco;1;1;2;1472
2910107;Dom Basílio;3534401;Osasco;1;1;2;1191
2910404;Encruzilhada;3534401;Osasco;1;1;2;1062
2910503;Entre Rios;3534401;Osasco;1;1;2;1546
2910602;Esplanada;3534401;Osasco;1;1;2;1562
2910701;Euclides da Cunha;3534401;Osasco;1;1;2;1632
2910727;Eunápolis;3534401;Osasco;1;1;2;1070
2911006;Floresta Azul;3534401;Osasco;1;1;2;1193
2911105;Formosa do Rio Preto;3534401;Osasco;1;1;2;1392
2911204;Gandu;3534401;Osasco;1;1;2;1303
2911709;Guanambi;3534401;Osasco;1;1;2;1098
2911907;Iaçu;3534401;Osasco;1;1;2;1356
2912103;Ibicaraí;3534401;Osasco;1;1;2;1201
2912202;Ibicoara;3534401;Osasco;1;1;2;1246
2912301;Ibicuí;3534401;Osasco;1;1;2;1176
2912400;Ibipeba;3534401;Osasco;1;1;2;1398
2913200;Ibotirama;3534401;Osasco;1;1;2;1306
2913507;Iguaí;3534401;Osasco;1;1;2;1178
2913705;Inhambupe;3534401;Osasco;1;1;2;1544
2913804;Ipecaetá;3534401;Osasco;1;1;2;1446
2913903;Ipiaú;3534401;Osasco;1;1;2;1260
2914000;Ipirá;3534401;Osasco;1;1;2;1433
2914109;Ipupiara;3534401;Osasco;1;1;2;1365
2914406;Iraquara;3534401;Osasco;1;1;2;1349
2914505;Irará;3534401;Osasco;1;1;2;1498
2914604;Irecê;3534401;Osasco;1;1;2;1434
2914653;Itabela;3534401;Osasco;1;1;2;1056
2914703;Itaberaba;3534401;Osasco;1;1;2;1373
2914901;Itacaré;3534401;Osasco;1;1;2;1283
2915106;Itagi;3534401;Osasco;1;1;2;1236
2915304;Itagimirim;3534401;Osasco;1;1;2;1092
2915403;Itaju do Colônia;3534401;Osasco;1;1;2;1165
2915502;Itajuípe;3534401;Osasco;1;1;2;1226
2915601;Itamaraju;3534401;Osasco;1;1;2;1023
2915809;Itambé;3534401;Osasco;1;1;2;1103
2916005;Itanhém;3534401;Osasco;1;1;2;955
2916104;Itaparica;3534401;Osasco;1;1;2;1421
2916203;Itapé;3534401;Osasco;1;1;2;1204
2916401;Itapetinga;3534401;Osasco;1;1;2;1121
2916856;Itatim;3534401;Osasco;1;1;2;1388
2916906;Itiruçu;3534401;Osasco;1;1;2;1288
2917003;Itiúba;3534401;Osasco;1;1;2;1580
2917102;Itororó;3534401;Osasco;1;1;2;1149
2917201;Ituaçu;3534401;Osasco;1;1;2;1206
2917300;Ituberá;3534401;Osasco;1;1;2;1323
2917334;Iuiú;3534401;Osasco;1;1;2;1059
2917508;Jacobina;3534401;Osasco;1;1;2;1495
2917607;Jaguaquara;3534401;Osasco;1;1;2;1299
2917706;Jaguarari;3534401;Osasco;1;1;2;1606
2918001;Jequié;3534401;Osasco;1;1;2;1265
2918100;Jeremoabo;3534401;Osasco;1;1;2;1705
2918357;João Dourado;3534401;Osasco;1;1;2;1440
2919157;Lapão;3534401;Osasco;1;1;2;1431
2919405;Licínio de Almeida;3534401;Osasco;1;1;2;1068
2919504;Livramento de Nossa Senhora;3534401;Osasco;1;1;2;1201
2919801;Macaúbas;3534401;Osasco;1;1;2;1230
2920007;Maiquinique;3534401;Osasco;1;1;2;1091
2920106;Mairi;3534401;Osasco;1;1;2;1463
2920304;Malhada de Pedras;3534401;Osasco;1;1;2;1124
2920502;Maracás;3534401;Osasco;1;1;2;1282
2920601;Maragogipe;3534401;Osasco;1;1;2;1420
2921005;Mata de São João;3534401;Osasco;1;1;2;1479
2921104;Medeiros Neto;3534401;Osasco;1;1;2;949
2921203;Miguel Calmon;3534401;Osasco;1;1;2;1472
2921302;Milagres;3534401;Osasco;1;1;2;1365
2921500;Monte Santo;3534401;Osasco;1;1;2;1624
2921708;Morro do Chapéu;3534401;Osasco;1;1;2;1437
2921807;Mortugaba;3534401;Osasco;1;1;2;1040
2922300;Muritiba;3534401;Osasco;1;1;2;1432
2922508;Nazaré;3534401;Osasco;1;1;2;1392
2922607;Nilo Peçanha;3534401;Osasco;1;1;2;1335
2922706;Nova Canaã;3534401;Osasco;1;1;2;1171
2923100;Olindina;3534401;Osasco;1;1;2;1584
2923209;Oliveira dos Brejinhos;3534401;Osasco;1;1;2;1299
2923357;Ourolândia;3534401;Osasco;1;1;2;1500
2923407;Palmas de Monte Alto;3534401;Osasco;1;1;2;1087
2923506;Palmeiras;3534401;Osasco;1;1;2;1323
2923605;Paramirim;3534401;Osasco;1;1;2;1203
2923704;Paratinga;3534401;Osasco;1;1;2;1248
2923803;Paripiranga;3534401;Osasco;1;1;2;1672
2924207;Pedro Alexandre;3534401;Osasco;1;1;2;1733
2924306;Piatã;3534401;Osasco;1;1;2;1252
2924405;Pilão Arcado;3534401;Osasco;1;1;2;1560
2924504;Pindaí;3534401;Osasco;1;1;2;1080
2924900;Planaltino;3534401;Osasco;1;1;2;1303
2925006;Planalto;3534401;Osasco;1;1;2;1163
2925105;Poções;3534401;Osasco;1;1;2;1187
2925204;Pojuca;3534401;Osasco;1;1;2;1486
2925253;Ponto Novo;3534401;Osasco;1;1;2;1548
2925402;Potiraguá;3534401;Osasco;1;1;2;1116
2925501;Prado;3534401;Osasco;1;1;2;1020
2925709;Presidente Jânio Quadros;3534401;Osasco;1;1;2;1103
2925758;Presidente Tancredo Neves;3534401;Osasco;1;1;2;1334
2925808;Queimadas;3534401;Osasco;1;1;2;1560
2925907;Quijingue;3534401;Osasco;1;1;2;1599
2926004;Remanso;3534401;Osasco;1;1;2;1612
2926301;Riachão do Jacuípe;3534401;Osasco;1;1;2;1492
2926400;Riacho de Santana;3534401;Osasco;1;1;2;1161
2926608;Ribeira do Pombal;3534401;Osasco;1;1;2;1624
2926905;Rio do Pires;3534401;Osasco;1;1;2;1238
2927002;Rio Real;3534401;Osasco;1;1;2;1597
2927101;Rodelas;3534401;Osasco;1;1;2;1805
2927200;Ruy Barbosa;3534401;Osasco;1;1;2;1390
2927507;Santa Bárbara;3534401;Osasco;1;1;2;1495
2927606;Santa Brígida;3534401;Osasco;1;1;2;1748
2927705;Santa Cruz Cabrália;3534401;Osasco;1;1;2;1112
2927804;Santa Cruz da Vitória;3534401;Osasco;1;1;2;1175
2927903;Santa Inês;3534401;Osasco;1;1;2;1327
2928000;Santaluz;3534401;Osasco;1;1;2;1543
2928109;Santa Maria da Vitória;3534401;Osasco;1;1;2;1156
2928208;Santana;3534401;Osasco;1;1;2;1199
2928604;Santo Amaro;3534401;Osasco;1;1;2;1455
2928802;Santo Estêvão;3534401;Osasco;1;1;2;1437
2928901;São Desidério;3534401;Osasco;1;1;2;1249
2929107;São Felipe;3534401;Osasco;1;1;2;1407
2929206;São Francisco do Conde;3534401;Osasco;1;1;2;1449
2929255;São Gabriel;3534401;Osasco;1;1;2;1444
2929305;São Gonçalo dos Campos;3534401;Osasco;1;1;2;1452
2929503;São Sebastião do Passé;3534401;Osasco;1;1;2;1470
2929800;Saúde;3534401;Osasco;1;1;2;1527
2929909;Seabra;3534401;Osasco;1;1;2;1325
2930105;Senhor do Bonfim;3534401;Osasco;1;1;2;1588
2930154;Serra do Ramalho;3534401;Osasco;1;1;2;1147
2930303;Serra Dourada;3534401;Osasco;1;1;2;1223
2930402;Serra Preta;3534401;Osasco;1;1;2;1458
2930501;Serrinha;3534401;Osasco;1;1;2;1523
2930774;Sobradinho;3534401;Osasco;1;1;2;1661
2930808;Souto Soares;3534401;Osasco;1;1;2;1365
2931004;Tanhaçu;3534401;Osasco;1;1;2;1189
2931053;Tanque Novo;3534401;Osasco;1;1;2;1185
2931301;Tapiramutá;3534401;Osasco;1;1;2;1422
2931608;Teolândia;3534401;Osasco;1;1;2;1318
2931806;Tremedal;3534401;Osasco;1;1;2;1088
2931905;Tucano;3534401;Osasco;1;1;2;1597
2932002;Uauá;3534401;Osasco;1;1;2;1675
2932101;Ubaíra;3534401;Osasco;1;1;2;1337
2932200;Ubaitaba;3534401;Osasco;1;1;2;1265
2932309;Ubatã;3534401;Osasco;1;1;2;1261
2932606;Urandi;3534401;Osasco;1;1;2;1053
2932705;Uruçuca;3534401;Osasco;1;1;2;1239
2932903;Valença;3534401;Osasco;1;1;2;1360
2933000;Valente;3534401;Osasco;1;1;2;1524
2933406;Wagner;3534401;Osasco;1;1;2;1363
2933455;Wanderley;3534401;Osasco;1;1;2;1295
2933604;Xique-Xique;3534401;Osasco;1;1;2;1464
3100203;Abaeté;3534401;Osasco;1;1;2;504
3100302;Abre Campo;3534401;Osasco;1;1;2;564
3100906;Águas Formosas;3534401;Osasco;1;1;2;920
3101102;Aimorés;3534401;Osasco;1;1;2;727
3101201;Aiuruoca;3534401;Osasco;1;1;2;281
3101508;Além Paraíba;3534401;Osasco;1;1;2;455
3101607;Alfenas;3534401;Osasco;1;1;2;251
3101706;Almenara;3534401;Osasco;1;1;2;1017
3101904;Alpinópolis;3534401;Osasco;1;1;2;298
3102001;Alterosa;3534401;Osasco;1;1;2;261
3103405;Araçuaí;3534401;Osasco;1;1;2;876
3103504;Araguari;3534401;Osasco;1;1;2;560
3104007;Araxá;3534401;Osasco;1;1;2;437
3104205;Arcos;3534401;Osasco;1;1;2;380
3104304;Areado;3534401;Osasco;1;1;2;250
3104502;Arinos;3534401;Osasco;1;1;2;846
3104700;Ataléia;3534401;Osasco;1;1;2;833
3105103;Bambuí;3534401;Osasco;1;1;2;398
3105905;Barroso;3534401;Osasco;1;1;2;386
3106309;Belo Oriente;3534401;Osasco;1;1;2;645
3106903;Bicas;3534401;Osasco;1;1;2;427
3107109;Boa Esperança;3534401;Osasco;1;1;2;298
3107307;Bocaiúva;3534401;Osasco;1;1;2;769
3107406;Bom Despacho;3534401;Osasco;1;1;2;449
3108008;Bom Sucesso;3534401;Osasco;1;1;2;345
3108305;Borda da Mata;3534401;Osasco;1;1;2;153
3108404;Botelhos;3534401;Osasco;1;1;2;214
3108909;Brasópolis;3534401;Osasco;1;1;2;168
3109006;Brumadinho;3534401;Osasco;1;1;2;458
3109105;Bueno Brandão;3534401;Osasco;1;1;2;129
3109303;Buritis;3534401;Osasco;1;1;2;875
3109402;Buritizeiro;3534401;Osasco;1;1;2;707
3109907;Caetanópolis;3534401;Osasco;1;1;2;527
3110004;Caeté;3534401;Osasco;1;1;2;513
3110301;Caldas;3534401;Osasco;1;1;2;183
3110608;Cambuí;3534401;Osasco;1;1;2;125
3110905;Campanha;3534401;Osasco;1;1;2;235
3111002;Campestre;3534401;Osasco;1;1;2;209
3111101;Campina Verde;3534401;Osasco;1;1;2;521
3111200;Campo Belo;3534401;Osasco;1;1;2;331
3111309;Campo do Meio;3534401;Osasco;1;1;2;286
3111606;Campos Gerais;3534401;Osasco;1;1;2;275
3111804;Canápolis;3534401;Osasco;1;1;2;585
3112000;Candeias;3534401;Osasco;1;1;2;343
3112307;Capelinha;3534401;Osasco;1;1;2;776
3112406;Capetinga;3534401;Osasco;1;1;2;324
3112604;Capinópolis;3534401;Osasco;1;1;2;604
3112703;Capitão Enéas;3534401;Osasco;1;1;2;857
3113305;Carangola;3534401;Osasco;1;1;2;573
3113404;Caratinga;3534401;Osasco;1;1;2;620
3113503;Carbonita;3534401;Osasco;1;1;2;765
3113602;Careaçu;3534401;Osasco;1;1;2;199
3113701;Carlos Chagas;3534401;Osasco;1;1;2;881
3113909;Carmo da Cachoeira;3534401;Osasco;1;1;2;279
3114006;Carmo da Mata;3534401;Osasco;1;1;2;382
3114204;Carmo do Cajuru;3534401;Osasco;1;1;2;423
3114303;Carmo do Paranaíba;3534401;Osasco;1;1;2;503
3114402;Carmo do Rio Claro;3534401;Osasco;1;1;2;291
3114501;Carmópolis de Minas;3534401;Osasco;1;1;2;397
3115102;Cássia;3534401;Osasco;1;1;2;328
3115300;Cataguases;3534401;Osasco;1;1;2;481
3115508;Caxambu;3534401;Osasco;1;1;2;254
3115805;Centralina;3534401;Osasco;1;1;2;600
3116100;Chapada do Norte;3534401;Osasco;1;1;2;831
3116605;Cláudio;3534401;Osasco;1;1;2;399
3117306;Conceição das Alagoas;3534401;Osasco;1;1;2;432
3117504;Conceição do Mato Dentro;3534401;Osasco;1;1;2;603
3117801;Conceição dos Ouros;3534401;Osasco;1;1;2;160
3118007;Congonhas;3534401;Osasco;1;1;2;446
3118403;Conselheiro Pena;3534401;Osasco;1;1;2;719
3118809;Coração de Jesus;3534401;Osasco;1;1;2;795
3119104;Corinto;3534401;Osasco;1;1;2;618
3119302;Coromandel;3534401;Osasco;1;1;2;563
3119401;Coronel Fabriciano;3534401;Osasco;1;1;2;611
3120201;Cristais;3534401;Osasco;1;1;2;321
3120508;Cristina;3534401;Osasco;1;1;2;213
3120805;Cruzília;3534401;Osasco;1;1;2;275
3120904;Curvelo;3534401;Osasco;1;1;2;577
3121605;Diamantina;3534401;Osasco;1;1;2;669
3122454;Divisópolis;3534401;Osasco;1;1;2;1039
3123205;Dores do Indaiá;3534401;Osasco;1;1;2;466
3123601;Elói Mendes;3534401;Osasco;1;1;2;247
3123700;Engenheiro Caldas;3534401;Osasco;1;1;2;675
3124104;Esmeraldas;3534401;Osasco;1;1;2;486
3124203;Espera Feliz;3534401;Osasco;1;1;2;588
3124302;Espinosa;3534401;Osasco;1;1;2;1032
3124500;Estiva;3534401;Osasco;1;1;2;142
3124906;Eugenópolis;3534401;Osasco;1;1;2;538
3125903;Ferros;3534401;Osasco;1;1;2;609
3126109;Formiga;3534401;Osasco;1;1;2;367
3126307;Fortaleza de Minas;3534401;Osasco;1;1;2;297
3126703;Francisco Sá;3534401;Osasco;1;1;2;844
3127107;Frutal;3534401;Osasco;1;1;2;438
3127800;Grão Mogol;3534401;Osasco;1;1;2;865
3128006;Guanhães;3534401;Osasco;1;1;2;657
3128105;Guapé;3534401;Osasco;1;1;2;319
3128253;Guaraciama;3534401;Osasco;1;1;2;786
3128303;Guaranésia;3534401;Osasco;1;1;2;247
3128600;Guarda-Mor;3534401;Osasco;1;1;2;639
3128709;Guaxupé;3534401;Osasco;1;1;2;247
3129301;Iapu;3534401;Osasco;1;1;2;646
3129509;Ibiá;3534401;Osasco;1;1;2;454
3130101;Igarapé;3534401;Osasco;1;1;2;457
3130200;Igaratinga;3534401;Osasco;1;1;2;448
3130309;Iguatama;3534401;Osasco;1;1;2;388
3130903;Inhapim;3534401;Osasco;1;1;2;643
3131000;Inhaúma;3534401;Osasco;1;1;2;509
3131158;Ipaba;3534401;Osasco;1;1;2;634
3131208;Ipanema;3534401;Osasco;1;1;2;659
3131505;Ipuiúna;3534401;Osasco;1;1;2;170
3131802;Itabirinha de Mantena;3534401;Osasco;1;1;2;784
3131901;Itabirito;3534401;Osasco;1;1;2;467
3132107;Itacarambi;3534401;Osasco;1;1;2;970
3132206;Itaguara;3534401;Osasco;1;1;2;419
3132305;Itaipé;3534401;Osasco;1;1;2;851
3132404;Itajubá;3534401;Osasco;1;1;2;183
3132503;Itamarandiba;3534401;Osasco;1;1;2;742
3132701;Itambacuri;3534401;Osasco;1;1;2;795
3133006;Itamonte;3534401;Osasco;1;1;2;239
3133105;Itanhandu;3534401;Osasco;1;1;2;233
3133303;Itaobim;3534401;Osasco;1;1;2;932
3133402;Itapagipe;3534401;Osasco;1;1;2;479
3133501;Itapecerica;3534401;Osasco;1;1;2;378
3133758;Itaú de Minas;3534401;Osasco;1;1;2;309
3133808;Itaúna;3534401;Osasco;1;1;2;440
3134202;Ituiutaba;3534401;Osasco;1;1;2;572
3134905;Jacutinga;3534401;Osasco;1;1;2;139
3135050;Jaíba;3534401;Osasco;1;1;2;960
3135100;Janaúba;3534401;Osasco;1;1;2;923
3135209;Januária;3534401;Osasco;1;1;2;925
3135803;Jequitinhonha;3534401;Osasco;1;1;2;972
3136207;João Monlevade;3534401;Osasco;1;1;2;550
3136306;João Pinheiro;3534401;Osasco;1;1;2;643
3137403;Lagoa Dourada;3534401;Osasco;1;1;2;399
3137601;Lagoa Santa;3534401;Osasco;1;1;2;522
3137700;Lajinha;3534401;Osasco;1;1;2;641
3137809;Lambari;3534401;Osasco;1;1;2;227
3138401;Leopoldina;3534401;Osasco;1;1;2;471
3138609;Lima Duarte;3534401;Osasco;1;1;2;357
3138807;Luz;3534401;Osasco;1;1;2;428
3139003;Machado;3534401;Osasco;1;1;2;224
3139201;Malacacheta;3534401;Osasco;1;1;2;787
3139300;Manga;3534401;Osasco;1;1;2;1011
3139508;Manhumirim;3534401;Osasco;1;1;2;602
3139607;Mantena;3534401;Osasco;1;1;2;780
3139706;Maravilhas;3534401;Osasco;1;1;2;493
3139904;Maria da Fé;3534401;Osasco;1;1;2;198
3140001;Mariana;3534401;Osasco;1;1;2;489
3140704;Mateus Leme;3534401;Osasco;1;1;2;460
3140902;Matipó;3534401;Osasco;1;1;2;576
3141009;Mato Verde;3534401;Osasco;1;1;2;982
3141108;Matozinhos;3534401;Osasco;1;1;2;518
3141405;Medina;3534401;Osasco;1;1;2;966
3141801;Minas Novas;3534401;Osasco;1;1;2;816
3142007;Mirabela;3534401;Osasco;1;1;2;846
3142106;Miradouro;3534401;Osasco;1;1;2;536
3142205;Miraí;3534401;Osasco;1;1;2;496
3142601;Monsenhor Paulo;3534401;Osasco;1;1;2;234
3142700;Montalvânia;3534401;Osasco;1;1;2;1031
3142809;Monte Alegre de Minas;3534401;Osasco;1;1;2;557
3142908;Monte Azul;3534401;Osasco;1;1;2;1006
3143104;Monte Carmelo;3534401;Osasco;1;1;2;537
3143203;Monte Santo de Minas;3534401;Osasco;1;1;2;262
3143807;Munhoz;3534401;Osasco;1;1;2;111
3144003;Mutum;3534401;Osasco;1;1;2;680
3144102;Muzambinho;3534401;Osasco;1;1;2;240
3144300;Nanuque;3534401;Osasco;1;1;2;899
3144607;Nepomuceno;3534401;Osasco;1;1;2;299
3144706;Nova Era;3534401;Osasco;1;1;2;563
3144805;Nova Lima;3534401;Osasco;1;1;2;489
3145000;Nova Ponte;3534401;Osasco;1;1;2;495
3145109;Nova Resende;3534401;Osasco;1;1;2;269
3145208;Nova Serrana;3534401;Osasco;1;1;2;444
3145307;Novo Cruzeiro;3534401;Osasco;1;1;2;832
3145604;Oliveira;3534401;Osasco;1;1;2;370
3146008;Ouro Fino;3534401;Osasco;1;1;2;145
3146305;Padre Paraíso;3534401;Osasco;1;1;2;887
3146909;Papagaios;3534401;Osasco;1;1;2;497
3147006;Paracatu;3534401;Osasco;1;1;2;698
3147105;Pará de Minas;3534401;Osasco;1;1;2;463
3147204;Paraguaçu;3534401;Osasco;1;1;2;245
3147303;Paraisópolis;3534401;Osasco;1;1;2;150
3147402;Paraopeba;3534401;Osasco;1;1;2;530
3147907;Passos;3534401;Osasco;1;1;2;314
3148103;Patrocínio;3534401;Osasco;1;1;2;508
3148509;Pavão;3534401;Osasco;1;1;2;889
3148608;Peçanha;3534401;Osasco;1;1;2;697
3148707;Pedra Azul;3534401;Osasco;1;1;2;993
3149309;Pedro Leopoldo;3534401;Osasco;1;1;2;514
3149804;Perdizes;3534401;Osasco;1;1;2;466
3149903;Perdões;3534401;Osasco;1;1;2;321
3150505;Pimenta;3534401;Osasco;1;1;2;352
3151206;Pirapora;3534401;Osasco;1;1;2;713
3151305;Piraúba;3534401;Osasco;1;1;2;456
3151404;Pitangui;3534401;Osasco;1;1;2;471
3151503;Piumhi;3534401;Osasco;1;1;2;350
3151701;Poço Fundo;3534401;Osasco;1;1;2;211
3152006;Pompéu;3534401;Osasco;1;1;2;512
3152105;Ponte Nova;3534401;Osasco;1;1;2;523
3152204;Porteirinha;3534401;Osasco;1;1;2;941
3152402;Poté;3534401;Osasco;1;1;2;808
3152600;Pouso Alto;3534401;Osasco;1;1;2;237
3152808;Prata;3534401;Osasco;1;1;2;516
3153905;Raposos;3534401;Osasco;1;1;2;497
3154002;Raul Soares;3534401;Osasco;1;1;2;581
3154200;Resende Costa;3534401;Osasco;1;1;2;388
3154309;Resplendor;3534401;Osasco;1;1;2;733
3154606;Ribeirão das Neves;3534401;Osasco;1;1;2;498
3154903;Rio Casca;3534401;Osasco;1;1;2;554
3155504;Rio Paranaíba;3534401;Osasco;1;1;2;484
3155603;Rio Pardo de Minas;3534401;Osasco;1;1;2;974
3155702;Rio Piracicaba;3534401;Osasco;1;1;2;540
3155801;Rio Pomba;3534401;Osasco;1;1;2;443
3156809;Sabinópolis;3534401;Osasco;1;1;2;655
3156908;Sacramento;3534401;Osasco;1;1;2;412
3157005;Salinas;3534401;Osasco;1;1;2;929
3157203;Santa Bárbara;3534401;Osasco;1;1;2;522
3157708;Santa Juliana;3534401;Osasco;1;1;2;474
3157906;Santa Margarida;3534401;Osasco;1;1;2;576
3158003;Santa Maria de Itabira;3534401;Osasco;1;1;2;585
3158201;Santa Maria do Suaçuí;3534401;Osasco;1;1;2;737
3159803;Santa Vitória;3534401;Osasco;1;1;2;617
3159902;Santo Antônio do Amparo;3534401;Osasco;1;1;2;344
3160405;Santo Antônio do Monte;3534401;Osasco;1;1;2;410
3160702;Santos Dumont;3534401;Osasco;1;1;2;400
3161007;São Domingos do Prata;3534401;Osasco;1;1;2;560
3161106;São Francisco;3534401;Osasco;1;1;2;859
3161502;São Geraldo;3534401;Osasco;1;1;2;494
3162005;São Gonçalo do Sapucaí;3534401;Osasco;1;1;2;219
3162104;São Gotardo;3534401;Osasco;1;1;2;474
3162401;São João da Ponte;3534401;Osasco;1;1;2;885
3162708;São João do Paraíso;3534401;Osasco;1;1;2;1026
3162906;São João Nepomuceno;3534401;Osasco;1;1;2;442
3162922;São Joaquim de Bicas;3534401;Osasco;1;1;2;462
3163607;São José do Mantimento;3534401;Osasco;1;1;2;640
3163706;São Lourenço;3534401;Osasco;1;1;2;238
3164100;São Pedro do Suaçuí;3534401;Osasco;1;1;2;710
3164704;São Sebastião do Paraíso;3534401;Osasco;1;1;2;289
3165008;São Tiago;3534401;Osasco;1;1;2;371
3165537;Sarzedo;3534401;Osasco;1;1;2;470
3166006;Senhora de Oliveira;3534401;Osasco;1;1;2;462
3166808;Serra do Salitre;3534401;Osasco;1;1;2;490
3166907;Serrania;3534401;Osasco;1;1;2;233
3167400;Silvianópolis;3534401;Osasco;1;1;2;193
3167707;Sobrália;3534401;Osasco;1;1;2;669
3168002;Taiobeiras;3534401;Osasco;1;1;2;968
3168408;Tarumirim;3534401;Osasco;1;1;2;673
3168705;Timóteo;3534401;Osasco;1;1;2;605
3168804;Tiradentes;3534401;Osasco;1;1;2;377
3169307;Três Corações;3534401;Osasco;1;1;2;261
3169356;Três Marias;3534401;Osasco;1;1;2;611
3169406;Três Pontas;3534401;Osasco;1;1;2;272
3169703;Turmalina;3534401;Osasco;1;1;2;802
3169901;Ubá;3534401;Osasco;1;1;2;471
3170404;Unaí;3534401;Osasco;1;1;2;790
3170909;Varzelândia;3534401;Osasco;1;1;2;910
3171204;Vespasiano;3534401;Osasco;1;1;2;513
3171600;Virgem da Lapa;3534401;Osasco;1;1;2;867
3172004;Visconde do Rio Branco;3534401;Osasco;1;1;2;488
3200102;Afonso Cláudio;3534401;Osasco;1;1;2;687
3200201;Alegre;3534401;Osasco;1;1;2;611
3200409;Anchieta;3534401;Osasco;1;1;2;684
3200805;Baixo Guandu;3534401;Osasco;1;1;2;729
3200904;Barra de São Francisco;3534401;Osasco;1;1;2;792
3201407;Castelo;3534401;Osasco;1;1;2;647
3202207;Fundão;3534401;Osasco;1;1;2;757
3202306;Guaçuí;3534401;Osasco;1;1;2;600
3202454;Ibatiba;3534401;Osasco;1;1;2;646
3202603;Iconha;3534401;Osasco;1;1;2;677
3202801;Itapemirim;3534401;Osasco;1;1;2;657
3203007;Iúna;3534401;Osasco;1;1;2;638
3203056;Jaguaré;3534401;Osasco;1;1;2;847
3203130;João Neiva;3534401;Osasco;1;1;2;768
3203205;Linhares;3534401;Osasco;1;1;2;823
3203320;Marataízes;3534401;Osasco;1;1;2;658
3203403;Mimoso do Sul;3534401;Osasco;1;1;2;614
3203502;Montanha;3534401;Osasco;1;1;2;882
3203908;Nova Venécia;3534401;Osasco;1;1;2;835
3204054;Pedro Canário;3534401;Osasco;1;1;2;902
3204104;Pinheiros;3534401;Osasco;1;1;2;869
3204559;Santa Maria de Jetibá;3534401;Osasco;1;1;2;722
3204609;Santa Teresa;3534401;Osasco;1;1;2;741
3204708;São Gabriel da Palha;3534401;Osasco;1;1;2;803
3204906;São Mateus;3534401;Osasco;1;1;2;873
3205036;Vargem Alta;3534401;Osasco;1;1;2;665
3205069;Venda Nova do Imigrante;3534401;Osasco;1;1;2;672
3205101;Viana;3534401;Osasco;1;1;2;717
3300159;Aperibé;3534401;Osasco;1;1;2;516
3300225;Areal;3534401;Osasco;1;1;2;400
3300258;Arraial do Cabo;3534401;Osasco;1;1;2;490
3300308;Barra do Piraí;3534401;Osasco;1;1;2;324
3300506;Bom Jardim;3534401;Osasco;1;1;2;470
3300605;Bom Jesus do Itabapoana;3534401;Osasco;1;1;2;582
3300803;Cachoeiras de Macacu;3534401;Osasco;1;1;2;437
3300902;Cambuci;3534401;Osasco;1;1;2;540
3300936;Carapebus;3534401;Osasco;1;1;2;542
3300951;Comendador Levy Gasparian;3534401;Osasco;1;1;2;398
3301108;Cantagalo;3534401;Osasco;1;1;2;482
3301157;Cardoso Moreira;3534401;Osasco;1;1;2;571
3301207;Carmo;3534401;Osasco;1;1;2;460
3301405;Conceição de Macabu;3534401;Osasco;1;1;2;525
3301504;Cordeiro;3534401;Osasco;1;1;2;479
3301603;Duas Barras;3534401;Osasco;1;1;2;464
3301801;Engenheiro Paulo de Frontin;3534401;Osasco;1;1;2;335
3301850;Guapimirim;3534401;Osasco;1;1;2;403
3301876;Iguaba Grande;3534401;Osasco;1;1;2;471
3301900;Itaboraí;3534401;Osasco;1;1;2;410
3302106;Itaocara;3534401;Osasco;1;1;2;520
3302270;Japeri;3534401;Osasco;1;1;2;334
3302304;Laje do Muriaé;3534401;Osasco;1;1;2;538
3302452;Macuco;3534401;Osasco;1;1;2;492
3302601;Mangaratiba;3534401;Osasco;1;1;2;290
3302700;Maricá;3534401;Osasco;1;1;2;410
3302809;Mendes;3534401;Osasco;1;1;2;329
3302858;Mesquita;3534401;Osasco;1;1;2;351
3303005;Miracema;3534401;Osasco;1;1;2;519
3303104;Natividade;3534401;Osasco;1;1;2;560
3303609;Paracambi;3534401;Osasco;1;1;2;330
3303708;Paraíba do Sul;3534401;Osasco;1;1;2;387
3303807;Parati;3534401;Osasco;1;1;2;214
3303856;Paty do Alferes;3534401;Osasco;1;1;2;364
3303955;Pinheiral;3534401;Osasco;1;1;2;306
3304003;Piraí;3534401;Osasco;1;1;2;311
3304102;Porciúncula;3534401;Osasco;1;1;2;559
3304128;Quatis;3534401;Osasco;1;1;2;286
3304151;Quissamã;3534401;Osasco;1;1;2;563
3304300;Rio Bonito;3534401;Osasco;1;1;2;434
3304409;Rio Claro;3534401;Osasco;1;1;2;285
3304508;Rio das Flores;3534401;Osasco;1;1;2;359
3304524;Rio das Ostras;3534401;Osasco;1;1;2;506
3304607;Santa Maria Madalena;3534401;Osasco;1;1;2;516
3304706;Santo Antônio de Pádua;3534401;Osasco;1;1;2;517
3304805;São Fidélis;3534401;Osasco;1;1;2;551
3305133;São José de Ubá;3534401;Osasco;1;1;2;547
3305158;São José do Vale do Rio Preto;3534401;Osasco;1;1;2;422
3305208;São Pedro da Aldeia;3534401;Osasco;1;1;2;483
3305307;São Sebastião do Alto;3534401;Osasco;1;1;2;502
3305406;Sapucaia;3534401;Osasco;1;1;2;429
3305505;Saquarema;3534401;Osasco;1;1;2;447
3305554;Seropédica;3534401;Osasco;1;1;2;326
3305604;Silva Jardim;3534401;Osasco;1;1;2;458
3305901;Trajano de Morais;3534401;Osasco;1;1;2;507
3306156;Varre-Sai;3534401;Osasco;1;1;2;575
3306206;Vassouras;3534401;Osasco;1;1;2;342
3500303;Aguaí;3534401;Osasco;1;1;2;164
3500402;Águas da Prata;3534401;Osasco;1;1;2;177
3500501;Águas de Lindóia;3534401;Osasco;1;1;2;118
3500550;Águas de Santa Bárbara;3534401;Osasco;1;1;2;260
3500600;Águas de São Pedro;3534401;Osasco;1;1;2;152
3501004;Altinópolis;3534401;Osasco;1;1;2;284
3501152;Alumínio;3534401;Osasco;1;1;2;48
3501301;Álvares Machado;3534401;Osasco;1;1;2;502
3501707;Américo Brasiliense;3534401;Osasco;1;1;2;241
3501806;Américo de Campos;3534401;Osasco;1;1;2;465
3501905;Amparo;3534401;Osasco;1;1;2;92
3502002;Analândia;3534401;Osasco;1;1;2;179
3502101;Andradina;3534401;Osasco;1;1;2;548
3502200;Angatuba;3534401;Osasco;1;1;2;166
3502705;Apiaí;3534401;Osasco;1;1;2;236
3502903;Araçoiaba da Serra;3534401;Osasco;1;1;2;84
3503604;Areiópolis;3534401;Osasco;1;1;2;213
3503703;Ariranha;3534401;Osasco;1;1;2;329
3504206;Auriflama;3534401;Osasco;1;1;2;494
3504404;Avanhandava;3534401;Osasco;1;1;2;394
3504602;Bady Bassitt;3534401;Osasco;1;1;2;395
3504909;Bananal;3534401;Osasco;1;1;2;268
3505104;Barbosa;3534401;Osasco;1;1;2;405
3505203;Bariri;3534401;Osasco;1;1;2;256
3505302;Barra Bonita;3534401;Osasco;1;1;2;213
3505609;Barrinha;3534401;Osasco;1;1;2;294
3505807;Bastos;3534401;Osasco;1;1;2;438
3505906;Batatais;3534401;Osasco;1;1;2;304
3506300;Bernardino de Campos;3534401;Osasco;1;1;2;279
3506409;Bilac;3534401;Osasco;1;1;2;443
3506607;Biritiba-Mirim;3534401;Osasco;1;1;2;77
3506706;Boa Esperança do Sul;3534401;Osasco;1;1;2;236
3506805;Bocaina;3534401;Osasco;1;1;2;234
3507100;Bom Jesus dos Perdões;3534401;Osasco;1;1;2;55
3507407;Borborema;3534401;Osasco;1;1;2;314
3507704;Braúna;3534401;Osasco;1;1;2;422
3507803;Brodowski;3534401;Osasco;1;1;2;295
3507902;Brotas;3534401;Osasco;1;1;2;194
3508009;Buri;3534401;Osasco;1;1;2;186
3508108;Buritama;3534401;Osasco;1;1;2;436
3508504;Caçapava;3534401;Osasco;1;1;2;121
3508603;Cachoeira Paulista;3534401;Osasco;1;1;2;205
3508702;Caconde;3534401;Osasco;1;1;2;223
3508801;Cafelândia;3534401;Osasco;1;1;2;344
3509304;Cajobi;3534401;Osasco;1;1;2;358
3509403;Cajuru;3534401;Osasco;1;1;2;255
3510005;Cândido Mota;3534401;Osasco;1;1;2;376
3510104;Cândido Rodrigues;3534401;Osasco;1;1;2;308
3510203;Capão Bonito;3534401;Osasco;1;1;2;168
3510302;Capela do Alto;3534401;Osasco;1;1;2;97
3510708;Cardoso;3534401;Osasco;1;1;2;498
3510807;Casa Branca;3534401;Osasco;1;1;2;197
3511003;Castilho;3534401;Osasco;1;1;2;559
3511409;Cerqueira César;3534401;Osasco;1;1;2;248
3511607;Cesário Lange;3534401;Osasco;1;1;2;123
3511706;Charqueada;3534401;Osasco;1;1;2;151
3511904;Clementina;3534401;Osasco;1;1;2;430
3512001;Colina;3534401;Osasco;1;1;2;359
3512100;Colômbia;3534401;Osasco;1;1;2;415
3512308;Conchas;3534401;Osasco;1;1;2;137
3512902;Cosmorama;3534401;Osasco;1;1;2;453
3513108;Cravinhos;3534401;Osasco;1;1;2;261
3513702;Descalvado;3534401;Osasco;1;1;2;199
3513900;Divinolândia;3534401;Osasco;1;1;2;207
3514106;Dois Córregos;3534401;Osasco;1;1;2;207
3514205;Dolcinópolis;3534401;Osasco;1;1;2;536
3514502;Duartina;3534401;Osasco;1;1;2;293
3514957;Embaúba;3534401;Osasco;1;1;2;353
3515152;Engenheiro Coelho;3534401;Osasco;1;1;2;124
3515186;Espírito Santo do Pinhal;3534401;Osasco;1;1;2;149
3515194;Espírito Santo do Turvo;3534401;Osasco;1;1;2;284
3515202;Estrela d'Oeste;3534401;Osasco;1;1;2;512
3515400;Fartura;3534401;Osasco;1;1;2;278
3515608;Fernando Prestes;3534401;Osasco;1;1;2;316
3516002;Flórida Paulista;3534401;Osasco;1;1;2;493
3516606;Gália;3534401;Osasco;1;1;2;313
3516705;Garça;3534401;Osasco;1;1;2;325
3516804;Gastão Vidigal;3534401;Osasco;1;1;2;458
3516903;General Salgado;3534401;Osasco;1;1;2;482
3517000;Getulina;3534401;Osasco;1;1;2;372
3517307;Guaimbê;3534401;Osasco;1;1;2;363
3517406;Guaíra;3534401;Osasco;1;1;2;388
3517505;Guapiaçu;3534401;Osasco;1;1;2;390
3517604;Guapiara;3534401;Osasco;1;1;2;192
3517802;Guaraçaí;3534401;Osasco;1;1;2;526
3517901;Guaraci;3534401;Osasco;1;1;2;400
3518008;Guarani d'Oeste;3534401;Osasco;1;1;2;526
3518206;Guararapes;3534401;Osasco;1;1;2;464
3518503;Guareí;3534401;Osasco;1;1;2;143
3518602;Guariba;3534401;Osasco;1;1;2;281
3519006;Herculândia;3534401;Osasco;1;1;2;402
3519055;Holambra;3534401;Osasco;1;1;2;103
3519105;Iacanga;3534401;Osasco;1;1;2;291
3519204;Iacri;3534401;Osasco;1;1;2;437
3519303;Ibaté;3534401;Osasco;1;1;2;213
3519402;Ibirá;3534401;Osasco;1;1;2;368
3519501;Ibirarema;3534401;Osasco;1;1;2;343
3519600;Ibitinga;3534401;Osasco;1;1;2;286
3519808;Icém;3534401;Osasco;1;1;2;429
3519907;Iepê;3534401;Osasco;1;1;2;447
3520004;Igaraçu do Tietê;3534401;Osasco;1;1;2;213
3520103;Igarapava;3534401;Osasco;1;1;2;398
3520400;Ilhabela;3534401;Osasco;1;1;2;149
3520426;Ilha Comprida;3534401;Osasco;1;1;2;154
3520442;Ilha Solteira;3534401;Osasco;1;1;2;574
3520608;Indiana;3534401;Osasco;1;1;2;478
3520905;Ipaussu;3534401;Osasco;1;1;2;294
3521101;Ipeúna;3534401;Osasco;1;1;2;154
3521309;Ipuã;3534401;Osasco;1;1;2;364
3521606;Irapuru;3534401;Osasco;1;1;2;510
3521705;Itaberá;3534401;Osasco;1;1;2;243
3521804;Itaí;3534401;Osasco;1;1;2;235
3521903;Itajobi;3534401;Osasco;1;1;2;336
3522604;Itapira;3534401;Osasco;1;1;2;122
3522703;Itápolis;3534401;Osasco;1;1;2;297
3522802;Itaporanga;3534401;Osasco;1;1;2;276
3522901;Itapuí;3534401;Osasco;1;1;2;243
3523602;Itirapina;3534401;Osasco;1;1;2;176
3524105;Ituverava;3534401;Osasco;1;1;2;368
3524709;Jaguariúna;3534401;Osasco;1;1;2;94
3524808;Jales;3534401;Osasco;1;1;2;524
3525706;José Bonifácio;3534401;Osasco;1;1;2;402
3526001;Junqueirópolis;3534401;Osasco;1;1;2;521
3526209;Juquitiba;3534401;Osasco;1;1;2;52
3526506;Lavínia;3534401;Osasco;1;1;2;504
3527405;Lucélia;3534401;Osasco;1;1;2;474
3527603;Luís Antônio;3534401;Osasco;1;1;2;238
3527702;Luiziânia;3534401;Osasco;1;1;2;413
3528007;Macatuba;3534401;Osasco;1;1;2;226
3528601;Manduri;3534401;Osasco;1;1;2;265
3528809;Maracaí;3534401;Osasco;1;1;2;407
3529203;Martinópolis;3534401;Osasco;1;1;2;471
3529302;Matão;3534401;Osasco;1;1;2;269
3529500;Mendonça;3534401;Osasco;1;1;2;385
3529708;Miguelópolis;3534401;Osasco;1;1;2;392
3529807;Mineiros do Tietê;3534401;Osasco;1;1;2;210
3530102;Mirandópolis;3534401;Osasco;1;1;2;511
3530201;Mirante do Paranapanema;3534401;Osasco;1;1;2;538
3530300;Mirassol;3534401;Osasco;1;1;2;408
3530508;Mococa;3534401;Osasco;1;1;2;230
3530904;Mombuca;3534401;Osasco;1;1;2;104
3531100;Mongaguá;3534401;Osasco;1;1;2;63
3531209;Monte Alegre do Sul;3534401;Osasco;1;1;2;95
3531308;Monte Alto;3534401;Osasco;1;1;2;302
3531407;Monte Aprazível;3534401;Osasco;1;1;2;425
3531506;Monte Azul Paulista;3534401;Osasco;1;1;2;346
3531902;Morro Agudo;3534401;Osasco;1;1;2;336
3532009;Morungaba;3534401;Osasco;1;1;2;72
3532405;Nazaré Paulista;3534401;Osasco;1;1;2;56
3532603;Nhandeara;3534401;Osasco;1;1;2;455
3532900;Nova Europa;3534401;Osasco;1;1;2;265
3533007;Nova Granada;3534401;Osasco;1;1;2;419
3533502;Novo Horizonte;3534401;Osasco;1;1;2;336
3533908;Olímpia;3534401;Osasco;1;1;2;375
3534104;Oriente;3534401;Osasco;1;1;2;368
3534302;Orlândia;3534401;Osasco;1;1;2;331
1508159;Uruará;3534302;Orlândia;1;1;2;1973
1709500;Gurupi;3534302;Orlândia;1;1;2;1004
1713205;Miracema do Tocantins;3534302;Orlândia;1;1;2;1237
3103504;Araguari;3534302;Orlândia;1;1;2;232
3104007;Araxá;3534302;Orlândia;1;1;2;159
3105103;Bambuí;3534302;Orlândia;1;1;2;212
3109402;Buritizeiro;3534302;Orlândia;1;1;2;478
3112604;Capinópolis;3534302;Orlândia;1;1;2;284
3129707;Ibiraci;3534302;Orlândia;1;1;2;85
3149200;Pedrinópolis;3534302;Orlândia;1;1;2;171
3151503;Piumhi;3534302;Orlândia;1;1;2;202
3156908;Sacramento;3534302;Orlândia;1;1;2;106
3159605;Santa Rita do Sapucaí;3534302;Orlândia;1;1;2;285
3171105;Veríssimo;3534302;Orlândia;1;1;2;125
3503208;Araraquara;3534302;Orlândia;1;1;2;122
3516705;Garça;3534302;Orlândia;1;1;2;249
3517703;Guará;3534302;Orlândia;1;1;2;33
3520103;Igarapava;3534302;Orlândia;1;1;2;76
3531100;Mongaguá;3534302;Orlândia;1;1;2;396
3531407;Monte Aprazível;3534302;Orlândia;1;1;2;190
3518602;Guariba;3534203;Orindiúva;1;1;2;176
3529302;Matão;3534203;Orindiúva;1;1;2;186
3529005;Marília;3534104;Oriente;1;1;2;17
3506102;Bebedouro;3534005;Onda Verde;1;1;2;87
3529302;Matão;3534005;Onda Verde;1;1;2;145
3530300;Mirassol;3534005;Onda Verde;1;1;2;34
3532702;Nipoã;3534005;Onda Verde;1;1;2;61
1702109;Araguaína;3533908;Olímpia;1;1;2;1501
3104007;Araxá;3533908;Olímpia;1;1;2;241
3134400;Iturama;3533908;Olímpia;1;1;2;174
3144805;Nova Lima;3533908;Olímpia;1;1;2;531
3147907;Passos;3533908;Olímpia;1;1;2;237
3170107;Uberaba;3533908;Olímpia;1;1;2;151
3304557;Rio de Janeiro;3533908;Olímpia;1;1;2;638
3503703;Ariranha;3533908;Olímpia;1;1;2;50
3510807;Casa Branca;3533908;Olímpia;1;1;2;222
3512001;Colina;3533908;Olímpia;1;1;2;38
3516200;Franca;3533908;Olímpia;1;1;2;158
3517802;Guaraçaí;3533908;Olímpia;1;1;2;242
3519402;Ibirá;3533908;Olímpia;1;1;2;51
3521507;Irapuã;3533908;Olímpia;1;1;2;79
3525706;José Bonifácio;3533908;Olímpia;1;1;2;88
3527108;Lins;3533908;Olímpia;1;1;2;138
3528858;Marapoama;3533908;Olímpia;1;1;2;61
3531506;Monte Azul Paulista;3533908;Olímpia;1;1;2;33
3516705;Garça;3533809;Óleo;1;1;2;86
3509502;Campinas;3533700;Ocauçu;1;1;2;300
3104007;Araxá;3533601;Nuporanga;1;1;2;150
3127107;Frutal;3533601;Nuporanga;1;1;2;146
3170206;Uberlândia;3533601;Nuporanga;1;1;2;210
3505906;Batatais;3533601;Nuporanga;1;1;2;21
3513009;Cotia;3533601;Nuporanga;1;1;2;329
1502764;Cumaru do Norte;3533502;Novo Horizonte;1;1;2;1517
2101400;Balsas;3533502;Novo Horizonte;1;1;2;1577
3114550;Carneirinho;3533502;Novo Horizonte;1;1;2;247
3131406;Ipiaçu;3533502;Novo Horizonte;1;1;2;316
3134202;Ituiutaba;3533502;Novo Horizonte;1;1;2;278
3500105;Adamantina;3533502;Novo Horizonte;1;1;2;195
3500204;Adolfo;3533502;Novo Horizonte;1;1;2;51
3503703;Ariranha;3533502;Novo Horizonte;1;1;2;55
3504206;Auriflama;3533502;Novo Horizonte;1;1;2;163
3505609;Barrinha;3533502;Novo Horizonte;1;1;2;114
3505906;Batatais;3533502;Novo Horizonte;1;1;2;178
3506003;Bauru;3533502;Novo Horizonte;1;1;2;98
3514403;Dracena;3533502;Novo Horizonte;1;1;2;242
3515509;Fernandópolis;3533502;Novo Horizonte;1;1;2;169
3516002;Flórida Paulista;3533502;Novo Horizonte;1;1;2;203
3516200;Franca;3533502;Novo Horizonte;1;1;2;214
3517000;Getulina;3533502;Novo Horizonte;1;1;2;82
3518107;Guarantã;3533502;Novo Horizonte;1;1;2;61
3519402;Ibirá;3533502;Novo Horizonte;1;1;2;43
3521507;Irapuã;3533502;Novo Horizonte;1;1;2;29
3525300;Jaú;3533502;Novo Horizonte;1;1;2;112
3525706;José Bonifácio;3533502;Novo Horizonte;1;1;2;67
3526001;Junqueirópolis;3533502;Novo Horizonte;1;1;2;229
3526506;Lavínia;3533502;Novo Horizonte;1;1;2;191
3529203;Martinópolis;3533502;Novo Horizonte;1;1;2;216
3531407;Monte Aprazível;3533502;Novo Horizonte;1;1;2;92
2927408;Salvador;3533403;Nova Odessa;1;1;2;1395
3205200;Vila Velha;3533403;Nova Odessa;1;1;2;756
3300100;Angra dos Reis;3533403;Nova Odessa;1;1;2;310
3301702;Duque de Caxias;3533403;Nova Odessa;1;1;2;409
3302403;Macaé;3533403;Nova Odessa;1;1;2;556
3503307;Araras;3533403;Nova Odessa;1;1;2;46
3503802;Artur Nogueira;3533403;Nova Odessa;1;1;2;25
3505708;Barueri;3533403;Nova Odessa;1;1;2;94
3513504;Cubatão;3533403;Nova Odessa;1;1;2;155
3513801;Diadema;3533403;Nova Odessa;1;1;2;124
3516200;Franca;3533403;Nova Odessa;1;1;2;246
3517703;Guará;3533403;Nova Odessa;1;1;2;264
3525904;Jundiaí;3533403;Nova Odessa;1;1;2;62
3526803;Lençóis Paulista;3533403;Nova Odessa;1;1;2;157
3526902;Limeira;3533403;Nova Odessa;1;1;2;24
3530805;Moji-Mirim;3533403;Nova Odessa;1;1;2;50
3531803;Monte Mor;3533403;Nova Odessa;1;1;2;20
3515905;Floreal;3533304;Nova Luzitânia;1;1;2;26
3532603;Nhandeara;3533304;Nova Luzitânia;1;1;2;32
3503703;Ariranha;3533254;Novais;1;1;2;26
3514403;Dracena;3533205;Nova Independência;1;1;2;47
3515202;Estrela d'Oeste;3533205;Nova Independência;1;1;2;145
3523008;Itapura;3533205;Nova Independência;1;1;2;51
3104007;Araxá;3533007;Nova Granada;1;1;2;267
3116902;Comendador Gomes;3533007;Nova Granada;1;1;2;96
3169604;Tupaciguara;3533007;Nova Granada;1;1;2;224
3502804;Araçatuba;3533007;Nova Granada;1;1;2;142
3506102;Bebedouro;3533007;Nova Granada;1;1;2;92
3509502;Campinas;3533007;Nova Granada;1;1;2;353
3530300;Mirassol;3533007;Nova Granada;1;1;2;38
3510203;Capão Bonito;3532900;Nova Europa;1;1;2;248
3519303;Ibaté;3532900;Nova Europa;1;1;2;62
3522703;Itápolis;3532900;Nova Europa;1;1;2;33
3304557;Rio de Janeiro;3532827;Nova Campina;1;1;2;587
3505302;Barra Bonita;3532827;Nova Campina;1;1;2;183
3505708;Barueri;3532827;Nova Campina;1;1;2;216
3523206;Itararé;3532827;Nova Campina;1;1;2;44
3504602;Bady Bassitt;3532801;Nova Aliança;1;1;2;12
3525706;José Bonifácio;3532801;Nova Aliança;1;1;2;20
3532702;Nipoã;3532801;Nova Aliança;1;1;2;31
3522307;Itapetininga;3532702;Nipoã;1;1;2;347
3527603;Luís Antônio;3532702;Nipoã;1;1;2;228
3530300;Mirassol;3532702;Nipoã;1;1;2;29
3531407;Monte Aprazível;3532702;Nipoã;1;1;2;17
3504206;Auriflama;3532603;Nhandeara;1;1;2;54
3506508;Birigui;3532603;Nhandeara;1;1;2;75
3509502;Campinas;3532603;Nhandeara;1;1;2;397
3515509;Fernandópolis;3532603;Nhandeara;1;1;2;51
3515905;Floreal;3532603;Nhandeara;1;1;2;11
3516804;Gastão Vidigal;3532603;Nhandeara;1;1;2;19
3516903;General Salgado;3532603;Nhandeara;1;1;2;34
3524808;Jales;3532603;Nhandeara;1;1;2;71
3525706;José Bonifácio;3532603;Nhandeara;1;1;2;54
3528106;Macaubal;3532603;Nhandeara;1;1;2;15
3531001;Monções;3532603;Nhandeara;1;1;2;18
3531407;Monte Aprazível;3532603;Nhandeara;1;1;2;35
3504602;Bady Bassitt;3532504;Neves Paulista;1;1;2;21
3511102;Catanduva;3532504;Neves Paulista;1;1;2;75
3521150;Ipiguá;3532504;Neves Paulista;1;1;2;31
3507605;Bragança Paulista;3532405;Nazaré Paulista;1;1;2;31
3509502;Campinas;3532405;Nazaré Paulista;1;1;2;75
3518800;Guarulhos;3532405;Nazaré Paulista;1;1;2;33
3524709;Jaguariúna;3532405;Nazaré Paulista;1;1;2;80
2607901;Jaboatão dos Guararapes;3532306;Natividade da Serra;1;1;2;1973
3508504;Caçapava;3532306;Natividade da Serra;1;1;2;41
3509502;Campinas;3532306;Natividade da Serra;1;1;2;173
3532009;Morungaba;3532306;Natividade da Serra;1;1;2;148
2931400;Teodoro Sampaio;3532207;Narandiba;1;1;2;1708
3153103;Presidente Bernardes;3532207;Narandiba;1;1;2;873
3515301;Estrela do Norte;3532207;Narandiba;1;1;2;17
3528700;Marabá Paulista;3532207;Narandiba;1;1;2;56
3530201;Mirante do Paranapanema;3532207;Narandiba;1;1;2;41
3520806;Inúbia Paulista;3532157;Nantes;1;1;2;98
3511003;Castilho;3532108;Murutinga do Sul;1;1;2;26
3503208;Araraquara;3532058;Motuca;1;1;2;31
3524303;Jaboticabal;3532058;Motuca;1;1;2;32
3529302;Matão;3532058;Motuca;1;1;2;27
1302603;Manaus;3532009;Morungaba;1;1;2;2544
2108405;Peri Mirim;3532009;Morungaba;1;1;2;2253
2611606;Recife;3532009;Morungaba;1;1;2;2009
3106200;Belo Horizonte;3532009;Morungaba;1;1;2;436
3149804;Perdizes;3532009;Morungaba;1;1;2;394
3503307;Araras;3532009;Morungaba;1;1;2;83
3507100;Bom Jesus dos Perdões;3532009;Morungaba;1;1;2;44
3513009;Cotia;3532009;Morungaba;1;1;2;81
3513405;Cruzeiro;3532009;Morungaba;1;1;2;190
3525904;Jundiaí;3532009;Morungaba;1;1;2;35
3104007;Araxá;3531902;Morro Agudo;1;1;2;171
3129509;Ibiá;3531902;Morro Agudo;1;1;2;213
3170107;Uberaba;3531902;Morro Agudo;1;1;2;110
3170206;Uberlândia;3531902;Morro Agudo;1;1;2;204
3501004;Altinópolis;3531902;Morro Agudo;1;1;2;78
3505500;Barretos;3531902;Morro Agudo;1;1;2;58
3505906;Batatais;3531902;Morro Agudo;1;1;2;49
3509502;Campinas;3531902;Morro Agudo;1;1;2;262
3517406;Guaíra;3531902;Morro Agudo;1;1;2;53
3531407;Monte Aprazível;3531902;Morro Agudo;1;1;2;173
1302603;Manaus;3531803;Monte Mor;1;1;2;2524
2611606;Recife;3531803;Monte Mor;1;1;2;2045
3106200;Belo Horizonte;3531803;Monte Mor;1;1;2;478
3304557;Rio de Janeiro;3531803;Monte Mor;1;1;2;416
3501608;Americana;3531803;Monte Mor;1;1;2;23
3503208;Araraquara;3531803;Monte Mor;1;1;2;155
3507001;Boituva;3531803;Monte Mor;1;1;2;52
3520509;Indaiatuba;3531803;Monte Mor;1;1;2;18
3530805;Moji-Mirim;3531803;Monte Mor;1;1;2;67
3514403;Dracena;3531605;Monte Castelo;1;1;2;25
3104007;Araxá;3531506;Monte Azul Paulista;1;1;2;228
3503703;Ariranha;3531506;Monte Azul Paulista;1;1;2;35
3511102;Catanduva;3531506;Monte Azul Paulista;1;1;2;45
3516200;Franca;3531506;Monte Azul Paulista;1;1;2;135
3517901;Guaraci;3531506;Monte Azul Paulista;1;1;2;55
3521903;Itajobi;3531506;Monte Azul Paulista;1;1;2;63
3134400;Iturama;3531407;Monte Aprazível;1;1;2;125
3504206;Auriflama;3531407;Monte Aprazível;1;1;2;88
3505906;Batatais;3531407;Monte Aprazível;1;1;2;219
3509502;Campinas;3531407;Monte Aprazível;1;1;2;365
3516200;Franca;3531407;Monte Aprazível;1;1;2;242
3516903;General Salgado;3531407;Monte Aprazível;1;1;2;69
3519600;Ibitinga;3531407;Monte Aprazível;1;1;2;142
3521150;Ipiguá;3531407;Monte Aprazível;1;1;2;34
3524808;Jales;3531407;Monte Aprazível;1;1;2;103
3525300;Jaú;3531407;Monte Aprazível;1;1;2;205
3527108;Lins;3531407;Monte Aprazível;1;1;2;101
3531308;Monte Alto;3531407;Monte Aprazível;1;1;2;140
2910800;Feira de Santana;3531308;Monte Alto;1;1;2;1386
2923001;Nova Viçosa;3531308;Monte Alto;1;1;2;997
3104007;Araxá;3531308;Monte Alto;1;1;2;246
3125101;Extrema;3531308;Monte Alto;1;1;2;285
3138203;Lavras;3531308;Monte Alto;1;1;2;361
3170206;Uberlândia;3531308;Monte Alto;1;1;2;265
3501608;Americana;3531308;Monte Alto;1;1;2;201
3506003;Bauru;3531308;Monte Alto;1;1;2;132
3510104;Cândido Rodrigues;3531308;Monte Alto;1;1;2;16
3510807;Casa Branca;3531308;Monte Alto;1;1;2;155
3513801;Diadema;3531308;Monte Alto;1;1;2;329
3514007;Dobrada;3531308;Monte Alto;1;1;2;27
3520509;Indaiatuba;3531308;Monte Alto;1;1;2;238
3525706;José Bonifácio;3531308;Monte Alto;1;1;2;128
3529302;Matão;3531308;Monte Alto;1;1;2;36
3530706;Mogi Guaçu;3531308;Monte Alto;1;1;2;197
3104205;Arcos;3531209;Monte Alegre do Sul;1;1;2;289
3507605;Bragança Paulista;3531209;Monte Alegre do Sul;1;1;2;32
3106200;Belo Horizonte;3531100;Mongaguá;1;1;2;534
3513504;Cubatão;3531100;Mongaguá;1;1;2;30
3518701;Guarujá;3531100;Mongaguá;1;1;2;39
3523305;Itariri;3531100;Mongaguá;1;1;2;60
3526209;Juquitiba;3531100;Mongaguá;1;1;2;48
1508407;Xinguara;3530805;Moji-Mirim;1;1;2;1722
2502151;Boa Vista;3530805;Moji-Mirim;1;1;2;1987
2507507;João Pessoa;3530805;Moji-Mirim;1;1;2;2070
2600054;Abreu e Lima;3530805;Moji-Mirim;1;1;2;2004
3101607;Alfenas;3530805;Moji-Mirim;1;1;2;154
3102605;Andradas;3530805;Moji-Mirim;1;1;2;58
3110509;Camanducaia;3530805;Moji-Mirim;1;1;2;93
3127206;Funilândia;3530805;Moji-Mirim;1;1;2;451
3132404;Itajubá;3530805;Moji-Mirim;1;1;2;154
3138203;Lavras;3530805;Moji-Mirim;1;1;2;242
3169307;Três Corações;3530805;Moji-Mirim;1;1;2;198
3503703;Ariranha;3530805;Moji-Mirim;1;1;2;231
3506003;Bauru;3530805;Moji-Mirim;1;1;2;217
3507605;Bragança Paulista;3530805;Moji-Mirim;1;1;2;71
3508405;Cabreúva;3530805;Moji-Mirim;1;1;2;99
3508702;Caconde;3530805;Moji-Mirim;1;1;2;105
3512803;Cosmópolis;3530805;Moji-Mirim;1;1;2;33
3513009;Cotia;3530805;Moji-Mirim;1;1;2;130
3514908;Elias Fausto;3530805;Moji-Mirim;1;1;2;80
3515152;Engenheiro Coelho;3530805;Moji-Mirim;1;1;2;26
3518305;Guararema;3530805;Moji-Mirim;1;1;2;145
3525904;Jundiaí;3530805;Moji-Mirim;1;1;2;83
3529005;Marília;3530805;Moji-Mirim;1;1;2;307
3530508;Mococa;3530805;Moji-Mirim;1;1;2;106
1705508;Colinas do Tocantins;3530706;Mogi Guaçu;1;1;2;1586
2611606;Recife;3530706;Mogi Guaçu;1;1;2;1974
3101409;Albertina;3530706;Mogi Guaçu;1;1;2;37
3104205;Arcos;3530706;Mogi Guaçu;1;1;2;267
3134905;Jacutinga;3530706;Mogi Guaçu;1;1;2;35
3139003;Machado;3530706;Mogi Guaçu;1;1;2;128
3162922;São Joaquim de Bicas;3530706;Mogi Guaçu;1;1;2;372
3164704;São Sebastião do Paraíso;3530706;Mogi Guaçu;1;1;2;155
3170206;Uberlândia;3530706;Mogi Guaçu;1;1;2;402
3170701;Varginha;3530706;Mogi Guaçu;1;1;2;183
3300506;Bom Jardim;3530706;Mogi Guaçu;1;1;2;467
3305109;São João de Meriti;3530706;Mogi Guaçu;1;1;2;372
3501004;Altinópolis;3530706;Mogi Guaçu;1;1;2;150
3505906;Batatais;3530706;Mogi Guaçu;1;1;2;173
3507902;Brotas;3530706;Mogi Guaçu;1;1;2;121
3510807;Casa Branca;3530706;Mogi Guaçu;1;1;2;63
3513009;Cotia;3530706;Mogi Guaçu;1;1;2;141
3513801;Diadema;3530706;Mogi Guaçu;1;1;2;154
3514908;Elias Fausto;3530706;Mogi Guaçu;1;1;2;91
3515103;Embu-Guaçu;3530706;Mogi Guaçu;1;1;2;167
3515152;Engenheiro Coelho;3530706;Mogi Guaçu;1;1;2;33
3517703;Guará;3530706;Mogi Guaçu;1;1;2;229
3522406;Itapeva;3530706;Mogi Guaçu;1;1;2;272
3523909;Itu;3530706;Mogi Guaçu;1;1;2;112
3525300;Jaú;3530706;Mogi Guaçu;1;1;2;167
3527306;Louveira;3530706;Mogi Guaçu;1;1;2;83
3529302;Matão;3530706;Mogi Guaçu;1;1;2;169
3530300;Mirassol;3530706;Mogi Guaçu;1;1;2;312
3530508;Mococa;3530706;Mogi Guaçu;1;1;2;95
1500800;Ananindeua;3530607;Moji das Cruzes;1;1;2;2463
1508084;Tucumã;3530607;Moji das Cruzes;1;1;2;1922
2304400;Fortaleza;3530607;Moji das Cruzes;1;1;2;2313
2601102;Araripina;3530607;Moji das Cruzes;1;1;2;1856
2602902;Cabo de Santo Agostinho;3530607;Moji das Cruzes;1;1;2;2013
2607901;Jaboatão dos Guararapes;3530607;Moji das Cruzes;1;1;2;2028
2611606;Recife;3530607;Moji das Cruzes;1;1;2;2033
2910727;Eunápolis;3530607;Moji das Cruzes;1;1;2;1032
2910800;Feira de Santana;3530607;Moji das Cruzes;1;1;2;1437
2922003;Mucuri;3530607;Moji das Cruzes;1;1;2;906
2931350;Teixeira de Freitas;3530607;Moji das Cruzes;1;1;2;928
3106309;Belo Oriente;3530607;Moji das Cruzes;1;1;2;608
3131307;Ipatinga;3530607;Moji das Cruzes;1;1;2;583
3131901;Itabirito;3530607;Moji das Cruzes;1;1;2;433
3133808;Itaúna;3530607;Moji das Cruzes;1;1;2;415
3135407;Jeceaba;3530607;Moji das Cruzes;1;1;2;402
3150505;Pimenta;3530607;Moji das Cruzes;1;1;2;343
3169307;Três Corações;3530607;Moji das Cruzes;1;1;2;231
3170107;Uberaba;3530607;Moji das Cruzes;1;1;2;457
3171204;Vespasiano;3530607;Moji das Cruzes;1;1;2;484
3200607;Aracruz;3530607;Moji das Cruzes;1;1;2;726
3201209;Cachoeiro de Itapemirim;3530607;Moji das Cruzes;1;1;2;598
3205101;Viana;3530607;Moji das Cruzes;1;1;2;666
3300407;Barra Mansa;3530607;Moji das Cruzes;1;1;2;232
3303302;Niterói;3530607;Moji das Cruzes;1;1;2;323
3304524;Rio das Ostras;3530607;Moji das Cruzes;1;1;2;448
3306107;Valença;3530607;Moji das Cruzes;1;1;2;289
3501608;Americana;3530607;Moji das Cruzes;1;1;2;148
3502101;Andradina;3530607;Moji das Cruzes;1;1;2;602
3507506;Botucatu;3530607;Moji das Cruzes;1;1;2;241
3511607;Cesário Lange;3530607;Moji das Cruzes;1;1;2;183
3513009;Cotia;3530607;Moji das Cruzes;1;1;2;75
3513405;Cruzeiro;3530607;Moji das Cruzes;1;1;2;166
3513504;Cubatão;3530607;Moji das Cruzes;1;1;2;44
3516408;Franco da Rocha;3530607;Moji das Cruzes;1;1;2;61
3516853;Gavião Peixoto;3530607;Moji das Cruzes;1;1;2;301
3522307;Itapetininga;3530607;Moji das Cruzes;1;1;2;190
3524006;Itupeva;3530607;Moji das Cruzes;1;1;2;99
3525003;Jandira;3530607;Moji das Cruzes;1;1;2;73
3525300;Jaú;3530607;Moji das Cruzes;1;1;2;281
3526902;Limeira;3530607;Moji das Cruzes;1;1;2;165
3528502;Mairiporã;3530607;Moji das Cruzes;1;1;2;48
3529005;Marília;3530607;Moji das Cruzes;1;1;2;409
1302603;Manaus;3530508;Mococa;1;1;2;2408
3123601;Elói Mendes;3530508;Mococa;1;1;2;154
3128303;Guaranésia;3530508;Mococa;1;1;2;31
3128709;Guaxupé;3530508;Mococa;1;1;2;38
3138203;Lavras;3530508;Mococa;1;1;2;212
3143401;Monte Sião;3530508;Mococa;1;1;2;117
3170107;Uberaba;3530508;Mococa;1;1;2;212
3501004;Altinópolis;3530508;Mococa;1;1;2;60
3503307;Araras;3530508;Mococa;1;1;2;104
3505708;Barueri;3530508;Mococa;1;1;2;227
3506003;Bauru;3530508;Mococa;1;1;2;233
3506102;Bebedouro;3530508;Mococa;1;1;2;166
3509403;Cajuru;3530508;Mococa;1;1;2;35
3512209;Conchal;3530508;Mococa;1;1;2;96
3513009;Cotia;3530508;Mococa;1;1;2;237
3513702;Descalvado;3530508;Mococa;1;1;2;77
3513801;Diadema;3530508;Mococa;1;1;2;249
3515186;Espírito Santo do Pinhal;3530508;Mococa;1;1;2;86
3518800;Guarulhos;3530508;Mococa;1;1;2;223
3520509;Indaiatuba;3530508;Mococa;1;1;2;181
3529005;Marília;3530508;Mococa;1;1;2;314
3151800;Poços de Caldas;3530300;Mirassol;1;1;2;328
3170107;Uberaba;3530300;Mirassol;1;1;2;205
3503208;Araraquara;3530300;Mirassol;1;1;2;177
3504206;Auriflama;3530300;Mirassol;1;1;2;109
3504602;Bady Bassitt;3530300;Mirassol;1;1;2;14
3507506;Botucatu;3530300;Mirassol;1;1;2;255
3509205;Cajamar;3530300;Mirassol;1;1;2;395
3516200;Franca;3530300;Mirassol;1;1;2;222
3520509;Indaiatuba;3530300;Mirassol;1;1;2;347
3524808;Jales;3530300;Mirassol;1;1;2;123
3525300;Jaú;3530300;Mirassol;1;1;2;189
3525904;Jundiaí;3530300;Mirassol;1;1;2;379
3526902;Limeira;3530300;Mirassol;1;1;2;295
3527108;Lins;3530300;Mirassol;1;1;2;99
3529005;Marília;3530300;Mirassol;1;1;2;162
3529500;Mendonça;3530300;Mirassol;1;1;2;39
3509502;Campinas;3530201;Mirante do Paranapanema;1;1;2;505
3106705;Betim;3530102;Mirandópolis;1;1;2;727
3170206;Uberlândia;3530102;Mirandópolis;1;1;2;383
3304557;Rio de Janeiro;3530102;Mirandópolis;1;1;2;842
3506409;Bilac;3530102;Mirandópolis;1;1;2;70
3506508;Birigui;3530102;Mirandópolis;1;1;2;81
3511003;Castilho;3530102;Mirandópolis;1;1;2;49
3516200;Franca;3530102;Mirandópolis;1;1;2;389
3527108;Lins;3530102;Mirandópolis;1;1;2;151
1100122;Ji-Paraná;3529906;Miracatu;1;1;2;2043
3514809;Eldorado;3529906;Miracatu;1;1;2;71
3518701;Guarujá;3529906;Miracatu;1;1;2;126
3520301;Iguape;3529906;Miracatu;1;1;2;48
3522109;Itanhaém;3529906;Miracatu;1;1;2;69
3523206;Itararé;3529906;Miracatu;1;1;2;192
3524600;Jacupiranga;3529906;Miracatu;1;1;2;72
3525904;Jundiaí;3529906;Miracatu;1;1;2;134
3507902;Brotas;3529807;Mineiros do Tietê;1;1;2;36
3526902;Limeira;3529807;Mineiros do Tietê;1;1;2;110
3104007;Araxá;3529708;Miguelópolis;1;1;2;131
3505500;Barretos;3529708;Miguelópolis;1;1;2;71
3509502;Campinas;3529708;Miguelópolis;1;1;2;318
3517703;Guará;3529708;Miguelópolis;1;1;2;35
3515202;Estrela d'Oeste;3529609;Meridiano;1;1;2;25
3106705;Betim;3529500;Mendonça;1;1;2;573
3151206;Pirapora;3529500;Mendonça;1;1;2;641
3525706;José Bonifácio;3529500;Mendonça;1;1;2;17
1100205;Porto Velho;3529401;Mauá;1;1;2;2372
1301209;Coari;3529401;Mauá;1;1;2;2704
1508357;Vitória do Xingu;3529401;Mauá;1;1;2;2362
2111300;São Luís;3529401;Mauá;1;1;2;2348
2304400;Fortaleza;3529401;Mauá;1;1;2;2333
2602902;Cabo de Santo Agostinho;3529401;Mauá;1;1;2;2037
2611606;Recife;3529401;Mauá;1;1;2;2057
2704302;Maceió;3529401;Mauá;1;1;2;1875
2906501;Candeias;3529401;Mauá;1;1;2;1446
2910727;Eunápolis;3529401;Mauá;1;1;2;1058
2919926;Madre de Deus;3529401;Mauá;1;1;2;1436
2930709;Simões Filho;3529401;Mauá;1;1;2;1443
3118601;Contagem;3529401;Mauá;1;1;2;479
3131307;Ipatinga;3529401;Mauá;1;1;2;609
3133808;Itaúna;3529401;Mauá;1;1;2;438
3134202;Ituiutaba;3529401;Mauá;1;1;2;601
3144805;Nova Lima;3529401;Mauá;1;1;2;482
3151800;Poços de Caldas;3529401;Mauá;1;1;2;210
3152501;Pouso Alegre;3529401;Mauá;1;1;2;169
3157807;Santa Luzia;3529401;Mauá;1;1;2;505
3200607;Aracruz;3529401;Mauá;1;1;2;755
3205309;Vitória;3529401;Mauá;1;1;2;727
3300258;Arraial do Cabo;3529401;Mauá;1;1;2;458
3301306;Casimiro de Abreu;3529401;Mauá;1;1;2;452
3302403;Macaé;3529401;Mauá;1;1;2;485
3304151;Quissamã;3529401;Mauá;1;1;2;535
3304904;São Gonçalo;3529401;Mauá;1;1;2;359
3305109;São João de Meriti;3529401;Mauá;1;1;2;328
3306305;Volta Redonda;3529401;Mauá;1;1;2;272
3502101;Andradina;3529401;Mauá;1;1;2;584
3507506;Botucatu;3529401;Mauá;1;1;2;220
3510609;Carapicuíba;3529401;Mauá;1;1;2;41
3514205;Dolcinópolis;3529401;Mauá;1;1;2;570
3517208;Guaiçara;3529401;Mauá;1;1;2;407
3518305;Guararema;3529401;Mauá;1;1;2;51
3518503;Guareí;3529401;Mauá;1;1;2;179
3521002;Iperó;3529401;Mauá;1;1;2;130
3522505;Itapevi;3529401;Mauá;1;1;2;51
3523107;Itaquaquecetuba;3529401;Mauá;1;1;2;24
3523404;Itatiba;3529401;Mauá;1;1;2;83
3525904;Jundiaí;3529401;Mauá;1;1;2;71
2611606;Recife;3529302;Matão;1;1;2;2010
3106200;Belo Horizonte;3529302;Matão;1;1;2;492
3152808;Prata;3529302;Matão;1;1;2;260
3156908;Sacramento;3529302;Matão;1;1;2;216
3300456;Belford Roxo;3529302;Matão;1;1;2;535
3500709;Agudos;3529302;Matão;1;1;2;116
3500907;Altair;3529302;Matão;1;1;2;137
3502804;Araçatuba;3529302;Matão;1;1;2;217
3505708;Barueri;3529302;Matão;1;1;2;265
3506003;Bauru;3529302;Matão;1;1;2;109
3507902;Brotas;3529302;Matão;1;1;2;81
3508801;Cafelândia;3529302;Matão;1;1;2;128
3510104;Cândido Rodrigues;3529302;Matão;1;1;2;39
3510203;Capão Bonito;3529302;Matão;1;1;2;267
3510807;Casa Branca;3529302;Matão;1;1;2;137
3511409;Cerqueira César;3529302;Matão;1;1;2;178
3514601;Dumont;3529302;Matão;1;1;2;59
3515194;Espírito Santo do Turvo;3529302;Matão;1;1;2;162
3516705;Garça;3529302;Matão;1;1;2;147
3517000;Getulina;3529302;Matão;1;1;2;160
3519253;Iaras;3529302;Matão;1;1;2;162
3521903;Itajobi;3529302;Matão;1;1;2;75
3522307;Itapetininga;3529302;Matão;1;1;2;222
3524808;Jales;3529302;Matão;1;1;2;266
3525706;José Bonifácio;3529302;Matão;1;1;2;146
3526803;Lençóis Paulista;3529302;Matão;1;1;2;120
3527504;Lucianópolis;3529302;Matão;1;1;2;149
3529005;Marília;3529302;Matão;1;1;2;175
3505708;Barueri;3529203;Martinópolis;1;1;2;470
3508900;Caiabu;3529203;Martinópolis;1;1;2;16
1100205;Porto Velho;3529005;Marília;1;1;2;2033
1302603;Manaus;3529005;Marília;1;1;2;2337
1504422;Marituba;3529005;Marília;1;1;2;2313
2304400;Fortaleza;3529005;Marília;1;1;2;2333
2304459;Fortim;3529005;Marília;1;1;2;2305
2609600;Olinda;3529005;Marília;1;1;2;2172
2611606;Recife;3529005;Marília;1;1;2;2160
2704302;Maceió;3529005;Marília;1;1;2;1986
2903201;Barreiras;3529005;Marília;1;1;2;1214
2927408;Salvador;3529005;Marília;1;1;2;1540
2933307;Vitória da Conquista;3529005;Marília;1;1;2;1227
2933455;Wanderley;3529005;Marília;1;1;2;1272
3118601;Contagem;3529005;Marília;1;1;2;652
3147402;Paraopeba;3529005;Marília;1;1;2;654
3151800;Poços de Caldas;3529005;Marília;1;1;2;354
3201209;Cachoeiro de Itapemirim;3529005;Marília;1;1;2;923
3205200;Vila Velha;3529005;Marília;1;1;2;1004
3306305;Volta Redonda;3529005;Marília;1;1;2;605
3501400;Álvaro de Carvalho;3529005;Marília;1;1;2;28
3501608;Americana;3529005;Marília;1;1;2;276
3505807;Bastos;3529005;Marília;1;1;2;87
3506508;Birigui;3529005;Marília;1;1;2;109
3510005;Cândido Mota;3529005;Marília;1;1;2;74
3513009;Cotia;3529005;Marília;1;1;2;349
3513801;Diadema;3529005;Marília;1;1;2;381
3514502;Duartina;3529005;Marília;1;1;2;60
3515707;Ferraz de Vasconcelos;3529005;Marília;1;1;2;399
3517000;Getulina;3529005;Marília;1;1;2;47
3517307;Guaimbê;3529005;Marília;1;1;2;35
3518404;Guaratinguetá;3529005;Marília;1;1;2;498
3518701;Guarujá;3529005;Marília;1;1;2;427
3519071;Hortolândia;3529005;Marília;1;1;2;291
3519501;Ibirarema;3529005;Marília;1;1;2;67
3519600;Ibitinga;3529005;Marília;1;1;2;125
3520509;Indaiatuba;3529005;Marília;1;1;2;296
3523909;Itu;3529005;Marília;1;1;2;299
3526902;Limeira;3529005;Marília;1;1;2;266
3527801;Lupércio;3529005;Marília;1;1;2;25
3527405;Lucélia;3528908;Mariápolis;1;1;2;19
2909307;Correntina;3528858;Marapoama;1;1;2;988
3503703;Ariranha;3528858;Marapoama;1;1;2;36
3522703;Itápolis;3528858;Marapoama;1;1;2;50
3513306;Cruzália;3528809;Maracaí;1;1;2;19
3522307;Itapetininga;3528809;Maracaí;1;1;2;290
3201704;Conceição do Castelo;3528601;Manduri;1;1;2;871
3506300;Bernardino de Campos;3528601;Manduri;1;1;2;16
3511409;Cerqueira César;3528601;Manduri;1;1;2;16
1100205;Porto Velho;3528502;Mairiporã;1;1;2;2341
2304400;Fortaleza;3528502;Mairiporã;1;1;2;2301
3125101;Extrema;3528502;Mairiporã;1;1;2;58
3136702;Juiz de Fora;3528502;Mairiporã;1;1;2;373
3149309;Pedro Leopoldo;3528502;Mairiporã;1;1;2;483
3506607;Biritiba-Mirim;3528502;Mairiporã;1;1;2;63
3509205;Cajamar;3528502;Mairiporã;1;1;2;30
3509254;Cajati;3528502;Mairiporã;1;1;2;222
3510609;Carapicuíba;3528502;Mairiporã;1;1;2;34
3510807;Casa Branca;3528502;Mairiporã;1;1;2;178
3513801;Diadema;3528502;Mairiporã;1;1;2;40
3516309;Francisco Morato;3528502;Mairiporã;1;1;2;16
3525003;Jandira;3528502;Mairiporã;1;1;2;40
3525201;Jarinu;3528502;Mairiporã;1;1;2;28
3525904;Jundiaí;3528502;Mairiporã;1;1;2;36
3170206;Uberlândia;3528403;Mairinque;1;1;2;526
3304557;Rio de Janeiro;3528403;Mairinque;1;1;2;406
3513009;Cotia;3528403;Mairinque;1;1;2;28
3522307;Itapetininga;3528403;Mairinque;1;1;2;89
3523909;Itu;3528403;Mairinque;1;1;2;31
3526209;Juquitiba;3528403;Mairinque;1;1;2;44
3527306;Louveira;3528403;Mairinque;1;1;2;57
3504206;Auriflama;3528304;Magda;1;1;2;35
3516903;General Salgado;3528304;Magda;1;1;2;14
3510708;Cardoso;3528205;Macedônia;1;1;2;26
3505104;Barbosa;3528106;Macaubal;1;1;2;54
3516903;General Salgado;3528106;Macaubal;1;1;2;45
3500105;Adamantina;3528007;Macatuba;1;1;2;260
3505302;Barra Bonita;3528007;Macatuba;1;1;2;16
3520004;Igaraçu do Tietê;3528007;Macatuba;1;1;2;16
3501103;Alto Alegre;3527702;Luiziânia;1;1;2;20
3511904;Clementina;3527702;Luiziânia;1;1;2;18
3518800;Guarulhos;3527702;Luiziânia;1;1;2;438
3132404;Itajubá;3527603;Luís Antônio;1;1;2;251
3505609;Barrinha;3527603;Luís Antônio;1;1;2;62
3514601;Dumont;3527603;Luís Antônio;1;1;2;45
3515608;Fernando Prestes;3527603;Luís Antônio;1;1;2;107
3517703;Guará;3527603;Luís Antônio;1;1;2;125
3522307;Itapetininga;3527504;Lucianópolis;1;1;2;198
3512506;Coroados;3527405;Lucélia;1;1;2;86
3514403;Dracena;3527405;Lucélia;1;1;2;59
3516200;Franca;3527405;Lucélia;1;1;2;395
3520806;Inúbia Paulista;3527405;Lucélia;1;1;2;8
1302603;Manaus;3527306;Louveira;1;1;2;2553
2600054;Abreu e Lima;3527306;Louveira;1;1;2;2056
2602902;Cabo de Santo Agostinho;3527306;Louveira;1;1;2;2015
2919207;Lauro de Freitas;3527306;Louveira;1;1;2;1418
3106705;Betim;3527306;Louveira;1;1;2;445
3110509;Camanducaia;3527306;Louveira;1;1;2;90
3136702;Juiz de Fora;3527306;Louveira;1;1;2;397
3500550;Águas de Santa Bárbara;3527306;Louveira;1;1;2;235
3502507;Aparecida;3527306;Louveira;1;1;2;179
3503307;Araras;3527306;Louveira;1;1;2;90
3504602;Bady Bassitt;3527306;Louveira;1;1;2;348
3507605;Bragança Paulista;3527306;Louveira;1;1;2;44
3509205;Cajamar;3527306;Louveira;1;1;2;32
3513108;Cravinhos;3527306;Louveira;1;1;2;208
3513504;Cubatão;3527306;Louveira;1;1;2;106
3516200;Franca;3527306;Louveira;1;1;2;284
3518107;Guarantã;3527306;Louveira;1;1;2;299
3519071;Hortolândia;3527306;Louveira;1;1;2;36
3522505;Itapevi;3527306;Louveira;1;1;2;52
3522604;Itapira;3527306;Louveira;1;1;2;72
3524709;Jaguariúna;3527306;Louveira;1;1;2;41
3527207;Lorena;3527306;Louveira;1;1;2;195
1100205;Porto Velho;3527207;Lorena;1;1;2;2418
2910800;Feira de Santana;3527207;Lorena;1;1;2;1307
3101607;Alfenas;3527207;Lorena;1;1;2;172
3106200;Belo Horizonte;3527207;Lorena;1;1;2;333
3118304;Conselheiro Lafaiete;3527207;Lorena;1;1;2;263
3133709;Itatiaiuçu;3527207;Lorena;1;1;2;289
3163706;São Lourenço;3527207;Lorena;1;1;2;68
3170701;Varginha;3527207;Lorena;1;1;2;140
3205200;Vila Velha;3527207;Lorena;1;1;2;549
3300407;Barra Mansa;3527207;Lorena;1;1;2;94
3301702;Duque de Caxias;3527207;Lorena;1;1;2;182
3303500;Nova Iguaçu;3527207;Lorena;1;1;2;166
3303955;Pinheiral;3527207;Lorena;1;1;2;114
3304201;Resende;3527207;Lorena;1;1;2;69
3501608;Americana;3527207;Lorena;1;1;2;231
3504909;Bananal;3527207;Lorena;1;1;2;79
3506102;Bebedouro;3527207;Lorena;1;1;2;405
3509007;Caieiras;3527207;Lorena;1;1;2;184
3509254;Cajati;3527207;Lorena;1;1;2;384
3509502;Campinas;3527207;Lorena;1;1;2;203
3510500;Caraguatatuba;3527207;Lorena;1;1;2;105
3513009;Cotia;3527207;Lorena;1;1;2;212
3518800;Guarulhos;3527207;Lorena;1;1;2;171
1100288;Rolim de Moura;3527108;Lins;1;1;2;1625
1502400;Castanhal;3527108;Lins;1;1;2;2262
1600303;Macapá;3527108;Lins;1;1;2;2410
3131307;Ipatinga;3527108;Lins;1;1;2;783
3170107;Uberaba;3527108;Lins;1;1;2;288
3304201;Resende;3527108;Lins;1;1;2;560
3304557;Rio de Janeiro;3527108;Lins;1;1;2;690
3500105;Adamantina;3527108;Lins;1;1;2;136
3503208;Araraquara;3527108;Lins;1;1;2;167
3503307;Araras;3527108;Lins;1;1;2;260
3504107;Atibaia;3527108;Lins;1;1;2;371
3504503;Avaré;3527108;Lins;1;1;2;180
3505906;Batatais;3527108;Lins;1;1;2;240
3507506;Botucatu;3527108;Lins;1;1;2;192
3507753;Brejo Alegre;3527108;Lins;1;1;2;74
3508108;Buritama;3527108;Lins;1;1;2;78
3509304;Cajobi;3527108;Lins;1;1;2;134
3511003;Castilho;3527108;Lins;1;1;2;198
3516200;Franca;3527108;Lins;1;1;2;275
3518206;Guararapes;3527108;Lins;1;1;2;101
3525706;José Bonifácio;3527108;Lins;1;1;2;70
3526803;Lençóis Paulista;3527108;Lins;1;1;2;142
3143401;Monte Sião;3527009;Lindóia;1;1;2;13
3505708;Barueri;3527009;Lindóia;1;1;2;113
3507605;Bragança Paulista;3527009;Lindóia;1;1;2;50
1100304;Vilhena;3526902;Limeira;1;1;2;1672
1500800;Ananindeua;3526902;Limeira;1;1;2;2346
1501402;Belém;3526902;Limeira;1;1;2;2345
1702109;Araguaína;3526902;Limeira;1;1;2;1703
1709500;Gurupi;3526902;Limeira;1;1;2;1213
1716604;Peixe;3526902;Limeira;1;1;2;1172
2303709;Caucaia;3526902;Limeira;1;1;2;2254
2307304;Juazeiro do Norte;3526902;Limeira;1;1;2;1876
2400208;Açu;3526902;Limeira;1;1;2;2146
2609600;Olinda;3526902;Limeira;1;1;2;2032
2800308;Aracaju;3526902;Limeira;1;1;2;1650
2908507;Conceição do Jacuípe;3526902;Limeira;1;1;2;1422
3136652;Juatuba;3526902;Limeira;1;1;2;425
3143401;Monte Sião;3526902;Limeira;1;1;2;86
3145000;Nova Ponte;3526902;Limeira;1;1;2;381
3149309;Pedro Leopoldo;3526902;Limeira;1;1;2;471
3151800;Poços de Caldas;3526902;Limeira;1;1;2;124
3152501;Pouso Alegre;3526902;Limeira;1;1;2;153
3169307;Três Corações;3526902;Limeira;1;1;2;244
3169406;Três Pontas;3526902;Limeira;1;1;2;234
3301702;Duque de Caxias;3526902;Limeira;1;1;2;420
3303500;Nova Iguaçu;3526902;Limeira;1;1;2;404
3500709;Agudos;3526902;Limeira;1;1;2;165
3501905;Amparo;3526902;Limeira;1;1;2;67
3502002;Analândia;3526902;Limeira;1;1;2;56
3502804;Araçatuba;3526902;Limeira;1;1;2;347
3503901;Arujá;3526902;Limeira;1;1;2;143
3504107;Atibaia;3526902;Limeira;1;1;2;106
3506003;Bauru;3526902;Limeira;1;1;2;175
3507506;Botucatu;3526902;Limeira;1;1;2;113
3507803;Brodowski;3526902;Limeira;1;1;2;176
3507902;Brotas;3526902;Limeira;1;1;2;81
3508306;Cabrália Paulista;3526902;Limeira;1;1;2;200
3509205;Cajamar;3526902;Limeira;1;1;2;103
3509700;Campos do Jordão;3526902;Limeira;1;1;2;188
3510807;Casa Branca;3526902;Limeira;1;1;2;93
3511409;Cerqueira César;3526902;Limeira;1;1;2;190
3511607;Cesário Lange;3526902;Limeira;1;1;2;93
3513009;Cotia;3526902;Limeira;1;1;2;125
3513405;Cruzeiro;3526902;Limeira;1;1;2;250
3513504;Cubatão;3526902;Limeira;1;1;2;178
3514106;Dois Córregos;3526902;Limeira;1;1;2;104
3514304;Dourado;3526902;Limeira;1;1;2;108
3514908;Elias Fausto;3526902;Limeira;1;1;2;53
3518701;Guarujá;3526902;Limeira;1;1;2;193
3519071;Hortolândia;3526902;Limeira;1;1;2;37
3522307;Itapetininga;3526902;Limeira;1;1;2;131
3522604;Itapira;3526902;Limeira;1;1;2;61
3523503;Itatinga;3526902;Limeira;1;1;2;139
3524303;Jaboticabal;3526902;Limeira;1;1;2;172
3524907;Jambeiro;3526902;Limeira;1;1;2;192
3526407;Laranjal Paulista;3526902;Limeira;1;1;2;70
3526704;Leme;3526902;Limeira;1;1;2;42
3526803;Lençóis Paulista;3526902;Limeira;1;1;2;147
1302603;Manaus;3526803;Lençóis Paulista;1;1;2;2422
1500800;Ananindeua;3526803;Lençóis Paulista;1;1;2;2349
2910800;Feira de Santana;3526803;Lençóis Paulista;1;1;2;1507
2914653;Itabela;3526803;Lençóis Paulista;1;1;2;1149
2927408;Salvador;3526803;Lençóis Paulista;1;1;2;1484
3118601;Contagem;3526803;Lençóis Paulista;1;1;2;567
3203205;Linhares;3526803;Lençóis Paulista;1;1;2;963
3301702;Duque de Caxias;3526803;Lençóis Paulista;1;1;2;567
3500105;Adamantina;3526803;Lençóis Paulista;1;1;2;254
3500550;Águas de Santa Bárbara;3526803;Lençóis Paulista;1;1;2;53
3503208;Araraquara;3526803;Lençóis Paulista;1;1;2;113
3503406;Arealva;3526803;Lençóis Paulista;1;1;2;65
3504008;Assis;3526803;Lençóis Paulista;1;1;2;167
3505302;Barra Bonita;3526803;Lençóis Paulista;1;1;2;30
3505708;Barueri;3526803;Lençóis Paulista;1;1;2;224
3505906;Batatais;3526803;Lençóis Paulista;1;1;2;226
3506102;Bebedouro;3526803;Lençóis Paulista;1;1;2;187
3508306;Cabrália Paulista;3526803;Lençóis Paulista;1;1;2;56
3508801;Cafelândia;3526803;Lençóis Paulista;1;1;2;120
3511409;Cerqueira César;3526803;Lençóis Paulista;1;1;2;59
3514502;Duartina;3526803;Lençóis Paulista;1;1;2;64
3515194;Espírito Santo do Turvo;3526803;Lençóis Paulista;1;1;2;63
3516200;Franca;3526803;Lençóis Paulista;1;1;2;271
3519105;Iacanga;3526803;Lençóis Paulista;1;1;2;82
3519253;Iaras;3526803;Lençóis Paulista;1;1;2;46
3522208;Itapecerica da Serra;3526803;Lençóis Paulista;1;1;2;238
3522307;Itapetininga;3526803;Lençóis Paulista;1;1;2;134
3523503;Itatinga;3526803;Lençóis Paulista;1;1;2;59
3524709;Jaguariúna;3526803;Lençóis Paulista;1;1;2;189
2905701;Camaçari;3526704;Leme;1;1;2;1390
3106705;Betim;3526704;Leme;1;1;2;411
3133758;Itaú de Minas;3526704;Leme;1;1;2;172
3134202;Ituiutaba;3526704;Leme;1;1;2;414
3140506;Martinho Campos;3526704;Leme;1;1;2;386
3164704;São Sebastião do Paraíso;3526704;Leme;1;1;2;146
3170107;Uberaba;3526704;Leme;1;1;2;276
3201506;Colatina;3526704;Leme;1;1;2;752
3302270;Japeri;3526704;Leme;1;1;2;390
3500303;Aguaí;3526704;Leme;1;1;2;46
3502804;Araçatuba;3526704;Leme;1;1;2;332
3503208;Araraquara;3526704;Leme;1;1;2;91
3505708;Barueri;3526704;Leme;1;1;2;156
3507506;Botucatu;3526704;Leme;1;1;2;132
3512407;Cordeirópolis;3526704;Leme;1;1;2;33
3515186;Espírito Santo do Pinhal;3526704;Leme;1;1;2;68
3516200;Franca;3526704;Leme;1;1;2;183
3518701;Guarujá;3526704;Leme;1;1;2;228
3519055;Holambra;3526704;Leme;1;1;2;60
3522505;Itapevi;3526704;Leme;1;1;2;157
3523404;Itatiba;3526704;Leme;1;1;2;107
3525300;Jaú;3526704;Leme;1;1;2;122
3304557;Rio de Janeiro;3526506;Lavínia;1;1;2;835
3500105;Adamantina;3526506;Lavínia;1;1;2;58
2911105;Formosa do Rio Preto;3526407;Laranjal Paulista;1;1;2;1355
3501608;Americana;3526407;Laranjal Paulista;1;1;2;62
3510401;Capivari;3526407;Laranjal Paulista;1;1;2;34
3518701;Guarujá;3526407;Laranjal Paulista;1;1;2;190
3523909;Itu;3526407;Laranjal Paulista;1;1;2;61
3525003;Jandira;3526407;Laranjal Paulista;1;1;2;110
3525854;Jumirim;3526407;Laranjal Paulista;1;1;2;7
3518404;Guaratinguetá;3526308;Lagoinha;1;1;2;30
3304557;Rio de Janeiro;3526209;Juquitiba;1;1;2;403
3500550;Águas de Santa Bárbara;3526209;Juquitiba;1;1;2;249
3513009;Cotia;3526209;Juquitiba;1;1;2;39
3515103;Embu-Guaçu;3526209;Juquitiba;1;1;2;28
3518800;Guarulhos;3526209;Juquitiba;1;1;2;75
3522208;Itapecerica da Serra;3526209;Juquitiba;1;1;2;33
1501402;Belém;3526100;Juquiá;1;1;2;2537
3509502;Campinas;3526100;Juquiá;1;1;2;168
3513801;Diadema;3526100;Juquiá;1;1;2;128
3514809;Eldorado;3526100;Juquiá;1;1;2;49
3519055;Holambra;3526100;Juquiá;1;1;2;196
3524600;Jacupiranga;3526100;Juquiá;1;1;2;54
3519204;Iacri;3526001;Junqueirópolis;1;1;2;86
3521606;Irapuru;3526001;Junqueirópolis;1;1;2;11
3525904;Jundiaí;3526001;Junqueirópolis;1;1;2;507
1100205;Porto Velho;3525904;Jundiaí;1;1;2;2310
1501402;Belém;3525904;Jundiaí;1;1;2;2416
2105302;Imperatriz;3525904;Jundiaí;1;1;2;1955
2111300;São Luís;3525904;Jundiaí;1;1;2;2299
2211001;Teresina;3525904;Jundiaí;1;1;2;2041
2412005;São Gonçalo do Amarante;3525904;Jundiaí;1;1;2;2234
2508604;Lucena;3525904;Jundiaí;1;1;2;2149
2607901;Jaboatão dos Guararapes;3525904;Jundiaí;1;1;2;2035
2609600;Olinda;3525904;Jundiaí;1;1;2;2053
2610707;Paulista;3525904;Jundiaí;1;1;2;2060
2802304;Frei Paulo;3525904;Jundiaí;1;1;2;1676
2913606;Ilhéus;3525904;Jundiaí;1;1;2;1210
2916401;Itapetinga;3525904;Jundiaí;1;1;2;1098
2919207;Lauro de Freitas;3525904;Jundiaí;1;1;2;1423
2921005;Mata de São João;3525904;Jundiaí;1;1;2;1455
2930709;Simões Filho;3525904;Jundiaí;1;1;2;1427
3104007;Araxá;3525904;Jundiaí;1;1;2;398
3107109;Boa Esperança;3525904;Jundiaí;1;1;2;268
3110509;Camanducaia;3525904;Jundiaí;1;1;2;91
3124500;Estiva;3525904;Jundiaí;1;1;2;120
3130408;Ijaci;3525904;Jundiaí;1;1;2;300
3134905;Jacutinga;3525904;Jundiaí;1;1;2;103
3146008;Ouro Fino;3525904;Jundiaí;1;1;2;113
3147105;Pará de Minas;3525904;Jundiaí;1;1;2;435
3149309;Pedro Leopoldo;3525904;Jundiaí;1;1;2;488
3151800;Poços de Caldas;3525904;Jundiaí;1;1;2;160
3170107;Uberaba;3525904;Jundiaí;1;1;2;394
3205309;Vitória;3525904;Jundiaí;1;1;2;743
3303500;Nova Iguaçu;3525904;Jundiaí;1;1;2;354
3304201;Resende;3525904;Jundiaí;1;1;2;261
3305752;Tanguá;3525904;Jundiaí;1;1;2;429
3306305;Volta Redonda;3525904;Jundiaí;1;1;2;296
3500709;Agudos;3525904;Jundiaí;1;1;2;227
3501905;Amparo;3525904;Jundiaí;1;1;2;55
3502200;Angatuba;3525904;Jundiaí;1;1;2;158
3502705;Apiaí;3525904;Jundiaí;1;1;2;248
3503307;Araras;3525904;Jundiaí;1;1;2;103
3504008;Assis;3525904;Jundiaí;1;1;2;366
3506508;Birigui;3525904;Jundiaí;1;1;2;407
3507506;Botucatu;3525904;Jundiaí;1;1;2;161
3508504;Caçapava;3525904;Jundiaí;1;1;2;123
3509700;Campos do Jordão;3525904;Jundiaí;1;1;2;145
3510500;Caraguatatuba;3525904;Jundiaí;1;1;2;156
3513009;Cotia;3525904;Jundiaí;1;1;2;47
3518503;Guareí;3525904;Jundiaí;1;1;2;133
3522208;Itapecerica da Serra;3525904;Jundiaí;1;1;2;60
3522703;Itápolis;3525904;Jundiaí;1;1;2;262
3525003;Jandira;3525904;Jundiaí;1;1;2;39
3525300;Jaú;3525904;Jundiaí;1;1;2;197
3510401;Capivari;3525854;Jumirim;1;1;2;30
3511508;Cerquilho;3525854;Jumirim;1;1;2;10
3114550;Carneirinho;3525706;José Bonifácio;1;1;2;182
3303500;Nova Iguaçu;3525706;José Bonifácio;1;1;2;677
3500204;Adolfo;3525706;José Bonifácio;1;1;2;21
3503703;Ariranha;3525706;José Bonifácio;1;1;2;95
3504602;Bady Bassitt;3525706;José Bonifácio;1;1;2;29
3505500;Barretos;3525706;José Bonifácio;1;1;2;127
3506102;Bebedouro;3525706;José Bonifácio;1;1;2;120
3507407;Borborema;3525706;José Bonifácio;1;1;2;90
3515509;Fernandópolis;3525706;José Bonifácio;1;1;2;104
3516200;Franca;3525706;José Bonifácio;1;1;2;243
3516804;Gastão Vidigal;3525706;José Bonifácio;1;1;2;59
3523602;Itirapina;3525706;José Bonifácio;1;1;2;236
3524808;Jales;3525706;José Bonifácio;1;1;2;124
3502903;Araçoiaba da Serra;3525508;Joanópolis;1;1;2;152
3509502;Campinas;3525508;Joanópolis;1;1;2;80
3524105;Ituverava;3525409;Jeriquara;1;1;2;25
2611606;Recife;3525300;Jaú;1;1;2;2071
2927408;Salvador;3525300;Jaú;1;1;2;1443
3205309;Vitória;3525300;Jaú;1;1;2;875
3500105;Adamantina;3525300;Jaú;1;1;2;267
3501707;Américo Brasiliense;3525300;Jaú;1;1;2;78
3502804;Araçatuba;3525300;Jaú;1;1;2;226
3503307;Araras;3525300;Jaú;1;1;2;124
3506508;Birigui;3525300;Jaú;1;1;2;211
3507308;Boracéia;3525300;Jaú;1;1;2;23
3511508;Cerquilho;3525300;Jaú;1;1;2;131
3513009;Cotia;3525300;Jaú;1;1;2;226
3513801;Diadema;3525300;Jaú;1;1;2;256
3514304;Dourado;3525300;Jaú;1;1;2;33
3515509;Fernandópolis;3525300;Jaú;1;1;2;280
3516705;Garça;3525300;Jaú;1;1;2;111
3520004;Igaraçu do Tietê;3525300;Jaú;1;1;2;26
3522000;Itaju;3525300;Jaú;1;1;2;40
3522604;Itapira;3525300;Jaú;1;1;2;181
3523602;Itirapina;3525300;Jaú;1;1;2;77
3524808;Jales;3525300;Jaú;1;1;2;300
3525003;Jandira;3525300;Jaú;1;1;2;222
2507507;João Pessoa;3525201;Jarinu;1;1;2;2112
2803609;Laranjeiras;3525201;Jarinu;1;1;2;1657
3143807;Munhoz;3525201;Jarinu;1;1;2;66
3205200;Vila Velha;3525201;Jarinu;1;1;2;714
3506102;Bebedouro;3525201;Jarinu;1;1;2;302
3508009;Buri;3525201;Jarinu;1;1;2;207
3509601;Campo Limpo Paulista;3525201;Jarinu;1;1;2;13
3512001;Colina;3525201;Jarinu;1;1;2;322
3513009;Cotia;3525201;Jarinu;1;1;2;59
3513801;Diadema;3525201;Jarinu;1;1;2;65
3518800;Guarulhos;3525201;Jarinu;1;1;2;41
3522406;Itapeva;3525201;Jarinu;1;1;2;242
2602902;Cabo de Santo Agostinho;3525102;Jardinópolis;1;1;2;1906
2704302;Maceió;3525102;Jardinópolis;1;1;2;1749
2910800;Feira de Santana;3525102;Jardinópolis;1;1;2;1316
2914802;Itabuna;3525102;Jardinópolis;1;1;2;1107
3104007;Araxá;3525102;Jardinópolis;1;1;2;179
3106200;Belo Horizonte;3525102;Jardinópolis;1;1;2;411
3132909;Itamogi;3525102;Jardinópolis;1;1;2;75
3147907;Passos;3525102;Jardinópolis;1;1;2;123
3152501;Pouso Alegre;3525102;Jardinópolis;1;1;2;231
3503208;Araraquara;3525102;Jardinópolis;1;1;2;95
3505906;Batatais;3525102;Jardinópolis;1;1;2;21
3509502;Campinas;3525102;Jardinópolis;1;1;2;221
3518859;Guatapará;3525102;Jardinópolis;1;1;2;60
3521309;Ipuã;3525102;Jardinópolis;1;1;2;69
1400100;Boa Vista;3525003;Jandira;1;1;2;3213
2307650;Maracanaú;3525003;Jandira;1;1;2;2320
2910800;Feira de Santana;3525003;Jandira;1;1;2;1470
2919207;Lauro de Freitas;3525003;Jandira;1;1;2;1452
2927408;Salvador;3525003;Jandira;1;1;2;1434
2931350;Teixeira de Freitas;3525003;Jandira;1;1;2;977
3164704;São Sebastião do Paraíso;3525003;Jandira;1;1;2;288
3172004;Visconde do Rio Branco;3525003;Jandira;1;1;2;497
3201506;Colatina;3525003;Jandira;1;1;2;771
3300100;Angra dos Reis;3525003;Jandira;1;1;2;275
3301009;Campos dos Goytacazes;3525003;Jandira;1;1;2;598
3501608;Americana;3525003;Jandira;1;1;2;98
3502804;Araçatuba;3525003;Jandira;1;1;2;441
3504503;Avaré;3525003;Jandira;1;1;2;212
3505302;Barra Bonita;3525003;Jandira;1;1;2;204
3506003;Bauru;3525003;Jandira;1;1;2;258
3506508;Birigui;3525003;Jandira;1;1;2;427
3507001;Boituva;3525003;Jandira;1;1;2;83
3507506;Botucatu;3525003;Jandira;1;1;2;172
3509205;Cajamar;3525003;Jandira;1;1;2;19
3515004;Embu;3525003;Jandira;1;1;2;14
3519600;Ibitinga;3525003;Jandira;1;1;2;278
3520509;Indaiatuba;3525003;Jandira;1;1;2;59
3523909;Itu;3525003;Jandira;1;1;2;49
3524402;Jacareí;3525003;Jandira;1;1;2;100
3510500;Caraguatatuba;3524907;Jambeiro;1;1;2;46
1501402;Belém;3524808;Jales;1;1;2;2101
2800308;Aracaju;3524808;Jales;1;1;2;1722
3134400;Iturama;3524808;Jales;1;1;2;71
3500105;Adamantina;3524808;Jales;1;1;2;166
3502606;Aparecida d'Oeste;3524808;Jales;1;1;2;42
3504206;Auriflama;3524808;Jales;1;1;2;45
3506003;Bauru;3524808;Jales;1;1;2;276
3508702;Caconde;3524808;Jales;1;1;2;433
3510708;Cardoso;3524808;Jales;1;1;2;66
3510807;Casa Branca;3524808;Jales;1;1;2;400
3513009;Cotia;3524808;Jales;1;1;2;532
3513801;Diadema;3524808;Jales;1;1;2;562
3515202;Estrela d'Oeste;3524808;Jales;1;1;2;16
3516200;Franca;3524808;Jales;1;1;2;331
3518909;Guzolândia;3524808;Jales;1;1;2;43
3522703;Itápolis;3524808;Jales;1;1;2;234
1100205;Porto Velho;3524709;Jaguariúna;1;1;2;2275
1302900;Maués;3524709;Jaguariúna;1;1;2;2383
1505536;Parauapebas;3524709;Jaguariúna;1;1;2;1869
1506138;Redenção;3524709;Jaguariúna;1;1;2;1653
1702109;Araguaína;3524709;Jaguariúna;1;1;2;1720
2101202;Bacabal;3524709;Jaguariúna;1;1;2;2058
2111300;São Luís;3524709;Jaguariúna;1;1;2;2248
2211001;Teresina;3524709;Jaguariúna;1;1;2;1992
2301109;Aracati;3524709;Jaguariúna;1;1;2;2203
2304400;Fortaleza;3524709;Jaguariúna;1;1;2;2254
2412005;São Gonçalo do Amarante;3524709;Jaguariúna;1;1;2;2196
2507507;João Pessoa;3524709;Jaguariúna;1;1;2;2093
2602902;Cabo de Santo Agostinho;3524709;Jaguariúna;1;1;2;1987
2604106;Caruaru;3524709;Jaguariúna;1;1;2;1931
2607752;Itapissuma;3524709;Jaguariúna;1;1;2;2037
2609600;Olinda;3524709;Jaguariúna;1;1;2;2019
2704302;Maceió;3524709;Jaguariúna;1;1;2;1826
2802106;Estância;3524709;Jaguariúna;1;1;2;1582
2903904;Bom Jesus da Lapa;3524709;Jaguariúna;1;1;2;1104
2910800;Feira de Santana;3524709;Jaguariúna;1;1;2;1403
2911709;Guanambi;3524709;Jaguariúna;1;1;2;1022
2913606;Ilhéus;3524709;Jaguariúna;1;1;2;1179
2925600;Presidente Dutra;3524709;Jaguariúna;1;1;2;1357
2926608;Ribeira do Pombal;3524709;Jaguariúna;1;1;2;1560
2927408;Salvador;3524709;Jaguariúna;1;1;2;1371
2933307;Vitória da Conquista;3524709;Jaguariúna;1;1;2;1064
3118601;Contagem;3524709;Jaguariúna;1;1;2;427
3136652;Juatuba;3524709;Jaguariúna;1;1;2;407
3143203;Monte Santo de Minas;3524709;Jaguariúna;1;1;2;169
3147303;Paraisópolis;3524709;Jaguariúna;1;1;2;125
3156205;Rochedo de Minas;3524709;Jaguariúna;1;1;2;423
3162906;São João Nepomuceno;3524709;Jaguariúna;1;1;2;427
3170107;Uberaba;3524709;Jaguariúna;1;1;2;342
3170206;Uberlândia;3524709;Jaguariúna;1;1;2;441
3201308;Cariacica;3524709;Jaguariúna;1;1;2;720
3205309;Vitória;3524709;Jaguariúna;1;1;2;733
3301009;Campos dos Goytacazes;3524709;Jaguariúna;1;1;2;589
3303302;Niterói;3524709;Jaguariúna;1;1;2;400
3303906;Petrópolis;3524709;Jaguariúna;1;1;2;387
3500501;Águas de Lindóia;3524709;Jaguariúna;1;1;2;44
3503208;Araraquara;3524709;Jaguariúna;1;1;2;158
3503703;Ariranha;3524709;Jaguariúna;1;1;2;249
3504107;Atibaia;3524709;Jaguariúna;1;1;2;64
3505906;Batatais;3524709;Jaguariúna;1;1;2;211
3507506;Botucatu;3524709;Jaguariúna;1;1;2;151
3508702;Caconde;3524709;Jaguariúna;1;1;2;135
3509007;Caieiras;3524709;Jaguariúna;1;1;2;77
3509205;Cajamar;3524709;Jaguariúna;1;1;2;73
3512209;Conchal;3524709;Jaguariúna;1;1;2;46
3512803;Cosmópolis;3524709;Jaguariúna;1;1;2;23
3513009;Cotia;3524709;Jaguariúna;1;1;2;100
3513504;Cubatão;3524709;Jaguariúna;1;1;2;144
3513900;Divinolândia;3524709;Jaguariúna;1;1;2;118
3516200;Franca;3524709;Jaguariúna;1;1;2;244
3522307;Itapetininga;3524709;Jaguariúna;1;1;2;146
3524402;Jacareí;3524709;Jaguariúna;1;1;2;127
1505536;Parauapebas;3524600;Jacupiranga;1;1;2;2075
3304557;Rio de Janeiro;3524600;Jacupiranga;1;1;2;517
3505401;Barra do Turvo;3524600;Jacupiranga;1;1;2;51
3509908;Cananéia;3524600;Jacupiranga;1;1;2;38
3520301;Iguape;3524600;Jacupiranga;1;1;2;45
3502804;Araçatuba;3524501;Jaci;1;1;2;100
3506508;Birigui;3524501;Jaci;1;1;2;93
1500503;Almeirim;3524402;Jacareí;1;1;2;2499
1500800;Ananindeua;3524402;Jacareí;1;1;2;2439
1501303;Barcarena;3524402;Jacareí;1;1;2;2426
2211001;Teresina;3524402;Jacareí;1;1;2;2040
2304103;Crateús;3524402;Jacareí;1;1;2;2073
2309706;Pacatuba;3524402;Jacareí;1;1;2;2255
2602902;Cabo de Santo Agostinho;3524402;Jacareí;1;1;2;1980
2611606;Recife;3524402;Jacareí;1;1;2;1999
3118601;Contagem;3524402;Jacareí;1;1;2;421
3131307;Ipatinga;3524402;Jacareí;1;1;2;547
3132404;Itajubá;3524402;Jacareí;1;1;2;111
3136702;Juiz de Fora;3524402;Jacareí;1;1;2;317
3163706;São Lourenço;3524402;Jacareí;1;1;2;162
3170800;Várzea da Palma;3524402;Jacareí;1;1;2;644
3201209;Cachoeiro de Itapemirim;3524402;Jacareí;1;1;2;565
3201308;Cariacica;3524402;Jacareí;1;1;2;652
3201407;Castelo;3524402;Jacareí;1;1;2;562
3202405;Guarapari;3524402;Jacareí;1;1;2;621
3202603;Iconha;3524402;Jacareí;1;1;2;591
3205002;Serra;3524402;Jacareí;1;1;2;671
3205101;Viana;3524402;Jacareí;1;1;2;633
3205200;Vila Velha;3524402;Jacareí;1;1;2;654
3302403;Macaé;3524402;Jacareí;1;1;2;426
3304144;Queimados;3524402;Jacareí;1;1;2;250
3304201;Resende;3524402;Jacareí;1;1;2;177
3306305;Volta Redonda;3524402;Jacareí;1;1;2;209
3501608;Americana;3524402;Jacareí;1;1;2;155
3503901;Arujá;3524402;Jacareí;1;1;2;39
3504107;Atibaia;3524402;Jacareí;1;1;2;65
3504503;Avaré;3524402;Jacareí;1;1;2;306
3506003;Bauru;3524402;Jacareí;1;1;2;337
3507001;Boituva;3524402;Jacareí;1;1;2;176
3509700;Campos do Jordão;3524402;Jacareí;1;1;2;76
3510609;Carapicuíba;3524402;Jacareí;1;1;2;94
3513504;Cubatão;3524402;Jacareí;1;1;2;81
3515004;Embu;3524402;Jacareí;1;1;2;100
3516200;Franca;3524402;Jacareí;1;1;2;341
3522307;Itapetininga;3524402;Jacareí;1;1;2;217
3523909;Itu;3524402;Jacareí;1;1;2;138
1716505;Pedro Afonso;3524303;Jaboticabal;1;1;2;1355
2919553;Luís Eduardo magalhães;3524303;Jaboticabal;1;1;2;1044
3104007;Araxá;3524303;Jaboticabal;1;1;2;232
3128105;Guapé;3524303;Jaboticabal;1;1;2;253
3170206;Uberlândia;3524303;Jaboticabal;1;1;2;261
3501608;Americana;3524303;Jaboticabal;1;1;2;193
3505302;Barra Bonita;3524303;Jaboticabal;1;1;2;140
3511003;Castilho;3524303;Jaboticabal;1;1;2;333
3514601;Dumont;3524303;Jaboticabal;1;1;2;35
3520442;Ilha Solteira;3524303;Jaboticabal;1;1;2;327
3523008;Itapura;3524303;Jaboticabal;1;1;2;339
3104007;Araxá;3524204;Jaborandi;1;1;2;195
3512001;Colina;3524204;Jaborandi;1;1;2;14
3514601;Dumont;3524204;Jaborandi;1;1;2;76
1714203;Natividade;3524105;Ituverava;1;1;2;953
3104007;Araxá;3524105;Ituverava;1;1;2;124
3127107;Frutal;3524105;Ituverava;1;1;2;123
3164704;São Sebastião do Paraíso;3524105;Ituverava;1;1;2;109
3506102;Bebedouro;3524105;Ituverava;1;1;2;100
3513207;Cristais Paulista;3524105;Ituverava;1;1;2;43
3515509;Fernandópolis;3524105;Ituverava;1;1;2;253
3517406;Guaíra;3524105;Ituverava;1;1;2;51
2303709;Caucaia;3524006;Itupeva;1;1;2;2301
2504009;Campina Grande;3524006;Itupeva;1;1;2;2077
2602902;Cabo de Santo Agostinho;3524006;Itupeva;1;1;2;2028
2803203;Itaporanga d'Ajuda;3524006;Itupeva;1;1;2;1655
2927408;Salvador;3524006;Itupeva;1;1;2;1412
3106200;Belo Horizonte;3524006;Itupeva;1;1;2;476
3117900;Congonhal;3524006;Itupeva;1;1;2;152
3140803;Matias Barbosa;3524006;Itupeva;1;1;2;407
3160702;Santos Dumont;3524006;Itupeva;1;1;2;402
3205002;Serra;3524006;Itupeva;1;1;2;762
3302254;Itatiaia;3524006;Itupeva;1;1;2;263
3501608;Americana;3524006;Itupeva;1;1;2;54
3504107;Atibaia;3524006;Itupeva;1;1;2;52
3511102;Catanduva;3524006;Itupeva;1;1;2;296
3516408;Franco da Rocha;3524006;Itupeva;1;1;2;39
3518701;Guarujá;3524006;Itupeva;1;1;2;120
3518800;Guarulhos;3524006;Itupeva;1;1;2;60
3519071;Hortolândia;3524006;Itupeva;1;1;2;37
3522505;Itapevi;3524006;Itupeva;1;1;2;45
1721000;Palmas;3523909;Itu;1;1;2;1434
2307650;Maracanaú;3523909;Itu;1;1;2;2309
2607752;Itapissuma;3523909;Itu;1;1;2;2103
2607901;Jaboatão dos Guararapes;3523909;Itu;1;1;2;2066
2900702;Alagoinhas;3523909;Itu;1;1;2;1515
2907509;Catu;3523909;Itu;1;1;2;1499
2910800;Feira de Santana;3523909;Itu;1;1;2;1470
2922003;Mucuri;3523909;Itu;1;1;2;973
3109402;Buritizeiro;3523909;Itu;1;1;2;696
3116605;Cláudio;3523909;Itu;1;1;2;406
3130101;Igarapé;3523909;Itu;1;1;2;466
3136702;Juiz de Fora;3523909;Itu;1;1;2;437
3162104;São Gotardo;3523909;Itu;1;1;2;458
3167202;Sete Lagoas;3523909;Itu;1;1;2;526
3201209;Cachoeiro de Itapemirim;3523909;Itu;1;1;2;686
3201308;Cariacica;3523909;Itu;1;1;2;771
3204054;Pedro Canário;3523909;Itu;1;1;2;924
3205309;Vitória;3523909;Itu;1;1;2;783
3300803;Cachoeiras de Macacu;3523909;Itu;1;1;2;482
3500550;Águas de Santa Bárbara;3523909;Itu;1;1;2;203
3501608;Americana;3523909;Itu;1;1;2;60
3503307;Araras;3523909;Itu;1;1;2;103
3504503;Avaré;3523909;Itu;1;1;2;168
3506508;Birigui;3523909;Itu;1;1;2;379
3507605;Bragança Paulista;3523909;Itu;1;1;2;85
3509007;Caieiras;3523909;Itu;1;1;2;58
3509908;Cananéia;3523909;Itu;1;1;2;206
3510401;Capivari;3523909;Itu;1;1;2;38
3511508;Cerquilho;3523909;Itu;1;1;2;47
3511607;Cesário Lange;3523909;Itu;1;1;2;67
3513009;Cotia;3523909;Itu;1;1;2;53
3515186;Espírito Santo do Pinhal;3523909;Itu;1;1;2;134
3518701;Guarujá;3523909;Itu;1;1;2;129
3521002;Iperó;3523909;Itu;1;1;2;41
3522406;Itapeva;3523909;Itu;1;1;2;180
3523404;Itatiba;3523909;Itu;1;1;2;56
3505906;Batatais;3523701;Itirapuã;1;1;2;50
3507803;Brodowski;3523701;Itirapuã;1;1;2;60
3516200;Franca;3523701;Itirapuã;1;1;2;22
2927408;Salvador;3523602;Itirapina;1;1;2;1390
3303807;Parati;3523602;Itirapina;1;1;2;338
3501608;Americana;3523602;Itirapina;1;1;2;74
3502002;Analândia;3523602;Itirapina;1;1;2;22
3505708;Barueri;3523602;Itirapina;1;1;2;170
3506003;Bauru;3523602;Itirapina;1;1;2;130
3507902;Brotas;3523602;Itirapina;1;1;2;32
3508108;Buritama;3523602;Itirapina;1;1;2;272
3509502;Campinas;3523602;Itirapina;1;1;2;107
3515509;Fernandópolis;3523602;Itirapina;1;1;2;331
3521200;Iporanga;3523602;Itirapina;1;1;2;270
3521408;Iracemápolis;3523602;Itirapina;1;1;2;48
3522307;Itapetininga;3523602;Itirapina;1;1;2;149
3306008;Três Rios;3523503;Itatinga;1;1;2;561
3506904;Bofete;3523503;Itatinga;1;1;2;37
3511409;Cerqueira César;3523503;Itatinga;1;1;2;57
3522406;Itapeva;3523503;Itatinga;1;1;2;101
2304400;Fortaleza;3523404;Itatiba;1;1;2;2279
2504009;Campina Grande;3523404;Itatiba;1;1;2;2053
2507507;João Pessoa;3523404;Itatiba;1;1;2;2110
2607208;Ipojuca;3523404;Itatiba;1;1;2;1990
2704302;Maceió;3523404;Itatiba;1;1;2;1841
2905701;Camaçari;3523404;Itatiba;1;1;2;1421
2927408;Salvador;3523404;Itatiba;1;1;2;1386
2930709;Simões Filho;3523404;Itatiba;1;1;2;1408
3106200;Belo Horizonte;3523404;Itatiba;1;1;2;450
3106705;Betim;3523404;Itatiba;1;1;2;431
3145208;Nova Serrana;3523404;Itatiba;1;1;2;394
3149309;Pedro Leopoldo;3523404;Itatiba;1;1;2;469
3170206;Uberlândia;3523404;Itatiba;1;1;2;477
3301702;Duque de Caxias;3523404;Itatiba;1;1;2;362
3303302;Niterói;3523404;Itatiba;1;1;2;383
3306107;Valença;3523404;Itatiba;1;1;2;328
3501608;Americana;3523404;Itatiba;1;1;2;59
3503802;Artur Nogueira;3523404;Itatiba;1;1;2;59
3505708;Barueri;3523404;Itatiba;1;1;2;56
3506508;Birigui;3523404;Itatiba;1;1;2;404
3508405;Cabreúva;3523404;Itatiba;1;1;2;45
3510401;Capivari;3523404;Itatiba;1;1;2;69
3512704;Corumbataí;3523404;Itatiba;1;1;2;119
3513801;Diadema;3523404;Itatiba;1;1;2;78
3516408;Franco da Rocha;3523404;Itatiba;1;1;2;37
3509254;Cajati;3523305;Itariri;1;1;2;108
3509908;Cananéia;3523305;Itariri;1;1;2;115
3522109;Itanhaém;3523305;Itariri;1;1;2;41
3301702;Duque de Caxias;3523206;Itararé;1;1;2;627
3305208;São Pedro da Aldeia;3523206;Itararé;1;1;2;745
3502309;Anhembi;3523206;Itararé;1;1;2;188
3505708;Barueri;3523206;Itararé;1;1;2;258
3508009;Buri;3523206;Itararé;1;1;2;83
3516200;Franca;3523206;Itararé;1;1;2;440
3517604;Guapiara;3523206;Itararé;1;1;2;83
3520509;Indaiatuba;3523206;Itararé;1;1;2;240
3521804;Itaí;3523206;Itararé;1;1;2;80
3522802;Itaporanga;3523206;Itararé;1;1;2;46
2307650;Maracanaú;3523107;Itaquaquecetuba;1;1;2;2297
2516201;Sousa;3523107;Itaquaquecetuba;1;1;2;2010
2919207;Lauro de Freitas;3523107;Itaquaquecetuba;1;1;2;1416
2927408;Salvador;3523107;Itaquaquecetuba;1;1;2;1398
2932200;Ubaitaba;3523107;Itaquaquecetuba;1;1;2;1235
3118601;Contagem;3523107;Itaquaquecetuba;1;1;2;456
3122306;Divinópolis;3523107;Itaquaquecetuba;1;1;2;396
3125101;Extrema;3523107;Itaquaquecetuba;1;1;2;69
3147907;Passos;3523107;Itaquaquecetuba;1;1;2;309
3152501;Pouso Alegre;3523107;Itaquaquecetuba;1;1;2;146
3167004;Serranos;3523107;Itaquaquecetuba;1;1;2;256
3201308;Cariacica;3523107;Itaquaquecetuba;1;1;2;695
3205002;Serra;3523107;Itaquaquecetuba;1;1;2;714
3300209;Araruama;3523107;Itaquaquecetuba;1;1;2;413
3303302;Niterói;3523107;Itaquaquecetuba;1;1;2;338
3304144;Queimados;3523107;Itaquaquecetuba;1;1;2;294
3501608;Americana;3523107;Itaquaquecetuba;1;1;2;130
3502754;Araçariguama;3523107;Itaquaquecetuba;1;1;2;73
3504107;Atibaia;3523107;Itaquaquecetuba;1;1;2;45
3506607;Biritiba-Mirim;3523107;Itaquaquecetuba;1;1;2;33
3508702;Caconde;3523107;Itaquaquecetuba;1;1;2;218
3509601;Campo Limpo Paulista;3523107;Itaquaquecetuba;1;1;2;54
3513504;Cubatão;3523107;Itaquaquecetuba;1;1;2;47
3513801;Diadema;3523107;Itaquaquecetuba;1;1;2;35
3516200;Franca;3523107;Itaquaquecetuba;1;1;2;342
3518701;Guarujá;3523107;Itaquaquecetuba;1;1;2;53
3520202;Igaratá;3523107;Itaquaquecetuba;1;1;2;36
3522505;Itapevi;3523107;Itaquaquecetuba;1;1;2;61
3520442;Ilha Solteira;3523008;Itapura;1;1;2;29
3505302;Barra Bonita;3522901;Itapuí;1;1;2;33
3506003;Bauru;3522901;Itapuí;1;1;2;39
3519600;Ibitinga;3522901;Itapuí;1;1;2;54
3509502;Campinas;3522802;Itaporanga;1;1;2;263
3522406;Itapeva;3522802;Itaporanga;1;1;2;68
1501402;Belém;3522703;Itápolis;1;1;2;2236
2601904;Bezerros;3522703;Itápolis;1;1;2;1971
3502804;Araçatuba;3522703;Itápolis;1;1;2;175
3505708;Barueri;3522703;Itápolis;1;1;2;293
3507407;Borborema;3522703;Itápolis;1;1;2;27
3510104;Cândido Rodrigues;3522703;Itápolis;1;1;2;35
3514106;Dois Córregos;3522703;Itápolis;1;1;2;96
3515509;Fernandópolis;3522703;Itápolis;1;1;2;208
3516200;Franca;3522703;Itápolis;1;1;2;186
3518107;Guarantã;3522703;Itápolis;1;1;2;87
3518701;Guarujá;3522703;Itápolis;1;1;2;372
3519105;Iacanga;3522703;Itápolis;1;1;2;39
3521903;Itajobi;3522703;Itápolis;1;1;2;40
1500503;Almeirim;3522653;Itapirapuã Paulista;1;1;2;2574
3522406;Itapeva;3522653;Itapirapuã Paulista;1;1;2;72
2927408;Salvador;3522604;Itapira;1;1;2;1339
3106200;Belo Horizonte;3522604;Itapira;1;1;2;404
3146008;Ouro Fino;3522604;Itapira;1;1;2;50
3169406;Três Pontas;3522604;Itapira;1;1;2;179
3170206;Uberlândia;3522604;Itapira;1;1;2;418
3170438;União de Minas;3522604;Itapira;1;1;2;481
3304557;Rio de Janeiro;3522604;Itapira;1;1;2;370
3503802;Artur Nogueira;3522604;Itapira;1;1;2;39
3507605;Bragança Paulista;3522604;Itapira;1;1;2;63
3512209;Conchal;3522604;Itapira;1;1;2;38
3515186;Espírito Santo do Pinhal;3522604;Itapira;1;1;2;28
1302603;Manaus;3522505;Itapevi;1;1;2;2595
2211001;Teresina;3522505;Itapevi;1;1;2;2081
2307700;Maranguape;3522505;Itapevi;1;1;2;2319
2312403;São Gonçalo do Amarante;3522505;Itapevi;1;1;2;2339
2602902;Cabo de Santo Agostinho;3522505;Itapevi;1;1;2;2054
2607901;Jaboatão dos Guararapes;3522505;Itapevi;1;1;2;2068
2611606;Recife;3522505;Itapevi;1;1;2;2073
2800308;Aracaju;3522505;Itapevi;1;1;2;1704
2905701;Camaçari;3522505;Itapevi;1;1;2;1472
2927408;Salvador;3522505;Itapevi;1;1;2;1438
2930709;Simões Filho;3522505;Itapevi;1;1;2;1460
3136207;João Monlevade;3522505;Itapevi;1;1;2;562
3136702;Juiz de Fora;3522505;Itapevi;1;1;2;416
3201308;Cariacica;3522505;Itapevi;1;1;2;750
3301702;Duque de Caxias;3522505;Itapevi;1;1;2;379
3303401;Nova Friburgo;3522505;Itapevi;1;1;2;465
3304201;Resende;3522505;Itapevi;1;1;2;278
3507605;Bragança Paulista;3522505;Itapevi;1;1;2;77
3509007;Caieiras;3522505;Itapevi;1;1;2;29
3514106;Dois Córregos;3522505;Itapevi;1;1;2;196
3515004;Embu;3522505;Itapevi;1;1;2;15
3516200;Franca;3522505;Itapevi;1;1;2;336
3516309;Francisco Morato;3522505;Itapevi;1;1;2;39
3516408;Franco da Rocha;3522505;Itapevi;1;1;2;33
3519071;Hortolândia;3522505;Itapevi;1;1;2;81
1100304;Vilhena;3522406;Itapeva;1;1;2;1661
2922003;Mucuri;3522406;Itapeva;1;1;2;1142
3103504;Araguari;3522406;Itapeva;1;1;2;595
3132404;Itajubá;3522406;Itapeva;1;1;2;387
3151800;Poços de Caldas;3522406;Itapeva;1;1;2;340
3170404;Unaí;3522406;Itapeva;1;1;2;861
3505302;Barra Bonita;3522406;Itapeva;1;1;2;167
3505351;Barra do Chapéu;3522406;Itapeva;1;1;2;57
3505708;Barueri;3522406;Itapeva;1;1;2;211
3507001;Boituva;3522406;Itapeva;1;1;2;145
3507159;Bom Sucesso de Itararé;3522406;Itapeva;1;1;2;46
3507506;Botucatu;3522406;Itapeva;1;1;2;130
3511508;Cerquilho;3522406;Itapeva;1;1;2;147
3513009;Cotia;3522406;Itapeva;1;1;2;204
3514106;Dois Córregos;3522406;Itapeva;1;1;2;186
3515400;Fartura;3522406;Itapeva;1;1;2;91
3517604;Guapiara;3522406;Itapeva;1;1;2;43
3520509;Indaiatuba;3522406;Itapeva;1;1;2;194
3521804;Itaí;3522406;Itapeva;1;1;2;65
2211001;Teresina;3522307;Itapetininga;1;1;2;2109
2611606;Recife;3522307;Itapetininga;1;1;2;2140
3124807;Estrela do Sul;3522307;Itapetininga;1;1;2;536
3156908;Sacramento;3522307;Itapetininga;1;1;2;417
3170107;Uberaba;3522307;Itapetininga;1;1;2;425
3205309;Vitória;3522307;Itapetininga;1;1;2;864
3500303;Aguaí;3522307;Itapetininga;1;1;2;201
3502101;Andradina;3522307;Itapetininga;1;1;2;448
3502309;Anhembi;3522307;Itapetininga;1;1;2;87
3502705;Apiaí;3522307;Itapetininga;1;1;2;131
3503208;Araraquara;3522307;Itapetininga;1;1;2;199
3504008;Assis;3522307;Itapetininga;1;1;2;264
3506904;Bofete;3522307;Itapetininga;1;1;2;57
3507159;Bom Sucesso de Itararé;3522307;Itapetininga;1;1;2;139
3508306;Cabrália Paulista;3522307;Itapetininga;1;1;2;181
3510302;Capela do Alto;3522307;Itapetininga;1;1;2;34
3510401;Capivari;3522307;Itapetininga;1;1;2;85
3511409;Cerqueira César;3522307;Itapetininga;1;1;2;129
3512308;Conchas;3522307;Itapetininga;1;1;2;63
3513009;Cotia;3522307;Itapetininga;1;1;2;116
3514106;Dois Córregos;3522307;Itapetininga;1;1;2;139
3514908;Elias Fausto;3522307;Itapetininga;1;1;2;91
3515194;Espírito Santo do Turvo;3522307;Itapetininga;1;1;2;171
3516200;Franca;3522307;Itapetininga;1;1;2;343
3518701;Guarujá;3522307;Itapetininga;1;1;2;186
1502400;Castanhal;3522208;Itapecerica da Serra;1;1;2;2482
2607901;Jaboatão dos Guararapes;3522208;Itapecerica da Serra;1;1;2;2077
2930709;Simões Filho;3522208;Itapecerica da Serra;1;1;2;1469
3140803;Matias Barbosa;3522208;Itapecerica da Serra;1;1;2;412
3165305;São Vicente de Minas;3522208;Itapecerica da Serra;1;1;2;329
3170107;Uberaba;3522208;Itapecerica da Serra;1;1;2;453
3302403;Macaé;3522208;Itapecerica da Serra;1;1;2;524
3305109;São João de Meriti;3522208;Itapecerica da Serra;1;1;2;367
3509502;Campinas;3522208;Itapecerica da Serra;1;1;2;93
3510609;Carapicuíba;3522208;Itapecerica da Serra;1;1;2;22
3513009;Cotia;3522208;Itapecerica da Serra;1;1;2;14
3513801;Diadema;3522208;Itapecerica da Serra;1;1;2;24
3514809;Eldorado;3522208;Itapecerica da Serra;1;1;2;157
3518800;Guarulhos;3522208;Itapecerica da Serra;1;1;2;43
1721000;Palmas;3522109;Itanhaém;1;1;2;1538
3106200;Belo Horizonte;3522109;Itanhaém;1;1;2;551
3304557;Rio de Janeiro;3522109;Itanhaém;1;1;2;385
3510401;Capivari;3522109;Itanhaém;1;1;2;150
3513009;Cotia;3522109;Itanhaém;1;1;2;65
3513504;Cubatão;3522109;Itanhaém;1;1;2;49
3520400;Ilhabela;3522109;Itanhaém;1;1;2;152
3507308;Boracéia;3522000;Itaju;1;1;2;24
2909802;Cruz das Almas;3521903;Itajobi;1;1;2;1390
2927002;Rio Real;3521903;Itajobi;1;1;2;1567
2929701;Sátiro Dias;3521903;Itajobi;1;1;2;1507
2930709;Simões Filho;3521903;Itajobi;1;1;2;1434
3104007;Araxá;3521903;Itajobi;1;1;2;290
3135050;Jaíba;3521903;Itajobi;1;1;2;859
3304557;Rio de Janeiro;3521903;Itajobi;1;1;2;628
3503208;Araraquara;3521903;Itajobi;1;1;2;105
3503802;Artur Nogueira;3521903;Itajobi;1;1;2;240
3506003;Bauru;3521903;Itajobi;1;1;2;113
3506102;Bebedouro;3521903;Itajobi;1;1;2;68
3507407;Borborema;3521903;Itajobi;1;1;2;34
3511201;Catiguá;3521903;Itajobi;1;1;2;30
3517208;Guaiçara;3521903;Itajobi;1;1;2;84
3519402;Ibirá;3521903;Itajobi;1;1;2;33
3106200;Belo Horizonte;3521804;Itaí;1;1;2;647
3170206;Uberlândia;3521804;Itaí;1;1;2;507
3304557;Rio de Janeiro;3521804;Itaí;1;1;2;598
3501608;Americana;3521804;Itaí;1;1;2;194
3504503;Avaré;3521804;Itaí;1;1;2;39
3507506;Botucatu;3521804;Itaí;1;1;2;89
3508009;Buri;3521804;Itaí;1;1;2;66
3511102;Catanduva;3521804;Itaí;1;1;2;252
3515400;Fartura;3521804;Itaí;1;1;2;43
3521309;Ipuã;3521804;Itaí;1;1;2;348
3304557;Rio de Janeiro;3521705;Itaberá;1;1;2;606
3508009;Buri;3521705;Itaberá;1;1;2;56
3515400;Fartura;3521705;Itaberá;1;1;2;65
3500105;Adamantina;3521606;Irapuru;1;1;2;29
3104007;Araxá;3521507;Irapuã;1;1;2;316
3519402;Ibirá;3521507;Irapuã;1;1;2;28
3201209;Cachoeiro de Itapemirim;3521408;Iracemápolis;1;1;2;685
3304557;Rio de Janeiro;3521408;Iracemápolis;1;1;2;439
3501608;Americana;3521408;Iracemápolis;1;1;2;26
3502002;Analândia;3521408;Iracemápolis;1;1;2;53
3507407;Borborema;3521408;Iracemápolis;1;1;2;192
3509502;Campinas;3521408;Iracemápolis;1;1;2;59
3512407;Cordeirópolis;3521408;Iracemápolis;1;1;2;13
3512704;Corumbataí;3521408;Iracemápolis;1;1;2;41
3521101;Ipeúna;3521408;Iracemápolis;1;1;2;26
3104007;Araxá;3521309;Ipuã;1;1;2;145
3148004;Patos de Minas;3521309;Ipuã;1;1;2;259
3505906;Batatais;3521309;Ipuã;1;1;2;65
3509502;Campinas;3521309;Ipuã;1;1;2;290
3517406;Guaíra;3521309;Ipuã;1;1;2;34
3513009;Cotia;3521200;Iporanga;1;1;2;201
2910057;Dias d'Ávila;3521002;Iperó;1;1;2;1509
3106705;Betim;3521002;Iperó;1;1;2;516
3510302;Capela do Alto;3521002;Iperó;1;1;2;14
3511607;Cesário Lange;3521002;Iperó;1;1;2;30
3504008;Assis;3520905;Ipaussu;1;1;2;94
3510005;Cândido Mota;3520905;Ipaussu;1;1;2;85
3500105;Adamantina;3520806;Inúbia Paulista;1;1;2;16
3506102;Bebedouro;3520707;Indiaporã;1;1;2;212
3509502;Campinas;3520707;Indiaporã;1;1;2;470
3502804;Araçatuba;3520608;Indiana;1;1;2;133
1200401;Rio Branco;3520509;Indaiatuba;1;1;2;2499
2111300;São Luís;3520509;Indaiatuba;1;1;2;2293
2503209;Cabedelo;3520509;Indaiatuba;1;1;2;2153
2607901;Jaboatão dos Guararapes;3520509;Indaiatuba;1;1;2;2047
2704302;Maceió;3520509;Indaiatuba;1;1;2;1872
2919207;Lauro de Freitas;3520509;Indaiatuba;1;1;2;1436
3101607;Alfenas;3520509;Indaiatuba;1;1;2;228
3131703;Itabira;3520509;Indaiatuba;1;1;2;558
3137601;Lagoa Santa;3520509;Indaiatuba;1;1;2;512
3162955;São José da Lapa;3520509;Indaiatuba;1;1;2;501
3167202;Sete Lagoas;3520509;Indaiatuba;1;1;2;506
3170701;Varginha;3520509;Indaiatuba;1;1;2;257
3205002;Serra;3520509;Indaiatuba;1;1;2;776
3205309;Vitória;3520509;Indaiatuba;1;1;2;771
3302403;Macaé;3520509;Indaiatuba;1;1;2;552
3302502;Magé;3520509;Indaiatuba;1;1;2;430
3500501;Águas de Lindóia;3520509;Indaiatuba;1;1;2;92
3501905;Amparo;3520509;Indaiatuba;1;1;2;65
3503208;Araraquara;3520509;Indaiatuba;1;1;2;173
3510203;Capão Bonito;3520509;Indaiatuba;1;1;2;153
3513504;Cubatão;3520509;Indaiatuba;1;1;2;122
3513702;Descalvado;3520509;Indaiatuba;1;1;2;137
3514106;Dois Córregos;3520509;Indaiatuba;1;1;2;141
3514601;Dumont;3520509;Indaiatuba;1;1;2;219
3518701;Guarujá;3520509;Indaiatuba;1;1;2;138
3519709;Ibiúna;3520509;Indaiatuba;1;1;2;62
3503208;Araraquara;3520442;Ilha Solteira;1;1;2;365
3506508;Birigui;3520442;Ilha Solteira;1;1;2;142
3509502;Campinas;3520442;Ilha Solteira;1;1;2;527
3516200;Franca;3520442;Ilha Solteira;1;1;2;411
3518909;Guzolândia;3520442;Ilha Solteira;1;1;2;75
3300100;Angra dos Reis;3520400;Ilhabela;1;1;2;144
3126208;Formoso;3520301;Iguape;1;1;2;1088
3514809;Eldorado;3520301;Iguape;1;1;2;60
3515004;Embu;3520301;Iguape;1;1;2;137
3505708;Barueri;3520202;Igaratá;1;1;2;81
3509502;Campinas;3520202;Igaratá;1;1;2;98
3104007;Araxá;3520103;Igarapava;1;1;2;98
3106200;Belo Horizonte;3520103;Igarapava;1;1;2;395
3106705;Betim;3520103;Igarapava;1;1;2;373
3113602;Careaçu;3520103;Igarapava;1;1;2;309
3147006;Paracatu;3520103;Igarapava;1;1;2;323
3169604;Tupaciguara;3520103;Igarapava;1;1;2;189
3509502;Campinas;3520103;Igarapava;1;1;2;324
3517406;Guaíra;3520103;Igarapava;1;1;2;66
3300407;Barra Mansa;3520004;Igaraçu do Tietê;1;1;2;449
3509502;Campinas;3520004;Igaraçu do Tietê;1;1;2;161
3512407;Cordeirópolis;3520004;Igaraçu do Tietê;1;1;2;113
3514106;Dois Córregos;3520004;Igaraçu do Tietê;1;1;2;24
3104007;Araxá;3519808;Icém;1;1;2;249
3134400;Iturama;3519808;Icém;1;1;2;124
2304400;Fortaleza;3519709;Ibiúna;1;1;2;2357
2930709;Simões Filho;3519709;Ibiúna;1;1;2;1485
3304557;Rio de Janeiro;3519709;Ibiúna;1;1;2;412
3504107;Atibaia;3519709;Ibiúna;1;1;2;91
3509502;Campinas;3519709;Ibiúna;1;1;2;85
3513108;Cravinhos;3519709;Ibiúna;1;1;2;262
3518800;Guarulhos;3519709;Ibiúna;1;1;2;72
3304557;Rio de Janeiro;3519600;Ibitinga;1;1;2;593
3505302;Barra Bonita;3519600;Ibitinga;1;1;2;87
3506508;Birigui;3519600;Ibitinga;1;1;2;163
3506706;Boa Esperança do Sul;3519600;Ibitinga;1;1;2;54
3511102;Catanduva;3519600;Ibitinga;1;1;2;69
3513702;Descalvado;3519600;Ibitinga;1;1;2;128
3505708;Barueri;3519501;Ibirarema;1;1;2;338
3510005;Cândido Mota;3519501;Ibirarema;1;1;2;33
3104007;Araxá;3519402;Ibirá;1;1;2;289
3504602;Bady Bassitt;3519402;Ibirá;1;1;2;28
3509502;Campinas;3519402;Ibirá;1;1;2;305
2918001;Jequié;3519303;Ibaté;1;1;2;1205
2927408;Salvador;3519303;Ibaté;1;1;2;1380
3505906;Batatais;3519303;Ibaté;1;1;2;124
3506706;Boa Esperança do Sul;3519303;Ibaté;1;1;2;41
3512209;Conchal;3519303;Ibaté;1;1;2;95
3512704;Corumbataí;3519303;Ibaté;1;1;2;48
3514304;Dourado;3519303;Ibaté;1;1;2;37
3516200;Franca;3519303;Ibaté;1;1;2;168
3500105;Adamantina;3519204;Iacri;1;1;2;46
2802106;Estância;3519105;Iacanga;1;1;2;1653
3503208;Araraquara;3519105;Iacanga;1;1;2;89
3509205;Cajamar;3519105;Iacanga;1;1;2;276
3509502;Campinas;3519105;Iacanga;1;1;2;233
1302603;Manaus;3519071;Hortolândia;1;1;2;2521
1500800;Ananindeua;3519071;Hortolândia;1;1;2;2380
2304400;Fortaleza;3519071;Hortolândia;1;1;2;2277
2606804;Igarassu;3519071;Hortolândia;1;1;2;2056
2910057;Dias d'Ávila;3519071;Hortolândia;1;1;2;1441
3129905;Ibitiúra de Minas;3519071;Hortolândia;1;1;2;119
3138203;Lavras;3519071;Hortolândia;1;1;2;289
3144805;Nova Lima;3519071;Hortolândia;1;1;2;464
3151800;Poços de Caldas;3519071;Hortolândia;1;1;2;139
3156700;Sabará;3519071;Hortolândia;1;1;2;478
3303302;Niterói;3519071;Hortolândia;1;1;2;423
3500600;Águas de São Pedro;3519071;Hortolândia;1;1;2;74
3503802;Artur Nogueira;3519071;Hortolândia;1;1;2;32
3507605;Bragança Paulista;3519071;Hortolândia;1;1;2;69
3510609;Carapicuíba;3519071;Hortolândia;1;1;2;84
3513009;Cotia;3519071;Hortolândia;1;1;2;88
3513405;Cruzeiro;3519071;Hortolândia;1;1;2;234
3513504;Cubatão;3519071;Hortolândia;1;1;2;141
3514924;Elisiário;3519071;Hortolândia;1;1;2;269
3516200;Franca;3519071;Hortolândia;1;1;2;257
3518800;Guarulhos;3519071;Hortolândia;1;1;2;93
3519055;Holambra;3519071;Hortolândia;1;1;2;30
1302603;Manaus;3519055;Holambra;1;1;2;2509
2304400;Fortaleza;3519055;Holambra;1;1;2;2249
3302403;Macaé;3519055;Holambra;1;1;2;531
3501905;Amparo;3519055;Holambra;1;1;2;31
3510401;Capivari;3519055;Holambra;1;1;2;61
3510807;Casa Branca;3519055;Holambra;1;1;2;95
3512803;Cosmópolis;3519055;Holambra;1;1;2;14
3515152;Engenheiro Coelho;3519055;Holambra;1;1;2;23
3500105;Adamantina;3519006;Herculândia;1;1;2;81
1503093;Goianésia do Pará;3518909;Guzolândia;1;1;2;1866
2905404;Cairu;3518859;Guatapará;1;1;2;1275
1100288;Rolim de Moura;3518800;Guarulhos;1;1;2;1975
1501501;Benevides;3518800;Guarulhos;1;1;2;2447
1501782;Breu Branco;3518800;Guarulhos;1;1;2;2167
1503606;Itaituba;3518800;Guarulhos;1;1;2;2316
1505536;Parauapebas;3518800;Guarulhos;1;1;2;1955
1506138;Redenção;3518800;Guarulhos;1;1;2;1740
1721000;Palmas;3518800;Guarulhos;1;1;2;1458
2108207;Pedreiras;3518800;Guarulhos;1;1;2;2098
2111508;São Mateus do Maranhão;3518800;Guarulhos;1;1;2;2155
2303709;Caucaia;3518800;Guarulhos;1;1;2;2312
2305506;Iguatu;3518800;Guarulhos;1;1;2;2018
2307650;Maracanaú;3518800;Guarulhos;1;1;2;2299
2307700;Maranguape;3518800;Guarulhos;1;1;2;2295
2312908;Sobral;3518800;Guarulhos;1;1;2;2269
2407104;Macaíba;3518800;Guarulhos;1;1;2;2233
2501807;Bayeux;3518800;Guarulhos;1;1;2;2134
2506301;Guarabira;3518800;Guarulhos;1;1;2;2131
2604007;Carpina;3518800;Guarulhos;1;1;2;2052
2604106;Caruaru;3518800;Guarulhos;1;1;2;1972
2605202;Escada;3518800;Guarulhos;1;1;2;2005
2606002;Garanhuns;3518800;Guarulhos;1;1;2;1891
2606200;Goiana;3518800;Guarulhos;1;1;2;2090
2607752;Itapissuma;3518800;Guarulhos;1;1;2;2075
2610707;Paulista;3518800;Guarulhos;1;1;2;2062
2612208;Salgueiro;3518800;Guarulhos;1;1;2;1843
2613909;Serra Talhada;3518800;Guarulhos;1;1;2;1895
2704708;Marechal Deodoro;3518800;Guarulhos;1;1;2;1846
2804805;Nossa Senhora do Socorro;3518800;Guarulhos;1;1;2;1674
2900702;Alagoinhas;3518800;Guarulhos;1;1;2;1487
2903201;Barreiras;3518800;Guarulhos;1;1;2;1252
2905008;Caculé;3518800;Guarulhos;1;1;2;1076
2911709;Guanambi;3518800;Guarulhos;1;1;2;1080
2913606;Ilhéus;3518800;Guarulhos;1;1;2;1210
2914604;Irecê;3518800;Guarulhos;1;1;2;1416
2917508;Jacobina;3518800;Guarulhos;1;1;2;1476
2918407;Juazeiro;3518800;Guarulhos;1;1;2;1655
2922003;Mucuri;3518800;Guarulhos;1;1;2;925
2925204;Pojuca;3518800;Guarulhos;1;1;2;1465
2929206;São Francisco do Conde;3518800;Guarulhos;1;1;2;1428
2931350;Teixeira de Freitas;3518800;Guarulhos;1;1;2;946
3101508;Além Paraíba;3518800;Guarulhos;1;1;2;430
3104205;Arcos;3518800;Guarulhos;1;1;2;363
3110608;Cambuí;3518800;Guarulhos;1;1;2;104
3113404;Caratinga;3518800;Guarulhos;1;1;2;595
3117876;Confins;3518800;Guarulhos;1;1;2;494
3118007;Congonhas;3518800;Guarulhos;1;1;2;423
3120409;Cristiano Otoni;3518800;Guarulhos;1;1;2;401
3124500;Estiva;3518800;Guarulhos;1;1;2;121
3127701;Governador Valadares;3518800;Guarulhos;1;1;2;689
3128303;Guaranésia;3518800;Guarulhos;1;1;2;238
3130705;Indianópolis;3518800;Guarulhos;1;1;2;506
3132404;Itajubá;3518800;Guarulhos;1;1;2;159
3135407;Jeceaba;3518800;Guarulhos;1;1;2;414
3136207;João Monlevade;3518800;Guarulhos;1;1;2;527
3136652;Juatuba;3518800;Guarulhos;1;1;2;446
3137601;Lagoa Santa;3518800;Guarulhos;1;1;2;500
3137809;Lambari;3518800;Guarulhos;1;1;2;204
3138005;Laranjal;3518800;Guarulhos;1;1;2;473
3138203;Lavras;3518800;Guarulhos;1;1;2;291
3139409;Manhuaçu;3518800;Guarulhos;1;1;2;576
3140803;Matias Barbosa;3518800;Guarulhos;1;1;2;372
3141108;Matozinhos;3518800;Guarulhos;1;1;2;497
3143906;Muriaé;3518800;Guarulhos;1;1;2;502
3144805;Nova Lima;3518800;Guarulhos;1;1;2;467
3146008;Ouro Fino;3518800;Guarulhos;1;1;2;129
3147303;Paraisópolis;3518800;Guarulhos;1;1;2;126
3147907;Passos;3518800;Guarulhos;1;1;2;303
3148103;Patrocínio;3518800;Guarulhos;1;1;2;499
3152105;Ponte Nova;3518800;Guarulhos;1;1;2;499
3154705;Ribeirão Vermelho;3518800;Guarulhos;1;1;2;293
3159605;Santa Rita do Sapucaí;3518800;Guarulhos;1;1;2;158
3161700;São Gonçalo do Abaeté;3518800;Guarulhos;1;1;2;569
3162906;São João Nepomuceno;3518800;Guarulhos;1;1;2;417
3162955;São José da Lapa;3518800;Guarulhos;1;1;2;490
3167202;Sete Lagoas;3518800;Guarulhos;1;1;2;501
3168101;Tapira;3518800;Guarulhos;1;1;2;390
3169802;Turvolândia;3518800;Guarulhos;1;1;2;190
3169901;Ubá;3518800;Guarulhos;1;1;2;446
3200300;Alfredo Chaves;3518800;Guarulhos;1;1;2;665
3202504;Ibiraçu;3518800;Guarulhos;1;1;2;741
3302205;Itaperuna;3518800;Guarulhos;1;1;2;537
3302254;Itatiaia;3518800;Guarulhos;1;1;2;227
3302502;Magé;3518800;Guarulhos;1;1;2;367
3303005;Miracema;3518800;Guarulhos;1;1;2;494
3303302;Niterói;3518800;Guarulhos;1;1;2;358
3304144;Queimados;3518800;Guarulhos;1;1;2;314
3305802;Teresópolis;3518800;Guarulhos;1;1;2;378
3500501;Águas de Lindóia;3518800;Guarulhos;1;1;2;107
3500709;Agudos;3518800;Guarulhos;1;1;2;270
3502200;Angatuba;3518800;Guarulhos;1;1;2;189
3502804;Araçatuba;3518800;Guarulhos;1;1;2;465
3504503;Avaré;3518800;Guarulhos;1;1;2;245
3507100;Bom Jesus dos Perdões;3518800;Guarulhos;1;1;2;35
3507605;Bragança Paulista;3518800;Guarulhos;1;1;2;55
3509205;Cajamar;3518800;Guarulhos;1;1;2;33
3509254;Cajati;3518800;Guarulhos;1;1;2;214
3509403;Cajuru;3518800;Guarulhos;1;1;2;251
3510401;Capivari;3518800;Guarulhos;1;1;2;108
3511508;Cerquilho;3518800;Guarulhos;1;1;2;124
3512407;Cordeirópolis;3518800;Guarulhos;1;1;2;140
3512902;Cosmorama;3518800;Guarulhos;1;1;2;462
3513702;Descalvado;3518800;Guarulhos;1;1;2;201
3515707;Ferraz de Vasconcelos;3518800;Guarulhos;1;1;2;23
3516309;Francisco Morato;3518800;Guarulhos;1;1;2;26
1400100;Boa Vista;3518701;Guarujá;1;1;2;3279
1721000;Palmas;3518701;Guarujá;1;1;2;1518
2111300;São Luís;3518701;Guarujá;1;1;2;2378
2408102;Natal;3518701;Guarujá;1;1;2;2275
2927408;Salvador;3518701;Guarujá;1;1;2;1436
3101508;Além Paraíba;3518701;Guarujá;1;1;2;430
3149309;Pedro Leopoldo;3518701;Guarujá;1;1;2;529
3151008;Piranguinho;3518701;Guarujá;1;1;2;187
3170701;Varginha;3518701;Guarujá;1;1;2;285
3205002;Serra;3518701;Guarujá;1;1;2;734
3300100;Angra dos Reis;3518701;Guarujá;1;1;2;232
3302403;Macaé;3518701;Guarujá;1;1;2;477
3303302;Niterói;3518701;Guarujá;1;1;2;343
3303500;Nova Iguaçu;3518701;Guarujá;1;1;2;313
3304904;São Gonçalo;3518701;Guarujá;1;1;2;350
3501608;Americana;3518701;Guarujá;1;1;2;172
3503208;Araraquara;3518701;Guarujá;1;1;2;307
3503307;Araras;3518701;Guarujá;1;1;2;209
3504503;Avaré;3518701;Guarujá;1;1;2;286
3509700;Campos do Jordão;3518701;Guarujá;1;1;2;154
3510500;Caraguatatuba;3518701;Guarujá;1;1;2;91
3516200;Franca;3518701;Guarujá;1;1;2;395
3104007;Araxá;3518602;Guariba;1;1;2;237
3501707;Américo Brasiliense;3518602;Guariba;1;1;2;42
3507407;Borborema;3518602;Guariba;1;1;2;92
3509502;Campinas;3518602;Guariba;1;1;2;210
3510203;Capão Bonito;3518503;Guareí;1;1;2;73
3511607;Cesário Lange;3518503;Guareí;1;1;2;29
3512308;Conchas;3518503;Guareí;1;1;2;43
1400100;Boa Vista;3518404;Guaratinguetá;1;1;2;3223
1500602;Altamira;3518404;Guaratinguetá;1;1;2;2282
1505536;Parauapebas;3518404;Guaratinguetá;1;1;2;1916
3118601;Contagem;3518404;Guaratinguetá;1;1;2;340
3126109;Formiga;3518404;Guaratinguetá;1;1;2;262
3139904;Maria da Fé;3518404;Guaratinguetá;1;1;2;60
3302254;Itatiaia;3518404;Guaratinguetá;1;1;2;70
3302403;Macaé;3518404;Guaratinguetá;1;1;2;339
3304110;Porto Real;3518404;Guaratinguetá;1;1;2;98
3305554;Seropédica;3518404;Guaratinguetá;1;1;2;150
3306305;Volta Redonda;3518404;Guaratinguetá;1;1;2;115
3507001;Boituva;3518404;Guaratinguetá;1;1;2;262
3509957;Canas;3518404;Guaratinguetá;1;1;2;17
2611606;Recife;3518305;Guararema;1;1;2;2013
2611903;Rio Formoso;3518305;Guararema;1;1;2;1951
2905701;Camaçari;3518305;Guararema;1;1;2;1411
2927408;Salvador;3518305;Guararema;1;1;2;1376
3106705;Betim;3518305;Guararema;1;1;2;426
3147303;Paraisópolis;3518305;Guararema;1;1;2;99
3201209;Cachoeiro de Itapemirim;3518305;Guararema;1;1;2;578
3513702;Descalvado;3518305;Guararema;1;1;2;232
3513801;Diadema;3518305;Guararema;1;1;2;66
3515004;Embu;3518305;Guararema;1;1;2;86
3304557;Rio de Janeiro;3518206;Guararapes;1;1;2;791
3502101;Andradina;3518206;Guararapes;1;1;2;87
3507605;Bragança Paulista;3518206;Guararapes;1;1;2;466
3508108;Buritama;3518206;Guararapes;1;1;2;56
3509502;Campinas;3518206;Guararapes;1;1;2;416
3511003;Castilho;3518206;Guararapes;1;1;2;98
3516200;Franca;3518206;Guararapes;1;1;2;345
3506003;Bauru;3518107;Guarantã;1;1;2;72
3134400;Iturama;3518008;Guarani d'Oeste;1;1;2;41
3515202;Estrela d'Oeste;3518008;Guarani d'Oeste;1;1;2;24
3104007;Araxá;3517901;Guaraci;1;1;2;231
3505500;Barretos;3517901;Guaraci;1;1;2;38
3509304;Cajobi;3517901;Guaraci;1;1;2;45
3511102;Catanduva;3517901;Guaraci;1;1;2;72
3127107;Frutal;3517802;Guaraçaí;1;1;2;252
3500105;Adamantina;3517802;Guaraçaí;1;1;2;74
3502101;Andradina;3517802;Guaraçaí;1;1;2;23
3506102;Bebedouro;3517802;Guaraçaí;1;1;2;277
3104007;Araxá;3517703;Guará;1;1;2;130
3200607;Aracruz;3517703;Guará;1;1;2;789
3504107;Atibaia;3517703;Guará;1;1;2;327
3509254;Cajati;3517703;Guará;1;1;2;476
3517406;Guaíra;3517703;Guará;1;1;2;52
1500503;Almeirim;3517604;Guapiara;1;1;2;2540
3509502;Campinas;3517604;Guapiara;1;1;2;206
3514908;Elias Fausto;3517604;Guapiara;1;1;2;172
3133402;Itapagipe;3517505;Guapiaçu;1;1;2;100
3506102;Bebedouro;3517505;Guapiaçu;1;1;2;72
1506138;Redenção;3517406;Guaíra;1;1;2;1373
2919553;Luís Eduardo magalhães;3517406;Guaíra;1;1;2;944
3104007;Araxá;3517406;Guaíra;1;1;2;163
3111408;Campo Florido;3517406;Guaíra;1;1;2;67
3112604;Capinópolis;3517406;Guaíra;1;1;2;223
3118601;Contagem;3517406;Guaíra;1;1;2;443
3121258;Delta;3517406;Guaíra;1;1;2;66
3147907;Passos;3517406;Guaíra;1;1;2;181
3149804;Perdizes;3517406;Guaíra;1;1;2;150
3150703;Pirajuba;3517406;Guaíra;1;1;2;61
3151602;Planura;3517406;Guaíra;1;1;2;45
3152808;Prata;3517406;Guaíra;1;1;2;131
3170107;Uberaba;3517406;Guaíra;1;1;2;76
3501608;Americana;3517406;Guaíra;1;1;2;287
3505906;Batatais;3517406;Guaíra;1;1;2;96
3509502;Campinas;3517406;Guaíra;1;1;2;315
3512001;Colina;3517406;Guaíra;1;1;2;50
3513504;Cubatão;3517406;Guaíra;1;1;2;443
1302603;Manaus;3517208;Guaiçara;1;1;2;2286
3507753;Brejo Alegre;3517208;Guaiçara;1;1;2;67
3511003;Castilho;3517208;Guaiçara;1;1;2;193
3506508;Birigui;3517109;Glicério;1;1;2;16
3507753;Brejo Alegre;3517109;Glicério;1;1;2;24
3507753;Brejo Alegre;3517000;Getulina;1;1;2;76
3509502;Campinas;3517000;Getulina;1;1;2;322
3502804;Araçatuba;3516903;General Salgado;1;1;2;65
3504800;Bálsamo;3516903;General Salgado;1;1;2;82
3506102;Bebedouro;3516903;General Salgado;1;1;2;192
3509502;Campinas;3516903;General Salgado;1;1;2;427
3501707;Américo Brasiliense;3516853;Gavião Peixoto;1;1;2;43
3509502;Campinas;3516853;Gavião Peixoto;1;1;2;190
2408003;Mossoró;3516705;Garça;1;1;2;2245
2611606;Recife;3516705;Garça;1;1;2;2140
3101607;Alfenas;3516705;Garça;1;1;2;391
3148103;Patrocínio;3516705;Garça;1;1;2;453
3501509;Alvinlândia;3516705;Garça;1;1;2;27
3504503;Avaré;3516705;Garça;1;1;2;122
3505500;Barretos;3516705;Garça;1;1;2;215
3506003;Bauru;3516705;Garça;1;1;2;60
3509502;Campinas;3516705;Garça;1;1;2;278
3511102;Catanduva;3516705;Garça;1;1;2;137
3514502;Duartina;3516705;Garça;1;1;2;33
3516200;Franca;3516705;Garça;1;1;2;296
3502804;Araçatuba;3516507;Gabriel Monteiro;1;1;2;35
3507753;Brejo Alegre;3516507;Gabriel Monteiro;1;1;2;53
3511904;Clementina;3516507;Gabriel Monteiro;1;1;2;11
1500503;Almeirim;3516408;Franco da Rocha;1;1;2;2481
3505708;Barueri;3516408;Franco da Rocha;1;1;2;26
3510609;Carapicuíba;3516408;Franco da Rocha;1;1;2;25
3513009;Cotia;3516408;Franco da Rocha;1;1;2;37
2304400;Fortaleza;3516309;Francisco Morato;1;1;2;2300
2610707;Paulista;3516309;Francisco Morato;1;1;2;2056
2611606;Recife;3516309;Francisco Morato;1;1;2;2037
3304557;Rio de Janeiro;3516309;Francisco Morato;1;1;2;356
3505708;Barueri;3516309;Francisco Morato;1;1;2;32
3509205;Cajamar;3516309;Francisco Morato;1;1;2;19
3509502;Campinas;3516309;Francisco Morato;1;1;2;52
3509601;Campo Limpo Paulista;3516309;Francisco Morato;1;1;2;8
3510609;Carapicuíba;3516309;Francisco Morato;1;1;2;32
3513801;Diadema;3516309;Francisco Morato;1;1;2;48
1100155;Ouro Preto do Oeste;3516200;Franca;1;1;2;1863
1302603;Manaus;3516200;Franca;1;1;2;2308
1721000;Palmas;3516200;Franca;1;1;2;1131
2203909;Floriano;3516200;Franca;1;1;2;1582
2208403;Piripiri;3516200;Franca;1;1;2;1886
2303709;Caucaia;3516200;Franca;1;1;2;2057
2304202;Crato;3516200;Franca;1;1;2;1681
2306405;Itapipoca;3516200;Franca;1;1;2;2042
2307650;Maracanaú;3516200;Franca;1;1;2;2045
2312205;Santa Quitéria;3516200;Franca;1;1;2;1937
2313401;Tianguá;3516200;Franca;1;1;2;1968
2403251;Parnamirim;3516200;Franca;1;1;2;2029
2500601;Alhandra;3516200;Franca;1;1;2;1923
2503704;Cajazeiras;3516200;Franca;1;1;2;1753
2504009;Campina Grande;3516200;Franca;1;1;2;1878
2506301;Guarabira;3516200;Franca;1;1;2;1935
2506905;Itabaiana;3516200;Franca;1;1;2;1903
2508901;Mamanguape;3516200;Franca;1;1;2;1956
2510808;Patos;3516200;Franca;1;1;2;1812
2512101;Pombal;3516200;Franca;1;1;2;1804
2515302;Sapé;3516200;Franca;1;1;2;1931
2516201;Sousa;3516200;Franca;1;1;2;1781
2600054;Abreu e Lima;3516200;Franca;1;1;2;1886
2602902;Cabo de Santo Agostinho;3516200;Franca;1;1;2;1847
2604007;Carpina;3516200;Franca;1;1;2;1868
2606002;Garanhuns;3516200;Franca;1;1;2;1699
2606200;Goiana;3516200;Franca;1;1;2;1907
2607901;Jaboatão dos Guararapes;3516200;Franca;1;1;2;1859
2608909;Limoeiro;3516200;Franca;1;1;2;1851
2614501;Surubim;3516200;Franca;1;1;2;1837
2615300;Timbaúba;3516200;Franca;1;1;2;1891
2616407;Vitória de Santo Antão;3516200;Franca;1;1;2;1842
2702405;Delmiro Gouveia;3516200;Franca;1;1;2;1563
2706307;Palmeira dos Índios;3516200;Franca;1;1;2;1644
2708006;Santana do Ipanema;3516200;Franca;1;1;2;1611
2802106;Estância;3516200;Franca;1;1;2;1442
2805703;Propriá;3516200;Franca;1;1;2;1566
2903201;Barreiras;3516200;Franca;1;1;2;954
2903904;Bom Jesus da Lapa;3516200;Franca;1;1;2;903
2904605;Brumado;3516200;Franca;1;1;2;916
2906501;Candeias;3516200;Franca;1;1;2;1256
2907509;Catu;3516200;Franca;1;1;2;1293
2908408;Conceição do Coité;3516200;Franca;1;1;2;1302
2909802;Cruz das Almas;3516200;Franca;1;1;2;1215
2910701;Euclides da Cunha;3516200;Franca;1;1;2;1399
2910727;Eunápolis;3516200;Franca;1;1;2;927
2911709;Guanambi;3516200;Franca;1;1;2;838
2913903;Ipiaú;3516200;Franca;1;1;2;1065
2914604;Irecê;3516200;Franca;1;1;2;1163
2915601;Itamaraju;3516200;Franca;1;1;2;902
2916401;Itapetinga;3516200;Franca;1;1;2;937
2917607;Jaguaquara;3516200;Franca;1;1;2;1088
2918407;Juazeiro;3516200;Franca;1;1;2;1410
2919207;Lauro de Freitas;3516200;Franca;1;1;2;1256
2924009;Paulo Afonso;3516200;Franca;1;1;2;1538
2925303;Porto Seguro;3516200;Franca;1;1;2;966
2926608;Ribeira do Pombal;3516200;Franca;1;1;2;1403
2928604;Santo Amaro;3516200;Franca;1;1;2;1253
2928703;Santo Antônio de Jesus;3516200;Franca;1;1;2;1179
2930105;Senhor do Bonfim;3516200;Franca;1;1;2;1336
2930501;Serrinha;3516200;Franca;1;1;2;1304
2931350;Teixeira de Freitas;3516200;Franca;1;1;2;861
2933604;Xique-Xique;3516200;Franca;1;1;2;1178
3101904;Alpinópolis;3516200;Franca;1;1;2;112
3102605;Andradas;3516200;Franca;1;1;2;191
3103504;Araguari;3516200;Franca;1;1;2;226
3104205;Arcos;3516200;Franca;1;1;2;196
3105608;Barbacena;3516200;Franca;1;1;2;384
3106705;Betim;3516200;Franca;1;1;2;341
3107109;Boa Esperança;3516200;Franca;1;1;2;202
3112406;Capetinga;3516200;Franca;1;1;2;38
3113404;Caratinga;3516200;Franca;1;1;2;547
3115300;Cataguases;3516200;Franca;1;1;2;503
3118304;Conselheiro Lafaiete;3516200;Franca;1;1;2;374
3119401;Coronel Fabriciano;3516200;Franca;1;1;2;509
3122306;Divinópolis;3516200;Franca;1;1;2;266
3126109;Formiga;3516200;Franca;1;1;2;207
3129509;Ibiá;3516200;Franca;1;1;2;152
3131307;Ipatinga;3516200;Franca;1;1;2;519
3131703;Itabira;3516200;Franca;1;1;2;444
3131901;Itabirito;3516200;Franca;1;1;2;373
3132404;Itajubá;3516200;Franca;1;1;2;290
3133808;Itaúna;3516200;Franca;1;1;2;297
3134202;Ituiutaba;3516200;Franca;1;1;2;275
3135100;Janaúba;3516200;Franca;1;1;2;671
3136207;João Monlevade;3516200;Franca;1;1;2;448
3136306;João Pinheiro;3516200;Franca;1;1;2;332
3137205;Lagoa da Prata;3516200;Franca;1;1;2;203
3137601;Lagoa Santa;3516200;Franca;1;1;2;379
3138203;Lavras;3516200;Franca;1;1;2;262
3139409;Manhuaçu;3516200;Franca;1;1;2;558
3143203;Monte Santo de Minas;3516200;Franca;1;1;2;80
3143302;Montes Claros;3516200;Franca;1;1;2;557
3143906;Muriaé;3516200;Franca;1;1;2;533
3144102;Muzambinho;3516200;Franca;1;1;2;130
3147006;Paracatu;3516200;Franca;1;1;2;370
3149705;Perdigão;3516200;Franca;1;1;2;250
3152105;Ponte Nova;3516200;Franca;1;1;2;469
3152501;Pouso Alegre;3516200;Franca;1;1;2;240
3152808;Prata;3516200;Franca;1;1;2;213
3157807;Santa Luzia;3516200;Franca;1;1;2;380
3159605;Santa Rita do Sapucaí;3516200;Franca;1;1;2;260
3162104;São Gotardo;3516200;Franca;1;1;2;196
3162500;São João del Rei;3516200;Franca;1;1;2;332
3163706;São Lourenço;3516200;Franca;1;1;2;305
3167202;Sete Lagoas;3516200;Franca;1;1;2;351
3168606;Teófilo Otoni;3516200;Franca;1;1;2;678
3169307;Três Corações;3516200;Franca;1;1;2;260
3169901;Ubá;3516200;Franca;1;1;2;466
3171204;Vespasiano;3516200;Franca;1;1;2;373
3301009;Campos dos Goytacazes;3516200;Franca;1;1;2;652
3500105;Adamantina;3516200;Franca;1;1;2;406
3500303;Aguaí;3516200;Franca;1;1;2;174
3500709;Agudos;3516200;Franca;1;1;2;273
3501608;Americana;3516200;Franca;1;1;2;244
3501707;Américo Brasiliense;3516200;Franca;1;1;2;150
3502101;Andradina;3516200;Franca;1;1;2;420
3504206;Auriflama;3516200;Franca;1;1;2;329
3504503;Avaré;3516200;Franca;1;1;2;325
3505609;Barrinha;3516200;Franca;1;1;2;107
3505807;Bastos;3516200;Franca;1;1;2;381
3506805;Bocaina;3516200;Franca;1;1;2;212
3507001;Boituva;3516200;Franca;1;1;2;305
3507308;Boracéia;3516200;Franca;1;1;2;233
3507605;Bragança Paulista;3516200;Franca;1;1;2;281
3509007;Caieiras;3516200;Franca;1;1;2;320
3510005;Cândido Mota;3516200;Franca;1;1;2;397
3510401;Capivari;3516200;Franca;1;1;2;272
3510609;Carapicuíba;3516200;Franca;1;1;2;336
3510807;Casa Branca;3516200;Franca;1;1;2;141
3511102;Catanduva;3516200;Franca;1;1;2;178
3513009;Cotia;3516200;Franca;1;1;2;343
3513108;Cravinhos;3516200;Franca;1;1;2;95
3513405;Cruzeiro;3516200;Franca;1;1;2;341
3514106;Dois Córregos;3516200;Franca;1;1;2;226
3514403;Dracena;3516200;Franca;1;1;2;447
3515509;Fernandópolis;3516200;Franca;1;1;2;298
3515707;Ferraz de Vasconcelos;3516200;Franca;1;1;2;350
3513306;Cruzália;3516101;Florínia;1;1;2;18
3505708;Barueri;3516002;Flórida Paulista;1;1;2;495
2601904;Bezerros;3515707;Ferraz de Vasconcelos;1;1;2;1986
2905701;Camaçari;3515707;Ferraz de Vasconcelos;1;1;2;1440
3304557;Rio de Janeiro;3515707;Ferraz de Vasconcelos;1;1;2;325
3505708;Barueri;3515707;Ferraz de Vasconcelos;1;1;2;52
3513801;Diadema;3515707;Ferraz de Vasconcelos;1;1;2;30
1505536;Parauapebas;3515608;Fernando Prestes;1;1;2;1692
3145901;Ouro Branco;3515608;Fernando Prestes;1;1;2;523
3205002;Serra;3515608;Fernando Prestes;1;1;2;876
3306305;Volta Redonda;3515608;Fernando Prestes;1;1;2;497
3503703;Ariranha;3515608;Fernando Prestes;1;1;2;14
3509205;Cajamar;3515608;Fernando Prestes;1;1;2;299
3513504;Cubatão;3515608;Fernando Prestes;1;1;2;375
2919553;Luís Eduardo magalhães;3515509;Fernandópolis;1;1;2;1012
3127107;Frutal;3515509;Fernandópolis;1;1;2;134
3170206;Uberlândia;3515509;Fernandópolis;1;1;2;256
3502754;Araçariguama;3515509;Fernandópolis;1;1;2;486
3504206;Auriflama;3515509;Fernandópolis;1;1;2;55
3506003;Bauru;3515509;Fernandópolis;1;1;2;259
3506102;Bebedouro;3515509;Fernandópolis;1;1;2;193
3508108;Buritama;3515509;Fernandópolis;1;1;2;88
3508702;Caconde;3515509;Fernandópolis;1;1;2;403
3509205;Cajamar;3515509;Fernandópolis;1;1;2;493
3510708;Cardoso;3515509;Fernandópolis;1;1;2;37
3504503;Avaré;3515400;Fartura;1;1;2;67
3506300;Bernardino de Campos;3515400;Fartura;1;1;2;42
3511409;Cerqueira César;3515400;Fartura;1;1;2;52
3170438;União de Minas;3515202;Estrela d'Oeste;1;1;2;84
3205002;Serra;3515202;Estrela d'Oeste;1;1;2;1054
3513009;Cotia;3515202;Estrela d'Oeste;1;1;2;520
2927408;Salvador;3515186;Espírito Santo do Pinhal;1;1;2;1314
2933307;Vitória da Conquista;3515186;Espírito Santo do Pinhal;1;1;2;1006
3111002;Campestre;3515186;Espírito Santo do Pinhal;1;1;2;74
3112406;Capetinga;3515186;Espírito Santo do Pinhal;1;1;2;177
3128105;Guapé;3515186;Espírito Santo do Pinhal;1;1;2;179
3139003;Machado;3515186;Espírito Santo do Pinhal;1;1;2;102
3139409;Manhuaçu;3515186;Espírito Santo do Pinhal;1;1;2;526
3147303;Paraisópolis;3515186;Espírito Santo do Pinhal;1;1;2;107
3155504;Rio Paranaíba;3515186;Espírito Santo do Pinhal;1;1;2;336
3169406;Três Pontas;3515186;Espírito Santo do Pinhal;1;1;2;155
3205002;Serra;3515186;Espírito Santo do Pinhal;1;1;2;697
3501608;Americana;3515186;Espírito Santo do Pinhal;1;1;2;86
3508702;Caconde;3515186;Espírito Santo do Pinhal;1;1;2;74
3510807;Casa Branca;3515186;Espírito Santo do Pinhal;1;1;2;58
3303401;Nova Friburgo;3515152;Engenheiro Coelho;1;1;2;477
3512209;Conchal;3515152;Engenheiro Coelho;1;1;2;18
2611606;Recife;3515103;Embu-Guaçu;1;1;2;2090
3152501;Pouso Alegre;3515103;Embu-Guaçu;1;1;2;199
3304557;Rio de Janeiro;3515103;Embu-Guaçu;1;1;2;375
3508009;Buri;3515103;Embu-Guaçu;1;1;2;182
3513801;Diadema;3515103;Embu-Guaçu;1;1;2;26
1500800;Ananindeua;3515004;Embu;1;1;2;2469
1504422;Marituba;3515004;Embu;1;1;2;2470
2403251;Parnamirim;3515004;Embu;1;1;2;2265
2507507;João Pessoa;3515004;Embu;1;1;2;2166
2704302;Maceió;3515004;Embu;1;1;2;1895
2800308;Aracaju;3515004;Embu;1;1;2;1708
2910727;Eunápolis;3515004;Embu;1;1;2;1083
2910800;Feira de Santana;3515004;Embu;1;1;2;1479
2930709;Simões Filho;3515004;Embu;1;1;2;1463
3118601;Contagem;3515004;Embu;1;1;2;498
3125101;Extrema;3515004;Embu;1;1;2;103
3152501;Pouso Alegre;3515004;Embu;1;1;2;183
3171204;Vespasiano;3515004;Embu;1;1;2;527
3205002;Serra;3515004;Embu;1;1;2;766
3301702;Duque de Caxias;3515004;Embu;1;1;2;373
3302403;Macaé;3515004;Embu;1;1;2;523
3303500;Nova Iguaçu;3515004;Embu;1;1;2;358
3500709;Agudos;3515004;Embu;1;1;2;253
3501608;Americana;3515004;Embu;1;1;2;112
3503307;Araras;3515004;Embu;1;1;2;153
3507506;Botucatu;3515004;Embu;1;1;2;183
3509254;Cajati;3515004;Embu;1;1;2;176
3513504;Cubatão;3515004;Embu;1;1;2;51
3503703;Ariranha;3514957;Embaúba;1;1;2;25
3511102;Catanduva;3514957;Embaúba;1;1;2;23
3503703;Ariranha;3514924;Elisiário;1;1;2;34
3205309;Vitória;3514908;Elias Fausto;1;1;2;781
3509502;Campinas;3514908;Elias Fausto;1;1;2;36
3513801;Diadema;3514908;Elias Fausto;1;1;2;105
3513900;Divinolândia;3514908;Elias Fausto;1;1;2;166
3509502;Campinas;3514809;Eldorado;1;1;2;208
3509908;Cananéia;3514809;Eldorado;1;1;2;59
3513009;Cotia;3514809;Eldorado;1;1;2;157
3504008;Assis;3514700;Echaporã;1;1;2;36
3507803;Brodowski;3514601;Dumont;1;1;2;42
3514007;Dobrada;3514601;Dumont;1;1;2;54
3504008;Assis;3514502;Duartina;1;1;2;111
3509502;Campinas;3514502;Duartina;1;1;2;248
1200401;Rio Branco;3514403;Dracena;1;1;2;2075
3200607;Aracruz;3514403;Dracena;1;1;2;1177
3502804;Araçatuba;3514403;Dracena;1;1;2;118
3504008;Assis;3514403;Dracena;1;1;2;171
3513009;Cotia;3514403;Dracena;1;1;2;536
3170206;Uberlândia;3514304;Dourado;1;1;2;354
3506706;Boa Esperança do Sul;3514304;Dourado;1;1;2;14
3506805;Bocaina;3514304;Dourado;1;1;2;21
3509502;Campinas;3514304;Dourado;1;1;2;158
3170107;Uberaba;3514106;Dois Córregos;1;1;2;294
3500709;Agudos;3514106;Dois Córregos;1;1;2;65
3503208;Araraquara;3514106;Dois Córregos;1;1;2;68
3506003;Bauru;3514106;Dois Córregos;1;1;2;72
3509502;Campinas;3514106;Dois Córregos;1;1;2;149
3104007;Araxá;3513900;Divinolândia;1;1;2;231
3156908;Sacramento;3513900;Divinolândia;1;1;2;212
3510807;Casa Branca;3513900;Divinolândia;1;1;2;38
2408003;Mossoró;3513801;Diadema;1;1;2;2237
2616407;Vitória de Santo Antão;3513801;Diadema;1;1;2;2048
2800308;Aracaju;3513801;Diadema;1;1;2;1698
2910057;Dias d'Ávila;3513801;Diadema;1;1;2;1475
2913606;Ilhéus;3513801;Diadema;1;1;2;1233
2930709;Simões Filho;3513801;Diadema;1;1;2;1453
3117801;Conceição dos Ouros;3513801;Diadema;1;1;2;163
3131307;Ipatinga;3513801;Diadema;1;1;2;621
3133600;Itapeva;3513801;Diadema;1;1;2;109
3137601;Lagoa Santa;3513801;Diadema;1;1;2;526
3138203;Lavras;3513801;Diadema;1;1;2;317
3140704;Mateus Leme;3513801;Diadema;1;1;2;465
3147303;Paraisópolis;3513801;Diadema;1;1;2;151
3152501;Pouso Alegre;3513801;Diadema;1;1;2;176
3157807;Santa Luzia;3513801;Diadema;1;1;2;515
3167202;Sete Lagoas;3513801;Diadema;1;1;2;527
3170107;Uberaba;3513801;Diadema;1;1;2;455
3170206;Uberlândia;3513801;Diadema;1;1;2;555
3201308;Cariacica;3513801;Diadema;1;1;2;729
3205101;Viana;3513801;Diadema;1;1;2;710
3205309;Vitória;3513801;Diadema;1;1;2;741
3301306;Casimiro de Abreu;3513801;Diadema;1;1;2;468
3301702;Duque de Caxias;3513801;Diadema;1;1;2;351
3301900;Itaboraí;3513801;Diadema;1;1;2;396
3302254;Itatiaia;3513801;Diadema;1;1;2;245
3302403;Macaé;3513801;Diadema;1;1;2;501
3304110;Porto Real;3513801;Diadema;1;1;2;273
3304904;São Gonçalo;3513801;Diadema;1;1;2;374
3502804;Araçatuba;3513801;Diadema;1;1;2;474
3503109;Arandu;3513801;Diadema;1;1;2;255
3503307;Araras;3513801;Diadema;1;1;2;166
3504107;Atibaia;3513801;Diadema;1;1;2;63
3508405;Cabreúva;3513801;Diadema;1;1;2;67
3508504;Caçapava;3513801;Diadema;1;1;2;113
3513504;Cubatão;3513801;Diadema;1;1;2;31
2613701;São Lourenço da Mata;3513702;Descalvado;1;1;2;1985
3106705;Betim;3513702;Descalvado;1;1;2;413
3118601;Contagem;3513702;Descalvado;1;1;2;424
3133808;Itaúna;3513702;Descalvado;1;1;2;370
3162500;São João del Rei;3513702;Descalvado;1;1;2;353
3205309;Vitória;3513702;Descalvado;1;1;2;774
3300407;Barra Mansa;3513702;Descalvado;1;1;2;361
3500303;Aguaí;3513702;Descalvado;1;1;2;68
3502002;Analândia;3513702;Descalvado;1;1;2;25
3507902;Brotas;3513702;Descalvado;1;1;2;67
3512209;Conchal;3513702;Descalvado;1;1;2;66
3512407;Cordeirópolis;3513702;Descalvado;1;1;2;66
3502507;Aparecida;3513603;Cunha;1;1;2;37
1302603;Manaus;3513504;Cubatão;1;1;2;2652
2304285;Eusébio;3513504;Cubatão;1;1;2;2345
2408102;Natal;3513504;Cubatão;1;1;2;2277
2905701;Camaçari;3513504;Cubatão;1;1;2;1474
2927408;Salvador;3513504;Cubatão;1;1;2;1439
3104205;Arcos;3513504;Cubatão;1;1;2;409
3106705;Betim;3513504;Cubatão;1;1;2;490
3109006;Brumadinho;3513504;Cubatão;1;1;2;472
3127107;Frutal;3513504;Cubatão;1;1;2;491
3136207;João Monlevade;3513504;Cubatão;1;1;2;558
3138203;Lavras;3513504;Cubatão;1;1;2;328
3147006;Paracatu;3513504;Cubatão;1;1;2;739
3165537;Sarzedo;3513504;Cubatão;1;1;2;485
3170206;Uberlândia;3513504;Cubatão;1;1;2;583
3205002;Serra;3513504;Cubatão;1;1;2;743
3205101;Viana;3513504;Cubatão;1;1;2;704
3300308;Barra do Piraí;3513504;Cubatão;1;1;2;307
3300407;Barra Mansa;3513504;Cubatão;1;1;2;271
3304201;Resende;3513504;Cubatão;1;1;2;252
3500303;Aguaí;3513504;Cubatão;1;1;2;211
3501608;Americana;3513504;Cubatão;1;1;2;158
3502754;Araçariguama;3513504;Cubatão;1;1;2;82
3502804;Araçatuba;3513504;Cubatão;1;1;2;503
3503901;Arujá;3513504;Cubatão;1;1;2;57
3506359;Bertioga;3513504;Cubatão;1;1;2;29
3507001;Boituva;3513504;Cubatão;1;1;2;144
3509205;Cajamar;3513504;Cubatão;1;1;2;75
3509254;Cajati;3513504;Cubatão;1;1;2;196
3509601;Campo Limpo Paulista;3513504;Cubatão;1;1;2;85
3510609;Carapicuíba;3513504;Cubatão;1;1;2;59
3513009;Cotia;3513504;Cubatão;1;1;2;60
3513405;Cruzeiro;3513504;Cubatão;1;1;2;208
1504208;Marabá;3513405;Cruzeiro;1;1;2;1947
1505536;Parauapebas;3513405;Cruzeiro;1;1;2;1896
2111300;São Luís;3513405;Cruzeiro;1;1;2;2218
2611606;Recife;3513405;Cruzeiro;1;1;2;1883
3106200;Belo Horizonte;3513405;Cruzeiro;1;1;2;313
3106705;Betim;3513405;Cruzeiro;1;1;2;300
3118601;Contagem;3513405;Cruzeiro;1;1;2;308
3122306;Divinópolis;3513405;Cruzeiro;1;1;2;268
3132404;Itajubá;3513405;Cruzeiro;1;1;2;55
3133105;Itanhandu;3513405;Cruzeiro;1;1;2;31
3152501;Pouso Alegre;3513405;Cruzeiro;1;1;2;109
3170206;Uberlândia;3513405;Cruzeiro;1;1;2;527
3170701;Varginha;3513405;Cruzeiro;1;1;2;127
3203205;Linhares;3513405;Cruzeiro;1;1;2;615
3205309;Vitória;3513405;Cruzeiro;1;1;2;540
3301009;Campos dos Goytacazes;3513405;Cruzeiro;1;1;2;383
3301702;Duque de Caxias;3513405;Cruzeiro;1;1;2;171
3303500;Nova Iguaçu;3513405;Cruzeiro;1;1;2;155
3502507;Aparecida;3513405;Cruzeiro;1;1;2;41
3508702;Caconde;3513405;Cruzeiro;1;1;2;208
3510609;Carapicuíba;3513405;Cruzeiro;1;1;2;220
3104007;Araxá;3513207;Cristais Paulista;1;1;2;102
3505906;Batatais;3513207;Cristais Paulista;1;1;2;58
3507803;Brodowski;3513207;Cristais Paulista;1;1;2;70
2100055;Açailândia;3513108;Cravinhos;1;1;2;1812
2111300;São Luís;3513108;Cravinhos;1;1;2;2109
2704302;Maceió;3513108;Cravinhos;1;1;2;1769
3104007;Araxá;3513108;Cravinhos;1;1;2;210
3108206;Bonfinópolis de Minas;3513108;Cravinhos;1;1;2;557
3118601;Contagem;3513108;Cravinhos;1;1;2;408
3128709;Guaxupé;3513108;Cravinhos;1;1;2;105
3304508;Rio das Flores;3513108;Cravinhos;1;1;2;441
3503208;Araraquara;3513108;Cravinhos;1;1;2;67
3503802;Artur Nogueira;3513108;Cravinhos;1;1;2;148
3505906;Batatais;3513108;Cravinhos;1;1;2;51
3507803;Brodowski;3513108;Cravinhos;1;1;2;39
1505536;Parauapebas;3513009;Cotia;1;1;2;1968
2111300;São Luís;3513009;Cotia;1;1;2;2345
2200806;Antônio Almeida;3513009;Cotia;1;1;2;1832
2500601;Alhandra;3513009;Cotia;1;1;2;2140
2610509;Passira;3513009;Cotia;1;1;2;2053
2900702;Alagoinhas;3513009;Cotia;1;1;2;1521
2925303;Porto Seguro;3513009;Cotia;1;1;2;1111
2926608;Ribeira do Pombal;3513009;Cotia;1;1;2;1637
2928703;Santo Antônio de Jesus;3513009;Cotia;1;1;2;1398
3104007;Araxá;3513009;Cotia;1;1;2;445
3105608;Barbacena;3513009;Cotia;1;1;2;413
3113404;Caratinga;3513009;Cotia;1;1;2;634
3115300;Cataguases;3513009;Cotia;1;1;2;495
3117801;Conceição dos Ouros;3513009;Cotia;1;1;2;174
3119401;Coronel Fabriciano;3513009;Cotia;1;1;2;626
3120904;Curvelo;3513009;Cotia;1;1;2;590
3122306;Divinópolis;3513009;Cotia;1;1;2;433
3127107;Frutal;3513009;Cotia;1;1;2;439
3127701;Governador Valadares;3513009;Cotia;1;1;2;726
3131307;Ipatinga;3513009;Cotia;1;1;2;635
3136702;Juiz de Fora;3513009;Cotia;1;1;2;417
3143302;Montes Claros;3513009;Cotia;1;1;2;819
3143906;Muriaé;3513009;Cotia;1;1;2;541
3147907;Passos;3513009;Cotia;1;1;2;322
3148103;Patrocínio;3513009;Cotia;1;1;2;515
3151206;Pirapora;3513009;Cotia;1;1;2;724
3151800;Poços de Caldas;3513009;Cotia;1;1;2;207
3156007;Rio Vermelho;3513009;Cotia;1;1;2;707
3163706;São Lourenço;3513009;Cotia;1;1;2;253
3168705;Timóteo;3513009;Cotia;1;1;2;619
3169901;Ubá;3513009;Cotia;1;1;2;486
3170107;Uberaba;3513009;Cotia;1;1;2;439
3170701;Varginha;3513009;Cotia;1;1;2;279
3201209;Cachoeiro de Itapemirim;3513009;Cotia;1;1;2;665
3201308;Cariacica;3513009;Cotia;1;1;2;751
3201506;Colatina;3513009;Cotia;1;1;2;776
3202405;Guarapari;3513009;Cotia;1;1;2;721
3205002;Serra;3513009;Cotia;1;1;2;770
3300100;Angra dos Reis;3513009;Cotia;1;1;2;278
3300209;Araruama;3513009;Cotia;1;1;2;472
3300308;Barra do Piraí;3513009;Cotia;1;1;2;339
3300704;Cabo Frio;3513009;Cotia;1;1;2;500
3301009;Campos dos Goytacazes;3513009;Cotia;1;1;2;602
3301900;Itaboraí;3513009;Cotia;1;1;2;424
3302205;Itaperuna;3513009;Cotia;1;1;2;577
3302502;Magé;3513009;Cotia;1;1;2;406
3302700;Maricá;3513009;Cotia;1;1;2;424
3303500;Nova Iguaçu;3513009;Cotia;1;1;2;363
3303807;Parati;3513009;Cotia;1;1;2;228
3304144;Queimados;3513009;Cotia;1;1;2;353
3304201;Resende;3513009;Cotia;1;1;2;278
3304300;Rio Bonito;3513009;Cotia;1;1;2;448
3305109;São João de Meriti;3513009;Cotia;1;1;2;371
3305505;Saquarema;3513009;Cotia;1;1;2;461
3306008;Três Rios;3513009;Cotia;1;1;2;411
3502101;Andradina;3513009;Cotia;1;1;2;541
3502804;Araçatuba;3513009;Cotia;1;1;2;445
3503901;Arujá;3513009;Cotia;1;1;2;65
3504008;Assis;3513009;Cotia;1;1;2;373
3506359;Bertioga;3513009;Cotia;1;1;2;82
3507001;Boituva;3513009;Cotia;1;1;2;85
3507506;Botucatu;3513009;Cotia;1;1;2;175
3507605;Bragança Paulista;3513009;Cotia;1;1;2;82
3509007;Caieiras;3513009;Cotia;1;1;2;32
3510203;Capão Bonito;3513009;Cotia;1;1;2;153
3511102;Catanduva;3513009;Cotia;1;1;2;343
3508108;Buritama;3512902;Cosmorama;1;1;2;76
2111201;São José de Ribamar;3512803;Cosmópolis;1;1;2;2247
2803609;Laranjeiras;3512803;Cosmópolis;1;1;2;1647
2930709;Simões Filho;3512803;Cosmópolis;1;1;2;1401
3104007;Araxá;3512803;Cosmópolis;1;1;2;340
3106200;Belo Horizonte;3512803;Cosmópolis;1;1;2;447
3118601;Contagem;3512803;Cosmópolis;1;1;2;438
3148004;Patos de Minas;3512803;Cosmópolis;1;1;2;456
3205002;Serra;3512803;Cosmópolis;1;1;2;755
3302403;Macaé;3512803;Cosmópolis;1;1;2;545
3500303;Aguaí;3512803;Cosmópolis;1;1;2;69
3505708;Barueri;3512803;Cosmópolis;1;1;2;101
3170206;Uberlândia;3512704;Corumbataí;1;1;2;373
3506102;Bebedouro;3512704;Corumbataí;1;1;2;170
3505302;Barra Bonita;3512506;Coroados;1;1;2;220
3507753;Brejo Alegre;3512506;Coroados;1;1;2;22
3508108;Buritama;3512506;Coroados;1;1;2;35
3103504;Araguari;3512407;Cordeirópolis;1;1;2;432
3140704;Mateus Leme;3512407;Cordeirópolis;1;1;2;415
3146107;Ouro Preto;3512407;Cordeirópolis;1;1;2;463
3156908;Sacramento;3512407;Cordeirópolis;1;1;2;291
3170206;Uberlândia;3512407;Cordeirópolis;1;1;2;405
3503208;Araraquara;3512407;Cordeirópolis;1;1;2;106
3501608;Americana;3512308;Conchas;1;1;2;76
3502200;Angatuba;3512308;Conchas;1;1;2;67
3509502;Campinas;3512308;Conchas;1;1;2;99
3511508;Cerquilho;3512308;Conchas;1;1;2;32
1721000;Palmas;3512209;Conchal;1;1;2;1330
2704302;Maceió;3512209;Conchal;1;1;2;1807
2909802;Cruz das Almas;3512209;Conchal;1;1;2;1339
3500303;Aguaí;3512209;Conchal;1;1;2;36
3502804;Araçatuba;3512209;Conchal;1;1;2;359
3503208;Araraquara;3512209;Conchal;1;1;2;119
3503802;Artur Nogueira;3512209;Conchal;1;1;2;27
3505708;Barueri;3512209;Conchal;1;1;2;134
3170206;Uberlândia;3512100;Colômbia;1;1;2;151
3505500;Barretos;3512100;Colômbia;1;1;2;40
3506102;Bebedouro;3512100;Colômbia;1;1;2;82
3104007;Araxá;3512001;Colina;1;1;2;207
3509304;Cajobi;3512001;Colina;1;1;2;33
3507704;Braúna;3511904;Clementina;1;1;2;15
3170206;Uberlândia;3511607;Cesário Lange;1;1;2;480
3304557;Rio de Janeiro;3511607;Cesário Lange;1;1;2;481
3510401;Capivari;3511607;Cesário Lange;1;1;2;52
2304400;Fortaleza;3511508;Cerquilho;1;1;2;2327
3147204;Paraguaçu;3511508;Cerquilho;1;1;2;272
3501608;Americana;3511508;Cerquilho;1;1;2;63
3509502;Campinas;3511508;Cerquilho;1;1;2;76
3510401;Capivari;3511508;Cerquilho;1;1;2;31
1302603;Manaus;3511409;Cerqueira César;1;1;2;2448
1501402;Belém;3511409;Cerqueira César;1;1;2;2396
1721000;Palmas;3511409;Cerqueira César;1;1;2;1405
2105302;Imperatriz;3511409;Cerqueira César;1;1;2;1946
2111300;São Luís;3511409;Cerqueira César;1;1;2;2319
2307304;Juazeiro do Norte;3511409;Cerqueira César;1;1;2;2000
2408102;Natal;3511409;Cerqueira César;1;1;2;2345
2507507;João Pessoa;3511409;Cerqueira César;1;1;2;2249
2704302;Maceió;3511409;Cerqueira César;1;1;2;1989
2914802;Itabuna;3511409;Cerqueira César;1;1;2;1345
2933307;Vitória da Conquista;3511409;Cerqueira César;1;1;2;1229
3136702;Juiz de Fora;3511409;Cerqueira César;1;1;2;612
3303302;Niterói;3511409;Cerqueira César;1;1;2;622
3500550;Águas de Santa Bárbara;3511409;Cerqueira César;1;1;2;19
3504503;Avaré;3511409;Cerqueira César;1;1;2;25
3503703;Ariranha;3511300;Cedral;1;1;2;59
3503703;Ariranha;3511201;Catiguá;1;1;2;32
1508126;Ulianópolis;3511102;Catanduva;1;1;2;1931
1721000;Palmas;3511102;Catanduva;1;1;2;1195
2101400;Balsas;3511102;Catanduva;1;1;2;1538
3106200;Belo Horizonte;3511102;Catanduva;1;1;2;536
3136702;Juiz de Fora;3511102;Catanduva;1;1;2;592
3170107;Uberaba;3511102;Catanduva;1;1;2;191
3303302;Niterói;3511102;Catanduva;1;1;2;644
3500907;Altair;3511102;Catanduva;1;1;2;69
3504008;Assis;3511102;Catanduva;1;1;2;227
3504206;Auriflama;3511102;Catanduva;1;1;2;171
3507605;Bragança Paulista;3511102;Catanduva;1;1;2;323
3510104;Cândido Rodrigues;3511102;Catanduva;1;1;2;42
1100023;Ariquemes;3511003;Castilho;1;1;2;1682
3502101;Andradina;3511003;Castilho;1;1;2;11
3503208;Araraquara;3511003;Castilho;1;1;2;361
2914802;Itabuna;3510906;Cássia dos Coqueiros;1;1;2;1078
3170206;Uberlândia;3510906;Cássia dos Coqueiros;1;1;2;287
3104007;Araxá;3510807;Casa Branca;1;1;2;242
3201209;Cachoeiro de Itapemirim;3510807;Casa Branca;1;1;2;627
3304557;Rio de Janeiro;3510807;Casa Branca;1;1;2;415
3504602;Bady Bassitt;3510807;Casa Branca;1;1;2;261
3508108;Buritama;3510807;Casa Branca;1;1;2;325
3508702;Caconde;3510807;Casa Branca;1;1;2;53
3509007;Caieiras;3510807;Casa Branca;1;1;2;180
3509205;Cajamar;3510807;Casa Branca;1;1;2;177
3509502;Campinas;3510807;Casa Branca;1;1;2;125
3104007;Araxá;3510708;Cardoso;1;1;2;319
3504800;Bálsamo;3510708;Cardoso;1;1;2;82
3508108;Buritama;3510708;Cardoso;1;1;2;111
3509502;Campinas;3510708;Cardoso;1;1;2;437
1100122;Ji-Paraná;3510609;Carapicuíba;1;1;2;2036
1501303;Barcarena;3510609;Carapicuíba;1;1;2;2441
1501402;Belém;3510609;Carapicuíba;1;1;2;2454
2602902;Cabo de Santo Agostinho;3510609;Carapicuíba;1;1;2;2046
2611101;Petrolina;3510609;Carapicuíba;1;1;2;1691
2905701;Camaçari;3510609;Carapicuíba;1;1;2;1464
2910800;Feira de Santana;3510609;Carapicuíba;1;1;2;1466
3110608;Cambuí;3510609;Carapicuíba;1;1;2;127
3131307;Ipatinga;3510609;Carapicuíba;1;1;2;623
3301702;Duque de Caxias;3510609;Carapicuíba;1;1;2;368
3302403;Macaé;3510609;Carapicuíba;1;1;2;518
3303500;Nova Iguaçu;3510609;Carapicuíba;1;1;2;353
3306305;Volta Redonda;3510609;Carapicuíba;1;1;2;301
3502804;Araçatuba;3510609;Carapicuíba;1;1;2;446
3509007;Caieiras;3510609;Carapicuíba;1;1;2;20
3509205;Cajamar;3510609;Carapicuíba;1;1;2;19
3509502;Campinas;3510609;Carapicuíba;1;1;2;73
2927408;Salvador;3510500;Caraguatatuba;1;1;2;1363
3205309;Vitória;3510500;Caraguatatuba;1;1;2;639
3300100;Angra dos Reis;3510500;Caraguatatuba;1;1;2;142
3506102;Bebedouro;3510500;Caraguatatuba;1;1;2;430
3507605;Bragança Paulista;3510500;Caraguatatuba;1;1;2;134
3509502;Campinas;3510500;Caraguatatuba;1;1;2;181
1501808;Breves;3510401;Capivari;1;1;2;2381
2309607;Pacajus;3510401;Capivari;1;1;2;2263
3133758;Itaú de Minas;3510401;Capivari;1;1;2;260
3143302;Montes Claros;3510401;Capivari;1;1;2;784
3152501;Pouso Alegre;3510401;Capivari;1;1;2;181
3159605;Santa Rita do Sapucaí;3510401;Capivari;1;1;2;202
3200706;Atilio Vivacqua;3510401;Capivari;1;1;2;682
3500709;Agudos;3510401;Capivari;1;1;2;163
3502309;Anhembi;3510401;Capivari;1;1;2;69
3503208;Araraquara;3510401;Capivari;1;1;2;150
3503307;Araras;3510401;Capivari;1;1;2;72
3503802;Artur Nogueira;3510401;Capivari;1;1;2;58
3507605;Bragança Paulista;3510401;Capivari;1;1;2;98
3502903;Araçoiaba da Serra;3510302;Capela do Alto;1;1;2;13
3503208;Araraquara;3510302;Capela do Alto;1;1;2;192
3151800;Poços de Caldas;3510203;Capão Bonito;1;1;2;308
3205200;Vila Velha;3510203;Capão Bonito;1;1;2;899
3304201;Resende;3510203;Capão Bonito;1;1;2;428
3503208;Araraquara;3510203;Capão Bonito;1;1;2;247
3503901;Arujá;3510203;Capão Bonito;1;1;2;217
3504008;Assis;3510203;Capão Bonito;1;1;2;259
3505708;Barueri;3510203;Capão Bonito;1;1;2;159
3507506;Botucatu;3510203;Capão Bonito;1;1;2;126
3509452;Campina do Monte Alegre;3509908;Cananéia;1;1;2;168
3509502;Campinas;3509908;Cananéia;1;1;2;253
1302603;Manaus;3509700;Campos do Jordão;1;1;2;2593
2304400;Fortaleza;3509700;Campos do Jordão;1;1;2;2208
2927408;Salvador;3509700;Campos do Jordão;1;1;2;1289
3105608;Barbacena;3509700;Campos do Jordão;1;1;2;248
3106200;Belo Horizonte;3509700;Campos do Jordão;1;1;2;352
3132404;Itajubá;3509700;Campos do Jordão;1;1;2;36
3143401;Monte Sião;3509700;Campos do Jordão;1;1;2;107
3163706;São Lourenço;3509700;Campos do Jordão;1;1;2;87
3302254;Itatiaia;3509700;Campos do Jordão;1;1;2;105
3305109;São João de Meriti;3509700;Campos do Jordão;1;1;2;226
3506359;Bertioga;3509700;Campos do Jordão;1;1;2;136
3507605;Bragança Paulista;3509700;Campos do Jordão;1;1;2;104
3508702;Caconde;3509700;Campos do Jordão;1;1;2;171
1500800;Ananindeua;3509601;Campo Limpo Paulista;1;1;2;2420
1722107;Xambioá;3509601;Campo Limpo Paulista;1;1;2;1865
2803609;Laranjeiras;3509601;Campo Limpo Paulista;1;1;2;1669
3106200;Belo Horizonte;3509601;Campo Limpo Paulista;1;1;2;463
3119955;Córrego Fundo;3509601;Campo Limpo Paulista;1;1;2;330
3125101;Extrema;3509601;Campo Limpo Paulista;1;1;2;61
3205002;Serra;3509601;Campo Limpo Paulista;1;1;2;739
3205200;Vila Velha;3509601;Campo Limpo Paulista;1;1;2;724
3302403;Macaé;3509601;Campo Limpo Paulista;1;1;2;507
3304557;Rio de Janeiro;3509601;Campo Limpo Paulista;1;1;2;362
3505708;Barueri;3509601;Campo Limpo Paulista;1;1;2;35
3509007;Caieiras;3509601;Campo Limpo Paulista;1;1;2;18
3509205;Cajamar;3509601;Campo Limpo Paulista;1;1;2;19
1100122;Ji-Paraná;3509502;Campinas;1;1;2;1981
1100304;Vilhena;3509502;Campinas;1;1;2;1718
1200203;Cruzeiro do Sul;3509502;Campinas;1;1;2;3042
1200401;Rio Branco;3509502;Campinas;1;1;2;2506
1200609;Tarauacá;3509502;Campinas;1;1;2;2856
1300409;Barcelos;3509502;Campinas;1;1;2;2881
1301001;Carauari;3509502;Campinas;1;1;2;2787
1301209;Coari;3509502;Campinas;1;1;2;2609
1301407;Eirunepé;3509502;Campinas;1;1;2;2883
1301605;Fonte Boa;3509502;Campinas;1;1;2;2928
1301704;Humaitá;3509502;Campinas;1;1;2;2320
1302702;Manicoré;3509502;Campinas;1;1;2;2350
1303403;Parintins;3509502;Campinas;1;1;2;2430
1303601;Santa Isabel do Rio Negro;3509502;Campinas;1;1;2;3049
1303809;São Gabriel da Cachoeira;3509502;Campinas;1;1;2;3199
1303908;São Paulo de Olivença;3509502;Campinas;1;1;2;3041
1304062;Tabatinga;3509502;Campinas;1;1;2;3050
1304203;Tefé;3509502;Campinas;1;1;2;2765
1400100;Boa Vista;3509502;Campinas;1;1;2;3147
1501303;Barcarena;3509502;Campinas;1;1;2;2371
1503606;Itaituba;3509502;Campinas;1;1;2;2244
1504208;Marabá;3509502;Campinas;1;1;2;1950
1505304;Oriximiná;3509502;Campinas;1;1;2;2493
1505437;Ourilândia do Norte;3509502;Campinas;1;1;2;1829
1508100;Tucuruí;3509502;Campinas;1;1;2;2134
1600303;Macapá;3509502;Campinas;1;1;2;2572
1701002;Ananás;3509502;Campinas;1;1;2;1831
1702109;Araguaína;3509502;Campinas;1;1;2;1741
1718204;Porto Nacional;3509502;Campinas;1;1;2;1356
2105302;Imperatriz;3509502;Campinas;1;1;2;1924
2109007;Porto Franco;3509502;Campinas;1;1;2;1831
2303709;Caucaia;3509502;Campinas;1;1;2;2275
2312908;Sobral;3509502;Campinas;1;1;2;2227
2400802;Angicos;3509502;Campinas;1;1;2;2159
2407104;Macaíba;3509502;Campinas;1;1;2;2209
2408003;Mossoró;3509502;Campinas;1;1;2;2180
2409407;Pau dos Ferros;3509502;Campinas;1;1;2;2051
2503209;Cabedelo;3509502;Campinas;1;1;2;2126
2601102;Araripina;3509502;Campinas;1;1;2;1817
2601201;Arcoverde;3509502;Campinas;1;1;2;1878
2604106;Caruaru;3509502;Campinas;1;1;2;1952
2605459;Fernando de Noronha;3509502;Campinas;1;1;2;2547
2606002;Garanhuns;3509502;Campinas;1;1;2;1871
2606408;Gravatá;3509502;Campinas;1;1;2;1983
2608909;Limoeiro;3509502;Campinas;1;1;2;2019
2609600;Olinda;3509502;Campinas;1;1;2;2039
2610004;Palmares;3509502;Campinas;1;1;2;1938
2611002;Petrolândia;3509502;Campinas;1;1;2;1758
2612208;Salgueiro;3509502;Campinas;1;1;2;1811
2613909;Serra Talhada;3509502;Campinas;1;1;2;1866
2906501;Candeias;3509502;Campinas;1;1;2;1414
2913606;Ilhéus;3509502;Campinas;1;1;2;1198
2918407;Juazeiro;3509502;Campinas;1;1;2;1620
2922003;Mucuri;3509502;Campinas;1;1;2;931
3101706;Almenara;3509502;Campinas;1;1;2;982
3103504;Araguari;3509502;Campinas;1;1;2;486
3104205;Arcos;3509502;Campinas;1;1;2;327
3107109;Boa Esperança;3509502;Campinas;1;1;2;252
3110608;Cambuí;3509502;Campinas;1;1;2;105
3120904;Curvelo;3509502;Campinas;1;1;2;527
3121605;Diamantina;3509502;Campinas;1;1;2;624
3124104;Esmeraldas;3509502;Campinas;1;1;2;445
3125101;Extrema;3509502;Campinas;1;1;2;76
3128709;Guaxupé;3509502;Campinas;1;1;2;180
3130804;Ingaí;3509502;Campinas;1;1;2;274
3133600;Itapeva;3509502;Campinas;1;1;2;85
3135100;Janaúba;3509502;Campinas;1;1;2;870
3136306;João Pinheiro;3509502;Campinas;1;1;2;576
3139003;Machado;3509502;Campinas;1;1;2;179
3139409;Manhuaçu;3509502;Campinas;1;1;2;587
3139904;Maria da Fé;3509502;Campinas;1;1;2;184
3143401;Monte Sião;3509502;Campinas;1;1;2;72
3144102;Muzambinho;3509502;Campinas;1;1;2;177
3144300;Nanuque;3509502;Campinas;1;1;2;875
3144805;Nova Lima;3509502;Campinas;1;1;2;456
3147006;Paracatu;3509502;Campinas;1;1;2;628
3147105;Pará de Minas;3509502;Campinas;1;1;2;418
3151206;Pirapora;3509502;Campinas;1;1;2;654
3151701;Poço Fundo;3509502;Campinas;1;1;2;167
3157005;Salinas;3509502;Campinas;1;1;2;884
3164704;São Sebastião do Paraíso;3509502;Campinas;1;1;2;218
3169604;Tupaciguara;3509502;Campinas;1;1;2;505
3170529;Urucuia;3509502;Campinas;1;1;2;761
3171204;Vespasiano;3509502;Campinas;1;1;2;476
3202207;Fundão;3509502;Campinas;1;1;2;751
3300100;Angra dos Reis;3509502;Campinas;1;1;2;284
3300308;Barra do Piraí;3509502;Campinas;1;1;2;334
3300407;Barra Mansa;3509502;Campinas;1;1;2;296
3300704;Cabo Frio;3509502;Campinas;1;1;2;512
3300951;Comendador Levy Gasparian;3509502;Campinas;1;1;2;403
3302254;Itatiaia;3509502;Campinas;1;1;2;257
3303401;Nova Friburgo;3509502;Campinas;1;1;2;463
3304110;Porto Real;3509502;Campinas;1;1;2;285
3304300;Rio Bonito;3509502;Campinas;1;1;2;455
3304524;Rio das Ostras;3509502;Campinas;1;1;2;525
3305505;Saquarema;3509502;Campinas;1;1;2;471
3306008;Três Rios;3509502;Campinas;1;1;2;402
3500105;Adamantina;3509502;Campinas;1;1;2;433
3500402;Águas da Prata;3509502;Campinas;1;1;2;112
3500501;Águas de Lindóia;3509502;Campinas;1;1;2;64
3501004;Altinópolis;3509502;Campinas;1;1;2;210
3502200;Angatuba;3509502;Campinas;1;1;2;154
3502507;Aparecida;3509502;Campinas;1;1;2;188
3502754;Araçariguama;3509502;Campinas;1;1;2;60
3503505;Areias;3509502;Campinas;1;1;2;244
3504206;Auriflama;3509502;Campinas;1;1;2;432
3504909;Bananal;3509502;Campinas;1;1;2;281
3505203;Bariri;3509502;Campinas;1;1;2;195
3505807;Bastos;3509502;Campinas;1;1;2;391
3506706;Boa Esperança do Sul;3509502;Campinas;1;1;2;169
3507100;Bom Jesus dos Perdões;3509502;Campinas;1;1;2;66
3507704;Braúna;3509502;Campinas;1;1;2;367
3508108;Buritama;3509502;Campinas;1;1;2;375
3508801;Cafelândia;3509502;Campinas;1;1;2;288
3509205;Cajamar;3509502;Campinas;1;1;2;54
3509403;Cajuru;3509502;Campinas;1;1;2;182
3502200;Angatuba;3509452;Campina do Monte Alegre;1;1;2;13
3104007;Araxá;3509403;Cajuru;1;1;2;190
3164704;São Sebastião do Paraíso;3509403;Cajuru;1;1;2;51
3104007;Araxá;3509304;Cajobi;1;1;2;240
3205101;Viana;3509304;Cajobi;1;1;2;858
3104007;Araxá;3509254;Cajati;1;1;2;580
3304557;Rio de Janeiro;3509254;Cajati;1;1;2;529
1100064;Colorado do Oeste;3509205;Cajamar;1;1;2;1768
1100288;Rolim de Moura;3509205;Cajamar;1;1;2;1946
2304400;Fortaleza;3509205;Cajamar;1;1;2;2315
2919207;Lauro de Freitas;3509205;Cajamar;1;1;2;1436
2927408;Salvador;3509205;Cajamar;1;1;2;1418
3135100;Janaúba;3509205;Cajamar;1;1;2;908
3139003;Machado;3509205;Cajamar;1;1;2;210
3169901;Ubá;3509205;Cajamar;1;1;2;468
3170701;Varginha;3509205;Cajamar;1;1;2;254
3203205;Linhares;3509205;Cajamar;1;1;2;820
3300407;Barra Mansa;3509205;Cajamar;1;1;2;288
3303906;Petrópolis;3509205;Cajamar;1;1;2;384
3501608;Americana;3509205;Cajamar;1;1;2;83
3504305;Avaí;3509205;Cajamar;1;1;2;284
3507803;Brodowski;3509205;Cajamar;1;1;2;274
3508405;Cabreúva;3509205;Cajamar;1;1;2;27
1721000;Palmas;3509007;Caieiras;1;1;2;1448
2408003;Mossoró;3509007;Caieiras;1;1;2;2211
2607208;Ipojuca;3509007;Caieiras;1;1;2;2015
3118601;Contagem;3509007;Caieiras;1;1;2;466
3204906;São Mateus;3509007;Caieiras;1;1;2;858
3301207;Carmo;3509007;Caieiras;1;1;2;449
3302403;Macaé;3509007;Caieiras;1;1;2;506
3503208;Araraquara;3509007;Caieiras;1;1;2;227
3503307;Araras;3509007;Caieiras;1;1;2;129
3503901;Arujá;3509007;Caieiras;1;1;2;43
3502101;Andradina;3508801;Cafelândia;1;1;2;209
3507753;Brejo Alegre;3508801;Cafelândia;1;1;2;95
3104007;Araxá;3508702;Caconde;1;1;2;217
3108404;Botelhos;3508702;Caconde;1;1;2;28
3118601;Contagem;3508702;Caconde;1;1;2;318
3134202;Ituiutaba;3508702;Caconde;1;1;2;405
3144102;Muzambinho;3508702;Caconde;1;1;2;21
3505906;Batatais;3508702;Caconde;1;1;2;123
3506706;Boa Esperança do Sul;3508702;Caconde;1;1;2;188
2611606;Recife;3508603;Cachoeira Paulista;1;1;2;1893
3502507;Aparecida;3508603;Cachoeira Paulista;1;1;2;30
1302603;Manaus;3508504;Caçapava;1;1;2;2619
2906501;Candeias;3508504;Caçapava;1;1;2;1356
2919207;Lauro de Freitas;3508504;Caçapava;1;1;2;1348
2930709;Simões Filho;3508504;Caçapava;1;1;2;1353
3163706;São Lourenço;3508504;Caçapava;1;1;2;129
3170206;Uberlândia;3508504;Caçapava;1;1;2;532
3205200;Vila Velha;3508504;Caçapava;1;1;2;622
3302403;Macaé;3508504;Caçapava;1;1;2;398
3304110;Porto Real;3508504;Caçapava;1;1;2;161
3501608;Americana;3508504;Caçapava;1;1;2;171
3502507;Aparecida;3508504;Caçapava;1;1;2;56
3502804;Araçatuba;3508504;Caçapava;1;1;2;526
3507506;Botucatu;3508504;Caçapava;1;1;2;281
3205002;Serra;3508405;Cabreúva;1;1;2;775
3502705;Apiaí;3508405;Cabreúva;1;1;2;220
3504107;Atibaia;3508405;Cabreúva;1;1;2;63
3170206;Uberlândia;3508207;Buritizal;1;1;2;154
3504602;Bady Bassitt;3508108;Buritama;1;1;2;75
3507753;Brejo Alegre;3508108;Buritama;1;1;2;13
2207603;Parnaguá;3508009;Buri;1;1;2;1553
3502705;Apiaí;3508009;Buri;1;1;2;83
2304400;Fortaleza;3507902;Brotas;1;1;2;2257
2610707;Paulista;3507902;Brotas;1;1;2;2062
3303708;Paraíba do Sul;3507902;Brotas;1;1;2;498
3503208;Araraquara;3507902;Brotas;1;1;2;55
3505302;Barra Bonita;3507902;Brotas;1;1;2;50
3506003;Bauru;3507902;Brotas;1;1;2;99
3106200;Belo Horizonte;3507803;Brodowski;1;1;2;400
3118205;Conquista;3507803;Brodowski;1;1;2;117
3505104;Barbosa;3507753;Brejo Alegre;1;1;2;32
3506409;Bilac;3507753;Brejo Alegre;1;1;2;39
3506508;Birigui;3507753;Brejo Alegre;1;1;2;20
3507704;Braúna;3507753;Brejo Alegre;1;1;2;38
3506409;Bilac;3507704;Braúna;1;1;2;21
1302603;Manaus;3507605;Bragança Paulista;1;1;2;2561
1501402;Belém;3507605;Bragança Paulista;1;1;2;2392
1721000;Palmas;3507605;Bragança Paulista;1;1;2;1404
2923605;Paramirim;3507605;Bragança Paulista;1;1;2;1135
3106705;Betim;3507605;Bragança Paulista;1;1;2;409
3109105;Bueno Brandão;3507605;Bragança Paulista;1;1;2;59
3111200;Campo Belo;3507605;Bragança Paulista;1;1;2;262
3124500;Estiva;3507605;Bragança Paulista;1;1;2;77
3133600;Itapeva;3507605;Bragança Paulista;1;1;2;38
3138203;Lavras;3507605;Bragança Paulista;1;1;2;247
3146008;Ouro Fino;3507605;Bragança Paulista;1;1;2;76
3151800;Poços de Caldas;3507605;Bragança Paulista;1;1;2;130
3169109;Toledo;3507605;Bragança Paulista;1;1;2;31
3169307;Três Corações;3507605;Bragança Paulista;1;1;2;196
3205002;Serra;3507605;Bragança Paulista;1;1;2;707
3304144;Queimados;3507605;Bragança Paulista;1;1;2;305
3502804;Araçatuba;3507605;Bragança Paulista;1;1;2;441
3503802;Artur Nogueira;3507605;Bragança Paulista;1;1;2;75
3507506;Botucatu;3507605;Bragança Paulista;1;1;2;194
1100205;Porto Velho;3507506;Botucatu;1;1;2;2182
1200401;Rio Branco;3507506;Botucatu;1;1;2;2393
1502400;Castanhal;3507506;Botucatu;1;1;2;2388
1508100;Tucuruí;3507506;Botucatu;1;1;2;2119
1600303;Macapá;3507506;Botucatu;1;1;2;2552
1707108;Divinópolis do Tocantins;3507506;Botucatu;1;1;2;1449
2110039;Santa Luzia do Paruá;3507506;Botucatu;1;1;2;2255
2208007;Picos;3507506;Botucatu;1;1;2;1878
2408102;Natal;3507506;Botucatu;1;1;2;2291
2611101;Petrolina;3507506;Botucatu;1;1;2;1693
2910800;Feira de Santana;3507506;Botucatu;1;1;2;1504
2927408;Salvador;3507506;Botucatu;1;1;2;1478
2933307;Vitória da Conquista;3507506;Botucatu;1;1;2;1168
3131307;Ipatinga;3507506;Botucatu;1;1;2;707
3143302;Montes Claros;3507506;Botucatu;1;1;2;821
3149309;Pedro Leopoldo;3507506;Botucatu;1;1;2;573
3170107;Uberaba;3507506;Botucatu;1;1;2;351
3205002;Serra;3507506;Botucatu;1;1;2;881
3205309;Vitória;3507506;Botucatu;1;1;2;877
3301009;Campos dos Goytacazes;3507506;Botucatu;1;1;2;738
3301702;Duque de Caxias;3507506;Botucatu;1;1;2;526
3500709;Agudos;3507506;Botucatu;1;1;2;72
3502309;Anhembi;3507506;Botucatu;1;1;2;31
3503109;Arandu;3507506;Botucatu;1;1;2;69
3503307;Araras;3507506;Botucatu;1;1;2;123
3505500;Barretos;3507506;Botucatu;1;1;2;258
3506102;Bebedouro;3507506;Botucatu;1;1;2;215
3500709;Agudos;3507456;Borebi;1;1;2;10
3503208;Araraquara;3507456;Borebi;1;1;2;119
1504208;Marabá;3507407;Borborema;1;1;2;1798
3503208;Araraquara;3507407;Borborema;1;1;2;95
3503703;Ariranha;3507407;Borborema;1;1;2;56
3505906;Batatais;3507407;Borborema;1;1;2;171
3506102;Bebedouro;3507407;Borborema;1;1;2;93
3505203;Bariri;3507308;Boracéia;1;1;2;14
3506508;Birigui;3507308;Boracéia;1;1;2;189
3301009;Campos dos Goytacazes;3507159;Bom Sucesso de Itararé;1;1;2;835
3302007;Itaguaí;3507159;Bom Sucesso de Itararé;1;1;2;564
3505708;Barueri;3507159;Bom Sucesso de Itararé;1;1;2;246
2919207;Lauro de Freitas;3507100;Bom Jesus dos Perdões;1;1;2;1393
3106200;Belo Horizonte;3507100;Bom Jesus dos Perdões;1;1;2;438
3205200;Vila Velha;3507100;Bom Jesus dos Perdões;1;1;2;692
3205309;Vitória;3507100;Bom Jesus dos Perdões;1;1;2;701
3306008;Três Rios;3507100;Bom Jesus dos Perdões;1;1;2;350
3505708;Barueri;3507100;Bom Jesus dos Perdões;1;1;2;59
3110608;Cambuí;3507001;Boituva;1;1;2;179
3170206;Uberlândia;3507001;Boituva;1;1;2;489
3501608;Americana;3507001;Boituva;1;1;2;69
3505708;Barueri;3507001;Boituva;1;1;2;85
3106903;Bicas;3506904;Bofete;1;1;2;549
3304557;Rio de Janeiro;3506904;Bofete;1;1;2;512
3503208;Araraquara;3506904;Bofete;1;1;2;146
3506003;Bauru;3506904;Bofete;1;1;2;119
2927408;Salvador;3506706;Boa Esperança do Sul;1;1;2;1410
3505302;Barra Bonita;3506706;Boa Esperança do Sul;1;1;2;58
3506102;Bebedouro;3506706;Boa Esperança do Sul;1;1;2;118
3505708;Barueri;3506607;Biritiba-Mirim;1;1;2;86
2304400;Fortaleza;3506508;Birigui;1;1;2;2270
2927408;Salvador;3506508;Birigui;1;1;2;1515
3118601;Contagem;3506508;Birigui;1;1;2;664
3145208;Nova Serrana;3506508;Birigui;1;1;2;576
3205002;Serra;3506508;Birigui;1;1;2;1046
3503208;Araraquara;3506508;Birigui;1;1;2;232
3504206;Auriflama;3506508;Birigui;1;1;2;72
3505807;Bastos;3506508;Birigui;1;1;2;80
3504404;Avanhandava;3506409;Bilac;1;1;2;56
2408102;Natal;3506359;Bertioga;1;1;2;2258
3109204;Buenópolis;3506359;Bertioga;1;1;2;688
3133006;Itamonte;3506359;Bertioga;1;1;2;214
3500600;Águas de São Pedro;3506359;Bertioga;1;1;2;222
3503901;Arujá;3506359;Bertioga;1;1;2;51
3505708;Barueri;3506359;Bertioga;1;1;2;81
3504008;Assis;3506300;Bernardino de Campos;1;1;2;107
2208007;Picos;3506102;Bebedouro;1;1;2;1690
3101409;Albertina;3506102;Bebedouro;1;1;2;245
3111408;Campo Florido;3506102;Bebedouro;1;1;2;130
3116902;Comendador Gomes;3506102;Bebedouro;1;1;2;148
3118601;Contagem;3506102;Bebedouro;1;1;2;476
3128303;Guaranésia;3506102;Bebedouro;1;1;2;185
3148103;Patrocínio;3506102;Bebedouro;1;1;2;273
3205101;Viana;3506102;Bebedouro;1;1;2;830
3501608;Americana;3506102;Bebedouro;1;1;2;236
3502200;Angatuba;3506102;Bebedouro;1;1;2;283
3503307;Araras;3506102;Bebedouro;1;1;2;199
3503703;Ariranha;3506102;Bebedouro;1;1;2;38
1100304;Vilhena;3506003;Bauru;1;1;2;1532
1503606;Itaituba;3506003;Bauru;1;1;2;2117
1505106;Óbidos;3506003;Bauru;1;1;2;2353
1721000;Palmas;3506003;Bauru;1;1;2;1328
2110302;Santo Antônio dos Lopes;3506003;Bauru;1;1;2;1988
2408102;Natal;3506003;Bauru;1;1;2;2284
2507507;João Pessoa;3506003;Bauru;1;1;2;2191
2910800;Feira de Santana;3506003;Bauru;1;1;2;1504
2919207;Lauro de Freitas;3506003;Bauru;1;1;2;1503
3136207;João Monlevade;3506003;Bauru;1;1;2;665
3148103;Patrocínio;3506003;Bauru;1;1;2;432
3149309;Pedro Leopoldo;3506003;Bauru;1;1;2;595
3151800;Poços de Caldas;3506003;Bauru;1;1;2;268
3154606;Ribeirão das Neves;3506003;Bauru;1;1;2;584
3200201;Alegre;3506003;Bauru;1;1;2;790
3201209;Cachoeiro de Itapemirim;3506003;Bauru;1;1;2;836
3205002;Serra;3506003;Bauru;1;1;2;930
3205200;Vila Velha;3506003;Bauru;1;1;2;919
3205309;Vitória;3506003;Bauru;1;1;2;927
3300407;Barra Mansa;3506003;Bauru;1;1;2;504
3502101;Andradina;3506003;Bauru;1;1;2;285
3504107;Atibaia;3506003;Bauru;1;1;2;275
3504305;Avaí;3506003;Bauru;1;1;2;34
3101607;Alfenas;3505906;Batatais;1;1;2;182
3104007;Araxá;3505906;Batatais;1;1;2;160
3147907;Passos;3505906;Batatais;1;1;2;105
3148103;Patrocínio;3505906;Batatais;1;1;2;225
3159803;Santa Vitória;3505906;Batatais;1;1;2;344
3164704;São Sebastião do Paraíso;3505906;Batatais;1;1;2;66
3501707;Américo Brasiliense;3505906;Batatais;1;1;2;105
1200401;Rio Branco;3505708;Barueri;1;1;2;2548
1301902;Itacoatiara;3505708;Barueri;1;1;2;2525
1400100;Boa Vista;3505708;Barueri;1;1;2;3213
1500503;Almeirim;3505708;Barueri;1;1;2;2498
1502152;Canaã dos Carajás;3505708;Barueri;1;1;2;1905
1600303;Macapá;3505708;Barueri;1;1;2;2641
1702109;Araguaína;3505708;Barueri;1;1;2;1810
1715259;Novo Jardim;3505708;Barueri;1;1;2;1294
1718204;Porto Nacional;3505708;Barueri;1;1;2;1425
2305233;Horizonte;3505708;Barueri;1;1;2;2298
2306405;Itapipoca;3505708;Barueri;1;1;2;2325
2307254;Jijoca de Jericoacoara;3505708;Barueri;1;1;2;2372
2404309;Governador Dix-Sept Rosado;3505708;Barueri;1;1;2;2197
2412005;São Gonçalo do Amarante;3505708;Barueri;1;1;2;2262
2501807;Bayeux;3505708;Barueri;1;1;2;2157
2603454;Camaragibe;3505708;Barueri;1;1;2;2071
2607208;Ipojuca;3505708;Barueri;1;1;2;2034
2607752;Itapissuma;3505708;Barueri;1;1;2;2098
2616407;Vitória de Santo Antão;3505708;Barueri;1;1;2;2047
2700300;Arapiraca;3505708;Barueri;1;1;2;1821
2706703;Penedo;3505708;Barueri;1;1;2;1783
2906501;Candeias;3505708;Barueri;1;1;2;1455
2908507;Conceição do Jacuípe;3505708;Barueri;1;1;2;1473
2917508;Jacobina;3505708;Barueri;1;1;2;1497
2918001;Jequié;3505708;Barueri;1;1;2;1268
2918407;Juazeiro;3505708;Barueri;1;1;2;1674
2931350;Teixeira de Freitas;3505708;Barueri;1;1;2;974
3101508;Além Paraíba;3505708;Barueri;1;1;2;462
3105400;Barão de Cocais;3505708;Barueri;1;1;2;521
3106309;Belo Oriente;3505708;Barueri;1;1;2;649
3109006;Brumadinho;3505708;Barueri;1;1;2;460
3110509;Camanducaia;3505708;Barueri;1;1;2;112
3111200;Campo Belo;3505708;Barueri;1;1;2;333
3115300;Cataguases;3505708;Barueri;1;1;2;487
3115359;Catas Altas;3505708;Barueri;1;1;2;517
3117876;Confins;3505708;Barueri;1;1;2;518
3118007;Congonhas;3505708;Barueri;1;1;2;450
3128006;Guanhães;3505708;Barueri;1;1;2;661
3131703;Itabira;3505708;Barueri;1;1;2;564
3132404;Itajubá;3505708;Barueri;1;1;2;188
3136306;João Pinheiro;3505708;Barueri;1;1;2;641
3137601;Lagoa Santa;3505708;Barueri;1;1;2;525
3139409;Manhuaçu;3505708;Barueri;1;1;2;606
3140001;Mariana;3505708;Barueri;1;1;2;493
3144805;Nova Lima;3505708;Barueri;1;1;2;492
3146008;Ouro Fino;3505708;Barueri;1;1;2;145
3151503;Piumhi;3505708;Barueri;1;1;2;349
3155702;Rio Piracicaba;3505708;Barueri;1;1;2;544
3157807;Santa Luzia;3505708;Barueri;1;1;2;514
3158953;Santana do Paraíso;3505708;Barueri;1;1;2;632
3159605;Santa Rita do Sapucaí;3505708;Barueri;1;1;2;183
3161908;São Gonçalo do Rio Abaixo;3505708;Barueri;1;1;2;540
3168705;Timóteo;3505708;Barueri;1;1;2;609
3170404;Unaí;3505708;Barueri;1;1;2;787
3171006;Vazante;3505708;Barueri;1;1;2;610
3200805;Baixo Guandu;3505708;Barueri;1;1;2;735
3201209;Cachoeiro de Itapemirim;3505708;Barueri;1;1;2;657
3202405;Guarapari;3505708;Barueri;1;1;2;713
3204906;São Mateus;3505708;Barueri;1;1;2;878
3205101;Viana;3505708;Barueri;1;1;2;724
3300233;Armação dos Búzios;3505708;Barueri;1;1;2;513
3300308;Barra do Piraí;3505708;Barueri;1;1;2;331
3301504;Cordeiro;3505708;Barueri;1;1;2;487
3301850;Guapimirim;3505708;Barueri;1;1;2;411
3302601;Mangaratiba;3505708;Barueri;1;1;2;298
3303708;Paraíba do Sul;3505708;Barueri;1;1;2;394
3304151;Quissamã;3505708;Barueri;1;1;2;571
3304524;Rio das Ostras;3505708;Barueri;1;1;2;514
3304755;São Francisco de Itabapoana;3505708;Barueri;1;1;2;639
3305802;Teresópolis;3505708;Barueri;1;1;2;411
3500303;Aguaí;3505708;Barueri;1;1;2;161
3500550;Águas de Santa Bárbara;3505708;Barueri;1;1;2;251
3504008;Assis;3505708;Barueri;1;1;2;375
3504503;Avaré;3505708;Barueri;1;1;2;215
3505302;Barra Bonita;3505708;Barueri;1;1;2;205
3104007;Araxá;3505609;Barrinha;1;1;2;218
3170206;Uberlândia;3505609;Barrinha;1;1;2;254
1501303;Barcarena;3505500;Barretos;1;1;2;2106
1502939;Dom Eliseu;3505500;Barretos;1;1;2;1799
1506138;Redenção;3505500;Barretos;1;1;2;1395
2111300;São Luís;3505500;Barretos;1;1;2;2041
2307650;Maracanaú;3505500;Barretos;1;1;2;2100
2926608;Ribeira do Pombal;3505500;Barretos;1;1;2;1483
3104007;Araxá;3505500;Barretos;1;1;2;201
3106200;Belo Horizonte;3505500;Barretos;1;1;2;484
3111101;Campina Verde;3505500;Barretos;1;1;2;148
3148004;Patos de Minas;3505500;Barretos;1;1;2;307
3151602;Planura;3505500;Barretos;1;1;2;48
3154606;Ribeirão das Neves;3505500;Barretos;1;1;2;476
3164704;São Sebastião do Paraíso;3505500;Barretos;1;1;2;172
3205101;Viana;3505500;Barretos;1;1;2;836
3501608;Americana;3505500;Barretos;1;1;2;275
1302603;Manaus;3505302;Barra Bonita;1;1;2;2424
3502804;Araçatuba;3505302;Barra Bonita;1;1;2;240
2704302;Maceió;3505203;Bariri;1;1;2;1891
3503406;Arealva;3505203;Bariri;1;1;2;18
3501301;Álvares Machado;3505104;Barbosa;1;1;2;181
3306305;Volta Redonda;3504909;Bananal;1;1;2;31
3304557;Rio de Janeiro;3504800;Bálsamo;1;1;2;705
3106200;Belo Horizonte;3504602;Bady Bassitt;1;1;2;578
3302254;Itatiaia;3504602;Bady Bassitt;1;1;2;537
3304557;Rio de Janeiro;3504602;Bady Bassitt;1;1;2;683
3500204;Adolfo;3504602;Bady Bassitt;1;1;2;41
1302603;Manaus;3504503;Avaré;1;1;2;2464
1600303;Macapá;3504503;Avaré;1;1;2;2572
2925303;Porto Seguro;3504503;Avaré;1;1;2;1229
2927408;Salvador;3504503;Avaré;1;1;2;1527
3143906;Muriaé;3504503;Avaré;1;1;2;707
3501608;Americana;3504503;Avaré;1;1;2;168
3502804;Araçatuba;3504503;Avaré;1;1;2;259
3503109;Arandu;3504503;Avaré;1;1;2;13
3504008;Assis;3504503;Avaré;1;1;2;162
3504107;Atibaia;3504503;Avaré;1;1;2;244
1302603;Manaus;3504107;Atibaia;1;1;2;2577
2513406;Santa Luzia;3504107;Atibaia;1;1;2;2032
2611606;Recife;3504107;Atibaia;1;1;2;2015
2916856;Itatim;3504107;Atibaia;1;1;2;1338
2927408;Salvador;3504107;Atibaia;1;1;2;1379
3115508;Caxambu;3504107;Atibaia;1;1;2;206
3133600;Itapeva;3504107;Atibaia;1;1;2;51
3136207;João Monlevade;3504107;Atibaia;1;1;2;501
3136702;Juiz de Fora;3504107;Atibaia;1;1;2;361
3139003;Machado;3504107;Atibaia;1;1;2;172
3140001;Mariana;3504107;Atibaia;1;1;2;440
3157807;Santa Luzia;3504107;Atibaia;1;1;2;460
3169307;Três Corações;3504107;Atibaia;1;1;2;210
3205002;Serra;3504107;Atibaia;1;1;2;714
3501905;Amparo;3504107;Atibaia;1;1;2;51
3502804;Araçatuba;3504107;Atibaia;1;1;2;449
3503208;Araraquara;3504107;Atibaia;1;1;2;221
2927408;Salvador;3504008;Assis;1;1;2;1605
3303708;Paraíba do Sul;3504008;Assis;1;1;2;736
1506807;Santarém;3503901;Arujá;1;1;2;2454
2916807;Itarantim;3503901;Arujá;1;1;2;1059
3106200;Belo Horizonte;3503901;Arujá;1;1;2;453
3106705;Betim;3503901;Arujá;1;1;2;437
3126109;Formiga;3503901;Arujá;1;1;2;336
3136207;João Monlevade;3503901;Arujá;1;1;2;508
3136702;Juiz de Fora;3503901;Arujá;1;1;2;354
3145901;Ouro Branco;3503901;Arujá;1;1;2;414
3159209;Santa Rita de Caldas;3503901;Arujá;1;1;2;151
3201308;Cariacica;3503901;Arujá;1;1;2;688
3300506;Bom Jardim;3503901;Arujá;1;1;2;420
3301702;Duque de Caxias;3503901;Arujá;1;1;2;315
3302403;Macaé;3503901;Arujá;1;1;2;465
3304557;Rio de Janeiro;3503901;Arujá;1;1;2;317
3306305;Volta Redonda;3503901;Arujá;1;1;2;247
3503208;Araraquara;3503901;Arujá;1;1;2;258
2919553;Luís Eduardo magalhães;3503802;Artur Nogueira;1;1;2;1167
3503307;Araras;3503802;Artur Nogueira;1;1;2;32
3153400;Presidente Olegário;3503703;Ariranha;1;1;2;392
3501905;Amparo;3503703;Ariranha;1;1;2;270
3107406;Bom Despacho;3503356;Arco-Íris;1;1;2;580
2402600;Ceará-Mirim;3503307;Araras;1;1;2;2195
2611606;Recife;3503307;Araras;1;1;2;2002
2702306;Coruripe;3503307;Araras;1;1;2;1754
2927408;Salvador;3503307;Araras;1;1;2;1368
2930709;Simões Filho;3503307;Araras;1;1;2;1389
3101607;Alfenas;3503307;Araras;1;1;2;180
3138203;Lavras;3503307;Araras;1;1;2;274
3143401;Monte Sião;3503307;Araras;1;1;2;83
3152501;Pouso Alegre;3503307;Araras;1;1;2;148
3302007;Itaguaí;3503307;Araras;1;1;2;371
3501905;Amparo;3503307;Araras;1;1;2;74
3502754;Araçariguama;3503307;Araras;1;1;2;124
1718204;Porto Nacional;3503208;Araraquara;1;1;2;1226
2412005;São Gonçalo do Amarante;3503208;Araraquara;1;1;2;2183
2607901;Jaboatão dos Guararapes;3503208;Araraquara;1;1;2;2002
2704302;Maceió;3503208;Araraquara;1;1;2;1832
2914802;Itabuna;3503208;Araraquara;1;1;2;1188
3103504;Araguari;3503208;Araraquara;1;1;2;348
3118601;Contagem;3503208;Araraquara;1;1;2;468
3132404;Itajubá;3503208;Araraquara;1;1;2;288
3145406;Olaria;3503208;Araraquara;1;1;2;435
3164704;São Sebastião do Paraíso;3503208;Araraquara;1;1;2;155
3172004;Visconde do Rio Branco;3503208;Araraquara;1;1;2;556
3205002;Serra;3503208;Araraquara;1;1;2;829
3301702;Duque de Caxias;3503208;Araraquara;1;1;2;515
3305109;São João de Meriti;3503208;Araraquara;1;1;2;510
3306008;Três Rios;3503208;Araraquara;1;1;2;512
3500709;Agudos;3503208;Araraquara;1;1;2;116
3502002;Analândia;3503208;Araraquara;1;1;2;65
3502101;Andradina;3503208;Araraquara;1;1;2;347
3104007;Araxá;3503000;Aramina;1;1;2;109
3170107;Uberaba;3503000;Aramina;1;1;2;39
3301702;Duque de Caxias;3503000;Aramina;1;1;2;563
2927408;Salvador;3502903;Araçoiaba da Serra;1;1;2;1474
3502754;Araçariguama;3502903;Araçoiaba da Serra;1;1;2;57
1302603;Manaus;3502804;Araçatuba;1;1;2;2220
1500958;Aurora do Pará;3502804;Araçatuba;1;1;2;2131
1705508;Colinas do Tocantins;3502804;Araçatuba;1;1;2;1470
1721000;Palmas;3502804;Araçatuba;1;1;2;1221
2304400;Fortaleza;3502804;Araçatuba;1;1;2;2269
2918407;Juazeiro;3502804;Araçatuba;1;1;2;1641
3103504;Araguari;3502804;Araçatuba;1;1;2;368
3106705;Betim;3502804;Araçatuba;1;1;2;663
3127107;Frutal;3502804;Araçatuba;1;1;2;197
3138203;Lavras;3502804;Araçatuba;1;1;2;566
3145109;Nova Resende;3502804;Araçatuba;1;1;2;419
3156908;Sacramento;3502804;Araçatuba;1;1;2;347
3300100;Angra dos Reis;3502804;Araçatuba;1;1;2;671
3500709;Agudos;3502804;Araçatuba;1;1;2;206
3501608;Americana;3502804;Araçatuba;1;1;2;366
1302603;Manaus;3502754;Araçariguama;1;1;2;2580
2307650;Maracanaú;3502754;Araçariguama;1;1;2;2317
2612208;Salgueiro;3502754;Araçariguama;1;1;2;1863
3118601;Contagem;3502754;Araçariguama;1;1;2;492
3201308;Cariacica;3502754;Araçariguama;1;1;2;756
3501152;Alumínio;3502754;Araçariguama;1;1;2;23
1500503;Almeirim;3502705;Apiaí;1;1;2;2571
3171204;Vespasiano;3502705;Apiaí;1;1;2;723
2607901;Jaboatão dos Guararapes;3502507;Aparecida;1;1;2;1916
3106200;Belo Horizonte;3502507;Aparecida;1;1;2;350
3304201;Resende;3502507;Aparecida;1;1;2;88
2304400;Fortaleza;3502309;Anhembi;1;1;2;2308
2927408;Salvador;3502309;Anhembi;1;1;2;1453
3304557;Rio de Janeiro;3502200;Angatuba;1;1;2;529
3500709;Agudos;3502200;Angatuba;1;1;2;126
1100189;Pimenta Bueno;3502101;Andradina;1;1;2;1428
1100205;Porto Velho;3502101;Andradina;1;1;2;1841
3111804;Canápolis;3502101;Andradina;1;1;2;334
3501608;Americana;3502002;Analândia;1;1;2;76
2307650;Maracanaú;3501905;Amparo;1;1;2;2232
2604106;Caruaru;3501905;Amparo;1;1;2;1919
2933307;Vitória da Conquista;3501905;Amparo;1;1;2;1051
3106200;Belo Horizonte;3501905;Amparo;1;1;2;420
3118601;Contagem;3501905;Amparo;1;1;2;411
3133402;Itapagipe;3501905;Amparo;1;1;2;408
3143401;Monte Sião;3501905;Amparo;1;1;2;36
3144805;Nova Lima;3501905;Amparo;1;1;2;419
3146008;Ouro Fino;3501905;Amparo;1;1;2;62
3147907;Passos;3501905;Amparo;1;1;2;222
3163706;São Lourenço;3501905;Amparo;1;1;2;190
3501608;Americana;3501905;Amparo;1;1;2;59
2927408;Salvador;3501707;Américo Brasiliense;1;1;2;1371
3110707;Cambuquira;3501707;Américo Brasiliense;1;1;2;291
2304400;Fortaleza;3501608;Americana;1;1;2;2270
2403251;Parnamirim;3501608;Americana;1;1;2;2209
2910800;Feira de Santana;3501608;Americana;1;1;2;1426
2914703;Itaberaba;3501608;Americana;1;1;2;1326
2930709;Simões Filho;3501608;Americana;1;1;2;1417
3104304;Areado;3501608;Americana;1;1;2;195
3128006;Guanhães;3501608;Americana;1;1;2;629
3129509;Ibiá;3501608;Americana;1;1;2;374
3130705;Indianópolis;3501608;Americana;1;1;2;414
3134202;Ituiutaba;3501608;Americana;1;1;2;470
3136702;Juiz de Fora;3501608;Americana;1;1;2;424
3143302;Montes Claros;3501608;Americana;1;1;2;751
3154606;Ribeirão das Neves;3501608;Americana;1;1;2;466
3167202;Sete Lagoas;3501608;Americana;1;1;2;483
3168101;Tapira;3501608;Americana;1;1;2;316
3170404;Unaí;3501608;Americana;1;1;2;703
3203908;Nova Venécia;3501608;Americana;1;1;2;833
3300803;Cachoeiras de Macacu;3501608;Americana;1;1;2;482
3303401;Nova Friburgo;3501608;Americana;1;1;2;490
3303906;Petrópolis;3501608;Americana;1;1;2;423
3306008;Três Rios;3501608;Americana;1;1;2;427
3501004;Altinópolis;3501608;Americana;1;1;2;190
1100122;Ji-Paraná;3501301;Álvares Machado;1;1;2;1616
2105302;Imperatriz;3501301;Álvares Machado;1;1;2;1876
3170206;Uberlândia;3501152;Alumínio;1;1;2;523
2304400;Fortaleza;3501103;Alto Alegre;1;1;2;2285
3104007;Araxá;3501004;Altinópolis;1;1;2;165
3106705;Betim;3501004;Altinópolis;1;1;2;350
3147907;Passos;3501004;Altinópolis;1;1;2;85
3170206;Uberlândia;3501004;Altinópolis;1;1;2;253
3304557;Rio de Janeiro;3501004;Altinópolis;1;1;2;477
2611606;Recife;3500709;Agudos;1;1;2;2115
2930709;Simões Filho;3500709;Agudos;1;1;2;1509
3148103;Patrocínio;3500709;Agudos;1;1;2;442
3304557;Rio de Janeiro;3500709;Agudos;1;1;2;593
3500600;Águas de São Pedro;3500709;Agudos;1;1;2;115
3110509;Camanducaia;3500501;Águas de Lindóia;1;1;2;59
3125101;Extrema;3500501;Águas de Lindóia;1;1;2;53
3146008;Ouro Fino;3500501;Águas de Lindóia;1;1;2;35
3149101;Pedralva;3500501;Águas de Lindóia;1;1;2;123
3152501;Pouso Alegre;3500501;Águas de Lindóia;1;1;2;76
3102605;Andradas;3500402;Águas da Prata;1;1;2;21
3139003;Machado;3500402;Águas da Prata;1;1;2;87
3301702;Duque de Caxias;3500402;Águas da Prata;1;1;2;364
2926004;Remanso;3500303;Aguaí;1;1;2;1465
3102605;Andradas;3500303;Aguaí;1;1;2;42
3151800;Poços de Caldas;3500303;Aguaí;1;1;2;55
3134400;Iturama;3500105;Adamantina;1;1;2;235
3145000;Nova Ponte;3500105;Adamantina;1;1;2;449
3170701;Varginha;3500105;Adamantina;1;1;2;589
2609600;Olinda;3306305;Volta Redonda;1;1;2;1845
2906501;Candeias;3306305;Volta Redonda;1;1;2;1221
2910057;Dias d'Ávila;3306305;Volta Redonda;1;1;2;1239
2927408;Salvador;3306305;Volta Redonda;1;1;2;1194
3104205;Arcos;3306305;Volta Redonda;1;1;2;285
3106705;Betim;3306305;Volta Redonda;1;1;2;282
3131307;Ipatinga;3306305;Volta Redonda;1;1;2;371
3131703;Itabira;3306305;Volta Redonda;1;1;2;330
3133808;Itaúna;3306305;Volta Redonda;1;1;2;270
3140803;Matias Barbosa;3306305;Volta Redonda;1;1;2;106
3143906;Muriaé;3306305;Volta Redonda;1;1;2;240
3160702;Santos Dumont;3306305;Volta Redonda;1;1;2;126
3167202;Sete Lagoas;3306305;Volta Redonda;1;1;2;339
3169901;Ubá;3306305;Volta Redonda;1;1;2;193
3201308;Cariacica;3306305;Volta Redonda;1;1;2;448
3202603;Iconha;3306305;Volta Redonda;1;1;2;386
3205002;Serra;3306305;Volta Redonda;1;1;2;468
3205200;Vila Velha;3306305;Volta Redonda;1;1;2;450
3300209;Araruama;3306305;Volta Redonda;1;1;2;186
3300704;Cabo Frio;3306305;Volta Redonda;1;1;2;213
3301702;Duque de Caxias;3306305;Volta Redonda;1;1;2;86
3302502;Magé;3306305;Volta Redonda;1;1;2;107
3302700;Maricá;3306305;Volta Redonda;1;1;2;140
3303104;Natividade;3306305;Volta Redonda;1;1;2;271
3304003;Piraí;3306305;Volta Redonda;1;1;2;25
3304144;Queimados;3306305;Volta Redonda;1;1;2;58
3304524;Rio das Ostras;3306305;Volta Redonda;1;1;2;221
3149309;Pedro Leopoldo;3306206;Vassouras;1;1;2;312
3300407;Barra Mansa;3306206;Vassouras;1;1;2;57
3301801;Engenheiro Paulo de Frontin;3306206;Vassouras;1;1;2;16
3301900;Itaboraí;3306206;Vassouras;1;1;2;91
3302809;Mendes;3306206;Vassouras;1;1;2;16
3303708;Paraíba do Sul;3306206;Vassouras;1;1;2;47
3303856;Paty do Alferes;3306206;Vassouras;1;1;2;25
3304201;Resende;3306206;Vassouras;1;1;2;82
3304508;Rio das Flores;3306206;Vassouras;1;1;2;27
3124203;Espera Feliz;3306156;Varre-Sai;1;1;2;31
3202306;Guaçuí;3306156;Varre-Sai;1;1;2;26
3301009;Campos dos Goytacazes;3306156;Varre-Sai;1;1;2;111
3302452;Macuco;3306156;Varre-Sai;1;1;2;123
3303005;Miracema;3306156;Varre-Sai;1;1;2;65
3303104;Natividade;3306156;Varre-Sai;1;1;2;16
3106200;Belo Horizonte;3306107;Valença;1;1;2;258
3107505;Bom Jardim de Minas;3306107;Valença;1;1;2;55
3138500;Liberdade;3306107;Valença;1;1;2;63
3300407;Barra Mansa;3306107;Valença;1;1;2;58
3301702;Duque de Caxias;3306107;Valença;1;1;2;75
3302908;Miguel Pereira;3306107;Valença;1;1;2;39
3303302;Niterói;3306107;Valença;1;1;2;99
3304508;Rio das Flores;3306107;Valença;1;1;2;17
3304524;Rio das Ostras;3306107;Valença;1;1;2;187
1506161;Rio Maria;3306008;Três Rios;1;1;2;1767
1506583;Santa Maria das Barreiras;3306008;Três Rios;1;1;2;1599
2611606;Recife;3306008;Três Rios;1;1;2;1751
2905701;Camaçari;3306008;Três Rios;1;1;2;1149
2912806;Ibirapuã;3306008;Três Rios;1;1;2;580
2918902;Lajedão;3306008;Três Rios;1;1;2;574
2927408;Salvador;3306008;Três Rios;1;1;2;1113
2930709;Simões Filho;3306008;Três Rios;1;1;2;1136
3101607;Alfenas;3306008;Três Rios;1;1;2;290
3104205;Arcos;3306008;Três Rios;1;1;2;308
3106200;Belo Horizonte;3306008;Três Rios;1;1;2;252
3116209;Chiador;3306008;Três Rios;1;1;2;20
3118007;Congonhas;3306008;Três Rios;1;1;2;186
3123007;Dores de Campos;3306008;Três Rios;1;1;2;134
3157807;Santa Luzia;3306008;Três Rios;1;1;2;262
3162906;São João Nepomuceno;3306008;Três Rios;1;1;2;63
3167202;Sete Lagoas;3306008;Três Rios;1;1;2;309
3170206;Uberlândia;3306008;Três Rios;1;1;2;622
3205002;Serra;3306008;Três Rios;1;1;2;369
3205309;Vitória;3306008;Três Rios;1;1;2;362
3300100;Angra dos Reis;3306008;Três Rios;1;1;2;144
3302908;Miguel Pereira;3306008;Três Rios;1;1;2;49
3304144;Queimados;3306008;Três Rios;1;1;2;80
3304524;Rio das Ostras;3306008;Três Rios;1;1;2;140
3304904;São Gonçalo;3306008;Três Rios;1;1;2;81
3305802;Teresópolis;3306008;Três Rios;1;1;2;46
3300159;Aperibé;3305901;Trajano de Morais;1;1;2;51
3300506;Bom Jardim;3305901;Trajano de Morais;1;1;2;38
3301009;Campos dos Goytacazes;3305901;Trajano de Morais;1;1;2;82
3301603;Duas Barras;3305901;Trajano de Morais;1;1;2;47
3302452;Macuco;3305901;Trajano de Morais;1;1;2;21
3303401;Nova Friburgo;3305901;Trajano de Morais;1;1;2;59
1302603;Manaus;3305802;Teresópolis;1;1;2;2718
1500800;Ananindeua;3305802;Teresópolis;1;1;2;2388
1501402;Belém;3305802;Teresópolis;1;1;2;2388
1700400;Almas;3305802;Teresópolis;1;1;2;1269
2105302;Imperatriz;3305802;Teresópolis;1;1;2;1922
2211001;Teresina;3305802;Teresópolis;1;1;2;1918
2304400;Fortaleza;3305802;Teresópolis;1;1;2;2111
2611101;Petrolina;3305802;Teresópolis;1;1;2;1473
2611606;Recife;3305802;Teresópolis;1;1;2;1774
2800308;Aracaju;3305802;Teresópolis;1;1;2;1407
2910800;Feira de Santana;3305802;Teresópolis;1;1;2;1193
2914802;Itabuna;3305802;Teresópolis;1;1;2;925
2927408;Salvador;3305802;Teresópolis;1;1;2;1139
3105608;Barbacena;3305802;Teresópolis;1;1;2;158
3115300;Cataguases;3305802;Teresópolis;1;1;2;122
3169901;Ubá;3305802;Teresópolis;1;1;2;148
3170107;Uberaba;3305802;Teresópolis;1;1;2;582
3170206;Uberlândia;3305802;Teresópolis;1;1;2;662
3201209;Cachoeiro de Itapemirim;3305802;Teresópolis;1;1;2;265
3205200;Vila Velha;3305802;Teresópolis;1;1;2;355
3300233;Armação dos Búzios;3305802;Teresópolis;1;1;2;117
3300308;Barra do Piraí;3305802;Teresópolis;1;1;2;84
3300456;Belford Roxo;3305802;Teresópolis;1;1;2;55
3301207;Carmo;3305802;Teresópolis;1;1;2;68
3301900;Itaboraí;3305802;Teresópolis;1;1;2;39
3304300;Rio Bonito;3305802;Teresópolis;1;1;2;51
3305406;Sapucaia;3305802;Teresópolis;1;1;2;49
3203205;Linhares;3305752;Tanguá;1;1;2;464
3205309;Vitória;3305752;Tanguá;1;1;2;370
3300209;Araruama;3305752;Tanguá;1;1;2;43
3300803;Cachoeiras de Macacu;3305752;Tanguá;1;1;2;31
3302007;Itaguaí;3305752;Tanguá;1;1;2;111
3302502;Magé;3305752;Tanguá;1;1;2;36
3303302;Niterói;3305752;Tanguá;1;1;2;41
3304300;Rio Bonito;3305752;Tanguá;1;1;2;12
3305505;Saquarema;3305752;Tanguá;1;1;2;31
3101508;Além Paraíba;3305703;Sumidouro;1;1;2;26
3115300;Cataguases;3305703;Sumidouro;1;1;2;75
3300803;Cachoeiras de Macacu;3305703;Sumidouro;1;1;2;46
3301207;Carmo;3305703;Sumidouro;1;1;2;15
1720978;Talismã;3305604;Silva Jardim;1;1;2;1280
3300704;Cabo Frio;3305604;Silva Jardim;1;1;2;41
3301900;Itaboraí;3305604;Silva Jardim;1;1;2;49
3303302;Niterói;3305604;Silva Jardim;1;1;2;77
3304904;São Gonçalo;3305604;Silva Jardim;1;1;2;71
2927408;Salvador;3305554;Seropédica;1;1;2;1199
3136702;Juiz de Fora;3305554;Seropédica;1;1;2;116
3201308;Cariacica;3305554;Seropédica;1;1;2;432
3205002;Serra;3305554;Seropédica;1;1;2;451
3302601;Mangaratiba;3305554;Seropédica;1;1;2;37
3303500;Nova Iguaçu;3305554;Seropédica;1;1;2;24
3304904;São Gonçalo;3305554;Seropédica;1;1;2;66
3305109;São João de Meriti;3305554;Seropédica;1;1;2;34
3305505;Saquarema;3305554;Seropédica;1;1;2;128
1501402;Belém;3305505;Saquarema;1;1;2;2446
1600303;Macapá;3305505;Saquarema;1;1;2;2673
2408102;Natal;3305505;Saquarema;1;1;2;2014
2507507;João Pessoa;3305505;Saquarema;1;1;2;1888
2915205;Itagibá;3305505;Saquarema;1;1;2;984
2919207;Lauro de Freitas;3305505;Saquarema;1;1;2;1178
3136702;Juiz de Fora;3305505;Saquarema;1;1;2;150
3143302;Montes Claros;3305505;Saquarema;1;1;2;692
3143906;Muriaé;3305505;Saquarema;1;1;2;198
3170107;Uberaba;3305505;Saquarema;1;1;2;652
3200904;Barra de São Francisco;3305505;Saquarema;1;1;2;479
3203403;Mimoso do Sul;3305505;Saquarema;1;1;2;227
3204807;São José do Calçado;3305505;Saquarema;1;1;2;219
3300803;Cachoeiras de Macacu;3305505;Saquarema;1;1;2;47
3301009;Campos dos Goytacazes;3305505;Saquarema;1;1;2;166
3301876;Iguaba Grande;3305505;Saquarema;1;1;2;24
3302502;Magé;3305505;Saquarema;1;1;2;66
3303906;Petrópolis;3305505;Saquarema;1;1;2;85
3304110;Porto Real;3305505;Saquarema;1;1;2;197
1302603;Manaus;3305406;Sapucaia;1;1;2;2691
2914802;Itabuna;3305406;Sapucaia;1;1;2;878
3103504;Araguari;3305406;Sapucaia;1;1;2;656
3106200;Belo Horizonte;3305406;Sapucaia;1;1;2;256
3113404;Caratinga;3305406;Sapucaia;1;1;2;253
3143906;Muriaé;3305406;Sapucaia;1;1;2;118
3148202;Patrocínio do Muriaé;3305406;Sapucaia;1;1;2;118
3172004;Visconde do Rio Branco;3305406;Sapucaia;1;1;2;109
3172103;Volta Grande;3305406;Sapucaia;1;1;2;46
3201100;Bom Jesus do Norte;3305406;Sapucaia;1;1;2;161
3301207;Carmo;3305406;Sapucaia;1;1;2;32
3302106;Itaocara;3305406;Sapucaia;1;1;2;93
3302452;Macuco;3305406;Sapucaia;1;1;2;68
3303401;Nova Friburgo;3305406;Sapucaia;1;1;2;48
3303856;Paty do Alferes;3305406;Sapucaia;1;1;2;71
3300159;Aperibé;3305307;São Sebastião do Alto;1;1;2;35
3300902;Cambuci;3305307;São Sebastião do Alto;1;1;2;50
3301108;Cantagalo;3305307;São Sebastião do Alto;1;1;2;22
3303401;Nova Friburgo;3305307;São Sebastião do Alto;1;1;2;59
3304557;Rio de Janeiro;3305307;São Sebastião do Alto;1;1;2;155
3304607;Santa Maria Madalena;3305307;São Sebastião do Alto;1;1;2;17
2407104;Macaíba;3305208;São Pedro da Aldeia;1;1;2;1992
2611606;Recife;3305208;São Pedro da Aldeia;1;1;2;1775
2800308;Aracaju;3305208;São Pedro da Aldeia;1;1;2;1412
3104601;Astolfo Dutra;3305208;São Pedro da Aldeia;1;1;2;185
3106200;Belo Horizonte;3305208;São Pedro da Aldeia;1;1;2;376
3169901;Ubá;3305208;São Pedro da Aldeia;1;1;2;212
3201308;Cariacica;3305208;São Pedro da Aldeia;1;1;2;331
3204906;São Mateus;3305208;São Pedro da Aldeia;1;1;2;504
3205200;Vila Velha;3305208;São Pedro da Aldeia;1;1;2;328
3205309;Vitória;3305208;São Pedro da Aldeia;1;1;2;339
3300258;Arraial do Cabo;3305208;São Pedro da Aldeia;1;1;2;18
3303203;Nilópolis;3305208;São Pedro da Aldeia;1;1;2;136
3304144;Queimados;3305208;São Pedro da Aldeia;1;1;2;152
3304904;São Gonçalo;3305208;São Pedro da Aldeia;1;1;2;98
2905701;Camaçari;3305158;São José do Vale do Rio Preto;1;1;2;1144
3169307;Três Corações;3305158;São José do Vale do Rio Preto;1;1;2;243
3301504;Cordeiro;3305158;São José do Vale do Rio Preto;1;1;2;59
3301702;Duque de Caxias;3305158;São José do Vale do Rio Preto;1;1;2;79
3303906;Petrópolis;3305158;São José do Vale do Rio Preto;1;1;2;52
3304524;Rio das Ostras;3305158;São José do Vale do Rio Preto;1;1;2;106
3304557;Rio de Janeiro;3305158;São José do Vale do Rio Preto;1;1;2;88
3302106;Itaocara;3305133;São José de Ubá;1;1;2;38
3303104;Natividade;3305133;São José de Ubá;1;1;2;35
3304706;Santo Antônio de Pádua;3305133;São José de Ubá;1;1;2;32
2800308;Aracaju;3305109;São João de Meriti;1;1;2;1458
2804805;Nossa Senhora do Socorro;3305109;São João de Meriti;1;1;2;1459
2927408;Salvador;3305109;São João de Meriti;1;1;2;1190
3118601;Contagem;3305109;São João de Meriti;1;1;2;326
3122306;Divinópolis;3305109;São João de Meriti;1;1;2;329
3136702;Juiz de Fora;3305109;São João de Meriti;1;1;2;115
3201209;Cachoeiro de Itapemirim;3305109;São João de Meriti;1;1;2;319
3300100;Angra dos Reis;3305109;São João de Meriti;1;1;2;95
3300258;Arraial do Cabo;3305109;São João de Meriti;1;1;2;140
3300407;Barra Mansa;3305109;São João de Meriti;1;1;2;89
3300605;Bom Jesus do Itabapoana;3305109;São João de Meriti;1;1;2;253
3302270;Japeri;3305109;São João de Meriti;1;1;2;33
3303609;Paracambi;3305109;São João de Meriti;1;1;2;41
3303708;Paraíba do Sul;3305109;São João de Meriti;1;1;2;70
3304201;Resende;3305109;São João de Meriti;1;1;2;115
3105400;Barão de Cocais;3305000;São João da Barra;1;1;2;314
3300704;Cabo Frio;3305000;São João da Barra;1;1;2;170
3302205;Itaperuna;3305000;São João da Barra;1;1;2;101
3304755;São Francisco de Itabapoana;3305000;São João da Barra;1;1;2;39
3304805;São Fidélis;3305000;São João da Barra;1;1;2;70
1500800;Ananindeua;3304904;São Gonçalo;1;1;2;2426
2304285;Eusébio;3304904;São Gonçalo;1;1;2;2139
2307601;Limoeiro do Norte;3304904;São Gonçalo;1;1;2;2012
2607901;Jaboatão dos Guararapes;3304904;São Gonçalo;1;1;2;1807
2804805;Nossa Senhora do Socorro;3304904;São Gonçalo;1;1;2;1446
2910800;Feira de Santana;3304904;São Gonçalo;1;1;2;1232
3106705;Betim;3304904;São Gonçalo;1;1;2;333
3118601;Contagem;3304904;São Gonçalo;1;1;2;334
3122306;Divinópolis;3304904;São Gonçalo;1;1;2;345
3156700;Sabará;3304904;São Gonçalo;1;1;2;331
3170206;Uberlândia;3304904;São Gonçalo;1;1;2;680
3202405;Guarapari;3304904;São Gonçalo;1;1;2;349
3205101;Viana;3304904;São Gonçalo;1;1;2;366
3205200;Vila Velha;3304904;São Gonçalo;1;1;2;386
3205309;Vitória;3304904;São Gonçalo;1;1;2;397
3300258;Arraial do Cabo;3304904;São Gonçalo;1;1;2;109
3300308;Barra do Piraí;3304904;São Gonçalo;1;1;2;85
3300506;Bom Jardim;3304904;São Gonçalo;1;1;2;97
3301876;Iguaba Grande;3304904;São Gonçalo;1;1;2;85
3302452;Macuco;3304904;São Gonçalo;1;1;2;122
3303203;Nilópolis;3304904;São Gonçalo;1;1;2;38
3304003;Piraí;3304904;São Gonçalo;1;1;2;87
3304201;Resende;3304904;São Gonçalo;1;1;2;145
3304706;Santo Antônio de Pádua;3304904;São Gonçalo;1;1;2;165
3136702;Juiz de Fora;3304805;São Fidélis;1;1;2;164
3205309;Vitória;3304805;São Fidélis;1;1;2;217
3300159;Aperibé;3304805;São Fidélis;1;1;2;42
3301157;Cardoso Moreira;3304805;São Fidélis;1;1;2;25
3302056;Italva;3304805;São Fidélis;1;1;2;29
3302908;Miguel Pereira;3304805;São Fidélis;1;1;2;198
3303104;Natividade;3304805;São Fidélis;1;1;2;74
3303302;Niterói;3304805;São Fidélis;1;1;2;193
3304102;Porciúncula;3304805;São Fidélis;1;1;2;84
3203130;João Neiva;3304755;São Francisco de Itabapoana;1;1;2;184
3300605;Bom Jesus do Itabapoana;3304755;São Francisco de Itabapoana;1;1;2;68
3300704;Cabo Frio;3304755;São Francisco de Itabapoana;1;1;2;204
3300936;Carapebus;3304755;São Francisco de Itabapoana;1;1;2;117
3301157;Cardoso Moreira;3304755;São Francisco de Itabapoana;1;1;2;62
3302205;Itaperuna;3304755;São Francisco de Itabapoana;1;1;2;89
3304151;Quissamã;3304755;São Francisco de Itabapoana;1;1;2;100
3101508;Além Paraíba;3304706;Santo Antônio de Pádua;1;1;2;63
3113404;Caratinga;3304706;Santo Antônio de Pádua;1;1;2;191
3138401;Leopoldina;3304706;Santo Antônio de Pádua;1;1;2;52
3170206;Uberlândia;3304706;Santo Antônio de Pádua;1;1;2;690
3201100;Bom Jesus do Norte;3304706;Santo Antônio de Pádua;1;1;2;71
3204807;São José do Calçado;3304706;Santo Antônio de Pádua;1;1;2;79
3301009;Campos dos Goytacazes;3304706;Santo Antônio de Pádua;1;1;2;93
3301108;Cantagalo;3304706;Santo Antônio de Pádua;1;1;2;49
3302304;Laje do Muriaé;3304706;Santo Antônio de Pádua;1;1;2;37
3106200;Belo Horizonte;3304607;Santa Maria Madalena;1;1;2;304
3300704;Cabo Frio;3304607;Santa Maria Madalena;1;1;2;102
3301108;Cantagalo;3304607;Santa Maria Madalena;1;1;2;38
3302452;Macuco;3304607;Santa Maria Madalena;1;1;2;26
3303302;Niterói;3304607;Santa Maria Madalena;1;1;2;153
3303401;Nova Friburgo;3304607;Santa Maria Madalena;1;1;2;70
1100023;Ariquemes;3304557;Rio de Janeiro;1;1;2;2427
1100049;Cacoal;3304557;Rio de Janeiro;1;1;2;2209
1100106;Guajará-Mirim;3304557;Rio de Janeiro;1;1;2;2567
1200500;Sena Madureira;3304557;Rio de Janeiro;1;1;2;2944
1301001;Carauari;3304557;Rio de Janeiro;1;1;2;3060
1301704;Humaitá;3304557;Rio de Janeiro;1;1;2;2589
1301902;Itacoatiara;3304557;Rio de Janeiro;1;1;2;2649
1303809;São Gabriel da Cachoeira;3304557;Rio de Janeiro;1;1;2;3439
1400209;Caracaraí;3304557;Rio de Janeiro;1;1;2;3249
1400472;Rorainópolis;3304557;Rio de Janeiro;1;1;2;3126
1500107;Abaetetuba;3304557;Rio de Janeiro;1;1;2;2401
1501204;Baião;3304557;Rio de Janeiro;1;1;2;2309
1502400;Castanhal;3304557;Rio de Janeiro;1;1;2;2430
1503457;Ipixuna do Pará;3304557;Rio de Janeiro;1;1;2;2286
1503903;Juruti;3304557;Rio de Janeiro;1;1;2;2610
1504422;Marituba;3304557;Rio de Janeiro;1;1;2;2432
1504604;Mocajuba;3304557;Rio de Janeiro;1;1;2;2328
1504703;Moju;3304557;Rio de Janeiro;1;1;2;2379
1505031;Novo Progresso;3304557;Rio de Janeiro;1;1;2;2113
1506138;Redenção;3304557;Rio de Janeiro;1;1;2;1775
1506708;Santana do Araguaia;3304557;Rio de Janeiro;1;1;2;1657
1507607;São Miguel do Guamá;3304557;Rio de Janeiro;1;1;2;2389
1508084;Tucumã;3304557;Rio de Janeiro;1;1;2;1947
1703842;Campos Lindos;3304557;Rio de Janeiro;1;1;2;1680
1705508;Colinas do Tocantins;3304557;Rio de Janeiro;1;1;2;1718
1706001;Couto de Magalhães;3304557;Rio de Janeiro;1;1;2;1718
1711902;Lagoa da Confusão;3304557;Rio de Janeiro;1;1;2;1479
1712009;Lajeado;3304557;Rio de Janeiro;1;1;2;1538
1714203;Natividade;3304557;Rio de Janeiro;1;1;2;1313
1716109;Paraíso do Tocantins;3304557;Rio de Janeiro;1;1;2;1514
1717206;Piraquê;3304557;Rio de Janeiro;1;1;2;1850
1717800;Ponte Alta do Bom Jesus;3304557;Rio de Janeiro;1;1;2;1237
1717909;Ponte Alta do Tocantins;3304557;Rio de Janeiro;1;1;2;1405
1718204;Porto Nacional;3304557;Rio de Janeiro;1;1;2;1439
1720903;Taguatinga;3304557;Rio de Janeiro;1;1;2;1201
1720978;Talismã;3304557;Rio de Janeiro;1;1;2;1258
2100204;Alcântara;3304557;Rio de Janeiro;1;1;2;2270
2101608;Barra do Corda;3304557;Rio de Janeiro;1;1;2;1931
2102804;Carolina;3304557;Rio de Janeiro;1;1;2;1765
2103307;Codó;3304557;Rio de Janeiro;1;1;2;2036
2103802;Dom Pedro;3304557;Rio de Janeiro;1;1;2;1976
2105401;Itapecuru Mirim;3304557;Rio de Janeiro;1;1;2;2157
2106755;Miranda do Norte;3304557;Rio de Janeiro;1;1;2;2140
2109007;Porto Franco;3304557;Rio de Janeiro;1;1;2;1872
2109502;Riachão;3304557;Rio de Janeiro;1;1;2;1747
2109908;Santa Inês;3304557;Rio de Janeiro;1;1;2;2118
2110500;São Bento;3304557;Rio de Janeiro;1;1;2;2238
2112209;Timon;3304557;Rio de Janeiro;1;1;2;1964
2202307;Canto do Buriti;3304557;Rio de Janeiro;1;1;2;1640
2301000;Aquiraz;3304557;Rio de Janeiro;1;1;2;2153
2302107;Baturité;3304557;Rio de Janeiro;1;1;2;2097
2303501;Cascavel;3304557;Rio de Janeiro;1;1;2;2132
2304103;Crateús;3304557;Rio de Janeiro;1;1;2;1976
2305357;Icapuí;3304557;Rio de Janeiro;1;1;2;2090
2305506;Iguatu;3304557;Rio de Janeiro;1;1;2;1869
2306256;Itaitinga;3304557;Rio de Janeiro;1;1;2;2143
2307601;Limoeiro do Norte;3304557;Rio de Janeiro;1;1;2;2027
2307700;Maranguape;3304557;Rio de Janeiro;1;1;2;2148
2308401;Missão Velha;3304557;Rio de Janeiro;1;1;2;1776
2308708;Morada Nova;3304557;Rio de Janeiro;1;1;2;2021
2309706;Pacatuba;3304557;Rio de Janeiro;1;1;2;2139
2310209;Paracuru;3304557;Rio de Janeiro;1;1;2;2193
2311603;Redenção;3304557;Rio de Janeiro;1;1;2;2114
2312205;Santa Quitéria;3304557;Rio de Janeiro;1;1;2;2075
2313401;Tianguá;3304557;Rio de Janeiro;1;1;2;2130
2314102;Viçosa do Ceará;3304557;Rio de Janeiro;1;1;2;2147
2401008;Apodi;3304557;Rio de Janeiro;1;1;2;1965
2403103;Currais Novos;3304557;Rio de Janeiro;1;1;2;1955
2404101;Galinhos;3304557;Rio de Janeiro;1;1;2;2082
2409332;Santa Maria;3304557;Rio de Janeiro;1;1;2;2027
2411205;Santa Cruz;3304557;Rio de Janeiro;1;1;2;1974
2412005;São Gonçalo do Amarante;3304557;Rio de Janeiro;1;1;2;2045
2414209;Tibau do Sul;3304557;Rio de Janeiro;1;1;2;2011
2502151;Boa Vista;3304557;Rio de Janeiro;1;1;2;1862
2504850;Coxixola;3304557;Rio de Janeiro;1;1;2;1811
2505105;Cuité;3304557;Rio de Janeiro;1;1;2;1945
2506806;Ingá;3304557;Rio de Janeiro;1;1;2;1885
2511202;Pedras de Fogo;3304557;Rio de Janeiro;1;1;2;1894
2512507;Queimadas;3304557;Rio de Janeiro;1;1;2;1868
2515302;Sapé;3304557;Rio de Janeiro;1;1;2;1918
2600104;Afogados da Ingazeira;3304557;Rio de Janeiro;1;1;2;1761
2601003;Angelim;3304557;Rio de Janeiro;1;1;2;1695
2601409;Barreiros;3304557;Rio de Janeiro;1;1;2;1748
2603454;Camaragibe;3304557;Rio de Janeiro;1;1;2;1835
2604601;Condado;3304557;Rio de Janeiro;1;1;2;1874
2606200;Goiana;3304557;Rio de Janeiro;1;1;2;1880
2607406;Itacuruba;3304557;Rio de Janeiro;1;1;2;1623
2607752;Itapissuma;3304557;Rio de Janeiro;1;1;2;1863
2608909;Limoeiro;3304557;Rio de Janeiro;1;1;2;1831
2610905;Pesqueira;3304557;Rio de Janeiro;1;1;2;1733
2613602;São José do Egito;3304557;Rio de Janeiro;1;1;2;1803
2614204;Sirinhaém;3304557;Rio de Janeiro;1;1;2;1774
2615409;Toritama;3304557;Rio de Janeiro;1;1;2;1795
2615607;Trindade;3304557;Rio de Janeiro;1;1;2;1695
2700102;Água Branca;3304557;Rio de Janeiro;1;1;2;1596
2701506;Campo Grande;3304557;Rio de Janeiro;1;1;2;1567
2702405;Delmiro Gouveia;3304557;Rio de Janeiro;1;1;2;1585
2703502;Jacuípe;3304557;Rio de Janeiro;1;1;2;1734
2705200;Messias;3304557;Rio de Janeiro;1;1;2;1664
2706703;Penedo;3304557;Rio de Janeiro;1;1;2;1546
2708600;São Miguel dos Campos;3304557;Rio de Janeiro;1;1;2;1613
2802106;Estância;3304557;Rio de Janeiro;1;1;2;1410
2803203;Itaporanga d'Ajuda;3304557;Rio de Janeiro;1;1;2;1441
2803906;Malhador;3304557;Rio de Janeiro;1;1;2;1476
2804003;Maruim;3304557;Rio de Janeiro;1;1;2;1479
2806107;Rosário do Catete;3304557;Rio de Janeiro;1;1;2;1483
2806701;São Cristóvão;3304557;Rio de Janeiro;1;1;2;1449
2807402;Tobias Barreto;3304557;Rio de Janeiro;1;1;2;1401
2901007;Amargosa;3304557;Rio de Janeiro;1;1;2;1149
2902054;Araças;3304557;Rio de Janeiro;1;1;2;1283
2902807;Barra da Estiva;3304557;Rio de Janeiro;1;1;2;1043
2903102;Barra do Rocha;3304557;Rio de Janeiro;1;1;2;1030
2903904;Bom Jesus da Lapa;3304557;Rio de Janeiro;1;1;2;1063
2904605;Brumado;3304557;Rio de Janeiro;1;1;2;974
2905602;Camacan;3304557;Rio de Janeiro;1;1;2;907
2908507;Conceição do Jacuípe;3304557;Rio de Janeiro;1;1;2;1249
2909307;Correntina;3304557;Rio de Janeiro;1;1;2;1064
2911105;Formosa do Rio Preto;3304557;Rio de Janeiro;1;1;2;1324
2911402;Glória;3304557;Rio de Janeiro;1;1;2;1576
2912202;Ibicoara;3304557;Rio de Janeiro;1;1;2;1066
2912806;Ibirapuã;3304557;Rio de Janeiro;1;1;2;657
2913705;Inhambupe;3304557;Rio de Janeiro;1;1;2;1321
2914604;Irecê;3304557;Rio de Janeiro;1;1;2;1284
2916104;Itaparica;3304557;Rio de Janeiro;1;1;2;1191
2916401;Itapetinga;3304557;Rio de Janeiro;1;1;2;894
2917409;Jacaraci;3304557;Rio de Janeiro;1;1;2;893
2917508;Jacobina;3304557;Rio de Janeiro;1;1;2;1317
2917706;Jaguarari;3304557;Rio de Janeiro;1;1;2;1429
2917805;Jaguaripe;3304557;Rio de Janeiro;1;1;2;1161
2918753;Lagoa Real;3304557;Rio de Janeiro;1;1;2;985
2918803;Laje;3304557;Rio de Janeiro;1;1;2;1140
2919801;Macaúbas;3304557;Rio de Janeiro;1;1;2;1092
2922508;Nazaré;3304557;Rio de Janeiro;1;1;2;1168
2924009;Paulo Afonso;3304557;Rio de Janeiro;1;1;2;1568
2928802;Santo Estêvão;3304557;Rio de Janeiro;1;1;2;1224
2928901;São Desidério;3304557;Rio de Janeiro;1;1;2;1176
2929602;Sapeaçu;3304557;Rio de Janeiro;1;1;2;1195
2929701;Sátiro Dias;3304557;Rio de Janeiro;1;1;2;1331
2930105;Senhor do Bonfim;3304557;Rio de Janeiro;1;1;2;1410
2932507;Una;3304557;Rio de Janeiro;1;1;2;938
3101904;Alpinópolis;3304557;Rio de Janeiro;1;1;2;389
3102308;Alvinópolis;3304557;Rio de Janeiro;1;1;2;308
3102902;Antônio Carlos;3304557;Rio de Janeiro;1;1;2;180
3104601;Astolfo Dutra;3304557;Rio de Janeiro;1;1;2;178
3105103;Bambuí;3304557;Rio de Janeiro;1;1;2;421
3106101;Belmiro Braga;3304557;Rio de Janeiro;1;1;2;104
3107109;Boa Esperança;3304557;Rio de Janeiro;1;1;2;307
3107307;Bocaiúva;3304557;Rio de Janeiro;1;1;2;639
3107406;Bom Despacho;3304557;Rio de Janeiro;1;1;2;404
3107505;Bom Jardim de Minas;3304557;Rio de Janeiro;1;1;2;140
3107703;Bom Jesus do Amparo;3304557;Rio de Janeiro;1;1;2;352
3109006;Brumadinho;3304557;Rio de Janeiro;1;1;2;318
3109402;Buritizeiro;3304557;Rio de Janeiro;1;1;2;635
3110301;Caldas;3304557;Rio de Janeiro;1;1;2;336
3110707;Cambuquira;3304557;Rio de Janeiro;1;1;2;237
3113701;Carlos Chagas;3304557;Rio de Janeiro;1;1;2;623
3113909;Carmo da Cachoeira;3304557;Rio de Janeiro;1;1;2;255
3114105;Carmo de Minas;3304557;Rio de Janeiro;1;1;2;209
3115359;Catas Altas;3304557;Rio de Janeiro;1;1;2;311
3116605;Cláudio;3304557;Rio de Janeiro;1;1;2;310
3117603;Conceição do Pará;3304557;Rio de Janeiro;1;1;2;384
3118908;Cordisburgo;3304557;Rio de Janeiro;1;1;2;430
3119302;Coromandel;3304557;Rio de Janeiro;1;1;2;631
3119609;Coronel Pacheco;3304557;Rio de Janeiro;1;1;2;143
3120805;Cruzília;3304557;Rio de Janeiro;1;1;2;196
3123106;Dores de Guanhães;3304557;Rio de Janeiro;1;1;2;425
3124807;Estrela do Sul;3304557;Rio de Janeiro;1;1;2;641
3125309;Faria Lemos;3304557;Rio de Janeiro;1;1;2;264
3127008;Fronteira;3304557;Rio de Janeiro;1;1;2;669
3127107;Frutal;3304557;Rio de Janeiro;1;1;2;657
3127388;Goianá;3304557;Rio de Janeiro;1;1;2;149
3127800;Grão Mogol;3304557;Rio de Janeiro;1;1;2;701
3128907;Guimarânia;3304557;Rio de Janeiro;1;1;2;572
3129509;Ibiá;3304557;Rio de Janeiro;1;1;2;505
3129707;Ibiraci;3304557;Rio de Janeiro;1;1;2;475
3130002;Ibituruna;3304557;Rio de Janeiro;1;1;2;244
3130309;Iguatama;3304557;Rio de Janeiro;1;1;2;390
3131604;Iraí de Minas;3304557;Rio de Janeiro;1;1;2;606
3131802;Itabirinha de Mantena;3304557;Rio de Janeiro;1;1;2;520
3133006;Itamonte;3304557;Rio de Janeiro;1;1;2;177
3133105;Itanhandu;3304557;Rio de Janeiro;1;1;2;183
3134509;Itutinga;3304557;Rio de Janeiro;1;1;2;226
3137536;Lagoa Grande;3304557;Rio de Janeiro;1;1;2;648
3137809;Lambari;3304557;Rio de Janeiro;1;1;2;240
3138104;Lassance;3304557;Rio de Janeiro;1;1;2;570
3138609;Lima Duarte;3304557;Rio de Janeiro;1;1;2;127
3139102;Madre de Deus de Minas;3304557;Rio de Janeiro;1;1;2;189
3139805;Mar de Espanha;3304557;Rio de Janeiro;1;1;2;115
3140001;Mariana;3304557;Rio de Janeiro;1;1;2;278
3140506;Martinho Campos;3304557;Rio de Janeiro;1;1;2;441
3141108;Matozinhos;3304557;Rio de Janeiro;1;1;2;377
3142809;Monte Alegre de Minas;3304557;Rio de Janeiro;1;1;2;721
3143104;Monte Carmelo;3304557;Rio de Janeiro;1;1;2;629
3144508;Nazareno;3304557;Rio de Janeiro;1;1;2;230
3145059;Nova Porteirinha;3304557;Rio de Janeiro;1;1;2;783
3147105;Pará de Minas;3304557;Rio de Janeiro;1;1;2;362
3149101;Pedralva;3304557;Rio de Janeiro;1;1;2;236
3149903;Perdões;3304557;Rio de Janeiro;1;1;2;274
3150307;Piedade do Rio Grande;3304557;Rio de Janeiro;1;1;2;183
3151107;Pirapetinga;3304557;Rio de Janeiro;1;1;2;165
3151503;Piumhi;3304557;Rio de Janeiro;1;1;2;383
3152105;Ponte Nova;3304557;Rio de Janeiro;1;1;2;276
3152600;Pouso Alto;3304557;Rio de Janeiro;1;1;2;191
3152808;Prata;3304557;Rio de Janeiro;1;1;2;702
3152907;Pratápolis;3304557;Rio de Janeiro;1;1;2;436
3153608;Prudente de Morais;3304557;Rio de Janeiro;1;1;2;387
3155801;Rio Pomba;3304557;Rio de Janeiro;1;1;2;178
3155900;Rio Preto;3304557;Rio de Janeiro;1;1;2;111
3156403;Romaria;3304557;Rio de Janeiro;1;1;2;622
3157005;Salinas;3304557;Rio de Janeiro;1;1;2;748
3157609;Santa Fé de Minas;3304557;Rio de Janeiro;1;1;2;719
3158706;Santana do Garambéu;3304557;Rio de Janeiro;1;1;2;166
3158953;Santana do Paraíso;3304557;Rio de Janeiro;1;1;2;396
3160108;Santo Antônio do Grama;3304557;Rio de Janeiro;1;1;2;292
3160801;São Bento Abade;3304557;Rio de Janeiro;1;1;2;234
3161403;São Francisco do Glória;3304557;Rio de Janeiro;1;1;2;253
3161908;São Gonçalo do Rio Abaixo;3304557;Rio de Janeiro;1;1;2;338
3162104;São Gotardo;3304557;Rio de Janeiro;1;1;2;487
3162708;São João do Paraíso;3304557;Rio de Janeiro;1;1;2;846
3162955;São José da Lapa;3304557;Rio de Janeiro;1;1;2;360
3165537;Sarzedo;3304557;Rio de Janeiro;1;1;2;328
3166808;Serra do Salitre;3304557;Rio de Janeiro;1;1;2;543
3167509;Simão Pereira;3304557;Rio de Janeiro;1;1;2;102
3169000;Tocantins;3304557;Rio de Janeiro;1;1;2;190
3169604;Tupaciguara;3304557;Rio de Janeiro;1;1;2;727
3170008;Ubaí;3304557;Rio de Janeiro;1;1;2;746
3170404;Unaí;3304557;Rio de Janeiro;1;1;2;806
3170800;Várzea da Palma;3304557;Rio de Janeiro;1;1;2;604
3172103;Volta Grande;3304557;Rio de Janeiro;1;1;2;143
3200201;Alegre;3304557;Rio de Janeiro;1;1;2;290
3201902;Domingos Martins;3304557;Rio de Janeiro;1;1;2;385
3202009;Dores do Rio Preto;3304557;Rio de Janeiro;1;1;2;283
3203320;Marataízes;3304557;Rio de Janeiro;1;1;2;316
3203403;Mimoso do Sul;3304557;Rio de Janeiro;1;1;2;279
3203809;Muqui;3304557;Rio de Janeiro;1;1;2;289
3204203;Piúma;3304557;Rio de Janeiro;1;1;2;343
3300506;Bom Jardim;3304557;Rio de Janeiro;1;1;2;118
3300936;Carapebus;3304557;Rio de Janeiro;1;1;2;181
3301157;Cardoso Moreira;3304557;Rio de Janeiro;1;1;2;228
3301603;Duas Barras;3304557;Rio de Janeiro;1;1;2;119
3302056;Italva;3304557;Rio de Janeiro;1;1;2;228
3302106;Itaocara;3304557;Rio de Janeiro;1;1;2;180
3303955;Pinheiral;3304557;Rio de Janeiro;1;1;2;86
2304400;Fortaleza;3304524;Rio das Ostras;1;1;2;2095
2607901;Jaboatão dos Guararapes;3304524;Rio das Ostras;1;1;2;1729
2919207;Lauro de Freitas;3304524;Rio das Ostras;1;1;2;1121
2927408;Salvador;3304524;Rio das Ostras;1;1;2;1105
2931350;Teixeira de Freitas;3304524;Rio das Ostras;1;1;2;589
3144805;Nova Lima;3304524;Rio das Ostras;1;1;2;333
3201308;Cariacica;3304524;Rio das Ostras;1;1;2;289
3202405;Guarapari;3304524;Rio das Ostras;1;1;2;247
3205002;Serra;3304524;Rio das Ostras;1;1;2;308
3300308;Barra do Piraí;3304524;Rio das Ostras;1;1;2;193
3300605;Bom Jesus do Itabapoana;3304524;Rio das Ostras;1;1;2;150
3300803;Cachoeiras de Macacu;3304524;Rio das Ostras;1;1;2;72
3300902;Cambuci;3304524;Rio das Ostras;1;1;2;102
3302106;Itaocara;3304524;Rio das Ostras;1;1;2;88
3302502;Magé;3304524;Rio das Ostras;1;1;2;116
3302858;Mesquita;3304524;Rio das Ostras;1;1;2;158
3303203;Nilópolis;3304524;Rio das Ostras;1;1;2;157
3303708;Paraíba do Sul;3304524;Rio das Ostras;1;1;2;142
1501402;Belém;3304508;Rio das Flores;1;1;2;2349
2610707;Paulista;3304508;Rio das Flores;1;1;2;1797
2704302;Maceió;3304508;Rio das Flores;1;1;2;1592
3152501;Pouso Alegre;3304508;Rio das Flores;1;1;2;244
3170107;Uberaba;3304508;Rio das Flores;1;1;2;518
3303906;Petrópolis;3304508;Rio das Flores;1;1;2;55
3106200;Belo Horizonte;3304409;Rio Claro;1;1;2;313
3300407;Barra Mansa;3304409;Rio Claro;1;1;2;22
3302601;Mangaratiba;3304409;Rio Claro;1;1;2;21
3304003;Piraí;3304409;Rio Claro;1;1;2;27
3304201;Resende;3304409;Rio Claro;1;1;2;40
2304400;Fortaleza;3304300;Rio Bonito;1;1;2;2133
2919207;Lauro de Freitas;3304300;Rio Bonito;1;1;2;1169
2927408;Salvador;3304300;Rio Bonito;1;1;2;1153
3131703;Itabira;3304300;Rio Bonito;1;1;2;347
3157807;Santa Luzia;3304300;Rio Bonito;1;1;2;348
3300605;Bom Jesus do Itabapoana;3304300;Rio Bonito;1;1;2;199
3300803;Cachoeiras de Macacu;3304300;Rio Bonito;1;1;2;27
3301850;Guapimirim;3304300;Rio Bonito;1;1;2;41
3303807;Parati;3304300;Rio Bonito;1;1;2;223
3304151;Quissamã;3304300;Rio Bonito;1;1;2;136
1302603;Manaus;3304201;Resende;1;1;2;2639
1501402;Belém;3304201;Resende;1;1;2;2370
2304400;Fortaleza;3304201;Resende;1;1;2;2154
2602902;Cabo de Santo Agostinho;3304201;Resende;1;1;2;1831
2611606;Recife;3304201;Resende;1;1;2;1851
2905701;Camaçari;3304201;Resende;1;1;2;1247
3106101;Belmiro Braga;3304201;Resende;1;1;2;123
3107208;Bocaina de Minas;3304201;Resende;1;1;2;38
3115508;Caxambu;3304201;Resende;1;1;2;83
3116605;Cláudio;3304201;Resende;1;1;2;231
3117504;Conceição do Mato Dentro;3304201;Resende;1;1;2;400
3121001;Datas;3304201;Resende;1;1;2;457
3132404;Itajubá;3304201;Resende;1;1;2;105
3147006;Paracatu;3304201;Resende;1;1;2;636
3167202;Sete Lagoas;3304201;Resende;1;1;2;341
3171006;Vazante;3304201;Resende;1;1;2;561
3205200;Vila Velha;3304201;Resende;1;1;2;482
3205309;Vitória;3304201;Resende;1;1;2;492
3300456;Belford Roxo;3304201;Resende;1;1;2;112
3301009;Campos dos Goytacazes;3304201;Resende;1;1;2;331
3302205;Itaperuna;3304201;Resende;1;1;2;303
3302403;Macaé;3304201;Resende;1;1;2;263
3302502;Magé;3304201;Resende;1;1;2;143
3303708;Paraíba do Sul;3304201;Resende;1;1;2;125
3300704;Cabo Frio;3304151;Quissamã;1;1;2;105
3301157;Cardoso Moreira;3304151;Quissamã;1;1;2;70
3302452;Macuco;3304151;Quissamã;1;1;2;82
3303104;Natividade;3304151;Quissamã;1;1;2;129
1302603;Manaus;3304144;Queimados;1;1;2;2705
2601102;Araripina;3304144;Queimados;1;1;2;1704
2905701;Camaçari;3304144;Queimados;1;1;2;1226
3106200;Belo Horizonte;3304144;Queimados;1;1;2;314
3300209;Araruama;3304144;Queimados;1;1;2;129
3300308;Barra do Piraí;3304144;Queimados;1;1;2;36
3302502;Magé;3304144;Queimados;1;1;2;54
2305233;Horizonte;3304110;Porto Real;1;1;2;2104
3106200;Belo Horizonte;3304110;Porto Real;1;1;2;279
3118601;Contagem;3304110;Porto Real;1;1;2;275
3159605;Santa Rita do Sapucaí;3304110;Porto Real;1;1;2;143
3167202;Sete Lagoas;3304110;Porto Real;1;1;2;328
3169307;Três Corações;3304110;Porto Real;1;1;2;123
3201308;Cariacica;3304110;Porto Real;1;1;2;462
3300100;Angra dos Reis;3304110;Porto Real;1;1;2;58
3301702;Duque de Caxias;3304110;Porto Real;1;1;2;112
3302270;Japeri;3304110;Porto Real;1;1;2;75
3303906;Petrópolis;3304110;Porto Real;1;1;2;115
3143906;Muriaé;3304102;Porciúncula;1;1;2;33
3158953;Santana do Paraíso;3304102;Porciúncula;1;1;2;185
3201209;Cachoeiro de Itapemirim;3304102;Porciúncula;1;1;2;100
3300605;Bom Jesus do Itabapoana;3304102;Porciúncula;1;1;2;42
3302106;Itaocara;3304102;Porciúncula;1;1;2;79
3302809;Mendes;3304102;Porciúncula;1;1;2;249
3303302;Niterói;3304102;Porciúncula;1;1;2;239
2913606;Ilhéus;3304003;Piraí;1;1;2;991
3140803;Matias Barbosa;3304003;Piraí;1;1;2;103
3300209;Araruama;3304003;Piraí;1;1;2;162
3301009;Campos dos Goytacazes;3304003;Piraí;1;1;2;280
3303708;Paraíba do Sul;3304003;Piraí;1;1;2;81
2929206;São Francisco do Conde;3303955;Pinheiral;1;1;2;1216
3136702;Juiz de Fora;3303955;Pinheiral;1;1;2;108
3140803;Matias Barbosa;3303955;Pinheiral;1;1;2;100
3157807;Santa Luzia;3303955;Pinheiral;1;1;2;304
3160702;Santos Dumont;3303955;Pinheiral;1;1;2;123
3170107;Uberaba;3303955;Pinheiral;1;1;2;503
3300407;Barra Mansa;3303955;Pinheiral;1;1;2;21
1302603;Manaus;3303906;Petrópolis;1;1;2;2713
2111300;São Luís;3303906;Petrópolis;1;1;2;2214
2408102;Natal;3303906;Petrópolis;1;1;2;2010
2910727;Eunápolis;3303906;Petrópolis;1;1;2;774
3101508;Além Paraíba;3303906;Petrópolis;1;1;2;95
3106705;Betim;3303906;Petrópolis;1;1;2;301
3106903;Bicas;3303906;Petrópolis;1;1;2;92
3122306;Divinópolis;3303906;Petrópolis;1;1;2;312
3131703;Itabira;3303906;Petrópolis;1;1;2;321
3134905;Jacutinga;3303906;Petrópolis;1;1;2;350
3139805;Mar de Espanha;3303906;Petrópolis;1;1;2;76
3140803;Matias Barbosa;3303906;Petrópolis;1;1;2;74
3158607;Santana do Deserto;3303906;Petrópolis;1;1;2;64
3162906;São João Nepomuceno;3303906;Petrópolis;1;1;2;112
3167202;Sete Lagoas;3303906;Petrópolis;1;1;2;358
3170404;Unaí;3303906;Petrópolis;1;1;2;775
3205002;Serra;3303906;Petrópolis;1;1;2;399
3300407;Barra Mansa;3303906;Petrópolis;1;1;2;101
3300951;Comendador Levy Gasparian;3303906;Petrópolis;1;1;2;55
3301306;Casimiro de Abreu;3303906;Petrópolis;1;1;2;105
3302700;Maricá;3303906;Petrópolis;1;1;2;60
3303609;Paracambi;3303906;Petrópolis;1;1;2;51
3143906;Muriaé;3303856;Paty do Alferes;1;1;2;187
3300308;Barra do Piraí;3303856;Paty do Alferes;1;1;2;42
3303401;Nova Friburgo;3303856;Paty do Alferes;1;1;2;88
2919207;Lauro de Freitas;3303807;Parati;1;1;2;1308
3300233;Armação dos Búzios;3303807;Parati;1;1;2;292
3302601;Mangaratiba;3303807;Parati;1;1;2;79
2925105;Poções;3303708;Paraíba do Sul;1;1;2;899
2927408;Salvador;3303708;Paraíba do Sul;1;1;2;1125
3106200;Belo Horizonte;3303708;Paraíba do Sul;1;1;2;260
3152105;Ponte Nova;3303708;Paraíba do Sul;1;1;2;198
3201209;Cachoeiro de Itapemirim;3303708;Paraíba do Sul;1;1;2;270
3201308;Cariacica;3303708;Paraíba do Sul;1;1;2;360
3300225;Areal;3303708;Paraíba do Sul;1;1;2;19
3300308;Barra do Piraí;3303708;Paraíba do Sul;1;1;2;65
3300704;Cabo Frio;3303708;Paraíba do Sul;1;1;2;149
3301702;Duque de Caxias;3303708;Paraíba do Sul;1;1;2;67
3301900;Itaboraí;3303708;Paraíba do Sul;1;1;2;79
3302205;Itaperuna;3303708;Paraíba do Sul;1;1;2;183
3302908;Miguel Pereira;3303708;Paraíba do Sul;1;1;2;37
3303500;Nova Iguaçu;3303708;Paraíba do Sul;1;1;2;68
2610707;Paulista;3303609;Paracambi;1;1;2;1842
3300308;Barra do Piraí;3303609;Paracambi;1;1;2;17
3300456;Belford Roxo;3303609;Paracambi;1;1;2;38
3302858;Mesquita;3303609;Paracambi;1;1;2;36
3303104;Natividade;3303609;Paracambi;1;1;2;247
2401107;Areia Branca;3303500;Nova Iguaçu;1;1;2;2065
2507507;João Pessoa;3303500;Nova Iguaçu;1;1;2;1921
2601706;Belo Jardim;3303500;Nova Iguaçu;1;1;2;1738
2606804;Igarassu;3303500;Nova Iguaçu;1;1;2;1853
2609600;Olinda;3303500;Nova Iguaçu;1;1;2;1839
2611606;Recife;3303500;Nova Iguaçu;1;1;2;1826
2704302;Maceió;3303500;Nova Iguaçu;1;1;2;1641
3128402;Guarani;3303500;Nova Iguaçu;1;1;2;161
3133006;Itamonte;3303500;Nova Iguaçu;1;1;2;152
3146107;Ouro Preto;3303500;Nova Iguaçu;1;1;2;263
3149309;Pedro Leopoldo;3303500;Nova Iguaçu;1;1;2;353
3162500;São João del Rei;3303500;Nova Iguaçu;1;1;2;199
3202603;Iconha;3303500;Nova Iguaçu;1;1;2;348
3205101;Viana;3303500;Nova Iguaçu;1;1;2;394
3300209;Araruama;3303500;Nova Iguaçu;1;1;2;116
3300233;Armação dos Búzios;3303500;Nova Iguaçu;1;1;2;160
3300308;Barra do Piraí;3303500;Nova Iguaçu;1;1;2;48
3301900;Itaboraí;3303500;Nova Iguaçu;1;1;2;63
3302205;Itaperuna;3303500;Nova Iguaçu;1;1;2;241
3302502;Magé;3303500;Nova Iguaçu;1;1;2;44
1302603;Manaus;3303401;Nova Friburgo;1;1;2;2734
2307650;Maracanaú;3303401;Nova Friburgo;1;1;2;2076
3101508;Além Paraíba;3303401;Nova Friburgo;1;1;2;54
3106200;Belo Horizonte;3303401;Nova Friburgo;1;1;2;301
3106705;Betim;3303401;Nova Friburgo;1;1;2;306
3118601;Contagem;3303401;Nova Friburgo;1;1;2;305
3148004;Patos de Minas;3303401;Nova Friburgo;1;1;2;573
3200409;Anchieta;3303401;Nova Friburgo;1;1;2;252
3201209;Cachoeiro de Itapemirim;3303401;Nova Friburgo;1;1;2;223
3205002;Serra;3303401;Nova Friburgo;1;1;2;334
3300233;Armação dos Búzios;3303401;Nova Friburgo;1;1;2;83
3300605;Bom Jesus do Itabapoana;3303401;Nova Friburgo;1;1;2;158
3301207;Carmo;3303401;Nova Friburgo;1;1;2;40
3301850;Guapimirim;3303401;Nova Friburgo;1;1;2;50
3302452;Macuco;3303401;Nova Friburgo;1;1;2;48
1100189;Pimenta Bueno;3303302;Niterói;1;1;2;2188
1501402;Belém;3303302;Niterói;1;1;2;2435
1505064;Novo Repartimento;3303302;Niterói;1;1;2;2168
2111300;São Luís;3303302;Niterói;1;1;2;2253
2203909;Floriano;3303302;Niterói;1;1;2;1778
2303709;Caucaia;3303302;Niterói;1;1;2;2163
2513604;Santana dos Garrotes;3303302;Niterói;1;1;2;1787
2602902;Cabo de Santo Agostinho;3303302;Niterói;1;1;2;1801
2609600;Olinda;3303302;Niterói;1;1;2;1834
2920601;Maragogipe;3303302;Niterói;1;1;2;1191
2921708;Morro do Chapéu;3303302;Niterói;1;1;2;1268
3105301;Bandeira do Sul;3303302;Niterói;1;1;2;359
3121605;Diamantina;3303302;Niterói;1;1;2;519
3122306;Divinópolis;3303302;Niterói;1;1;2;351
3140803;Matias Barbosa;3303302;Niterói;1;1;2;114
3167202;Sete Lagoas;3303302;Niterói;1;1;2;398
3200409;Anchieta;3303302;Niterói;1;1;2;334
3300225;Areal;3303302;Niterói;1;1;2;73
3300308;Barra do Piraí;3303302;Niterói;1;1;2;87
3300407;Barra Mansa;3303302;Niterói;1;1;2;119
3300605;Bom Jesus do Itabapoana;3303302;Niterói;1;1;2;242
3301108;Cantagalo;3303302;Niterói;1;1;2;128
3301306;Casimiro de Abreu;3303302;Niterói;1;1;2;102
3301504;Cordeiro;3303302;Niterói;1;1;2;120
3301876;Iguaba Grande;3303302;Niterói;1;1;2;89
2804805;Nossa Senhora do Socorro;3303203;Nilópolis;1;1;2;1463
3205002;Serra;3303203;Nilópolis;1;1;2;435
3300704;Cabo Frio;3303203;Nilópolis;1;1;2;140
3302205;Itaperuna;3303203;Nilópolis;1;1;2;243
3113305;Carangola;3303104;Natividade;1;1;2;35
3113404;Caratinga;3303104;Natividade;1;1;2;138
3118601;Contagem;3303104;Natividade;1;1;2;252
3138401;Leopoldina;3303104;Natividade;1;1;2;92
3169208;Tombos;3303104;Natividade;1;1;2;16
3201209;Cachoeiro de Itapemirim;3303104;Natividade;1;1;2;95
3301405;Conceição de Macabu;3303104;Natividade;1;1;2;116
3302106;Itaocara;3303104;Natividade;1;1;2;71
3302809;Mendes;3303104;Natividade;1;1;2;248
3302908;Miguel Pereira;3303104;Natividade;1;1;2;221
3138401;Leopoldina;3303005;Miracema;1;1;2;50
3201308;Cariacica;3303005;Miracema;1;1;2;224
3301009;Campos dos Goytacazes;3303005;Miracema;1;1;2;102
3301504;Cordeiro;3303005;Miracema;1;1;2;70
3302205;Itaperuna;3303005;Miracema;1;1;2;46
3302403;Macaé;3303005;Miracema;1;1;2;110
3101508;Além Paraíba;3302908;Miguel Pereira;1;1;2;105
3136702;Juiz de Fora;3302908;Miguel Pereira;1;1;2;79
3300308;Barra do Piraí;3302908;Miguel Pereira;1;1;2;37
3302809;Mendes;3302908;Miguel Pereira;1;1;2;30
2304400;Fortaleza;3302858;Mesquita;1;1;2;2159
3106705;Betim;3302858;Mesquita;1;1;2;322
3127701;Governador Valadares;3302858;Mesquita;1;1;2;465
3131307;Ipatinga;3302858;Mesquita;1;1;2;379
3136207;João Monlevade;3302858;Mesquita;1;1;2;331
3301702;Duque de Caxias;3302858;Mesquita;1;1;2;13
3106903;Bicas;3302809;Mendes;1;1;2;113
3300308;Barra do Piraí;3302809;Mendes;1;1;2;9
3302007;Itaguaí;3302809;Mendes;1;1;2;32
3302270;Japeri;3302809;Mendes;1;1;2;17
2111300;São Luís;3302700;Maricá;1;1;2;2259
3205200;Vila Velha;3302700;Maricá;1;1;2;379
3300803;Cachoeiras de Macacu;3302700;Maricá;1;1;2;53
3301876;Iguaba Grande;3302700;Maricá;1;1;2;61
2304400;Fortaleza;3302601;Mangaratiba;1;1;2;2183
2925303;Porto Seguro;3302601;Mangaratiba;1;1;2;868
3136702;Juiz de Fora;3302601;Mangaratiba;1;1;2;145
3157807;Santa Luzia;3302601;Mangaratiba;1;1;2;346
3205309;Vitória;3302601;Mangaratiba;1;1;2;478
3106200;Belo Horizonte;3302502;Magé;1;1;2;317
3149309;Pedro Leopoldo;3302502;Magé;1;1;2;349
3205309;Vitória;3302502;Magé;1;1;2;386
3301876;Iguaba Grande;3302502;Magé;1;1;2;87
3302007;Itaguaí;3302502;Magé;1;1;2;79
3302403;Macaé;3302502;Magé;1;1;2;124
3301009;Campos dos Goytacazes;3302452;Macuco;1;1;2;98
1400100;Boa Vista;3302403;Macaé;1;1;2;3349
2111300;São Luís;3302403;Macaé;1;1;2;2205
2310209;Paracuru;3302403;Macaé;1;1;2;2114
2404507;Guamaré;3302403;Macaé;1;1;2;1987
2408102;Natal;3302403;Macaé;1;1;2;1945
2607208;Ipojuca;3302403;Macaé;1;1;2;1687
2611606;Recife;3302403;Macaé;1;1;2;1720
2800605;Barra dos Coqueiros;3302403;Macaé;1;1;2;1362
2905701;Camaçari;3302403;Macaé;1;1;2;1128
2919207;Lauro de Freitas;3302403;Macaé;1;1;2;1108
2925204;Pojuca;3302403;Macaé;1;1;2;1155
2929503;São Sebastião do Passé;3302403;Macaé;1;1;2;1142
2930709;Simões Filho;3302403;Macaé;1;1;2;1116
3106705;Betim;3302403;Macaé;1;1;2;354
3116605;Cláudio;3302403;Macaé;1;1;2;362
3118304;Conselheiro Lafaiete;3302403;Macaé;1;1;2;273
3122306;Divinópolis;3302403;Macaé;1;1;2;391
3131307;Ipatinga;3302403;Macaé;1;1;2;327
3165537;Sarzedo;3302403;Macaé;1;1;2;345
3200607;Aracruz;3302403;Macaé;1;1;2;327
3201100;Bom Jesus do Norte;3302403;Macaé;1;1;2;140
3202405;Guarapari;3302403;Macaé;1;1;2;235
3202504;Ibiraçu;3302403;Macaé;1;1;2;320
3204807;São José do Calçado;3302403;Macaé;1;1;2;150
3300605;Bom Jesus do Itabapoana;3302403;Macaé;1;1;2;138
3301504;Cordeiro;3302403;Macaé;1;1;2;60
3301009;Campos dos Goytacazes;3302304;Laje do Muriaé;1;1;2;105
2905701;Camaçari;3302270;Japeri;1;1;2;1223
2611606;Recife;3302254;Itatiaia;1;1;2;1855
2910057;Dias d'Ávila;3302254;Itatiaia;1;1;2;1260
2927408;Salvador;3302254;Itatiaia;1;1;2;1216
3107208;Bocaina de Minas;3302254;Itatiaia;1;1;2;40
3118601;Contagem;3302254;Itatiaia;1;1;2;288
3133808;Itaúna;3302254;Itatiaia;1;1;2;263
3202603;Iconha;3302254;Itatiaia;1;1;2;429
3205002;Serra;3302254;Itatiaia;1;1;2;509
3300233;Armação dos Búzios;3302254;Itatiaia;1;1;2;276
3300308;Barra do Piraí;3302254;Itatiaia;1;1;2;79
3300407;Barra Mansa;3302254;Itatiaia;1;1;2;40
2915601;Itamaraju;3302205;Itaperuna;1;1;2;516
3111200;Campo Belo;3302205;Itaperuna;1;1;2;352
3111606;Campos Gerais;3302205;Itaperuna;1;1;2;402
3112109;Caparaó;3302205;Itaperuna;1;1;2;68
3138401;Leopoldina;3302205;Itaperuna;1;1;2;94
3141108;Matozinhos;3302205;Itaperuna;1;1;2;286
3142205;Miraí;3302205;Itaperuna;1;1;2;76
3169208;Tombos;3302205;Itaperuna;1;1;2;30
3169901;Ubá;3302205;Itaperuna;1;1;2;114
3170206;Uberlândia;3302205;Itaperuna;1;1;2;703
3201209;Cachoeiro de Itapemirim;3302205;Itaperuna;1;1;2;90
3202603;Iconha;3302205;Itaperuna;1;1;2;118
3203809;Muqui;3302205;Itaperuna;1;1;2;60
3204104;Pinheiros;3302205;Itaperuna;1;1;2;347
3205002;Serra;3302205;Itaperuna;1;1;2;198
3300209;Araruama;3302205;Itaperuna;1;1;2;199
3300308;Barra do Piraí;3302205;Itaperuna;1;1;2;250
3300456;Belford Roxo;3302205;Itaperuna;1;1;2;239
3301702;Duque de Caxias;3302205;Itaperuna;1;1;2;234
3301900;Itaboraí;3302205;Itaperuna;1;1;2;204
3302056;Italva;3302205;Itaperuna;1;1;2;37
3302106;Itaocara;3302205;Itaperuna;1;1;2;63
3151107;Pirapetinga;3302106;Itaocara;1;1;2;27
3205309;Vitória;3302106;Itaocara;1;1;2;242
3301009;Campos dos Goytacazes;3302106;Itaocara;1;1;2;80
3301108;Cantagalo;3302106;Itaocara;1;1;2;42
3149309;Pedro Leopoldo;3302056;Italva;1;1;2;316
3205200;Vila Velha;3302056;Italva;1;1;2;182
3300605;Bom Jesus do Itabapoana;3302056;Italva;1;1;2;32
3300902;Cambuci;3302056;Italva;1;1;2;28
3301157;Cardoso Moreira;3302056;Italva;1;1;2;11
2111300;São Luís;3302007;Itaguaí;1;1;2;2243
2800605;Barra dos Coqueiros;3302007;Itaguaí;1;1;2;1484
2925303;Porto Seguro;3302007;Itaguaí;1;1;2;849
3122306;Divinópolis;3302007;Itaguaí;1;1;2;313
3133808;Itaúna;3302007;Itaguaí;1;1;2;310
3136702;Juiz de Fora;3302007;Itaguaí;1;1;2;126
3149309;Pedro Leopoldo;3302007;Itaguaí;1;1;2;355
3167202;Sete Lagoas;3302007;Itaguaí;1;1;2;375
3201308;Cariacica;3302007;Itaguaí;1;1;2;444
3205101;Viana;3302007;Itaguaí;1;1;2;424
3301900;Itaboraí;3302007;Itaguaí;1;1;2;98
2800605;Barra dos Coqueiros;3301900;Itaboraí;1;1;2;1437
2905701;Camaçari;3301900;Itaboraí;1;1;2;1200
3131307;Ipatinga;3301900;Itaboraí;1;1;2;364
3138401;Leopoldina;3301900;Itaboraí;1;1;2;135
3200904;Barra de São Francisco;3301900;Itaboraí;1;1;2;483
3205200;Vila Velha;3301900;Itaboraí;1;1;2;368
3300456;Belford Roxo;3301900;Itaboraí;1;1;2;56
3301306;Casimiro de Abreu;3301900;Itaboraí;1;1;2;73
3301876;Iguaba Grande;3301900;Itaboraí;1;1;2;64
3300704;Cabo Frio;3301876;Iguaba Grande;1;1;2;19
3300803;Cachoeiras de Macacu;3301876;Iguaba Grande;1;1;2;56
2927408;Salvador;3301850;Guapimirim;1;1;2;1149
3300308;Barra do Piraí;3301850;Guapimirim;1;1;2;87
3300506;Bom Jardim;3301850;Guapimirim;1;1;2;72
3300803;Cachoeiras de Macacu;3301850;Guapimirim;1;1;2;35
1501808;Breves;3301702;Duque de Caxias;1;1;2;2441
1702000;Araguaçu;3301702;Duque de Caxias;1;1;2;1268
2103000;Caxias;3301702;Duque de Caxias;1;1;2;1981
2105302;Imperatriz;3301702;Duque de Caxias;1;1;2;1951
2108603;Pinheiro;3301702;Duque de Caxias;1;1;2;2248
2109007;Porto Franco;3301702;Duque de Caxias;1;1;2;1859
2111300;São Luís;3301702;Duque de Caxias;1;1;2;2240
2112209;Timon;3301702;Duque de Caxias;1;1;2;1951
2112803;Viana;3301702;Duque de Caxias;1;1;2;2175
2211001;Teresina;3301702;Duque de Caxias;1;1;2;1956
2301109;Aracati;3301702;Duque de Caxias;1;1;2;2086
2304202;Crato;3301702;Duque de Caxias;1;1;2;1763
2306306;Itapagé;3301702;Duque de Caxias;1;1;2;2142
2307601;Limoeiro do Norte;3301702;Duque de Caxias;1;1;2;2016
2312908;Sobral;3301702;Duque de Caxias;1;1;2;2132
2403251;Parnamirim;3301702;Duque de Caxias;1;1;2;2026
2408003;Mossoró;3301702;Duque de Caxias;1;1;2;2032
2503209;Cabedelo;3301702;Duque de Caxias;1;1;2;1929
2507507;João Pessoa;3301702;Duque de Caxias;1;1;2;1915
2602902;Cabo de Santo Agostinho;3301702;Duque de Caxias;1;1;2;1800
2607208;Ipojuca;3301702;Duque de Caxias;1;1;2;1787
2609600;Olinda;3301702;Duque de Caxias;1;1;2;1833
2615409;Toritama;3301702;Duque de Caxias;1;1;2;1785
2707503;Porto Real do Colégio;3301702;Duque de Caxias;1;1;2;1537
2905701;Camaçari;3301702;Duque de Caxias;1;1;2;1220
2910800;Feira de Santana;3301702;Duque de Caxias;1;1;2;1238
2913606;Ilhéus;3301702;Duque de Caxias;1;1;2;978
3101102;Aimorés;3301702;Duque de Caxias;1;1;2;426
3102902;Antônio Carlos;3301702;Duque de Caxias;1;1;2;166
3103504;Araguari;3301702;Duque de Caxias;1;1;2;674
3113404;Caratinga;3301702;Duque de Caxias;1;1;2;346
3129806;Ibirité;3301702;Duque de Caxias;1;1;2;313
3137601;Lagoa Santa;3301702;Duque de Caxias;1;1;2;352
3139003;Machado;3301702;Duque de Caxias;1;1;2;292
3144805;Nova Lima;3301702;Duque de Caxias;1;1;2;309
3146107;Ouro Preto;3301702;Duque de Caxias;1;1;2;265
3149309;Pedro Leopoldo;3301702;Duque de Caxias;1;1;2;357
3155801;Rio Pomba;3301702;Duque de Caxias;1;1;2;165
3159605;Santa Rita do Sapucaí;3301702;Duque de Caxias;1;1;2;251
3167202;Sete Lagoas;3301702;Duque de Caxias;1;1;2;380
3167509;Simão Pereira;3301702;Duque de Caxias;1;1;2;89
3170701;Varginha;3301702;Duque de Caxias;1;1;2;255
3172004;Visconde do Rio Branco;3301702;Duque de Caxias;1;1;2;200
3201209;Cachoeiro de Itapemirim;3301702;Duque de Caxias;1;1;2;312
3202405;Guarapari;3301702;Duque de Caxias;1;1;2;366
3204906;São Mateus;3301702;Duque de Caxias;1;1;2;564
3300258;Arraial do Cabo;3301702;Duque de Caxias;1;1;2;134
3300704;Cabo Frio;3301702;Duque de Caxias;1;1;2;128
3300951;Comendador Levy Gasparian;3301702;Duque de Caxias;1;1;2;81
2918407;Juazeiro;3301603;Duas Barras;1;1;2;1406
3301108;Cantagalo;3301603;Duas Barras;1;1;2;19
3301504;Cordeiro;3301603;Duas Barras;1;1;2;16
3300803;Cachoeiras de Macacu;3301504;Cordeiro;1;1;2;56
2907509;Catu;3301405;Conceição de Macabu;1;1;2;1133
3300704;Cabo Frio;3301405;Conceição de Macabu;1;1;2;89
3300936;Carapebus;3301405;Conceição de Macabu;1;1;2;24
3301009;Campos dos Goytacazes;3301405;Conceição de Macabu;1;1;2;65
3301108;Cantagalo;3301405;Conceição de Macabu;1;1;2;55
3143906;Muriaé;3301306;Casimiro de Abreu;1;1;2;157
3201506;Colatina;3301306;Casimiro de Abreu;1;1;2;362
3300233;Armação dos Búzios;3301306;Casimiro de Abreu;1;1;2;40
3101508;Além Paraíba;3301207;Carmo;1;1;2;17
3201100;Bom Jesus do Norte;3301207;Carmo;1;1;2;133
3300209;Araruama;3301207;Carmo;1;1;2;109
3301009;Campos dos Goytacazes;3301207;Carmo;1;1;2;134
3301108;Cantagalo;3301207;Carmo;1;1;2;24
3170503;Urucânia;3301157;Cardoso Moreira;1;1;2;171
3149309;Pedro Leopoldo;3301108;Cantagalo;1;1;2;311
3205200;Vila Velha;3301108;Cantagalo;1;1;2;272
3300506;Bom Jardim;3301108;Cantagalo;1;1;2;24
2408102;Natal;3301009;Campos dos Goytacazes;1;1;2;1868
2704302;Maceió;3301009;Campos dos Goytacazes;1;1;2;1456
3101508;Além Paraíba;3301009;Campos dos Goytacazes;1;1;2;144
3122306;Divinópolis;3301009;Campos dos Goytacazes;1;1;2;408
3136702;Juiz de Fora;3301009;Campos dos Goytacazes;1;1;2;208
3140803;Matias Barbosa;3301009;Campos dos Goytacazes;1;1;2;207
3143302;Montes Claros;3301009;Campos dos Goytacazes;1;1;2;617
3149309;Pedro Leopoldo;3301009;Campos dos Goytacazes;1;1;2;371
3151107;Pirapetinga;3301009;Campos dos Goytacazes;1;1;2;107
3169901;Ubá;3301009;Campos dos Goytacazes;1;1;2;188
3200136;Águia Branca;3301009;Campos dos Goytacazes;1;1;2;317
3201100;Bom Jesus do Norte;3301009;Campos dos Goytacazes;1;1;2;83
3202603;Iconha;3301009;Campos dos Goytacazes;1;1;2;123
3203320;Marataízes;3301009;Campos dos Goytacazes;1;1;2;94
3204302;Presidente Kennedy;3301009;Campos dos Goytacazes;1;1;2;82
3204500;Santa Leopoldina;3301009;Campos dos Goytacazes;1;1;2;204
3204906;São Mateus;3301009;Campos dos Goytacazes;1;1;2;367
3205069;Venda Nova do Imigrante;3301009;Campos dos Goytacazes;1;1;2;162
3300209;Araruama;3301009;Campos dos Goytacazes;1;1;2;161
3300308;Barra do Piraí;3301009;Campos dos Goytacazes;1;1;2;270
2604106;Caruaru;3300951;Comendador Levy Gasparian;1;1;2;1684
3143906;Muriaé;3300951;Comendador Levy Gasparian;1;1;2;141
3158607;Santana do Deserto;3300951;Comendador Levy Gasparian;1;1;2;11
3167509;Simão Pereira;3300951;Comendador Levy Gasparian;1;1;2;12
3300456;Belford Roxo;3300936;Carapebus;1;1;2;191
3204658;São Domingos do Norte;3300902;Cambuci;1;1;2;297
1501501;Benevides;3300803;Cachoeiras de Macacu;1;1;2;2398
2103000;Caxias;3300803;Cachoeiras de Macacu;1;1;2;1949
2305233;Horizonte;3300803;Cachoeiras de Macacu;1;1;2;2072
3204708;São Gabriel da Palha;3300803;Cachoeiras de Macacu;1;1;2;440
3300704;Cabo Frio;3300803;Cachoeiras de Macacu;1;1;2;75
2304400;Fortaleza;3300704;Cabo Frio;1;1;2;2141
2408102;Natal;3300704;Cabo Frio;1;1;2;2003
3122306;Divinópolis;3300704;Cabo Frio;1;1;2;415
3138401;Leopoldina;3300704;Cabo Frio;1;1;2;160
3169901;Ubá;3300704;Cabo Frio;1;1;2;218
3201209;Cachoeiro de Itapemirim;3300704;Cabo Frio;1;1;2;247
3300308;Barra do Piraí;3300704;Cabo Frio;1;1;2;185
3300456;Belford Roxo;3300704;Cabo Frio;1;1;2;137
2606002;Garanhuns;3300605;Bom Jesus do Itabapoana;1;1;2;1455
3112109;Caparaó;3300605;Bom Jesus do Itabapoana;1;1;2;71
3132107;Itacarambi;3300605;Bom Jesus do Itabapoana;1;1;2;711
3136702;Juiz de Fora;3300605;Bom Jesus do Itabapoana;1;1;2;185
3139409;Manhuaçu;3300605;Bom Jesus do Itabapoana;1;1;2;107
3143906;Muriaé;3300605;Bom Jesus do Itabapoana;1;1;2;69
3201100;Bom Jesus do Norte;3300605;Bom Jesus do Itabapoana;1;1;2;2
3201407;Castelo;3300605;Bom Jesus do Itabapoana;1;1;2;73
3202603;Iconha;3300605;Bom Jesus do Itabapoana;1;1;2;98
3300100;Angra dos Reis;3300605;Bom Jesus do Itabapoana;1;1;2;337
3300209;Araruama;3300605;Bom Jesus do Itabapoana;1;1;2;206
3300225;Areal;3300605;Bom Jesus do Itabapoana;1;1;2;193
3106200;Belo Horizonte;3300506;Bom Jardim;1;1;2;296
3117900;Congonhal;3300506;Bom Jardim;1;1;2;373
2500601;Alhandra;3300456;Belford Roxo;1;1;2;1891
2927408;Salvador;3300456;Belford Roxo;1;1;2;1188
3122306;Divinópolis;3300456;Belford Roxo;1;1;2;325
3300407;Barra Mansa;3300456;Belford Roxo;1;1;2;86
2304400;Fortaleza;3300407;Barra Mansa;1;1;2;2149
2403251;Parnamirim;3300407;Barra Mansa;1;1;2;2039
2607208;Ipojuca;3300407;Barra Mansa;1;1;2;1807
2607901;Jaboatão dos Guararapes;3300407;Barra Mansa;1;1;2;1835
2611606;Recife;3300407;Barra Mansa;1;1;2;1840
2800308;Aracaju;3300407;Barra Mansa;1;1;2;1470
2905701;Camaçari;3300407;Barra Mansa;1;1;2;1237
2914802;Itabuna;3300407;Barra Mansa;1;1;2;989
3103009;Antônio Dias;3300407;Barra Mansa;1;1;2;346
3103603;Arantina;3300407;Barra Mansa;1;1;2;69
3104205;Arcos;3300407;Barra Mansa;1;1;2;283
3106705;Betim;3300407;Barra Mansa;1;1;2;285
3116605;Cláudio;3300407;Barra Mansa;1;1;2;238
3132404;Itajubá;3300407;Barra Mansa;1;1;2;131
3133105;Itanhandu;3300407;Barra Mansa;1;1;2;80
3133808;Itaúna;3300407;Barra Mansa;1;1;2;272
3136603;Nova União;3300407;Barra Mansa;1;1;2;321
3139003;Machado;3300407;Barra Mansa;1;1;2;200
3140001;Mariana;3300407;Barra Mansa;1;1;2;252
3140803;Matias Barbosa;3300407;Barra Mansa;1;1;2;116
3147808;Passa-Vinte;3300407;Barra Mansa;1;1;2;36
3158003;Santa Maria de Itabira;3300407;Barra Mansa;1;1;2;359
3163706;São Lourenço;3300407;Barra Mansa;1;1;2;96
3167004;Serranos;3300407;Barra Mansa;1;1;2;81
3170206;Uberlândia;3300407;Barra Mansa;1;1;2;576
3201407;Castelo;3300407;Barra Mansa;1;1;2;369
3203130;João Neiva;3300407;Barra Mansa;1;1;2;494
3205309;Vitória;3300407;Barra Mansa;1;1;2;471
3146503;Pains;3300308;Barra do Piraí;1;1;2;299
3151503;Piumhi;3300308;Barra do Piraí;1;1;2;311
3205200;Vila Velha;3300308;Barra do Piraí;1;1;2;425
3205309;Vitória;3300308;Barra do Piraí;1;1;2;435
3171204;Vespasiano;3300258;Arraial do Cabo;1;1;2;410
3300209;Araruama;3300258;Arraial do Cabo;1;1;2;34
3300233;Armação dos Búzios;3300258;Arraial do Cabo;1;1;2;30
3106200;Belo Horizonte;3300233;Armação dos Búzios;1;1;2;376
3136702;Juiz de Fora;3300233;Armação dos Búzios;1;1;2;180
3106200;Belo Horizonte;3300225;Areal;1;1;2;272
3136702;Juiz de Fora;3300225;Areal;1;1;2;56
3138401;Leopoldina;3300225;Areal;1;1;2;88
3169208;Tombos;3300225;Areal;1;1;2;185
3106200;Belo Horizonte;3300209;Araruama;1;1;2;370
3106705;Betim;3300209;Araruama;1;1;2;374
3122306;Divinópolis;3300209;Araruama;1;1;2;397
3205309;Vitória;3300209;Araruama;1;1;2;358
3136702;Juiz de Fora;3300100;Angra dos Reis;1;1;2;162
1100049;Cacoal;3205309;Vitória;1;1;2;2372
1100122;Ji-Paraná;3205309;Vitória;1;1;2;2434
1200401;Rio Branco;3205309;Vitória;1;1;2;3027
1301902;Itacoatiara;3205309;Vitória;1;1;2;2636
1400100;Boa Vista;3205309;Vitória;1;1;2;3277
1501303;Barcarena;3205309;Vitória;1;1;2;2236
1505304;Oriximiná;3205309;Vitória;1;1;2;2576
1506807;Santarém;3205309;Vitória;1;1;2;2446
2105302;Imperatriz;3205309;Vitória;1;1;2;1783
2210631;Sebastião Leal;3205309;Vitória;1;1;2;1454
2211001;Teresina;3205309;Vitória;1;1;2;1696
2302701;Campos Sales;3205309;Vitória;1;1;2;1457
2304285;Eusébio;3205309;Vitória;1;1;2;1819
2408003;Mossoró;3205309;Vitória;1;1;2;1693
2503209;Cabedelo;3205309;Vitória;1;1;2;1561
2507804;Junco do Seridó;3205309;Vitória;1;1;2;1511
2511400;Picuí;3205309;Vitória;1;1;2;1567
2602308;Bonito;3205309;Vitória;1;1;2;1383
2602902;Cabo de Santo Agostinho;3205309;Vitória;1;1;2;1428
2606200;Goiana;3205309;Vitória;1;1;2;1503
2607901;Jaboatão dos Guararapes;3205309;Vitória;1;1;2;1445
2611101;Petrolina;3205309;Vitória;1;1;2;1211
2900801;Alcobaça;3205309;Vitória;1;1;2;326
2903201;Barreiras;3205309;Vitória;1;1;2;1010
2906907;Caravelas;3205309;Vitória;1;1;2;299
2910800;Feira de Santana;3205309;Vitória;1;1;2;892
2914653;Itabela;3205309;Vitória;1;1;2;414
2918902;Lajedão;3205309;Vitória;1;1;2;292
2921005;Mata de São João;3205309;Vitória;1;1;2;879
2921203;Miguel Calmon;3205309;Vitória;1;1;2;976
2921401;Mirangaba;3205309;Vitória;1;1;2;1029
2923209;Oliveira dos Brejinhos;3205309;Vitória;1;1;2;916
2925758;Presidente Tancredo Neves;3205309;Vitória;1;1;2;758
2929503;São Sebastião do Passé;3205309;Vitória;1;1;2;876
2930709;Simões Filho;3205309;Vitória;1;1;2;849
2931806;Tremedal;3205309;Vitória;1;1;2;595
2933307;Vitória da Conquista;3205309;Vitória;1;1;2;599
3104007;Araxá;3205309;Vitória;1;1;2;696
3104700;Ataléia;3205309;Vitória;1;1;2;258
3105608;Barbacena;3205309;Vitória;1;1;2;381
3110103;Caiana;3205309;Vitória;1;1;2;176
3113404;Caratinga;3205309;Vitória;1;1;2;204
3114006;Carmo da Mata;3205309;Vitória;1;1;2;479
3117009;Comercinho;3205309;Vitória;1;1;2;464
3117876;Confins;3205309;Vitória;1;1;2;390
3118007;Congonhas;3205309;Vitória;1;1;2;375
3118304;Conselheiro Lafaiete;3205309;Vitória;1;1;2;371
3123106;Dores de Guanhães;3205309;Vitória;1;1;2;303
3131703;Itabira;3205309;Vitória;1;1;2;314
3133808;Itaúna;3205309;Vitória;1;1;2;447
3136207;João Monlevade;3205309;Vitória;1;1;2;303
3139003;Machado;3205309;Vitória;1;1;2;610
3139607;Mantena;3205309;Vitória;1;1;2;178
3143906;Muriaé;3205309;Vitória;1;1;2;232
3144805;Nova Lima;3205309;Vitória;1;1;2;371
3146107;Ouro Preto;3205309;Vitória;1;1;2;338
3148103;Patrocínio;3205309;Vitória;1;1;2;709
3151800;Poços de Caldas;3205309;Vitória;1;1;2;676
3154606;Ribeirão das Neves;3205309;Vitória;1;1;2;398
3157807;Santa Luzia;3205309;Vitória;1;1;2;373
3159506;Santa Rita do Itueto;3205309;Vitória;1;1;2;149
3167202;Sete Lagoas;3205309;Vitória;1;1;2;419
3168051;Taparuba;3205309;Vitória;1;1;2;147
3168705;Timóteo;3205309;Vitória;1;1;2;255
3171501;Mathias Lobato;3205309;Vitória;1;1;2;248
3201159;Brejetuba;3205309;Vitória;1;1;2;103
3202256;Governador Lindenberg;3205309;Vitória;1;1;2;112
3202553;Ibitirama;3205309;Vitória;1;1;2;146
3203163;Laranja da Terra;3205309;Vitória;1;1;2;87
1501402;Belém;3205200;Vila Velha;1;1;2;2249
1501501;Benevides;3205200;Vila Velha;1;1;2;2243
1502772;Curionópolis;3205200;Vila Velha;1;1;2;1837
1504208;Marabá;3205200;Vila Velha;1;1;2;1876
1505536;Parauapebas;3205200;Vila Velha;1;1;2;1853
2105302;Imperatriz;3205200;Vila Velha;1;1;2;1789
2111201;São José de Ribamar;3205200;Vila Velha;1;1;2;2004
2111300;São Luís;3205200;Vila Velha;1;1;2;2008
2211001;Teresina;3205200;Vila Velha;1;1;2;1704
2403251;Parnamirim;3205200;Vila Velha;1;1;2;1677
2408003;Mossoró;3205200;Vila Velha;1;1;2;1704
2503209;Cabedelo;3205200;Vila Velha;1;1;2;1572
2605202;Escada;3205200;Vila Velha;1;1;2;1424
2606002;Garanhuns;3205200;Vila Velha;1;1;2;1329
2607208;Ipojuca;3205200;Vila Velha;1;1;2;1426
2607901;Jaboatão dos Guararapes;3205200;Vila Velha;1;1;2;1456
2609402;Moreno;3205200;Vila Velha;1;1;2;1454
2800308;Aracaju;3205200;Vila Velha;1;1;2;1098
2916005;Itanhém;3205200;Vila Velha;1;1;2;351
2918407;Juazeiro;3205200;Vila Velha;1;1;2;1202
2919207;Lauro de Freitas;3205200;Vila Velha;1;1;2;851
2924009;Paulo Afonso;3205200;Vila Velha;1;1;2;1227
2925303;Porto Seguro;3205200;Vila Velha;1;1;2;451
3105608;Barbacena;3205200;Vila Velha;1;1;2;372
3117009;Comercinho;3205200;Vila Velha;1;1;2;471
3119401;Coronel Fabriciano;3205200;Vila Velha;1;1;2;252
3126000;Florestal;3205200;Vila Velha;1;1;2;427
3127107;Frutal;3205200;Vila Velha;1;1;2;899
3131901;Itabirito;3205200;Vila Velha;1;1;2;363
3135209;Januária;3205200;Vila Velha;1;1;2;680
3139508;Manhumirim;3205200;Vila Velha;1;1;2;166
3140803;Matias Barbosa;3205200;Vila Velha;1;1;2;353
3149309;Pedro Leopoldo;3205200;Vila Velha;1;1;2;393
3152501;Pouso Alegre;3205200;Vila Velha;1;1;2;622
3154606;Ribeirão das Neves;3205200;Vila Velha;1;1;2;393
3157807;Santa Luzia;3205200;Vila Velha;1;1;2;368
3162500;São João del Rei;3205200;Vila Velha;1;1;2;420
3168606;Teófilo Otoni;3205200;Vila Velha;1;1;2;299
3201001;Boa Esperança;3205200;Vila Velha;1;1;2;199
3201605;Conceição da Barra;3205200;Vila Velha;1;1;2;204
3202306;Guaçuí;3205200;Vila Velha;1;1;2;145
3202454;Ibatiba;3205200;Vila Velha;1;1;2;120
3202801;Itapemirim;3205200;Vila Velha;1;1;2;95
3204104;Pinheiros;3205200;Vila Velha;1;1;2;214
3204203;Piúma;3205200;Vila Velha;1;1;2;67
3205069;Venda Nova do Imigrante;3205200;Vila Velha;1;1;2;80
2910727;Eunápolis;3205176;Vila Valério;1;1;2;303
3200359;Alto Rio Novo;3205176;Vila Valério;1;1;2;66
3201159;Brejetuba;3205176;Vila Valério;1;1;2;159
3201506;Colatina;3205176;Vila Valério;1;1;2;66
3203205;Linhares;3205176;Vila Valério;1;1;2;54
3203502;Montanha;3205176;Vila Valério;1;1;2;99
3203908;Nova Venécia;3205176;Vila Valério;1;1;2;31
3204658;São Domingos do Norte;3205176;Vila Valério;1;1;2;30
3113701;Carlos Chagas;3205150;Vila Pavão;1;1;2;100
3141504;Mendes Pimentel;3205150;Vila Pavão;1;1;2;84
3201001;Boa Esperança;3205150;Vila Pavão;1;1;2;34
3201605;Conceição da Barra;3205150;Vila Pavão;1;1;2;85
3202108;Ecoporanga;3205150;Vila Pavão;1;1;2;39
3203205;Linhares;3205150;Vila Pavão;1;1;2;102
3204708;São Gabriel da Palha;3205150;Vila Pavão;1;1;2;41
3205002;Serra;3205150;Vila Pavão;1;1;2;171
2604106;Caruaru;3205101;Viana;1;1;2;1419
2607901;Jaboatão dos Guararapes;3205101;Viana;1;1;2;1471
2611606;Recife;3205101;Viana;1;1;2;1474
2707701;Rio Largo;3205101;Viana;1;1;2;1301
2804003;Maruim;3205101;Viana;1;1;2;1129
2906501;Candeias;3205101;Viana;1;1;2;881
2906709;Cândido Sales;3205101;Viana;1;1;2;550
2906907;Caravelas;3205101;Viana;1;1;2;325
2908507;Conceição do Jacuípe;3205101;Viana;1;1;2;912
2911204;Gandu;3205101;Viana;1;1;2;745
2914802;Itabuna;3205101;Viana;1;1;2;636
2915304;Itagimirim;3205101;Viana;1;1;2;488
2919553;Luís Eduardo magalhães;3205101;Viana;1;1;2;1064
2922003;Mucuri;3205101;Viana;1;1;2;287
2923605;Paramirim;3205101;Viana;1;1;2;790
2925501;Prado;3205101;Viana;1;1;2;368
2930709;Simões Filho;3205101;Viana;1;1;2;872
2931350;Teixeira de Freitas;3205101;Viana;1;1;2;329
3100302;Abre Campo;3205101;Viana;1;1;2;200
3130101;Igarapé;3205101;Viana;1;1;2;393
3130309;Iguatama;3205101;Viana;1;1;2;537
3131307;Ipatinga;3205101;Viana;1;1;2;230
3133501;Itapecerica;3205101;Viana;1;1;2;476
3133808;Itaúna;3205101;Viana;1;1;2;420
3136702;Juiz de Fora;3205101;Viana;1;1;2;326
3139607;Mantena;3205101;Viana;1;1;2;185
3148004;Patos de Minas;3205101;Viana;1;1;2;649
3155702;Rio Piracicaba;3205101;Viana;1;1;2;279
3156700;Sabará;3205101;Viana;1;1;2;344
3157807;Santa Luzia;3205101;Viana;1;1;2;349
3162559;São João do Manhuaçu;3205101;Viana;1;1;2;165
3167202;Sete Lagoas;3205101;Viana;1;1;2;396
3169307;Três Corações;3205101;Viana;1;1;2;507
3171204;Vespasiano;3205101;Viana;1;1;2;359
3200607;Aracruz;3205101;Viana;1;1;2;73
3200904;Barra de São Francisco;3205101;Viana;1;1;2;186
3201506;Colatina;3205101;Viana;1;1;2;95
3201902;Domingos Martins;3205101;Viana;1;1;2;11
3202702;Itaguaçu;3205101;Viana;1;1;2;74
3203007;Iúna;3205101;Viana;1;1;2;100
3203056;Jaguaré;3205101;Viana;1;1;2;174
3203320;Marataízes;3205101;Viana;1;1;2;78
3203908;Nova Venécia;3205101;Viana;1;1;2;188
3204054;Pedro Canário;3205101;Viana;1;1;2;267
3204104;Pinheiros;3205101;Viana;1;1;2;224
3205010;Sooretama;3205101;Viana;1;1;2;143
3205069;Venda Nova do Imigrante;3205101;Viana;1;1;2;60
2105658;Junco do Maranhão;3205069;Venda Nova do Imigrante;1;1;2;2106
2800308;Aracaju;3205069;Venda Nova do Imigrante;1;1;2;1124
3118601;Contagem;3205069;Venda Nova do Imigrante;1;1;2;311
3124500;Estiva;3205069;Venda Nova do Imigrante;1;1;2;565
3156908;Sacramento;3205069;Venda Nova do Imigrante;1;1;2;660
3200201;Alegre;3205069;Venda Nova do Imigrante;1;1;2;66
3200300;Alfredo Chaves;3205069;Venda Nova do Imigrante;1;1;2;52
3202306;Guaçuí;3205069;Venda Nova do Imigrante;1;1;2;75
3202553;Ibitirama;3205069;Venda Nova do Imigrante;1;1;2;60
3202652;Irupi;3205069;Venda Nova do Imigrante;1;1;2;53
3203163;Laranja da Terra;3205069;Venda Nova do Imigrante;1;1;2;49
3203205;Linhares;3205069;Venda Nova do Imigrante;1;1;2;158
3204609;Santa Teresa;3205069;Venda Nova do Imigrante;1;1;2;72
2313906;Uruoca;3205036;Vargem Alta;1;1;2;1921
2905156;Caetanos;3205036;Vargem Alta;1;1;2;701
2915403;Itaju do Colônia;3205036;Vargem Alta;1;1;2;626
3119500;Coronel Murta;3205036;Vargem Alta;1;1;2;465
3137601;Lagoa Santa;3205036;Vargem Alta;1;1;2;321
3156502;Rubelita;3205036;Vargem Alta;1;1;2;489
3200201;Alegre;3205036;Vargem Alta;1;1;2;59
3200300;Alfredo Chaves;3205036;Vargem Alta;1;1;2;27
3200904;Barra de São Francisco;3205036;Vargem Alta;1;1;2;211
3201407;Castelo;3205036;Vargem Alta;1;1;2;27
3202108;Ecoporanga;3205036;Vargem Alta;1;1;2;259
3202306;Guaçuí;3205036;Vargem Alta;1;1;2;71
2401453;Baraúna;3205010;Sooretama;1;1;2;1582
2910727;Eunápolis;3205010;Sooretama;1;1;2;318
2917300;Ituberá;3205010;Sooretama;1;1;2;613
2920908;Mascote;3205010;Sooretama;1;1;2;411
3169901;Ubá;3205010;Sooretama;1;1;2;370
3203056;Jaguaré;3205010;Sooretama;1;1;2;32
1100122;Ji-Paraná;3205002;Serra;1;1;2;2431
1100205;Porto Velho;3205002;Serra;1;1;2;2708
1100320;São Miguel do Guaporé;3205002;Serra;1;1;2;2479
1508407;Xinguara;3205002;Serra;1;1;2;1741
2105302;Imperatriz;3205002;Serra;1;1;2;1771
2505006;Cubati;3205002;Serra;1;1;2;1521
2507507;João Pessoa;3205002;Serra;1;1;2;1534
2602209;Bom Jardim;3205002;Serra;1;1;2;1446
2615607;Trindade;3205002;Serra;1;1;2;1365
2700300;Arapiraca;3205002;Serra;1;1;2;1204
2801504;Carmópolis;3205002;Serra;1;1;2;1102
2803807;Malhada dos Bois;3205002;Serra;1;1;2;1137
2903409;Belmonte;3205002;Serra;1;1;2;489
2904803;Caatiba;3205002;Serra;1;1;2;570
2906006;Campo Formoso;3205002;Serra;1;1;2;1065
2906501;Candeias;3205002;Serra;1;1;2;845
2906709;Cândido Sales;3205002;Serra;1;1;2;524
2910057;Dias d'Ávila;3205002;Serra;1;1;2;857
2911907;Iaçu;3205002;Serra;1;1;2;811
2914000;Ipirá;3205002;Serra;1;1;2;878
2914604;Irecê;3205002;Serra;1;1;2;985
2919603;Macajuba;3205002;Serra;1;1;2;884
2919702;Macarani;3205002;Serra;1;1;2;505
2920908;Mascote;3205002;Serra;1;1;2;516
2921054;Matina;3205002;Serra;1;1;2;736
2921203;Miguel Calmon;3205002;Serra;1;1;2;963
2921401;Mirangaba;3205002;Serra;1;1;2;1016
2921708;Morro do Chapéu;3205002;Serra;1;1;2;952
2923209;Oliveira dos Brejinhos;3205002;Serra;1;1;2;904
2925204;Pojuca;3205002;Serra;1;1;2;876
2928059;Santa Luzia;3205002;Serra;1;1;2;530
2928406;Santa Rita de Cássia;3205002;Serra;1;1;2;1100
2929503;São Sebastião do Passé;3205002;Serra;1;1;2;863
2930709;Simões Filho;3205002;Serra;1;1;2;836
2932903;Valença;3205002;Serra;1;1;2;761
3101102;Aimorés;3205002;Serra;1;1;2;107
3104502;Arinos;3205002;Serra;1;1;2;759
3109006;Brumadinho;3205002;Serra;1;1;2;407
3109303;Buritis;3205002;Serra;1;1;2;804
3113602;Careaçu;3205002;Serra;1;1;2;606
3118304;Conselheiro Lafaiete;3205002;Serra;1;1;2;373
3119401;Coronel Fabriciano;3205002;Serra;1;1;2;252
3119500;Coronel Murta;3205002;Serra;1;1;2;434
3125101;Extrema;3205002;Serra;1;1;2;702
3128709;Guaxupé;3205002;Serra;1;1;2;685
3131307;Ipatinga;3205002;Serra;1;1;2;244
3133709;Itatiaiuçu;3205002;Serra;1;1;2;430
3137205;Lagoa da Prata;3205002;Serra;1;1;2;546
3138203;Lavras;3205002;Serra;1;1;2;508
3139003;Machado;3205002;Serra;1;1;2;614
3139409;Manhuaçu;3205002;Serra;1;1;2;184
3139607;Mantena;3205002;Serra;1;1;2;167
3141405;Medina;3205002;Serra;1;1;2;450
3143153;Monte Formoso;3205002;Serra;1;1;2;374
3143906;Muriaé;3205002;Serra;1;1;2;237
3144672;Nova Belém;3205002;Serra;1;1;2;198
3144706;Nova Era;3205002;Serra;1;1;2;288
3145604;Oliveira;3205002;Serra;1;1;2;481
3146107;Ouro Preto;3205002;Serra;1;1;2;339
3148509;Pavão;3205002;Serra;1;1;2;308
3151404;Pitangui;3205002;Serra;1;1;2;480
3152105;Ponte Nova;3205002;Serra;1;1;2;274
3154200;Resende Costa;3205002;Serra;1;1;2;421
3154606;Ribeirão das Neves;3205002;Serra;1;1;2;397
3157807;Santa Luzia;3205002;Serra;1;1;2;372
3159209;Santa Rita de Caldas;3205002;Serra;1;1;2;668
3164803;São Sebastião do Rio Preto;3205002;Serra;1;1;2;313
3165578;Senador Amaral;3205002;Serra;1;1;2;676
3200201;Alegre;3205002;Serra;1;1;2;150
3201001;Boa Esperança;3205002;Serra;1;1;2;176
3202306;Guaçuí;3205002;Serra;1;1;2;161
3203130;João Neiva;3205002;Serra;1;1;2;43
3204302;Presidente Kennedy;3205002;Serra;1;1;2;132
3204401;Rio Novo do Sul;3205002;Serra;1;1;2;105
3204500;Santa Leopoldina;3205002;Serra;1;1;2;23
3204658;São Domingos do Norte;3205002;Serra;1;1;2;114
3204708;São Gabriel da Palha;3205002;Serra;1;1;2;130
3125309;Faria Lemos;3204955;São Roque do Canaã;1;1;2;185
3202702;Itaguaçu;3204955;São Roque do Canaã;1;1;2;23
3203908;Nova Venécia;3204955;São Roque do Canaã;1;1;2;116
1505502;Paragominas;3204906;São Mateus;1;1;2;1900
1508126;Ulianópolis;3204906;São Mateus;1;1;2;1833
2103257;Cidelândia;3204906;São Mateus;1;1;2;1706
2109007;Porto Franco;3204906;São Mateus;1;1;2;1572
2400703;Alto do Rodrigues;3204906;São Mateus;1;1;2;1524
2408003;Mossoró;3204906;São Mateus;1;1;2;1523
2611101;Petrolina;3204906;São Mateus;1;1;2;1048
2706901;Pilar;3204906;São Mateus;1;1;2;1091
2900702;Alagoinhas;3204906;São Mateus;1;1;2;748
2907509;Catu;3204906;São Mateus;1;1;2;725
2913606;Ilhéus;3204906;São Mateus;1;1;2;446
2915601;Itamaraju;3204906;São Mateus;1;1;2;195
2916401;Itapetinga;3204906;São Mateus;1;1;2;386
2931350;Teixeira de Freitas;3204906;São Mateus;1;1;2;135
3106705;Betim;3204906;São Mateus;1;1;2;475
3109402;Buritizeiro;3204906;São Mateus;1;1;2;557
3128006;Guanhães;3204906;São Mateus;1;1;2;321
3131307;Ipatinga;3204906;São Mateus;1;1;2;292
3152808;Prata;3204906;São Mateus;1;1;2;964
3200169;Água Doce do Norte;3204906;São Mateus;1;1;2;118
3200409;Anchieta;3204906;São Mateus;1;1;2;243
3201001;Boa Esperança;3204906;São Mateus;1;1;2;49
3202108;Ecoporanga;3204906;São Mateus;1;1;2;111
3204203;Piúma;3204906;São Mateus;1;1;2;247
3204302;Presidente Kennedy;3204906;São Mateus;1;1;2;287
3204559;Santa Maria de Jetibá;3204906;São Mateus;1;1;2;169
3106200;Belo Horizonte;3204807;São José do Calçado;1;1;2;271
3201209;Cachoeiro de Itapemirim;3204807;São José do Calçado;1;1;2;63
2914653;Itabela;3204708;São Gabriel da Palha;1;1;2;287
3127701;Governador Valadares;3204708;São Gabriel da Palha;1;1;2;150
3200359;Alto Rio Novo;3204708;São Gabriel da Palha;1;1;2;48
3200904;Barra de São Francisco;3204708;São Gabriel da Palha;1;1;2;44
3202108;Ecoporanga;3204708;São Gabriel da Palha;1;1;2;77
3203403;Mimoso do Sul;3204708;São Gabriel da Palha;1;1;2;245
3203502;Montanha;3204708;São Gabriel da Palha;1;1;2;100
3204005;Pancas;3204708;São Gabriel da Palha;1;1;2;40
3204104;Pinheiros;3204708;São Gabriel da Palha;1;1;2;73
3106606;Bertópolis;3204658;São Domingos do Norte;1;1;2;230
3132305;Itaipé;3204658;São Domingos do Norte;1;1;2;222
3140902;Matipó;3204658;São Domingos do Norte;1;1;2;221
3200805;Baixo Guandu;3204658;São Domingos do Norte;1;1;2;62
3201001;Boa Esperança;3204658;São Domingos do Norte;1;1;2;75
3201308;Cariacica;3204658;São Domingos do Norte;1;1;2;125
3202108;Ecoporanga;3204658;São Domingos do Norte;1;1;2;92
3202256;Governador Lindenberg;3204658;São Domingos do Norte;1;1;2;20
3203908;Nova Venécia;3204658;São Domingos do Norte;1;1;2;53
3204005;Pancas;3204658;São Domingos do Norte;1;1;2;26
3204401;Rio Novo do Sul;3204658;São Domingos do Norte;1;1;2;193
2304400;Fortaleza;3204609;Santa Teresa;1;1;2;1800
2910727;Eunápolis;3204609;Santa Teresa;1;1;2;408
2915601;Itamaraju;3204609;Santa Teresa;1;1;2;341
3200169;Água Doce do Norte;3204609;Santa Teresa;1;1;2;159
3202207;Fundão;3204609;Santa Teresa;1;1;2;20
3203205;Linhares;3204609;Santa Teresa;1;1;2;87
3204500;Santa Leopoldina;3204609;Santa Teresa;1;1;2;20
2605202;Escada;3204559;Santa Maria de Jetibá;1;1;2;1409
2927408;Salvador;3204559;Santa Maria de Jetibá;1;1;2;814
3104007;Araxá;3204559;Santa Maria de Jetibá;1;1;2;650
3118403;Conselheiro Pena;3204559;Santa Maria de Jetibá;1;1;2;123
3127701;Governador Valadares;3204559;Santa Maria de Jetibá;1;1;2;188
3200300;Alfredo Chaves;3204559;Santa Maria de Jetibá;1;1;2;66
3200409;Anchieta;3204559;Santa Maria de Jetibá;1;1;2;83
3200607;Aracruz;3204559;Santa Maria de Jetibá;1;1;2;55
3201209;Cachoeiro de Itapemirim;3204559;Santa Maria de Jetibá;1;1;2;94
3203700;Muniz Freire;3204559;Santa Maria de Jetibá;1;1;2;84
3203205;Linhares;3204500;Santa Leopoldina;1;1;2;97
3200409;Anchieta;3204401;Rio Novo do Sul;1;1;2;23
3201506;Colatina;3204351;Rio Bananal;1;1;2;44
3203353;Marilândia;3204351;Rio Bananal;1;1;2;27
3106200;Belo Horizonte;3204302;Presidente Kennedy;1;1;2;331
3203320;Marataízes;3204302;Presidente Kennedy;1;1;2;18
3202108;Ecoporanga;3204252;Ponto Belo;1;1;2;39
2927408;Salvador;3204203;Piúma;1;1;2;898
3200409;Anchieta;3204203;Piúma;1;1;2;4
3200607;Aracruz;3204203;Piúma;1;1;2;123
3201506;Colatina;3204203;Piúma;1;1;2;142
2900801;Alcobaça;3204104;Pinheiros;1;1;2;147
2905602;Camacan;3204104;Pinheiros;1;1;2;339
2906303;Canavieiras;3204104;Pinheiros;1;1;2;330
2914653;Itabela;3204104;Pinheiros;1;1;2;215
2914802;Itabuna;3204104;Pinheiros;1;1;2;413
2915601;Itamaraju;3204104;Pinheiros;1;1;2;170
2918001;Jequié;3204104;Pinheiros;1;1;2;509
2921104;Medeiros Neto;3204104;Pinheiros;1;1;2;116
2927408;Salvador;3204104;Pinheiros;1;1;2;627
2929057;São Félix do Coribe;3204104;Pinheiros;1;1;2;691
3113701;Carlos Chagas;3204104;Pinheiros;1;1;2;95
3139607;Mantena;3204104;Pinheiros;1;1;2;96
3200409;Anchieta;3204104;Pinheiros;1;1;2;269
3200904;Barra de São Francisco;3204104;Pinheiros;1;1;2;82
3202108;Ecoporanga;3204104;Pinheiros;1;1;2;64
3203056;Jaguaré;3204104;Pinheiros;1;1;2;57
3203601;Mucurici;3204104;Pinheiros;1;1;2;46
2910727;Eunápolis;3204054;Pedro Canário;1;1;2;193
2921104;Medeiros Neto;3204054;Pedro Canário;1;1;2;75
2923001;Nova Viçosa;3204054;Pedro Canário;1;1;2;71
3109402;Buritizeiro;3204054;Pedro Canário;1;1;2;515
3144300;Nanuque;3204054;Pedro Canário;1;1;2;29
3201605;Conceição da Barra;3204054;Pedro Canário;1;1;2;71
3203056;Jaguaré;3204054;Pedro Canário;1;1;2;97
1503606;Itaituba;3204005;Pancas;1;1;2;2267
3101102;Aimorés;3204005;Pancas;1;1;2;40
3139607;Mantena;3204005;Pancas;1;1;2;52
3154309;Resplendor;3204005;Pancas;1;1;2;37
3201209;Cachoeiro de Itapemirim;3204005;Pancas;1;1;2;179
3203353;Marilândia;3204005;Pancas;1;1;2;39
2507507;João Pessoa;3203908;Nova Venécia;1;1;2;1396
2916401;Itapetinga;3203908;Nova Venécia;1;1;2;380
3110301;Caldas;3203908;Nova Venécia;1;1;2;731
3113008;Caraí;3203908;Nova Venécia;1;1;2;217
3164001;São Pedro dos Ferros;3203908;Nova Venécia;1;1;2;277
3200102;Afonso Cláudio;3203908;Nova Venécia;1;1;2;170
3203130;João Neiva;3203908;Nova Venécia;1;1;2;115
3200169;Água Doce do Norte;3203809;Muqui;1;1;2;269
3200706;Atilio Vivacqua;3203809;Muqui;1;1;2;16
3202801;Itapemirim;3203809;Muqui;1;1;2;46
3203106;Jerônimo Monteiro;3203809;Muqui;1;1;2;19
3203700;Muniz Freire;3203809;Muqui;1;1;2;54
3106200;Belo Horizonte;3203700;Muniz Freire;1;1;2;275
3169000;Tocantins;3203700;Muniz Freire;1;1;2;185
3200102;Afonso Cláudio;3203700;Muniz Freire;1;1;2;52
3200706;Atilio Vivacqua;3203700;Muniz Freire;1;1;2;55
3202454;Ibatiba;3203700;Muniz Freire;1;1;2;27
3203007;Iúna;3203700;Muniz Freire;1;1;2;17
3203403;Mimoso do Sul;3203700;Muniz Freire;1;1;2;67
3203502;Montanha;3203601;Mucurici;1;1;2;16
2931350;Teixeira de Freitas;3203502;Montanha;1;1;2;91
3144300;Nanuque;3203502;Montanha;1;1;2;25
3200607;Aracruz;3203502;Montanha;1;1;2;189
2915601;Itamaraju;3203403;Mimoso do Sul;1;1;2;485
3133303;Itaobim;3203403;Mimoso do Sul;1;1;2;499
3200201;Alegre;3203403;Mimoso do Sul;1;1;2;38
3200607;Aracruz;3203403;Mimoso do Sul;1;1;2;179
3202702;Itaguaçu;3203403;Mimoso do Sul;1;1;2;149
2910727;Eunápolis;3203353;Marilândia;1;1;2;351
3200805;Baixo Guandu;3203353;Marilândia;1;1;2;52
3201902;Domingos Martins;3203353;Marilândia;1;1;2;106
3203205;Linhares;3203353;Marilândia;1;1;2;54
2910727;Eunápolis;3203346;Marechal Floriano;1;1;2;462
3139409;Manhuaçu;3203346;Marechal Floriano;1;1;2;145
3200300;Alfredo Chaves;3203346;Marechal Floriano;1;1;2;26
3201704;Conceição do Castelo;3203346;Marechal Floriano;1;1;2;59
2304400;Fortaleza;3203320;Marataízes;1;1;2;1926
3201308;Cariacica;3203320;Marataízes;1;1;2;99
3202306;Guaçuí;3203320;Marataízes;1;1;2;88
3202603;Iconha;3203320;Marataízes;1;1;2;30
2300200;Acaraú;3203205;Linhares;1;1;2;1819
2304285;Eusébio;3203205;Linhares;1;1;2;1718
2306405;Itapipoca;3203205;Linhares;1;1;2;1754
2410405;Pureza;3203205;Linhares;1;1;2;1603
2514909;São Mamede;3203205;Linhares;1;1;2;1407
2606002;Garanhuns;3203205;Linhares;1;1;2;1216
2611606;Recife;3203205;Linhares;1;1;2;1348
2800308;Aracaju;3203205;Linhares;1;1;2;985
2903409;Belmonte;3203205;Linhares;1;1;2;399
2906907;Caravelas;3203205;Linhares;1;1;2;197
2914802;Itabuna;3203205;Linhares;1;1;2;511
2919207;Lauro de Freitas;3203205;Linhares;1;1;2;738
2922003;Mucuri;3203205;Linhares;1;1;2;159
2923001;Nova Viçosa;3203205;Linhares;1;1;2;175
2929057;São Félix do Coribe;3203205;Linhares;1;1;2;787
3123601;Elói Mendes;3203205;Linhares;1;1;2;636
3131307;Ipatinga;3203205;Linhares;1;1;2;264
3131703;Itabira;3203205;Linhares;1;1;2;339
3139409;Manhuaçu;3203205;Linhares;1;1;2;235
3144300;Nanuque;3203205;Linhares;1;1;2;168
3170701;Varginha;3203205;Linhares;1;1;2;616
3200102;Afonso Cláudio;3203205;Linhares;1;1;2;140
3200409;Anchieta;3203205;Linhares;1;1;2;175
3201605;Conceição da Barra;3203205;Linhares;1;1;2;90
3201902;Domingos Martins;3203205;Linhares;1;1;2;129
3202207;Fundão;3203205;Linhares;1;1;2;75
3202256;Governador Lindenberg;3203205;Linhares;1;1;2;47
3202603;Iconha;3203205;Linhares;1;1;2;179
3202702;Itaguaçu;3203205;Linhares;1;1;2;101
3200102;Afonso Cláudio;3203163;Laranja da Terra;1;1;2;21
3201407;Castelo;3203163;Laranja da Terra;1;1;2;81
2910727;Eunápolis;3203130;João Neiva;1;1;2;384
3200904;Barra de São Francisco;3203106;Jerônimo Monteiro;1;1;2;230
3202306;Guaçuí;3203106;Jerônimo Monteiro;1;1;2;30
1100049;Cacoal;3203056;Jaguaré;1;1;2;2363
2910727;Eunápolis;3203056;Jaguaré;1;1;2;285
2915601;Itamaraju;3203056;Jaguaré;1;1;2;216
2931350;Teixeira de Freitas;3203056;Jaguaré;1;1;2;155
2928703;Santo Antônio de Jesus;3203007;Iúna;1;1;2;849
3137700;Lajinha;3203007;Iúna;1;1;2;24
3139409;Manhuaçu;3203007;Iúna;1;1;2;58
3139508;Manhumirim;3203007;Iúna;1;1;2;45
3143906;Muriaé;3203007;Iúna;1;1;2;116
3170206;Uberlândia;3203007;Iúna;1;1;2;719
3201209;Cachoeiro de Itapemirim;3203007;Iúna;1;1;2;69
3202553;Ibitirama;3203007;Iúna;1;1;2;25
3103009;Antônio Dias;3202801;Itapemirim;1;1;2;253
3200300;Alfredo Chaves;3202801;Itapemirim;1;1;2;46
3202603;Iconha;3202801;Itapemirim;1;1;2;27
3200102;Afonso Cláudio;3202702;Itaguaçu;1;1;2;41
3200169;Água Doce do Norte;3202702;Itaguaçu;1;1;2;139
3162559;São João do Manhuaçu;3202652;Irupi;1;1;2;54
3200201;Alegre;3202652;Irupi;1;1;2;48
3201902;Domingos Martins;3202652;Irupi;1;1;2;103
1100304;Vilhena;3202603;Iconha;1;1;2;2162
1504208;Marabá;3202603;Iconha;1;1;2;1899
1504422;Marituba;3202603;Iconha;1;1;2;2278
2111300;São Luís;3202603;Iconha;1;1;2;2049
2305233;Horizonte;3202603;Iconha;1;1;2;1861
2307650;Maracanaú;3202603;Iconha;1;1;2;1885
2403251;Parnamirim;3202603;Iconha;1;1;2;1738
2501807;Bayeux;3202603;Iconha;1;1;2;1624
2603009;Cabrobó;3202603;Iconha;1;1;2;1374
2607901;Jaboatão dos Guararapes;3202603;Iconha;1;1;2;1519
2615607;Trindade;3202603;Iconha;1;1;2;1439
2700300;Arapiraca;3202603;Iconha;1;1;2;1289
2704708;Marechal Deodoro;3202603;Iconha;1;1;2;1323
2900702;Alagoinhas;3202603;Iconha;1;1;2;989
2908507;Conceição do Jacuípe;3202603;Iconha;1;1;2;958
2922003;Mucuri;3202603;Iconha;1;1;2;336
2930709;Simões Filho;3202603;Iconha;1;1;2;920
3106200;Belo Horizonte;3202603;Iconha;1;1;2;343
3118007;Congonhas;3202603;Iconha;1;1;2;322
3136702;Juiz de Fora;3202603;Iconha;1;1;2;284
3146107;Ouro Preto;3202603;Iconha;1;1;2;287
3200300;Alfredo Chaves;3202603;Iconha;1;1;2;19
3200607;Aracruz;3202603;Iconha;1;1;2;122
3201308;Cariacica;3202603;Iconha;1;1;2;70
3201407;Castelo;3202603;Iconha;1;1;2;51
3201803;Divino de São Lourenço;3202553;Ibitirama;1;1;2;9
2408003;Mossoró;3202504;Ibiraçu;1;1;2;1649
2607901;Jaboatão dos Guararapes;3202504;Ibiraçu;1;1;2;1405
2615607;Trindade;3202504;Ibiraçu;1;1;2;1332
2931350;Teixeira de Freitas;3202504;Ibiraçu;1;1;2;262
3136702;Juiz de Fora;3202504;Ibiraçu;1;1;2;378
3201209;Cachoeiro de Itapemirim;3202504;Ibiraçu;1;1;2;134
3201506;Colatina;3202504;Ibiraçu;1;1;2;41
3201605;Conceição da Barra;3202504;Ibiraçu;1;1;2;151
3202405;Guarapari;3202504;Ibiraçu;1;1;2;91
3104007;Araxá;3202454;Ibatiba;1;1;2;572
3106200;Belo Horizonte;3202454;Ibatiba;1;1;2;260
3113404;Caratinga;3202454;Ibatiba;1;1;2;86
3200102;Afonso Cláudio;3202454;Ibatiba;1;1;2;43
3201159;Brejetuba;3202454;Ibatiba;1;1;2;25
3201308;Cariacica;3202454;Ibatiba;1;1;2;112
3201407;Castelo;3202454;Ibatiba;1;1;2;49
3201704;Conceição do Castelo;3202454;Ibatiba;1;1;2;32
2304400;Fortaleza;3202405;Guarapari;1;1;2;1877
2602902;Cabo de Santo Agostinho;3202405;Guarapari;1;1;2;1477
2611606;Recife;3202405;Guarapari;1;1;2;1497
2922003;Mucuri;3202405;Guarapari;1;1;2;311
2931350;Teixeira de Freitas;3202405;Guarapari;1;1;2;353
2933257;Vereda;3202405;Guarapari;1;1;2;381
3113404;Caratinga;3202405;Guarapari;1;1;2;193
3137601;Lagoa Santa;3202405;Guarapari;1;1;2;363
3138401;Leopoldina;3202405;Guarapari;1;1;2;243
3139409;Manhuaçu;3202405;Guarapari;1;1;2;162
3139508;Manhumirim;3202405;Guarapari;1;1;2;148
3143906;Muriaé;3202405;Guarapari;1;1;2;191
3164704;São Sebastião do Paraíso;3202405;Guarapari;1;1;2;671
3170800;Várzea da Palma;3202405;Guarapari;1;1;2;549
3202306;Guaçuí;3202405;Guarapari;1;1;2;117
3113305;Carangola;3202306;Guaçuí;1;1;2;37
3143906;Muriaé;3202306;Guaçuí;1;1;2;76
3201407;Castelo;3202306;Guaçuí;1;1;2;48
1503606;Itaituba;3202207;Fundão;1;1;2;2348
3106200;Belo Horizonte;3202207;Fundão;1;1;2;374
3200706;Atilio Vivacqua;3202207;Fundão;1;1;2;137
3106200;Belo Horizonte;3202108;Ecoporanga;1;1;2;376
3200805;Baixo Guandu;3202108;Ecoporanga;1;1;2;137
3201506;Colatina;3202108;Ecoporanga;1;1;2;137
3139409;Manhuaçu;3202009;Dores do Rio Preto;1;1;2;58
3140902;Matipó;3202009;Dores do Rio Preto;1;1;2;71
3201803;Divino de São Lourenço;3202009;Dores do Rio Preto;1;1;2;17
3125952;Fervedouro;3201902;Domingos Martins;1;1;2;175
3127701;Governador Valadares;3201902;Domingos Martins;1;1;2;220
3200102;Afonso Cláudio;3201902;Domingos Martins;1;1;2;58
3201209;Cachoeiro de Itapemirim;3201902;Domingos Martins;1;1;2;68
3201704;Conceição do Castelo;3201902;Domingos Martins;1;1;2;61
2922003;Mucuri;3201605;Conceição da Barra;1;1;2;69
3109402;Buritizeiro;3201605;Conceição da Barra;1;1;2;561
1506807;Santarém;3201506;Colatina;1;1;2;2370
2906006;Campo Formoso;3201506;Colatina;1;1;2;1001
2914802;Itabuna;3201506;Colatina;1;1;2;545
2915601;Itamaraju;3201506;Colatina;1;1;2;302
2917706;Jaguarari;3201506;Colatina;1;1;2;1029
2925303;Porto Seguro;3201506;Colatina;1;1;2;379
2926806;Rio do Antônio;3201506;Colatina;1;1;2;589
2927408;Salvador;3201506;Colatina;1;1;2;759
2932200;Ubaitaba;3201506;Colatina;1;1;2;600
3118007;Congonhas;3201506;Colatina;1;1;2;359
3118601;Contagem;3201506;Colatina;1;1;2;366
3123601;Elói Mendes;3201506;Colatina;1;1;2;570
3127107;Frutal;3201506;Colatina;1;1;2;881
3127701;Governador Valadares;3201506;Colatina;1;1;2;165
3139508;Manhumirim;3201506;Colatina;1;1;2;166
3143906;Muriaé;3201506;Colatina;1;1;2;247
3144904;Nova Módica;3201506;Colatina;1;1;2;154
3154309;Resplendor;3201506;Colatina;1;1;2;67
3170701;Varginha;3201506;Colatina;1;1;2;549
3200409;Anchieta;3201506;Colatina;1;1;2;138
3200706;Atilio Vivacqua;3201506;Colatina;1;1;2;162
3106200;Belo Horizonte;3201407;Castelo;1;1;2;293
3113305;Carangola;3201407;Castelo;1;1;2;82
3131307;Ipatinga;3201407;Castelo;1;1;2;183
3136702;Juiz de Fora;3201407;Castelo;1;1;2;252
3144003;Mutum;3201407;Castelo;1;1;2;91
3172004;Visconde do Rio Branco;3201407;Castelo;1;1;2;171
3200201;Alegre;3201407;Castelo;1;1;2;37
3200805;Baixo Guandu;3201407;Castelo;1;1;2;118
3200904;Barra de São Francisco;3201407;Castelo;1;1;2;207
3201308;Cariacica;3201407;Castelo;1;1;2;93
1100205;Porto Velho;3201308;Cariacica;1;1;2;2700
1501402;Belém;3201308;Cariacica;1;1;2;2238
2301000;Aquiraz;3201308;Cariacica;1;1;2;1821
2304400;Fortaleza;3201308;Cariacica;1;1;2;1834
2403251;Parnamirim;3201308;Cariacica;1;1;2;1671
2607901;Jaboatão dos Guararapes;3201308;Cariacica;1;1;2;1451
2611606;Recife;3201308;Cariacica;1;1;2;1454
2706901;Pilar;3201308;Cariacica;1;1;2;1265
2910800;Feira de Santana;3201308;Cariacica;1;1;2;895
2914604;Irecê;3201308;Cariacica;1;1;2;997
2914703;Itaberaba;3201308;Cariacica;1;1;2;851
2918407;Juazeiro;3201308;Cariacica;1;1;2;1193
2925303;Porto Seguro;3201308;Cariacica;1;1;2;445
2930709;Simões Filho;3201308;Cariacica;1;1;2;853
2932903;Valença;3201308;Cariacica;1;1;2;777
3105608;Barbacena;3201308;Cariacica;1;1;2;367
3113206;Carandaí;3201308;Cariacica;1;1;2;368
3114204;Carmo do Cajuru;3201308;Cariacica;1;1;2;452
3116605;Cláudio;3201308;Cariacica;1;1;2;452
3131307;Ipatinga;3201308;Cariacica;1;1;2;236
3136207;João Monlevade;3201308;Cariacica;1;1;2;289
3139409;Manhuaçu;3201308;Cariacica;1;1;2;169
3149309;Pedro Leopoldo;3201308;Cariacica;1;1;2;384
3154309;Resplendor;3201308;Cariacica;1;1;2;132
3154606;Ribeirão das Neves;3201308;Cariacica;1;1;2;384
3170107;Uberaba;3201308;Cariacica;1;1;2;782
3170701;Varginha;3201308;Cariacica;1;1;2;538
1702109;Araguaína;3201209;Cachoeiro de Itapemirim;1;1;2;1670
2100055;Açailândia;3201209;Cachoeiro de Itapemirim;1;1;2;1869
2109908;Santa Inês;3201209;Cachoeiro de Itapemirim;1;1;2;1930
2207702;Parnaíba;3201209;Cachoeiro de Itapemirim;1;1;2;1987
2301000;Aquiraz;3201209;Cachoeiro de Itapemirim;1;1;2;1892
2312908;Sobral;3201209;Cachoeiro de Itapemirim;1;1;2;1900
2408102;Natal;3201209;Cachoeiro de Itapemirim;1;1;2;1761
2506301;Guarabira;3201209;Cachoeiro de Itapemirim;1;1;2;1645
2507507;João Pessoa;3201209;Cachoeiro de Itapemirim;1;1;2;1634
2510808;Patos;3201209;Cachoeiro de Itapemirim;1;1;2;1575
2610905;Pesqueira;3201209;Cachoeiro de Itapemirim;1;1;2;1449
2615607;Trindade;3201209;Cachoeiro de Itapemirim;1;1;2;1444
2704302;Maceió;3201209;Cachoeiro de Itapemirim;1;1;2;1351
2707701;Rio Largo;3201209;Cachoeiro de Itapemirim;1;1;2;1363
2800308;Aracaju;3201209;Cachoeiro de Itapemirim;1;1;2;1172
2804003;Maruim;3201209;Cachoeiro de Itapemirim;1;1;2;1190
2807402;Tobias Barreto;3201209;Cachoeiro de Itapemirim;1;1;2;1118
2903508;Belo Campo;3201209;Cachoeiro de Itapemirim;1;1;2;641
2906006;Campo Formoso;3201209;Cachoeiro de Itapemirim;1;1;2;1145
2908507;Conceição do Jacuípe;3201209;Cachoeiro de Itapemirim;1;1;2;969
2910404;Encruzilhada;3201209;Cachoeiro de Itapemirim;1;1;2;586
2913606;Ilhéus;3201209;Cachoeiro de Itapemirim;1;1;2;698
2914604;Irecê;3201209;Cachoeiro de Itapemirim;1;1;2;1052
2914802;Itabuna;3201209;Cachoeiro de Itapemirim;1;1;2;693
2916807;Itarantim;3201209;Cachoeiro de Itapemirim;1;1;2;581
2921054;Matina;3201209;Cachoeiro de Itapemirim;1;1;2;786
2923357;Ourolândia;3201209;Cachoeiro de Itapemirim;1;1;2;1091
2924009;Paulo Afonso;3201209;Cachoeiro de Itapemirim;1;1;2;1294
2924702;Piripá;3201209;Cachoeiro de Itapemirim;1;1;2;655
2931350;Teixeira de Freitas;3201209;Cachoeiro de Itapemirim;1;1;2;389
3101003;Águas Vermelhas;3201209;Cachoeiro de Itapemirim;1;1;2;564
3101102;Aimorés;3201209;Cachoeiro de Itapemirim;1;1;2;147
3102704;Cachoeira de Pajeú;3201209;Cachoeiro de Itapemirim;1;1;2;540
3105608;Barbacena;3201209;Cachoeiro de Itapemirim;1;1;2;285
3106705;Betim;3201209;Cachoeiro de Itapemirim;1;1;2;336
3109907;Caetanópolis;3201209;Cachoeiro de Itapemirim;1;1;2;384
3113008;Caraí;3201209;Cachoeiro de Itapemirim;1;1;2;408
3113305;Carangola;3201209;Cachoeiro de Itapemirim;1;1;2;98
3124203;Espera Feliz;3201209;Cachoeiro de Itapemirim;1;1;2;87
3125507;São Gonçalo do Rio Preto;3201209;Cachoeiro de Itapemirim;1;1;2;393
3127305;Galiléia;3201209;Cachoeiro de Itapemirim;1;1;2;208
3127370;Goiabeira;3201209;Cachoeiro de Itapemirim;1;1;2;205
3133303;Itaobim;3201209;Cachoeiro de Itapemirim;1;1;2;475
3134202;Ituiutaba;3201209;Cachoeiro de Itapemirim;1;1;2;891
3136207;João Monlevade;3201209;Cachoeiro de Itapemirim;1;1;2;244
3141108;Matozinhos;3201209;Cachoeiro de Itapemirim;1;1;2;341
3145901;Ouro Branco;3201209;Cachoeiro de Itapemirim;1;1;2;273
3147006;Paracatu;3201209;Cachoeiro de Itapemirim;1;1;2;721
3147105;Pará de Minas;3201209;Cachoeiro de Itapemirim;1;1;2;382
3149903;Perdões;3201209;Cachoeiro de Itapemirim;1;1;2;419
3151503;Piumhi;3201209;Cachoeiro de Itapemirim;1;1;2;508
3152105;Ponte Nova;3201209;Cachoeiro de Itapemirim;1;1;2;194
3167202;Sete Lagoas;3201209;Cachoeiro de Itapemirim;1;1;2;361
3169356;Três Marias;3201209;Cachoeiro de Itapemirim;1;1;2;519
3169901;Ubá;3201209;Cachoeiro de Itapemirim;1;1;2;199
3170107;Uberaba;3201209;Cachoeiro de Itapemirim;1;1;2;719
3170701;Varginha;3201209;Cachoeiro de Itapemirim;1;1;2;456
3200136;Águia Branca;3201209;Cachoeiro de Itapemirim;1;1;2;207
3200300;Alfredo Chaves;3201209;Cachoeiro de Itapemirim;1;1;2;41
3201159;Brejetuba;3201209;Cachoeiro de Itapemirim;1;1;2;78
3139409;Manhuaçu;3201159;Brejetuba;1;1;2;82
3200102;Afonso Cláudio;3201159;Brejetuba;1;1;2;18
3143906;Muriaé;3201100;Bom Jesus do Norte;1;1;2;70
2915601;Itamaraju;3201001;Boa Esperança;1;1;2;186
3104700;Ataléia;3201001;Boa Esperança;1;1;2;102
3127602;Gouveia;3201001;Boa Esperança;1;1;2;365
2921104;Medeiros Neto;3200904;Barra de São Francisco;1;1;2;172
2931350;Teixeira de Freitas;3200904;Barra de São Francisco;1;1;2;184
3102704;Cachoeira de Pajeú;3200904;Barra de São Francisco;1;1;2;315
3104007;Araxá;3200904;Barra de São Francisco;1;1;2;644
3110301;Caldas;3200904;Barra de São Francisco;1;1;2;679
3113404;Caratinga;3200904;Barra de São Francisco;1;1;2;179
3113701;Carlos Chagas;3200904;Barra de São Francisco;1;1;2;116
3147402;Paraopeba;3200904;Barra de São Francisco;1;1;2;372
3200102;Afonso Cláudio;3200904;Barra de São Francisco;1;1;2;147
3200607;Aracruz;3200904;Barra de São Francisco;1;1;2;134
3200706;Atilio Vivacqua;3200904;Barra de São Francisco;1;1;2;240
3200805;Baixo Guandu;3200904;Barra de São Francisco;1;1;2;89
2906709;Cândido Sales;3200805;Baixo Guandu;1;1;2;452
2910404;Encruzilhada;3200805;Baixo Guandu;1;1;2;446
2926905;Rio do Pires;3200805;Baixo Guandu;1;1;2;725
3104007;Araxá;3200805;Baixo Guandu;1;1;2;623
3113701;Carlos Chagas;3200805;Baixo Guandu;1;1;2;204
3127701;Governador Valadares;3200805;Baixo Guandu;1;1;2;131
3169901;Ubá;3200805;Baixo Guandu;1;1;2;268
3200607;Aracruz;3200805;Baixo Guandu;1;1;2;82
2911659;Guajeru;3200706;Atilio Vivacqua;1;1;2;709
3106200;Belo Horizonte;3200706;Atilio Vivacqua;1;1;2;310
3110301;Caldas;3200706;Atilio Vivacqua;1;1;2;553
3134004;Itinga;3200706;Atilio Vivacqua;1;1;2;480
3138203;Lavras;3200706;Atilio Vivacqua;1;1;2;398
3200201;Alegre;3200706;Atilio Vivacqua;1;1;2;41
2900702;Alagoinhas;3200607;Aracruz;1;1;2;871
2906907;Caravelas;3200607;Aracruz;1;1;2;253
2907509;Catu;3200607;Aracruz;1;1;2;848
2927408;Salvador;3200607;Aracruz;1;1;2;777
2931350;Teixeira de Freitas;3200607;Aracruz;1;1;2;257
3106200;Belo Horizonte;3200607;Aracruz;1;1;2;388
3106309;Belo Oriente;3200607;Aracruz;1;1;2;240
3106705;Betim;3200607;Aracruz;1;1;2;410
3109402;Buritizeiro;3200607;Aracruz;1;1;2;559
3118403;Conselheiro Pena;3200607;Aracruz;1;1;2;145
3139409;Manhuaçu;3200607;Aracruz;1;1;2;193
3200102;Afonso Cláudio;3200607;Aracruz;1;1;2;94
3200300;Alfredo Chaves;3200607;Aracruz;1;1;2;104
3200359;Alto Rio Novo;3200607;Aracruz;1;1;2;114
3101508;Além Paraíba;3200508;Apiacá;1;1;2;140
2803203;Itaporanga d'Ajuda;3200409;Anchieta;1;1;2;1138
3136207;João Monlevade;3200409;Anchieta;1;1;2;276
3140001;Mariana;3200409;Anchieta;1;1;2;283
3146107;Ouro Preto;3200409;Anchieta;1;1;2;296
3157807;Santa Luzia;3200409;Anchieta;1;1;2;343
3200300;Alfredo Chaves;3200409;Anchieta;1;1;2;18
3113404;Caratinga;3200359;Alto Rio Novo;1;1;2;150
3157807;Santa Luzia;3200300;Alfredo Chaves;1;1;2;336
3124203;Espera Feliz;3200201;Alegre;1;1;2;38
3143906;Muriaé;3200201;Alegre;1;1;2;87
3164704;São Sebastião do Paraíso;3200201;Alegre;1;1;2;565
3171303;Viçosa;3200201;Alegre;1;1;2;139
3101102;Aimorés;3200169;Água Doce do Norte;1;1;2;106
3139607;Mantena;3200169;Água Doce do Norte;1;1;2;28
3168606;Teófilo Otoni;3200169;Água Doce do Norte;1;1;2;94
3144003;Mutum;3200102;Afonso Cláudio;1;1;2;45
3101508;Além Paraíba;3172103;Volta Grande;1;1;2;19
3106200;Belo Horizonte;3172103;Volta Grande;1;1;2;255
3106903;Bicas;3172103;Volta Grande;1;1;2;57
3127388;Goianá;3172103;Volta Grande;1;1;2;73
3132602;Itamarati de Minas;3172103;Volta Grande;1;1;2;50
3136702;Juiz de Fora;3172103;Volta Grande;1;1;2;82
3138005;Laranjal;3172103;Volta Grande;1;1;2;44
3138401;Leopoldina;3172103;Volta Grande;1;1;2;30
3139805;Mar de Espanha;3172103;Volta Grande;1;1;2;50
3140209;Maripá de Minas;3172103;Volta Grande;1;1;2;44
3146701;Palma;3172103;Volta Grande;1;1;2;50
3154101;Recreio;3172103;Volta Grande;1;1;2;28
3155405;Rio Novo;3172103;Volta Grande;1;1;2;70
3156205;Rochedo de Minas;3172103;Volta Grande;1;1;2;52
3160009;Santo Antônio do Aventureiro;3172103;Volta Grande;1;1;2;29
3160702;Santos Dumont;3172103;Volta Grande;1;1;2;109
3162906;São João Nepomuceno;3172103;Volta Grande;1;1;2;55
3165602;Senador Cortes;3172103;Volta Grande;1;1;2;42
3113305;Carangola;3172004;Visconde do Rio Branco;1;1;2;90
3118007;Congonhas;3172004;Visconde do Rio Branco;1;1;2;123
3118601;Contagem;3172004;Visconde do Rio Branco;1;1;2;177
3127701;Governador Valadares;3172004;Visconde do Rio Branco;1;1;2;259
3135506;Jequeri;3172004;Visconde do Rio Branco;1;1;2;64
3148103;Patrocínio;3172004;Visconde do Rio Branco;1;1;2;485
3155801;Rio Pomba;3172004;Visconde do Rio Branco;1;1;2;46
3165701;Senador Firmino;3172004;Visconde do Rio Branco;1;1;2;29
3168507;Teixeiras;3172004;Visconde do Rio Branco;1;1;2;40
3169000;Tocantins;3172004;Visconde do Rio Branco;1;1;2;26
3171303;Viçosa;3172004;Visconde do Rio Branco;1;1;2;28
3106200;Belo Horizonte;3171907;Virgolândia;1;1;2;237
3106309;Belo Oriente;3171907;Virgolândia;1;1;2;84
3119203;Coroaci;3171907;Virgolândia;1;1;2;16
3127701;Governador Valadares;3171907;Virgolândia;1;1;2;50
3128006;Guanhães;3171907;Virgolândia;1;1;2;72
3100500;Açucena;3171808;Virginópolis;1;1;2;32
3106200;Belo Horizonte;3171808;Virginópolis;1;1;2;180
3106309;Belo Oriente;3171808;Virginópolis;1;1;2;50
3122207;Divinolândia de Minas;3171808;Virginópolis;1;1;2;10
3125101;Extrema;3171808;Virginópolis;1;1;2;590
3127701;Governador Valadares;3171808;Virginópolis;1;1;2;76
3131703;Itabira;3171808;Virginópolis;1;1;2;106
3132404;Itajubá;3171709;Virgínia;1;1;2;40
2927408;Salvador;3171600;Virgem da Lapa;1;1;2;587
3104007;Araxá;3171600;Virgem da Lapa;1;1;2;583
3106200;Belo Horizonte;3171600;Virgem da Lapa;1;1;2;385
3119500;Coronel Murta;3171600;Virgem da Lapa;1;1;2;27
3134004;Itinga;3171600;Virgem da Lapa;1;1;2;65
3151206;Pirapora;3171600;Virgem da Lapa;1;1;2;280
3106200;Belo Horizonte;3171501;Mathias Lobato;1;1;2;263
3125952;Fervedouro;3171402;Vieiras;1;1;2;15
3142106;Miradouro;3171402;Vieiras;1;1;2;11
3149002;Pedra Dourada;3171402;Vieiras;1;1;2;12
3169208;Tombos;3171402;Vieiras;1;1;2;25
2408003;Mossoró;3171303;Viçosa;1;1;2;1812
3100401;Acaiaca;3171303;Viçosa;1;1;2;52
3104007;Araxá;3171303;Viçosa;1;1;2;440
3105608;Barbacena;3171303;Viçosa;1;1;2;105
3110202;Cajuri;3171303;Viçosa;1;1;2;11
3111705;Canaã;3171303;Viçosa;1;1;2;31
3113305;Carangola;3171303;Viçosa;1;1;2;91
3118304;Conselheiro Lafaiete;3171303;Viçosa;1;1;2;97
3118601;Contagem;3171303;Viçosa;1;1;2;155
3122306;Divinópolis;3171303;Viçosa;1;1;2;217
3127701;Governador Valadares;3171303;Viçosa;1;1;2;237
3128204;Guaraciaba;3171303;Viçosa;1;1;2;25
3131307;Ipatinga;3171303;Viçosa;1;1;2;149
3131901;Itabirito;3171303;Viçosa;1;1;2;111
3136207;João Monlevade;3171303;Viçosa;1;1;2;110
3138401;Leopoldina;3171303;Viçosa;1;1;2;88
3139805;Mar de Espanha;3171303;Viçosa;1;1;2;122
3144359;Naque;3171303;Viçosa;1;1;2;180
3146008;Ouro Fino;3171303;Viçosa;1;1;2;400
3147105;Pará de Minas;3171303;Viçosa;1;1;2;205
3152303;Porto Firme;3171303;Viçosa;1;1;2;22
3161502;São Geraldo;3171303;Viçosa;1;1;2;18
3162500;São João del Rei;3171303;Viçosa;1;1;2;151
3163805;São Miguel do Anta;3171303;Viçosa;1;1;2;20
3169000;Tocantins;3171303;Viçosa;1;1;2;47
1400100;Boa Vista;3171204;Vespasiano;1;1;2;3017
2611606;Recife;3171204;Vespasiano;1;1;2;1576
2615607;Trindade;3171204;Vespasiano;1;1;2;1369
2801504;Carmópolis;3171204;Vespasiano;1;1;2;1229
3105608;Barbacena;3171204;Vespasiano;1;1;2;167
3131703;Itabira;3171204;Vespasiano;1;1;2;72
3133808;Itaúna;3171204;Vespasiano;1;1;2;82
3134608;Jaboticatubas;3171204;Vespasiano;1;1;2;28
3141108;Matozinhos;3171204;Vespasiano;1;1;2;22
3143302;Montes Claros;3171204;Vespasiano;1;1;2;329
3144805;Nova Lima;3171204;Vespasiano;1;1;2;36
3167202;Sete Lagoas;3171204;Vespasiano;1;1;2;43
3113404;Caratinga;3171154;Vermelho Novo;1;1;2;26
3106200;Belo Horizonte;3171105;Veríssimo;1;1;2;455
3117306;Conceição das Alagoas;3171105;Veríssimo;1;1;2;29
3106200;Belo Horizonte;3171071;Veredinha;1;1;2;307
3118601;Contagem;3171071;Veredinha;1;1;2;314
3169703;Turmalina;3171071;Veredinha;1;1;2;13
2101608;Barra do Corda;3171030;Verdelândia;1;1;2;1127
3124302;Espinosa;3171030;Verdelândia;1;1;2;113
3126406;Fortuna de Minas;3171030;Verdelândia;1;1;2;450
3129806;Ibirité;3171030;Verdelândia;1;1;2;493
3132107;Itacarambi;3171030;Verdelândia;1;1;2;75
3142908;Monte Azul;3171030;Verdelândia;1;1;2;92
3149309;Pedro Leopoldo;3171030;Verdelândia;1;1;2;448
3154606;Ribeirão das Neves;3171030;Verdelândia;1;1;2;465
3100203;Abaeté;3171006;Vazante;1;1;2;205
3104007;Araxá;3171006;Vazante;1;1;2;176
3106200;Belo Horizonte;3171006;Vazante;1;1;2;382
3129509;Ibiá;3171006;Vazante;1;1;2;166
3136306;João Pinheiro;3171006;Vazante;1;1;2;86
3140506;Martinho Campos;3171006;Vazante;1;1;2;236
3153400;Presidente Olegário;3171006;Vazante;1;1;2;75
3161700;São Gonçalo do Abaeté;3171006;Vazante;1;1;2;127
3169356;Três Marias;3171006;Vazante;1;1;2;184
3104007;Araxá;3170909;Varzelândia;1;1;2;534
3106200;Belo Horizonte;3170909;Varzelândia;1;1;2;465
3133808;Itaúna;3170909;Varzelândia;1;1;2;491
3143302;Montes Claros;3170909;Varzelândia;1;1;2;115
3152204;Porteirinha;3170909;Varzelândia;1;1;2;109
3162401;São João da Ponte;3170909;Varzelândia;1;1;2;26
1711506;Jaú do Tocantins;3170800;Várzea da Palma;1;1;2;679
2905602;Camacan;3170800;Várzea da Palma;1;1;2;604
2905701;Camaçari;3170800;Várzea da Palma;1;1;2;867
2908101;Cocos;3170800;Várzea da Palma;1;1;2;380
2909307;Correntina;3170800;Várzea da Palma;1;1;2;471
2917359;Jaborandi;3170800;Várzea da Palma;1;1;2;443
3100203;Abaeté;3170800;Várzea da Palma;1;1;2;186
3104007;Araxá;3170800;Várzea da Palma;1;1;2;320
3109907;Caetanópolis;3170800;Várzea da Palma;1;1;2;191
3111200;Campo Belo;3170800;Várzea da Palma;1;1;2;368
3112703;Capitão Enéas;3170800;Várzea da Palma;1;1;2;181
3119104;Corinto;3170800;Várzea da Palma;1;1;2;92
3122306;Divinópolis;3170800;Várzea da Palma;1;1;2;284
3123908;Entre Rios de Minas;3170800;Várzea da Palma;1;1;2;348
3125101;Extrema;3170800;Várzea da Palma;1;1;2;605
3125705;Felixlândia;3170800;Várzea da Palma;1;1;2;129
3127800;Grão Mogol;3170800;Várzea da Palma;1;1;2;230
3129509;Ibiá;3170800;Várzea da Palma;1;1;2;277
3133105;Itanhandu;3170800;Várzea da Palma;1;1;2;520
3133808;Itaúna;3170800;Várzea da Palma;1;1;2;278
3136306;João Pinheiro;3170800;Várzea da Palma;1;1;2;154
3136405;Joaquim Felício;3170800;Várzea da Palma;1;1;2;66
3141009;Mato Verde;3170800;Várzea da Palma;1;1;2;316
3143104;Monte Carmelo;3170800;Várzea da Palma;1;1;2;317
3145455;Olhos-d'Água;3170800;Várzea da Palma;1;1;2;129
3146909;Papagaios;3170800;Várzea da Palma;1;1;2;205
3147105;Pará de Minas;3170800;Várzea da Palma;1;1;2;250
3148707;Pedra Azul;3170800;Várzea da Palma;1;1;2;406
3149309;Pedro Leopoldo;3170800;Várzea da Palma;1;1;2;235
3153400;Presidente Olegário;3170800;Várzea da Palma;1;1;2;197
3154606;Ribeirão das Neves;3170800;Várzea da Palma;1;1;2;251
3169356;Três Marias;3170800;Várzea da Palma;1;1;2;83
3104007;Araxá;3170750;Varjão de MInas;1;1;2;165
3106200;Belo Horizonte;3170750;Varjão de MInas;1;1;2;275
3143104;Monte Carmelo;3170750;Varjão de MInas;1;1;2;161
2905701;Camaçari;3170701;Varginha;1;1;2;1209
2914653;Itabela;3170701;Varginha;1;1;2;809
2919553;Luís Eduardo magalhães;3170701;Varginha;1;1;2;1041
2927408;Salvador;3170701;Varginha;1;1;2;1174
3102605;Andradas;3170701;Varginha;1;1;2;136
3102803;Andrelândia;3170701;Varginha;1;1;2;113
3102852;Angelândia;3170701;Varginha;1;1;2;545
3104007;Araxá;3170701;Varginha;1;1;2;265
3104304;Areado;3170701;Varginha;1;1;2;79
3104908;Baependi;3170701;Varginha;1;1;2;73
3110905;Campanha;3170701;Varginha;1;1;2;37
3111606;Campos Gerais;3170701;Varginha;1;1;2;47
3118304;Conselheiro Lafaiete;3170701;Varginha;1;1;2;188
3120805;Cruzília;3170701;Varginha;1;1;2;72
3127107;Frutal;3170701;Varginha;1;1;2;399
3131703;Itabira;3170701;Varginha;1;1;2;304
3133105;Itanhandu;3170701;Varginha;1;1;2;100
3137502;Lagoa Formosa;3170701;Varginha;1;1;2;319
3137809;Lambari;3170701;Varginha;1;1;2;49
3143302;Montes Claros;3170701;Varginha;1;1;2;551
3144607;Nepomuceno;3170701;Varginha;1;1;2;34
3144805;Nova Lima;3170701;Varginha;1;1;2;229
3151701;Poço Fundo;3170701;Varginha;1;1;2;66
3156700;Sabará;3170701;Varginha;1;1;2;243
3157807;Santa Luzia;3170701;Varginha;1;1;2;250
3159605;Santa Rita do Sapucaí;3170701;Varginha;1;1;2;89
3160801;São Bento Abade;3170701;Varginha;1;1;2;35
3162500;São João del Rei;3170701;Varginha;1;1;2;122
3164704;São Sebastião do Paraíso;3170701;Varginha;1;1;2;176
3165206;São Thomé das Letras;3170701;Varginha;1;1;2;50
3167202;Sete Lagoas;3170701;Varginha;1;1;2;258
2921807;Mortugaba;3170651;Vargem Grande do Rio Pardo;1;1;2;43
3106200;Belo Horizonte;3170602;Vargem Bonita;1;1;2;254
3145703;Oliveira Fortes;3170602;Vargem Bonita;1;1;2;320
3106200;Belo Horizonte;3170578;Vargem Alegre;1;1;2;177
3130903;Inhapim;3170578;Vargem Alegre;1;1;2;21
3159357;Santa Rita de Minas;3170578;Vargem Alegre;1;1;2;36
3120201;Cristais;3170529;Urucuia;1;1;2;526
3130051;Icaraí de Minas;3170529;Urucuia;1;1;2;90
3135100;Janaúba;3170529;Urucuia;1;1;2;259
3161106;São Francisco;3170529;Urucuia;1;1;2;99
3100302;Abre Campo;3170503;Urucânia;1;1;2;28
3106200;Belo Horizonte;3170503;Urucânia;1;1;2;139
3127701;Governador Valadares;3170503;Urucânia;1;1;2;188
3135506;Jequeri;3170503;Urucânia;1;1;2;14
3144706;Nova Era;3170503;Urucânia;1;1;2;72
3116159;Chapada Gaúcha;3170479;Uruana de Minas;1;1;2;108
2702306;Coruripe;3170438;União de Minas;1;1;2;1787
3106200;Belo Horizonte;3170438;União de Minas;1;1;2;669
1720903;Taguatinga;3170404;Unaí;1;1;2;445
2312908;Sobral;3170404;Unaí;1;1;2;1566
2910800;Feira de Santana;3170404;Unaí;1;1;2;957
2928901;São Desidério;3170404;Unaí;1;1;2;492
3100203;Abaeté;3170404;Unaí;1;1;2;342
3106705;Betim;3170404;Unaí;1;1;2;492
3108552;Brasilândia de Minas;3170404;Unaí;1;1;2;119
3122470;Dom Bosco;3170404;Unaí;1;1;2;75
3126109;Formiga;3170404;Unaí;1;1;2;478
3126208;Formoso;3170404;Unaí;1;1;2;177
3143104;Monte Carmelo;3170404;Unaí;1;1;2;265
3143302;Montes Claros;3170404;Unaí;1;1;2;328
3144375;Natalândia;3170404;Unaí;1;1;2;47
3147907;Passos;3170404;Unaí;1;1;2;477
3148905;Pedra do Indaiá;3170404;Unaí;1;1;2;465
3160405;Santo Antônio do Monte;3170404;Unaí;1;1;2;444
3162104;São Gotardo;3170404;Unaí;1;1;2;335
3162955;São José da Lapa;3170404;Unaí;1;1;2;484
3170206;Uberlândia;3170404;Unaí;1;1;2;312
3100906;Águas Formosas;3170305;Umburatiba;1;1;2;43
3106200;Belo Horizonte;3170305;Umburatiba;1;1;2;465
1500602;Altamira;3170206;Uberlândia;1;1;2;1787
1504208;Marabá;3170206;Uberlândia;1;1;2;1499
1504976;Nova Ipixuna;3170206;Uberlândia;1;1;2;1549
1506807;Santarém;3170206;Uberlândia;1;1;2;1933
1706506;Darcinópolis;3170206;Uberlândia;1;1;2;1349
1716109;Paraíso do Tocantins;3170206;Uberlândia;1;1;2;969
1720903;Taguatinga;3170206;Uberlândia;1;1;2;743
2100808;Anapurus;3170206;Uberlândia;1;1;2;1765
2104057;Estreito;3170206;Uberlândia;1;1;2;1367
2109502;Riachão;3170206;Uberlândia;1;1;2;1286
2109700;Sambaíba;3170206;Uberlândia;1;1;2;1335
2109908;Santa Inês;3170206;Uberlândia;1;1;2;1691
2110658;São Domingos do Azeitão;3170206;Uberlândia;1;1;2;1388
2112001;Tasso Fragoso;3170206;Uberlândia;1;1;2;1179
2112100;Timbiras;3170206;Uberlândia;1;1;2;1682
2203909;Floriano;3170206;Uberlândia;1;1;2;1442
2209203;Santa Filomena;3170206;Uberlândia;1;1;2;1109
2303709;Caucaia;3170206;Uberlândia;1;1;2;1944
2307304;Juazeiro do Norte;3170206;Uberlândia;1;1;2;1585
2312908;Sobral;3170206;Uberlândia;1;1;2;1869
2403251;Parnamirim;3170206;Uberlândia;1;1;2;1959
2408003;Mossoró;3170206;Uberlândia;1;1;2;1885
2604106;Caruaru;3170206;Uberlândia;1;1;2;1724
2607208;Ipojuca;3170206;Uberlândia;1;1;2;1787
2611101;Petrolina;3170206;Uberlândia;1;1;2;1327
2612208;Salgueiro;3170206;Uberlândia;1;1;2;1516
2803609;Laranjeiras;3170206;Uberlândia;1;1;2;1455
2806701;São Cristóvão;3170206;Uberlândia;1;1;2;1441
2900702;Alagoinhas;3170206;Uberlândia;1;1;2;1265
2905701;Camaçari;3170206;Uberlândia;1;1;2;1239
2906501;Candeias;3170206;Uberlândia;1;1;2;1221
2913606;Ilhéus;3170206;Uberlândia;1;1;2;1056
2914703;Itaberaba;3170206;Uberlândia;1;1;2;1083
2925303;Porto Seguro;3170206;Uberlândia;1;1;2;994
2928703;Santo Antônio de Jesus;3170206;Uberlândia;1;1;2;1139
2930105;Senhor do Bonfim;3170206;Uberlândia;1;1;2;1253
3103702;Araponga;3170206;Uberlândia;1;1;2;639
3105608;Barbacena;3170206;Uberlândia;1;1;2;538
3107406;Bom Despacho;3170206;Uberlândia;1;1;2;330
3109006;Brumadinho;3170206;Uberlândia;1;1;2;452
3109402;Buritizeiro;3170206;Uberlândia;1;1;2;385
3111705;Canaã;3170206;Uberlândia;1;1;2;630
3111804;Canápolis;3170206;Uberlândia;1;1;2;101
3113404;Caratinga;3170206;Uberlândia;1;1;2;649
3114204;Carmo do Cajuru;3170206;Uberlândia;1;1;2;396
3114550;Carneirinho;3170206;Uberlândia;1;1;2;270
3115508;Caxambu;3170206;Uberlândia;1;1;2;486
3118304;Conselheiro Lafaiete;3170206;Uberlândia;1;1;2;509
3119401;Coronel Fabriciano;3170206;Uberlândia;1;1;2;599
3120805;Cruzília;3170206;Uberlândia;1;1;2;491
3124104;Esmeraldas;3170206;Uberlândia;1;1;2;428
3129509;Ibiá;3170206;Uberlândia;1;1;2;192
3131604;Iraí de Minas;3170206;Uberlândia;1;1;2;85
3133808;Itaúna;3170206;Uberlândia;1;1;2;411
3137536;Lagoa Grande;3170206;Uberlândia;1;1;2;219
3138625;Limeira do Oeste;3170206;Uberlândia;1;1;2;255
3142304;Moeda;3170206;Uberlândia;1;1;2;473
3143906;Muriaé;3170206;Uberlândia;1;1;2;673
3145604;Oliveira;3170206;Uberlândia;1;1;2;412
3146107;Ouro Preto;3170206;Uberlândia;1;1;2;526
3147907;Passos;3170206;Uberlândia;1;1;2;264
3149309;Pedro Leopoldo;3170206;Uberlândia;1;1;2;451
3153004;Pratinha;3170206;Uberlândia;1;1;2;221
3154002;Raul Soares;3170206;Uberlândia;1;1;2;630
3156403;Romaria;3170206;Uberlândia;1;1;2;72
3156908;Sacramento;3170206;Uberlândia;1;1;2;137
3158953;Santana do Paraíso;3170206;Uberlândia;1;1;2;603
3159902;Santo Antônio do Amparo;3170206;Uberlândia;1;1;2;421
3162005;São Gonçalo do Sapucaí;3170206;Uberlândia;1;1;2;436
3162104;São Gotardo;3170206;Uberlândia;1;1;2;238
3163102;São José da Varginha;3170206;Uberlândia;1;1;2;402
3163706;São Lourenço;3170206;Uberlândia;1;1;2;496
3164605;São Sebastião do Oeste;3170206;Uberlândia;1;1;2;377
1501402;Belém;3170107;Uberaba;1;1;2;2032
1504703;Moju;3170107;Uberaba;1;1;2;1972
1707306;Dueré;3170107;Uberaba;1;1;2;940
2100055;Açailândia;3170107;Uberaba;1;1;2;1636
2304400;Fortaleza;3170107;Uberaba;1;1;2;2007
2408102;Natal;3170107;Uberaba;1;1;2;2008
2603207;Caetés;3170107;Uberaba;1;1;2;1674
2607208;Ipojuca;3170107;Uberaba;1;1;2;1815
2611101;Petrolina;3170107;Uberaba;1;1;2;1379
2708600;São Miguel dos Campos;3170107;Uberaba;1;1;2;1636
2903201;Barreiras;3170107;Uberaba;1;1;2;886
2908101;Cocos;3170107;Uberaba;1;1;2;708
2911105;Formosa do Rio Preto;3170107;Uberaba;1;1;2;1004
2912301;Ibicuí;3170107;Uberaba;1;1;2;983
2922250;Muquém de São Francisco;3170107;Uberaba;1;1;2;961
3100203;Abaeté;3170107;Uberaba;1;1;2;266
3101607;Alfenas;3170107;Uberaba;1;1;2;277
3101706;Almenara;3170107;Uberaba;1;1;2;846
3103504;Araguari;3170107;Uberaba;1;1;2;126
3105608;Barbacena;3170107;Uberaba;1;1;2;463
3107406;Bom Despacho;3170107;Uberaba;1;1;2;278
3111101;Campina Verde;3170107;Uberaba;1;1;2;166
3114204;Carmo do Cajuru;3170107;Uberaba;1;1;2;334
3114303;Carmo do Paranaíba;3170107;Uberaba;1;1;2;182
3114402;Carmo do Rio Claro;3170107;Uberaba;1;1;2;234
3115300;Cataguases;3170107;Uberaba;1;1;2;581
3120904;Curvelo;3170107;Uberaba;1;1;2;376
3121209;Delfinópolis;3170107;Uberaba;1;1;2;130
3121258;Delta;3170107;Uberaba;1;1;2;25
3121605;Diamantina;3170107;Uberaba;1;1;2;480
3127701;Governador Valadares;3170107;Uberaba;1;1;2;629
3128006;Guanhães;3170107;Uberaba;1;1;2;533
3128709;Guaxupé;3170107;Uberaba;1;1;2;214
3128907;Guimarânia;3170107;Uberaba;1;1;2;154
3131000;Inhaúma;3170107;Uberaba;1;1;2;371
3136702;Juiz de Fora;3170107;Uberaba;1;1;2;532
3137106;Lagamar;3170107;Uberaba;1;1;2;208
3137205;Lagoa da Prata;3170107;Uberaba;1;1;2;252
3143302;Montes Claros;3170107;Uberaba;1;1;2;536
3147907;Passos;3170107;Uberaba;1;1;2;172
3149804;Perdizes;3170107;Uberaba;1;1;2;78
3150703;Pirajuba;3170107;Uberaba;1;1;2;84
3152006;Pompéu;3170107;Uberaba;1;1;2;317
3152105;Ponte Nova;3170107;Uberaba;1;1;2;532
3152501;Pouso Alegre;3170107;Uberaba;1;1;2;344
3153004;Pratinha;3170107;Uberaba;1;1;2;161
3153400;Presidente Olegário;3170107;Uberaba;1;1;2;215
3154606;Ribeirão das Neves;3170107;Uberaba;1;1;2;402
3162104;São Gotardo;3170107;Uberaba;1;1;2;201
3166808;Serra do Salitre;3170107;Uberaba;1;1;2;146
3167509;Simão Pereira;3170107;Uberaba;1;1;2;545
3168101;Tapira;3170107;Uberaba;1;1;2;117
3169356;Três Marias;3170107;Uberaba;1;1;2;327
3106200;Belo Horizonte;3170057;Ubaporanga;1;1;2;199
3122504;Dom Cavati;3170057;Ubaporanga;1;1;2;29
3127701;Governador Valadares;3170057;Ubaporanga;1;1;2;92
3130556;Imbé de Minas;3170057;Ubaporanga;1;1;2;15
3130903;Inhapim;3170057;Ubaporanga;1;1;2;7
3140902;Matipó;3170057;Ubaporanga;1;1;2;76
3152105;Ponte Nova;3170057;Ubaporanga;1;1;2;120
3106200;Belo Horizonte;3170008;Ubaí;1;1;2;409
3108602;Brasília de Minas;3170008;Ubaí;1;1;2;40
3111150;Campo Azul;3170008;Ubaí;1;1;2;24
3146909;Papagaios;3170008;Ubaí;1;1;2;350
3161106;São Francisco;3170008;Ubaí;1;1;2;35
3164209;São Romão;3170008;Ubaí;1;1;2;36
2504009;Campina Grande;3169901;Ubá;1;1;2;1693
3104601;Astolfo Dutra;3169901;Ubá;1;1;2;27
3106705;Betim;3169901;Ubá;1;1;2;177
3112109;Caparaó;3169901;Ubá;1;1;2;129
3113206;Carandaí;3169901;Ubá;1;1;2;94
3119401;Coronel Fabriciano;3169901;Ubá;1;1;2;178
3120904;Curvelo;3169901;Ubá;1;1;2;301
3123304;Dores do Turvo;3169901;Ubá;1;1;2;25
3124005;Ervália;3169901;Ubá;1;1;2;44
3128402;Guarani;3169901;Ubá;1;1;2;30
3129004;Guiricema;3169901;Ubá;1;1;2;29
3131307;Ipatinga;3169901;Ubá;1;1;2;185
3133808;Itaúna;3169901;Ubá;1;1;2;199
3136207;João Monlevade;3169901;Ubá;1;1;2;143
3139409;Manhuaçu;3169901;Ubá;1;1;2;134
3145901;Ouro Branco;3169901;Ubá;1;1;2;97
3146107;Ouro Preto;3169901;Ubá;1;1;2;98
3148202;Patrocínio do Muriaé;3169901;Ubá;1;1;2;80
3152501;Pouso Alegre;3169901;Ubá;1;1;2;334
3155405;Rio Novo;3169901;Ubá;1;1;2;43
3157807;Santa Luzia;3169901;Ubá;1;1;2;172
3162500;São João del Rei;3169901;Ubá;1;1;2;136
3162906;São João Nepomuceno;3169901;Ubá;1;1;2;50
3167202;Sete Lagoas;3169901;Ubá;1;1;2;224
3139003;Machado;3169802;Turvolândia;1;1;2;26
3162005;São Gonçalo do Sapucaí;3169802;Turvolândia;1;1;2;20
3167400;Silvianópolis;3169802;Turvolândia;1;1;2;18
3104007;Araxá;3169703;Turmalina;1;1;2;518
3112059;Cantagalo;3169703;Turmalina;1;1;2;137
3113503;Carbonita;3169703;Turmalina;1;1;2;40
3121605;Diamantina;3169703;Turmalina;1;1;2;140
3122306;Divinópolis;3169703;Turmalina;1;1;2;393
3148004;Patos de Minas;3169703;Turmalina;1;1;2;427
3151206;Pirapora;3169703;Turmalina;1;1;2;232
3103504;Araguari;3169604;Tupaciguara;1;1;2;53
3104007;Araxá;3169604;Tupaciguara;1;1;2;216
3106200;Belo Horizonte;3169604;Tupaciguara;1;1;2;521
3143104;Monte Carmelo;3169604;Tupaciguara;1;1;2;127
3159803;Santa Vitória;3169604;Tupaciguara;1;1;2;152
3106200;Belo Horizonte;3169505;Tumiritinga;1;1;2;267
3127305;Galiléia;3169505;Tumiritinga;1;1;2;11
3127701;Governador Valadares;3169505;Tumiritinga;1;1;2;40
2913200;Ibotirama;3169406;Três Pontas;1;1;2;1043
3102605;Andradas;3169406;Três Pontas;1;1;2;134
3103504;Araguari;3169406;Três Pontas;1;1;2;410
3104007;Araxá;3169406;Três Pontas;1;1;2;246
3104106;Arceburgo;3169406;Três Pontas;1;1;2;148
3104304;Areado;3169406;Três Pontas;1;1;2;65
3108008;Bom Sucesso;3169406;Três Pontas;1;1;2;87
3108305;Borda da Mata;3169406;Três Pontas;1;1;2;121
3109501;Cabo Verde;3169406;Três Pontas;1;1;2;92
3111002;Campestre;3169406;Três Pontas;1;1;2;85
3111309;Campo do Meio;3169406;Três Pontas;1;1;2;44
3113602;Careaçu;3169406;Três Pontas;1;1;2;77
3117108;Conceição da Aparecida;3169406;Três Pontas;1;1;2;78
3117801;Conceição dos Ouros;3169406;Três Pontas;1;1;2;119
3117900;Congonhal;3169406;Três Pontas;1;1;2;102
3123205;Dores do Indaiá;3169406;Três Pontas;1;1;2;211
3131703;Itabira;3169406;Três Pontas;1;1;2;303
3132404;Itajubá;3169406;Três Pontas;1;1;2;115
3136900;Juruaia;3169406;Três Pontas;1;1;2;111
3143005;Monte Belo;3169406;Três Pontas;1;1;2;88
3143203;Monte Santo de Minas;3169406;Três Pontas;1;1;2;160
3145109;Nova Resende;3169406;Três Pontas;1;1;2;97
3145604;Oliveira;3169406;Três Pontas;1;1;2;101
3147204;Paraguaçu;3169406;Três Pontas;1;1;2;30
3148103;Patrocínio;3169406;Três Pontas;1;1;2;307
3151701;Poço Fundo;3169406;Três Pontas;1;1;2;65
3154705;Ribeirão Vermelho;3169406;Três Pontas;1;1;2;50
3159209;Santa Rita de Caldas;3169406;Três Pontas;1;1;2;112
3104007;Araxá;3169356;Três Marias;1;1;2;237
3109402;Buritizeiro;3169356;Três Marias;1;1;2;97
3111507;Campos Altos;3169356;Três Marias;1;1;2;193
3112307;Capelinha;3169356;Três Marias;1;1;2;293
3116605;Cláudio;3169356;Três Marias;1;1;2;254
3118601;Contagem;3169356;Três Marias;1;1;2;227
3125705;Felixlândia;3169356;Três Marias;1;1;2;72
3128303;Guaranésia;3169356;Três Marias;1;1;2;382
3131109;Inimutaba;3169356;Três Marias;1;1;2;111
3136652;Juatuba;3169356;Três Marias;1;1;2;217
3136702;Juiz de Fora;3169356;Três Marias;1;1;2;444
3139409;Manhuaçu;3169356;Três Marias;1;1;2;407
3143104;Monte Carmelo;3169356;Três Marias;1;1;2;247
3148103;Patrocínio;3169356;Três Marias;1;1;2;202
3161106;São Francisco;3169356;Três Marias;1;1;2;250
3166808;Serra do Salitre;3169356;Três Marias;1;1;2;184
3168903;Tiros;3169356;Três Marias;1;1;2;117
1500800;Ananindeua;3169307;Três Corações;1;1;2;2267
2704302;Maceió;3169307;Três Corações;1;1;2;1635
2803500;Lagarto;3169307;Três Corações;1;1;2;1413
2905701;Camaçari;3169307;Três Corações;1;1;2;1212
3101508;Além Paraíba;3169307;Três Corações;1;1;2;260
3104007;Araxá;3169307;Três Corações;1;1;2;290
3110509;Camanducaia;3169307;Três Corações;1;1;2;154
3110608;Cambuí;3169307;Três Corações;1;1;2;137
3110905;Campanha;3169307;Três Corações;1;1;2;26
3111606;Campos Gerais;3169307;Três Corações;1;1;2;73
3115508;Caxambu;3169307;Três Corações;1;1;2;40
3118700;Coqueiral;3169307;Três Corações;1;1;2;57
3122306;Divinópolis;3169307;Três Corações;1;1;2;170
3124203;Espera Feliz;3169307;Três Corações;1;1;2;360
3131703;Itabira;3169307;Três Corações;1;1;2;304
3133105;Itanhandu;3169307;Três Corações;1;1;2;76
3135902;Jesuânia;3169307;Três Corações;1;1;2;37
3136702;Juiz de Fora;3169307;Três Corações;1;1;2;196
3137809;Lambari;3169307;Três Corações;1;1;2;35
3139102;Madre de Deus de Minas;3169307;Três Corações;1;1;2;95
3139409;Manhuaçu;3169307;Três Corações;1;1;2;362
3140902;Matipó;3169307;Três Corações;1;1;2;334
3142601;Monsenhor Paulo;3169307;Três Corações;1;1;2;34
3144409;Natércia;3169307;Três Corações;1;1;2;59
3145604;Oliveira;3169307;Três Corações;1;1;2;114
3149309;Pedro Leopoldo;3169307;Três Corações;1;1;2;257
3159605;Santa Rita do Sapucaí;3169307;Três Corações;1;1;2;82
3113305;Carangola;3169208;Tombos;1;1;2;19
3124203;Espera Feliz;3169208;Tombos;1;1;2;31
3125309;Faria Lemos;3169208;Tombos;1;1;2;13
3143906;Muriaé;3169208;Tombos;1;1;2;38
3106200;Belo Horizonte;3169109;Toledo;1;1;2;396
3112000;Candeias;3169109;Toledo;1;1;2;243
3165578;Senador Amaral;3169109;Toledo;1;1;2;25
3106200;Belo Horizonte;3169059;Tocos do Moji;1;1;2;349
3107901;Bom Repouso;3169059;Tocos do Moji;1;1;2;12
3124500;Estiva;3169059;Tocos do Moji;1;1;2;13
3125101;Extrema;3169059;Tocos do Moji;1;1;2;58
2601706;Belo Jardim;3169000;Tocantins;1;1;2;1565
2700300;Arapiraca;3169000;Tocantins;1;1;2;1414
3104007;Araxá;3169000;Tocantins;1;1;2;442
3115300;Cataguases;3169000;Tocantins;1;1;2;41
3118304;Conselheiro Lafaiete;3169000;Tocantins;1;1;2;101
3128402;Guarani;3169000;Tocantins;1;1;2;20
3136702;Juiz de Fora;3169000;Tocantins;1;1;2;72
3138401;Leopoldina;3169000;Tocantins;1;1;2;53
3143401;Monte Sião;3169000;Tocantins;1;1;2;396
3158953;Santana do Paraíso;3169000;Tocantins;1;1;2;206
3104007;Araxá;3168903;Tiros;1;1;2;122
3106200;Belo Horizonte;3168903;Tiros;1;1;2;232
3114303;Carmo do Paranaíba;3168903;Tiros;1;1;2;42
3137502;Lagoa Formosa;3168903;Tiros;1;1;2;53
3141207;Matutina;3168903;Tiros;1;1;2;24
1100023;Ariquemes;3168804;Tiradentes;1;1;2;2270
3106200;Belo Horizonte;3168804;Tiradentes;1;1;2;136
3134905;Jacutinga;3168804;Tiradentes;1;1;2;285
3136702;Juiz de Fora;3168804;Tiradentes;1;1;2;113
3157336;Santa Cruz de Minas;3168804;Tiradentes;1;1;2;7
2804805;Nossa Senhora do Socorro;3168705;Timóteo;1;1;2;1119
2905701;Camaçari;3168705;Timóteo;1;1;2;882
3106309;Belo Oriente;3168705;Timóteo;1;1;2;44
3106705;Betim;3168705;Timóteo;1;1;2;168
3113404;Caratinga;3168705;Timóteo;1;1;2;53
3121803;Dionísio;3168705;Timóteo;1;1;2;32
3143104;Monte Carmelo;3168705;Timóteo;1;1;2;518
3144805;Nova Lima;3168705;Timóteo;1;1;2;136
3152105;Ponte Nova;3168705;Timóteo;1;1;2;95
3158003;Santa Maria de Itabira;3168705;Timóteo;1;1;2;51
1302603;Manaus;3168606;Teófilo Otoni;1;1;2;2512
2606002;Garanhuns;3168606;Teófilo Otoni;1;1;2;1123
2607901;Jaboatão dos Guararapes;3168606;Teófilo Otoni;1;1;2;1270
2610004;Palmares;3168606;Teófilo Otoni;1;1;2;1186
2910800;Feira de Santana;3168606;Teófilo Otoni;1;1;2;671
2915601;Itamaraju;3168606;Teófilo Otoni;1;1;2;230
2922003;Mucuri;3168606;Teófilo Otoni;1;1;2;206
2923001;Nova Viçosa;3168606;Teófilo Otoni;1;1;2;212
2925303;Porto Seguro;3168606;Teófilo Otoni;1;1;2;296
2925501;Prado;3168606;Teófilo Otoni;1;1;2;244
3104007;Araxá;3168606;Teófilo Otoni;1;1;2;610
3105202;Bandeira;3168606;Teófilo Otoni;1;1;2;240
3110806;Campanário;3168606;Teófilo Otoni;1;1;2;49
3113008;Caraí;3168606;Teófilo Otoni;1;1;2;77
3113701;Carlos Chagas;3168606;Teófilo Otoni;1;1;2;79
3115458;Catuji;3168606;Teófilo Otoni;1;1;2;61
3125606;Felisburgo;3168606;Teófilo Otoni;1;1;2;156
3126802;Frei Gaspar;3168606;Teófilo Otoni;1;1;2;23
3128006;Guanhães;3168606;Teófilo Otoni;1;1;2;180
3129301;Iapu;3168606;Teófilo Otoni;1;1;2;190
3130903;Inhapim;3168606;Teófilo Otoni;1;1;2;201
3132305;Itaipé;3168606;Teófilo Otoni;1;1;2;53
3136207;João Monlevade;3168606;Teófilo Otoni;1;1;2;280
3136504;Jordânia;3168606;Teófilo Otoni;1;1;2;258
3141405;Medina;3168606;Teófilo Otoni;1;1;2;181
3143104;Monte Carmelo;3168606;Teófilo Otoni;1;1;2;645
3143906;Muriaé;3168606;Teófilo Otoni;1;1;2;366
3144904;Nova Módica;3168606;Teófilo Otoni;1;1;2;64
3146305;Padre Paraíso;3168606;Teófilo Otoni;1;1;2;86
3148509;Pavão;3168606;Teófilo Otoni;1;1;2;70
3148707;Pedra Azul;3168606;Teófilo Otoni;1;1;2;202
3155108;Rio do Prado;3168606;Teófilo Otoni;1;1;2;170
3156601;Rubim;3168606;Teófilo Otoni;1;1;2;190
3158102;Santa Maria do Salto;3168606;Teófilo Otoni;1;1;2;229
3162500;São João del Rei;3168606;Teófilo Otoni;1;1;2;469
3163300;São José do Divino;3168606;Teófilo Otoni;1;1;2;70
3106200;Belo Horizonte;3168507;Teixeiras;1;1;2;143
3128204;Guaraciaba;3168507;Teixeiras;1;1;2;18
3152105;Ponte Nova;3168507;Teixeiras;1;1;2;27
3106200;Belo Horizonte;3168408;Tarumirim;1;1;2;219
3113404;Caratinga;3168408;Tarumirim;1;1;2;62
3118403;Conselheiro Pena;3168408;Tarumirim;1;1;2;55
3122504;Dom Cavati;3168408;Tarumirim;1;1;2;15
3123700;Engenheiro Caldas;3168408;Tarumirim;1;1;2;8
3133204;Itanhomi;3168408;Tarumirim;1;1;2;19
3120904;Curvelo;3168309;Taquaraçu de Minas;1;1;2;130
3134608;Jaboticatubas;3168309;Taquaraçu de Minas;1;1;2;18
3156700;Sabará;3168309;Taquaraçu de Minas;1;1;2;27
3157807;Santa Luzia;3168309;Taquaraçu de Minas;1;1;2;20
2927408;Salvador;3168002;Taiobeiras;1;1;2;508
3101706;Almenara;3168002;Taiobeiras;1;1;2;167
3104007;Araxá;3168002;Taiobeiras;1;1;2;659
3106200;Belo Horizonte;3168002;Taiobeiras;1;1;2;490
3107307;Bocaiúva;3168002;Taiobeiras;1;1;2;225
3112307;Capelinha;3168002;Taiobeiras;1;1;2;210
3118601;Contagem;3168002;Taiobeiras;1;1;2;497
3119500;Coronel Murta;3168002;Taiobeiras;1;1;2;90
3133303;Itaobim;3168002;Taiobeiras;1;1;2;110
3135308;Japaraíba;3168002;Taiobeiras;1;1;2;596
3142908;Monte Azul;3168002;Taiobeiras;1;1;2;100
3143104;Monte Carmelo;3168002;Taiobeiras;1;1;2;654
3146305;Padre Paraíso;3168002;Taiobeiras;1;1;2;159
3148707;Pedra Azul;3168002;Taiobeiras;1;1;2;105
3151206;Pirapora;3168002;Taiobeiras;1;1;2;333
3152204;Porteirinha;3168002;Taiobeiras;1;1;2;83
3152501;Pouso Alegre;3168002;Taiobeiras;1;1;2;816
3161106;São Francisco;3168002;Taiobeiras;1;1;2;278
3106200;Belo Horizonte;3167905;Tabuleiro;1;1;2;178
3136702;Juiz de Fora;3167905;Tabuleiro;1;1;2;45
3155405;Rio Novo;3167905;Tabuleiro;1;1;2;17
3115508;Caxambu;3167806;Soledade de Minas;1;1;2;14
3106200;Belo Horizonte;3167707;Sobrália;1;1;2;210
3106200;Belo Horizonte;3167608;Simonésia;1;1;2;206
3151800;Poços de Caldas;3167608;Simonésia;1;1;2;509
3158607;Santana do Deserto;3167509;Simão Pereira;1;1;2;15
3109709;Cachoeira de Minas;3167400;Silvianópolis;1;1;2;37
3117900;Congonhal;3167400;Silvianópolis;1;1;2;25
3124401;Espírito Santo do Dourado;3167400;Silvianópolis;1;1;2;12
3125200;Fama;3167400;Silvianópolis;1;1;2;65
3159605;Santa Rita do Sapucaí;3167400;Silvianópolis;1;1;2;28
3162005;São Gonçalo do Sapucaí;3167400;Silvianópolis;1;1;2;29
3106200;Belo Horizonte;3167301;Silveirânia;1;1;2;160
3118601;Contagem;3167301;Silveirânia;1;1;2;164
2100055;Açailândia;3167202;Sete Lagoas;1;1;2;1635
2304400;Fortaleza;3167202;Sete Lagoas;1;1;2;1828
2611606;Recife;3167202;Sete Lagoas;1;1;2;1572
2804805;Nossa Senhora do Socorro;3167202;Sete Lagoas;1;1;2;1198
2902708;Barra;3167202;Sete Lagoas;1;1;2;941
2903904;Bom Jesus da Lapa;3167202;Sete Lagoas;1;1;2;688
2906709;Cândido Sales;3167202;Sete Lagoas;1;1;2;537
2921609;Morpará;3167202;Sete Lagoas;1;1;2;877
2930709;Simões Filho;3167202;Sete Lagoas;1;1;2;951
3101003;Águas Vermelhas;3167202;Sete Lagoas;1;1;2;501
3104809;Augusto de Lima;3167202;Sete Lagoas;1;1;2;147
3105004;Baldim;3167202;Sete Lagoas;1;1;2;34
3105608;Barbacena;3167202;Sete Lagoas;1;1;2;200
3109600;Cachoeira da Prata;3167202;Sete Lagoas;1;1;2;25
3111200;Campo Belo;3167202;Sete Lagoas;1;1;2;194
3112505;Capim Branco;3167202;Sete Lagoas;1;1;2;15
3112703;Capitão Enéas;3167202;Sete Lagoas;1;1;2;352
3114204;Carmo do Cajuru;3167202;Sete Lagoas;1;1;2;100
3116605;Cláudio;3167202;Sete Lagoas;1;1;2;125
3118908;Cordisburgo;3167202;Sete Lagoas;1;1;2;37
3125705;Felixlândia;3167202;Sete Lagoas;1;1;2;103
3127206;Funilândia;3167202;Sete Lagoas;1;1;2;20
3127701;Governador Valadares;3167202;Sete Lagoas;1;1;2;246
3132008;Itacambira;3167202;Sete Lagoas;1;1;2;280
3132503;Itamarandiba;3167202;Sete Lagoas;1;1;2;227
3135209;Januária;3167202;Sete Lagoas;1;1;2;440
3136652;Juatuba;3167202;Sete Lagoas;1;1;2;58
3138203;Lavras;3167202;Sete Lagoas;1;1;2;214
3139409;Manhuaçu;3167202;Sete Lagoas;1;1;2;245
3140704;Mateus Leme;3167202;Sete Lagoas;1;1;2;64
3143450;Montezuma;3167202;Sete Lagoas;1;1;2;505
3145455;Olhos-d'Água;3167202;Sete Lagoas;1;1;2;236
3146909;Papagaios;3167202;Sete Lagoas;1;1;2;54
3155603;Rio Pardo de Minas;3167202;Sete Lagoas;1;1;2;459
3156700;Sabará;3167202;Sete Lagoas;1;1;2;65
3158508;Santana de Pirapama;3167202;Sete Lagoas;1;1;2;52
3159001;Santana do Riacho;3167202;Sete Lagoas;1;1;2;62
3159902;Santo Antônio do Amparo;3167202;Sete Lagoas;1;1;2;182
3162401;São João da Ponte;3167202;Sete Lagoas;1;1;2;388
3162955;São José da Lapa;3167202;Sete Lagoas;1;1;2;40
3164704;São Sebastião do Paraíso;3167202;Sete Lagoas;1;1;2;334
3104007;Araxá;3167103;Serro;1;1;2;394
3106200;Belo Horizonte;3167103;Serro;1;1;2;158
3117504;Conceição do Mato Dentro;3167103;Serro;1;1;2;48
3118601;Contagem;3167103;Serro;1;1;2;165
3120904;Curvelo;3167103;Serro;1;1;2;119
3121001;Datas;3167103;Serro;1;1;2;35
3122306;Divinópolis;3167103;Serro;1;1;2;236
3151206;Pirapora;3167103;Serro;1;1;2;215
3167004;Serranos;3167103;Serro;1;1;2;383
3102803;Andrelândia;3167004;Serranos;1;1;2;27
3107505;Bom Jardim de Minas;3167004;Serranos;1;1;2;37
3114808;Carvalhos;3167004;Serranos;1;1;2;16
3138500;Liberdade;3167004;Serranos;1;1;2;29
3104007;Araxá;3166907;Serrania;1;1;2;236
3106200;Belo Horizonte;3166907;Serrania;1;1;2;280
3109501;Cabo Verde;3166907;Serrania;1;1;2;38
3111002;Campestre;3166907;Serrania;1;1;2;28
3117108;Conceição da Aparecida;3166907;Serrania;1;1;2;53
3122405;Divisa Nova;3166907;Serrania;1;1;2;17
3128709;Guaxupé;3166907;Serrania;1;1;2;75
3131505;Ipuiúna;3166907;Serrania;1;1;2;63
3143005;Monte Belo;3166907;Serrania;1;1;2;42
3106200;Belo Horizonte;3166808;Serra do Salitre;1;1;2;299
3128709;Guaxupé;3166808;Serra do Salitre;1;1;2;243
3129509;Ibiá;3166808;Serra do Salitre;1;1;2;40
3153400;Presidente Olegário;3166808;Serra do Salitre;1;1;2;82
3155504;Rio Paranaíba;3166808;Serra do Salitre;1;1;2;48
2931350;Teixeira de Freitas;3166709;Serra dos Aimorés;1;1;2;62
3106200;Belo Horizonte;3166709;Serra dos Aimorés;1;1;2;462
3106200;Belo Horizonte;3166600;Serra da Saudade;1;1;2;198
3106200;Belo Horizonte;3166501;Serra Azul de Minas;1;1;2;191
3101300;Alagoa;3166402;Seritinga;1;1;2;32
3114808;Carvalhos;3166402;Seritinga;1;1;2;12
3106200;Belo Horizonte;3166303;Sericita;1;1;2;168
3154002;Raul Soares;3166303;Sericita;1;1;2;42
3157906;Santa Margarida;3166303;Sericita;1;1;2;26
3113206;Carandaí;3166204;Senhora dos Remédios;1;1;2;31
3154408;Ressaquinha;3166204;Senhora dos Remédios;1;1;2;19
2927408;Salvador;3165909;Senador Modestino Gonçalves;1;1;2;740
3105608;Barbacena;3165909;Senador Modestino Gonçalves;1;1;2;365
3121605;Diamantina;3165909;Senador Modestino Gonçalves;1;1;2;51
3125408;Felício dos Santos;3165909;Senador Modestino Gonçalves;1;1;2;15
3117801;Conceição dos Ouros;3165800;Senador José Bento;1;1;2;48
3129004;Guiricema;3165701;Senador Firmino;1;1;2;41
3136702;Juiz de Fora;3165701;Senador Firmino;1;1;2;97
3148301;Paula Cândido;3165701;Senador Firmino;1;1;2;13
3140209;Maripá de Minas;3165602;Senador Cortes;1;1;2;11
3106200;Belo Horizonte;3165578;Senador Amaral;1;1;2;372
3108305;Borda da Mata;3165578;Senador Amaral;1;1;2;35
3143807;Munhoz;3165578;Senador Amaral;1;1;2;19
3134004;Itinga;3165552;Setubinha;1;1;2;134
3141405;Medina;3165552;Setubinha;1;1;2;185
3146305;Padre Paraíso;3165552;Setubinha;1;1;2;106
2931350;Teixeira de Freitas;3165537;Sarzedo;1;1;2;536
3106705;Betim;3165537;Sarzedo;1;1;2;10
3109006;Brumadinho;3165537;Sarzedo;1;1;2;13
3130101;Igarapé;3165537;Sarzedo;1;1;2;19
3131109;Inimutaba;3165537;Sarzedo;1;1;2;146
3131901;Itabirito;3165537;Sarzedo;1;1;2;42
3133808;Itaúna;3165537;Sarzedo;1;1;2;47
3140159;Mário Campos;3165537;Sarzedo;1;1;2;5
3140506;Martinho Campos;3165537;Sarzedo;1;1;2;138
3146107;Ouro Preto;3165537;Sarzedo;1;1;2;74
3154606;Ribeirão das Neves;3165537;Sarzedo;1;1;2;30
3154804;Rio Acima;3165537;Sarzedo;1;1;2;38
3106200;Belo Horizonte;3165503;Sardoá;1;1;2;209
3106309;Belo Oriente;3165503;Sardoá;1;1;2;50
3122207;Divinolândia de Minas;3165503;Sardoá;1;1;2;24
3127701;Governador Valadares;3165503;Sardoá;1;1;2;42
3110509;Camanducaia;3165404;Sapucaí-Mirim;1;1;2;41
3121100;Delfim Moreira;3165404;Sapucaí-Mirim;1;1;2;54
3146107;Ouro Preto;3165404;Sapucaí-Mirim;1;1;2;345
3147303;Paraisópolis;3165404;Sapucaí-Mirim;1;1;2;22
2902708;Barra;3165305;São Vicente de Minas;1;1;2;1192
3106200;Belo Horizonte;3165305;São Vicente de Minas;1;1;2;206
3114600;Carrancas;3165305;São Vicente de Minas;1;1;2;30
3120805;Cruzília;3165305;São Vicente de Minas;1;1;2;39
3136702;Juiz de Fora;3165305;São Vicente de Minas;1;1;2;117
3138500;Liberdade;3165305;São Vicente de Minas;1;1;2;39
3138609;Lima Duarte;3165305;São Vicente de Minas;1;1;2;71
3154200;Resende Costa;3165305;São Vicente de Minas;1;1;2;89
3156106;Ritápolis;3165305;São Vicente de Minas;1;1;2;77
3162500;São João del Rei;3165305;São Vicente de Minas;1;1;2;66
3163706;São Lourenço;3165305;São Vicente de Minas;1;1;2;75
3102803;Andrelândia;3165206;São Thomé das Letras;1;1;2;67
3106200;Belo Horizonte;3165206;São Thomé das Letras;1;1;2;227
3114600;Carrancas;3165206;São Thomé das Letras;1;1;2;44
3104007;Araxá;3165107;São Tomás de Aquino;1;1;2;133
3106200;Belo Horizonte;3165107;São Tomás de Aquino;1;1;2;338
3120201;Cristais;3165107;São Tomás de Aquino;1;1;2;165
3151800;Poços de Caldas;3165107;São Tomás de Aquino;1;1;2;124
2314102;Viçosa do Ceará;3165008;São Tiago;1;1;2;1949
2920007;Maiquinique;3165008;São Tiago;1;1;2;729
3104007;Araxá;3165008;São Tiago;1;1;2;292
3105608;Barbacena;3165008;São Tiago;1;1;2;81
3106200;Belo Horizonte;3165008;São Tiago;1;1;2;125
3115201;Conceição da Barra de Minas;3165008;São Tiago;1;1;2;24
3118304;Conselheiro Lafaiete;3165008;São Tiago;1;1;2;77
3119708;Coronel Xavier Chaves;3165008;São Tiago;1;1;2;32
3123007;Dores de Campos;3165008;São Tiago;1;1;2;55
3129400;Ibertioga;3165008;São Tiago;1;1;2;81
3134509;Itutinga;3165008;São Tiago;1;1;2;45
3139102;Madre de Deus de Minas;3165008;São Tiago;1;1;2;66
3144508;Nazareno;3165008;São Tiago;1;1;2;35
3133006;Itamonte;3164902;São Sebastião do Rio Verde;1;1;2;16
3133105;Itanhandu;3164902;São Sebastião do Rio Verde;1;1;2;11
3152600;Pouso Alto;3164902;São Sebastião do Rio Verde;1;1;2;5
1722107;Xambioá;3164704;São Sebastião do Paraíso;1;1;2;1612
2933307;Vitória da Conquista;3164704;São Sebastião do Paraíso;1;1;2;919
3102605;Andradas;3164704;São Sebastião do Paraíso;1;1;2;133
3107604;Bom Jesus da Penha;3164704;São Sebastião do Paraíso;1;1;2;49
3111606;Campos Gerais;3164704;São Sebastião do Paraíso;1;1;2;132
3112406;Capetinga;3164704;São Sebastião do Paraíso;1;1;2;35
3115102;Cássia;3164704;São Sebastião do Paraíso;1;1;2;40
3117108;Conceição da Aparecida;3164704;São Sebastião do Paraíso;1;1;2;83
3120201;Cristais;3164704;São Sebastião do Paraíso;1;1;2;153
3123601;Elói Mendes;3164704;São Sebastião do Paraíso;1;1;2;166
3124203;Espera Feliz;3164704;São Sebastião do Paraíso;1;1;2;529
3128105;Guapé;3164704;São Sebastião do Paraíso;1;1;2;112
3139409;Manhuaçu;3164704;São Sebastião do Paraíso;1;1;2;516
3145109;Nova Resende;3164704;São Sebastião do Paraíso;1;1;2;63
3152501;Pouso Alegre;3164704;São Sebastião do Paraíso;1;1;2;179
3137205;Lagoa da Prata;3164605;São Sebastião do Oeste;1;1;2;62
3106200;Belo Horizonte;3164506;São Sebastião do Maranhão;1;1;2;251
3128006;Guanhães;3164506;São Sebastião do Maranhão;1;1;2;82
3164100;São Pedro do Suaçuí;3164506;São Sebastião do Maranhão;1;1;2;31
3113404;Caratinga;3164472;São Sebastião do Anta;1;1;2;42
3130556;Imbé de Minas;3164472;São Sebastião do Anta;1;1;2;11
3130903;Inhapim;3164472;São Sebastião do Anta;1;1;2;17
3131307;Ipatinga;3164472;São Sebastião do Anta;1;1;2;59
3106200;Belo Horizonte;3164431;São Sebastião da Vargem Alegre;1;1;2;187
3143906;Muriaé;3164431;São Sebastião da Vargem Alegre;1;1;2;33
3104007;Araxá;3164308;São Roque de Minas;1;1;2;95
3115102;Cássia;3164308;São Roque de Minas;1;1;2;69
3118601;Contagem;3164308;São Roque de Minas;1;1;2;241
3156908;Sacramento;3164308;São Roque de Minas;1;1;2;120
3162203;São João Batista do Glória;3164308;São Roque de Minas;1;1;2;46
3106200;Belo Horizonte;3164100;São Pedro do Suaçuí;1;1;2;224
3106200;Belo Horizonte;3164001;São Pedro dos Ferros;1;1;2;155
3146107;Ouro Preto;3164001;São Pedro dos Ferros;1;1;2;109
3101904;Alpinópolis;3163904;São Pedro da União;1;1;2;37
3106200;Belo Horizonte;3163904;São Pedro da União;1;1;2;305
3128709;Guaxupé;3163904;São Pedro da União;1;1;2;22
3136900;Juruaia;3163904;São Pedro da União;1;1;2;14
3106200;Belo Horizonte;3163805;São Miguel do Anta;1;1;2;159
3101201;Aiuruoca;3163706;São Lourenço;1;1;2;46
3102803;Andrelândia;3163706;São Lourenço;1;1;2;84
3104205;Arcos;3163706;São Lourenço;1;1;2;209
3111606;Campos Gerais;3163706;São Lourenço;1;1;2;124
3117702;Conceição do Rio Verde;3163706;São Lourenço;1;1;2;28
3118601;Contagem;3163706;São Lourenço;1;1;2;262
3120508;Cristina;3163706;São Lourenço;1;1;2;27
3123601;Elói Mendes;3163706;São Lourenço;1;1;2;80
3136702;Juiz de Fora;3163706;São Lourenço;1;1;2;179
3138203;Lavras;3163706;São Lourenço;1;1;2;99
3138500;Liberdade;3163706;São Lourenço;1;1;2;73
3149705;Perdigão;3163706;São Lourenço;1;1;2;240
3106200;Belo Horizonte;3163607;São José do Mantimento;1;1;2;232
3139409;Manhuaçu;3163607;São José do Mantimento;1;1;2;41
3126950;Frei Lagonegro;3163508;São José do Jacuri;1;1;2;16
3128006;Guanhães;3163508;São José do Jacuri;1;1;2;58
3162807;São João Evangelista;3163508;São José do Jacuri;1;1;2;30
3106200;Belo Horizonte;3163409;São José do Goiabal;1;1;2;133
3131307;Ipatinga;3163409;São José do Goiabal;1;1;2;54
3136207;João Monlevade;3163409;São José do Goiabal;1;1;2;51
3154002;Raul Soares;3163409;São José do Goiabal;1;1;2;33
3106200;Belo Horizonte;3163300;São José do Divino;1;1;2;317
3132701;Itambacuri;3163300;São José do Divino;1;1;2;58
3106200;Belo Horizonte;3163201;São José do Alegre;1;1;2;312
3132404;Itajubá;3163201;São José do Alegre;1;1;2;11
3151008;Piranguinho;3163201;São José do Alegre;1;1;2;9
3146909;Papagaios;3163102;São José da Varginha;1;1;2;35
3106200;Belo Horizonte;3163003;São José da Safira;1;1;2;262
3126901;Frei Inocêncio;3163003;São José da Safira;1;1;2;34
3127701;Governador Valadares;3163003;São José da Safira;1;1;2;56
3128006;Guanhães;3163003;São José da Safira;1;1;2;95
2401453;Baraúna;3162955;São José da Lapa;1;1;2;1741
3118304;Conselheiro Lafaiete;3162955;São José da Lapa;1;1;2;108
3122306;Divinópolis;3162955;São José da Lapa;1;1;2;109
3124104;Esmeraldas;3162955;São José da Lapa;1;1;2;37
3131703;Itabira;3162955;São José da Lapa;1;1;2;77
3136207;João Monlevade;3162955;São José da Lapa;1;1;2;85
3141108;Matozinhos;3162955;São José da Lapa;1;1;2;19
3145901;Ouro Branco;3162955;São José da Lapa;1;1;2;96
3146503;Pains;3162955;São José da Lapa;1;1;2;193
3154606;Ribeirão das Neves;3162955;São José da Lapa;1;1;2;15
3104007;Araxá;3162948;São José da Barra;1;1;2;142
3106200;Belo Horizonte;3162948;São José da Barra;1;1;2;259
3147907;Passos;3162948;São José da Barra;1;1;2;33
3109006;Brumadinho;3162922;São Joaquim de Bicas;1;1;2;13
3126109;Formiga;3162922;São Joaquim de Bicas;1;1;2;129
3131307;Ipatinga;3162922;São Joaquim de Bicas;1;1;2;192
3137205;Lagoa da Prata;3162922;São Joaquim de Bicas;1;1;2;132
3137403;Lagoa Dourada;3162922;São Joaquim de Bicas;1;1;2;98
3138203;Lavras;3162922;São Joaquim de Bicas;1;1;2;151
3140506;Martinho Campos;3162922;São Joaquim de Bicas;1;1;2;128
3151404;Pitangui;3162922;São Joaquim de Bicas;1;1;2;77
3156908;Sacramento;3162922;São Joaquim de Bicas;1;1;2;332
3157807;Santa Luzia;3162922;São Joaquim de Bicas;1;1;2;54
3101508;Além Paraíba;3162906;São João Nepomuceno;1;1;2;43
3127388;Goianá;3162906;São João Nepomuceno;1;1;2;20
3128402;Guarani;3162906;São João Nepomuceno;1;1;2;21
3128501;Guarará;3162906;São João Nepomuceno;1;1;2;21
3139409;Manhuaçu;3162906;São João Nepomuceno;1;1;2;174
3143906;Muriaé;3162906;São João Nepomuceno;1;1;2;87
3104007;Araxá;3162807;São João Evangelista;1;1;2;456
3106309;Belo Oriente;3162807;São João Evangelista;1;1;2;84
3112059;Cantagalo;3162807;São João Evangelista;1;1;2;15
3116803;Coluna;3162807;São João Evangelista;1;1;2;32
3127701;Governador Valadares;3162807;São João Evangelista;1;1;2;91
3131703;Itabira;3162807;São João Evangelista;1;1;2;132
3143500;Morada Nova de Minas;3162807;São João Evangelista;1;1;2;276
3148400;Paulistas;3162807;São João Evangelista;1;1;2;14
3162401;São João da Ponte;3162807;São João Evangelista;1;1;2;314
3104007;Araxá;3162708;São João do Paraíso;1;1;2;714
3117009;Comercinho;3162708;São João do Paraíso;1;1;2;111
3121605;Diamantina;3162708;São João do Paraíso;1;1;2;364
3133709;Itatiaiuçu;3162708;São João do Paraíso;1;1;2;600
3135100;Janaúba;3162708;São João do Paraíso;1;1;2;151
3138609;Lima Duarte;3162708;São João do Paraíso;1;1;2;748
3141009;Mato Verde;3162708;São João do Paraíso;1;1;2;91
3142007;Mirabela;3162708;São João do Paraíso;1;1;2;253
3152006;Pompéu;3162708;São João do Paraíso;1;1;2;536
3106200;Belo Horizonte;3162609;São João do Oriente;1;1;2;201
3109253;Bugre;3162609;São João do Oriente;1;1;2;15
3113404;Caratinga;3162609;São João do Oriente;1;1;2;53
3131307;Ipatinga;3162609;São João do Oriente;1;1;2;42
3127701;Governador Valadares;3162575;São João do Manteninha;1;1;2;87
3139607;Mantena;3162575;São João do Manteninha;1;1;2;14
3100500;Açucena;3162559;São João do Manhuaçu;1;1;2;152
3117900;Congonhal;3162559;São João do Manhuaçu;1;1;2;452
3122009;Divino;3162559;São João do Manhuaçu;1;1;2;24
3139508;Manhumirim;3162559;São João do Manhuaçu;1;1;2;21
3140902;Matipó;3162559;São João do Manhuaçu;1;1;2;23
3143906;Muriaé;3162559;São João do Manhuaçu;1;1;2;77
3157906;Santa Margarida;3162559;São João do Manhuaçu;1;1;2;10
1100023;Ariquemes;3162500;São João del Rei;1;1;2;2261
1100205;Porto Velho;3162500;São João del Rei;1;1;2;2400
3102803;Andrelândia;3162500;São João del Rei;1;1;2;66
3104007;Araxá;3162500;São João del Rei;1;1;2;323
3104205;Arcos;3162500;São João del Rei;1;1;2;159
3106705;Betim;3162500;São João del Rei;1;1;2;130
3111200;Campo Belo;3162500;São João del Rei;1;1;2;104
3115201;Conceição da Barra de Minas;3162500;São João del Rei;1;1;2;18
3123601;Elói Mendes;3162500;São João del Rei;1;1;2;143
3123908;Entre Rios de Minas;3162500;São João del Rei;1;1;2;56
3131703;Itabira;3162500;São João del Rei;1;1;2;198
3131901;Itabirito;3162500;São João del Rei;1;1;2;104
3134301;Itumirim;3162500;São João del Rei;1;1;2;63
3134509;Itutinga;3162500;São João del Rei;1;1;2;42
3137205;Lagoa da Prata;3162500;São João del Rei;1;1;2;178
3140001;Mariana;3162500;São João del Rei;1;1;2;124
3149903;Perdões;3162500;São João del Rei;1;1;2;84
3150307;Piedade do Rio Grande;3162500;São João del Rei;1;1;2;39
3151206;Pirapora;3162500;São João del Rei;1;1;2;426
3152501;Pouso Alegre;3162500;São João del Rei;1;1;2;210
3154705;Ribeirão Vermelho;3162500;São João del Rei;1;1;2;83
3156106;Ritápolis;3162500;São João del Rei;1;1;2;12
3104007;Araxá;3162401;São João da Ponte;1;1;2;514
3112703;Capitão Enéas;3162401;São João da Ponte;1;1;2;49
3123809;Engenheiro Navarro;3162401;São João da Ponte;1;1;2;148
3127339;Gameleiras;3162401;São João da Ponte;1;1;2;134
3135357;Japonvar;3162401;São João da Ponte;1;1;2;28
3135605;Jequitaí;3162401;São João da Ponte;1;1;2;146
3161106;São Francisco;3162401;São João da Ponte;1;1;2;88
3106200;Belo Horizonte;3162252;São João da Lagoa;1;1;2;340
3120904;Curvelo;3162252;São João da Lagoa;1;1;2;211
3143302;Montes Claros;3162252;São João da Lagoa;1;1;2;53
3151206;Pirapora;3162252;São João da Lagoa;1;1;2;79
3104007;Araxá;3162203;São João Batista do Glória;1;1;2;125
3106200;Belo Horizonte;3162203;São João Batista do Glória;1;1;2;275
3112802;Capitólio;3162203;São João Batista do Glória;1;1;2;48
1100098;Espigão d'Oeste;3162104;São Gotardo;1;1;2;1767
3107406;Bom Despacho;3162104;São Gotardo;1;1;2;96
3112802;Capitólio;3162104;São Gotardo;1;1;2;145
3118601;Contagem;3162104;São Gotardo;1;1;2;218
3122306;Divinópolis;3162104;São Gotardo;1;1;2;155
3125101;Extrema;3162104;São Gotardo;1;1;2;394
3137205;Lagoa da Prata;3162104;São Gotardo;1;1;2;96
3138807;Luz;3162104;São Gotardo;1;1;2;66
3143104;Monte Carmelo;3162104;São Gotardo;1;1;2;165
3147006;Paracatu;3162104;São Gotardo;1;1;2;247
3159704;Santa Rosa da Serra;3162104;São Gotardo;1;1;2;27
3160405;Santo Antônio do Monte;3162104;São Gotardo;1;1;2;118
3104007;Araxá;3162005;São Gonçalo do Sapucaí;1;1;2;290
3106200;Belo Horizonte;3162005;São Gonçalo do Sapucaí;1;1;2;276
3107406;Bom Despacho;3162005;São Gonçalo do Sapucaí;1;1;2;242
3107901;Bom Repouso;3162005;São Gonçalo do Sapucaí;1;1;2;86
3109709;Cachoeira de Minas;3162005;São Gonçalo do Sapucaí;1;1;2;55
3110608;Cambuí;3162005;São Gonçalo do Sapucaí;1;1;2;94
3110707;Cambuquira;3162005;São Gonçalo do Sapucaí;1;1;2;31
3114105;Carmo de Minas;3162005;São Gonçalo do Sapucaí;1;1;2;55
3117207;Conceição das Pedras;3162005;São Gonçalo do Sapucaí;1;1;2;33
3118601;Contagem;3162005;São Gonçalo do Sapucaí;1;1;2;268
3120508;Cristina;3162005;São Gonçalo do Sapucaí;1;1;2;49
3129202;Heliodora;3162005;São Gonçalo do Sapucaí;1;1;2;20
3133006;Itamonte;3162005;São Gonçalo do Sapucaí;1;1;2;87
3133105;Itanhandu;3162005;São Gonçalo do Sapucaí;1;1;2;82
3134905;Jacutinga;3162005;São Gonçalo do Sapucaí;1;1;2;114
3135902;Jesuânia;3162005;São Gonçalo do Sapucaí;1;1;2;34
3138203;Lavras;3162005;São Gonçalo do Sapucaí;1;1;2;95
3140407;Marmelópolis;3162005;São Gonçalo do Sapucaí;1;1;2;76
3142601;Monsenhor Paulo;3162005;São Gonçalo do Sapucaí;1;1;2;16
3146008;Ouro Fino;3162005;São Gonçalo do Sapucaí;1;1;2;91
3147600;Passa Quatro;3162005;São Gonçalo do Sapucaí;1;1;2;85
3149101;Pedralva;3162005;São Gonçalo do Sapucaí;1;1;2;41
3151800;Poços de Caldas;3162005;São Gonçalo do Sapucaí;1;1;2;99
2905701;Camaçari;3161908;São Gonçalo do Rio Abaixo;1;1;2;944
3106200;Belo Horizonte;3161908;São Gonçalo do Rio Abaixo;1;1;2;65
3106309;Belo Oriente;3161908;São Gonçalo do Rio Abaixo;1;1;2;114
3144706;Nova Era;3161908;São Gonçalo do Rio Abaixo;1;1;2;34
3104007;Araxá;3161809;São Gonçalo do Pará;1;1;2;223
3107406;Bom Despacho;3161809;São Gonçalo do Pará;1;1;2;51
3114204;Carmo do Cajuru;3161809;São Gonçalo do Pará;1;1;2;24
3124104;Esmeraldas;3161809;São Gonçalo do Pará;1;1;2;62
3126109;Formiga;3161809;São Gonçalo do Pará;1;1;2;80
3130200;Igaratinga;3161809;São Gonçalo do Pará;1;1;2;16
3143401;Monte Sião;3161809;São Gonçalo do Pará;1;1;2;326
3144805;Nova Lima;3161809;São Gonçalo do Pará;1;1;2;105
3147105;Pará de Minas;3161809;São Gonçalo do Pará;1;1;2;29
3104007;Araxá;3161700;São Gonçalo do Abaeté;1;1;2;182
3118403;Conselheiro Pena;3161650;São Geraldo do Baixio;1;1;2;34
3148301;Paula Cândido;3161502;São Geraldo;1;1;2;16
3122009;Divino;3161403;São Francisco do Glória;1;1;2;23
3124203;Espera Feliz;3161403;São Francisco do Glória;1;1;2;41
3125952;Fervedouro;3161403;São Francisco do Glória;1;1;2;8
3149002;Pedra Dourada;3161403;São Francisco do Glória;1;1;2;13
3104007;Araxá;3161304;São Francisco de Sales;1;1;2;297
3106200;Belo Horizonte;3161304;São Francisco de Sales;1;1;2;607
3114550;Carneirinho;3161304;São Francisco de Sales;1;1;2;97
3106200;Belo Horizonte;3161205;São Francisco de Paula;1;1;2;138
3108008;Bom Sucesso;3161205;São Francisco de Paula;1;1;2;43
3111200;Campo Belo;3161205;São Francisco de Paula;1;1;2;36
3158805;Santana do Jacaré;3161205;São Francisco de Paula;1;1;2;26
3104007;Araxá;3161106;São Francisco;1;1;2;461
3109402;Buritizeiro;3161106;São Francisco;1;1;2;154
3124302;Espinosa;3161106;São Francisco;1;1;2;245
3135100;Janaúba;3161106;São Francisco;1;1;2;161
3139300;Manga;3161106;São Francisco;1;1;2;164
3142700;Montalvânia;3161106;São Francisco;1;1;2;172
3143104;Monte Carmelo;3161106;São Francisco;1;1;2;419
3150570;Pintópolis;3161106;São Francisco;1;1;2;36
3127701;Governador Valadares;3161056;São Félix de Minas;1;1;2;58
3106002;Bela Vista de Minas;3161007;São Domingos do Prata;1;1;2;13
3106309;Belo Oriente;3161007;São Domingos do Prata;1;1;2;88
3107802;Bom Jesus do Galho;3161007;São Domingos do Prata;1;1;2;68
3125101;Extrema;3161007;São Domingos do Prata;1;1;2;485
3146107;Ouro Preto;3161007;São Domingos do Prata;1;1;2;83
3151800;Poços de Caldas;3161007;São Domingos do Prata;1;1;2;432
3155702;Rio Piracicaba;3161007;São Domingos do Prata;1;1;2;25
3145901;Ouro Branco;3160900;São Brás do Suaçuí;1;1;2;32
3105608;Barbacena;3160801;São Bento Abade;1;1;2;139
3106200;Belo Horizonte;3160801;São Bento Abade;1;1;2;218
3113909;Carmo da Cachoeira;3160801;São Bento Abade;1;1;2;20
3117702;Conceição do Rio Verde;3160801;São Bento Abade;1;1;2;33
3145802;Onça de Pitangui;3160801;São Bento Abade;1;1;2;207
3146909;Papagaios;3160801;São Bento Abade;1;1;2;239
3102902;Antônio Carlos;3160702;Santos Dumont;1;1;2;27
3104007;Araxá;3160702;Santos Dumont;1;1;2;408
3106200;Belo Horizonte;3160702;Santos Dumont;1;1;2;180
3108008;Bom Sucesso;3160702;Santos Dumont;1;1;2;134
3118601;Contagem;3160702;Santos Dumont;1;1;2;181
3123601;Elói Mendes;3160702;Santos Dumont;1;1;2;209
3124906;Eugenópolis;3160702;Santos Dumont;1;1;2;147
3138401;Leopoldina;3160702;Santos Dumont;1;1;2;90
3139409;Manhuaçu;3160702;Santos Dumont;1;1;2;206
3139508;Manhumirim;3160702;Santos Dumont;1;1;2;206
3140803;Matias Barbosa;3160702;Santos Dumont;1;1;2;50
3145703;Oliveira Fortes;3160702;Santos Dumont;1;1;2;18
3152501;Pouso Alegre;3160702;Santos Dumont;1;1;2;262
3106200;Belo Horizonte;3160603;Santo Hipólito;1;1;2;179
3119104;Corinto;3160603;Santo Hipólito;1;1;2;26
3142502;Monjolos;3160603;Santo Hipólito;1;1;2;11
3117504;Conceição do Mato Dentro;3160504;Santo Antônio do Rio Abaixo;1;1;2;28
3128006;Guanhães;3160504;Santo Antônio do Rio Abaixo;1;1;2;64
3106200;Belo Horizonte;3160454;Santo Antônio do Retiro;1;1;2;526
3143302;Montes Claros;3160454;Santo Antônio do Retiro;1;1;2;205
3155603;Rio Pardo de Minas;3160454;Santo Antônio do Retiro;1;1;2;31
3104007;Araxá;3160405;Santo Antônio do Monte;1;1;2;181
3106705;Betim;3160405;Santo Antônio do Monte;1;1;2;116
3118601;Contagem;3160405;Santo Antônio do Monte;1;1;2;128
3129509;Ibiá;3160405;Santo Antônio do Monte;1;1;2;148
3142403;Moema;3160405;Santo Antônio do Monte;1;1;2;30
3147907;Passos;3160405;Santo Antônio do Monte;1;1;2;156
3148905;Pedra do Indaiá;3160405;Santo Antônio do Monte;1;1;2;21
3151404;Pitangui;3160405;Santo Antônio do Monte;1;1;2;65
3151503;Piumhi;3160405;Santo Antônio do Monte;1;1;2;82
3106200;Belo Horizonte;3160306;Santo Antônio do Jacinto;1;1;2;554
3156601;Rubim;3160306;Santo Antônio do Jacinto;1;1;2;43
3106309;Belo Oriente;3160207;Santo Antônio do Itambé;1;1;2;121
3112307;Capelinha;3160207;Santo Antônio do Itambé;1;1;2;120
3100302;Abre Campo;3160108;Santo Antônio do Grama;1;1;2;14
3106200;Belo Horizonte;3160108;Santo Antônio do Grama;1;1;2;150
3112901;Caputira;3160108;Santo Antônio do Grama;1;1;2;39
3150208;Piedade de Ponte Nova;3160108;Santo Antônio do Grama;1;1;2;15
3154002;Raul Soares;3160108;Santo Antônio do Grama;1;1;2;30
3101508;Além Paraíba;3160009;Santo Antônio do Aventureiro;1;1;2;12
3139805;Mar de Espanha;3160009;Santo Antônio do Aventureiro;1;1;2;23
3104007;Araxá;3159902;Santo Antônio do Amparo;1;1;2;258
3105103;Bambuí;3159902;Santo Antônio do Amparo;1;1;2;152
3111200;Campo Belo;3159902;Santo Antônio do Amparo;1;1;2;37
3123601;Elói Mendes;3159902;Santo Antônio do Amparo;1;1;2;100
3126109;Formiga;3159902;Santo Antônio do Amparo;1;1;2;75
3133501;Itapecerica;3159902;Santo Antônio do Amparo;1;1;2;57
3139003;Machado;3159902;Santo Antônio do Amparo;1;1;2;132
3145208;Nova Serrana;3159902;Santo Antônio do Amparo;1;1;2;119
3151404;Pitangui;3159902;Santo Antônio do Amparo;1;1;2;143
3154606;Ribeirão das Neves;3159902;Santo Antônio do Amparo;1;1;2;156
3158805;Santana do Jacaré;3159902;Santo Antônio do Amparo;1;1;2;23
1502764;Cumaru do Norte;3159803;Santa Vitória;1;1;2;1222
1506138;Redenção;3159803;Santa Vitória;1;1;2;1200
3104007;Araxá;3159803;Santa Vitória;1;1;2;345
3107406;Bom Despacho;3159803;Santa Vitória;1;1;2;523
3109006;Brumadinho;3159803;Santa Vitória;1;1;2;643
3114550;Carneirinho;3159803;Santa Vitória;1;1;2;111
3143104;Monte Carmelo;3159803;Santa Vitória;1;1;2;276
3105103;Bambuí;3159704;Santa Rosa da Serra;1;1;2;53
3123205;Dores do Indaiá;3159704;Santa Rosa da Serra;1;1;2;39
1504208;Marabá;3159605;Santa Rita do Sapucaí;1;1;2;1898
2913606;Ilhéus;3159605;Santa Rita do Sapucaí;1;1;2;1059
3105608;Barbacena;3159605;Santa Rita do Sapucaí;1;1;2;228
3108305;Borda da Mata;3159605;Santa Rita do Sapucaí;1;1;2;48
3110905;Campanha;3159605;Santa Rita do Sapucaí;1;1;2;56
3112802;Capitólio;3159605;Santa Rita do Sapucaí;1;1;2;185
3115508;Caxambu;3159605;Santa Rita do Sapucaí;1;1;2;82
3117900;Congonhal;3159605;Santa Rita do Sapucaí;1;1;2;36
3123601;Elói Mendes;3159605;Santa Rita do Sapucaí;1;1;2;72
3134905;Jacutinga;3159605;Santa Rita do Sapucaí;1;1;2;94
3143401;Monte Sião;3159605;Santa Rita do Sapucaí;1;1;2;92
3144409;Natércia;3159605;Santa Rita do Sapucaí;1;1;2;25
3151206;Pirapora;3159605;Santa Rita do Sapucaí;1;1;2;551
3106200;Belo Horizonte;3159506;Santa Rita do Itueto;1;1;2;280
3126752;Franciscópolis;3159506;Santa Rita do Itueto;1;1;2;168
3145307;Novo Cruzeiro;3159506;Santa Rita do Itueto;1;1;2;216
3106200;Belo Horizonte;3159407;Santa Rita de Ibitipoca;1;1;2;184
3129400;Ibertioga;3159407;Santa Rita de Ibitipoca;1;1;2;16
2918001;Jequié;3159357;Santa Rita de Minas;1;1;2;704
3106200;Belo Horizonte;3159357;Santa Rita de Minas;1;1;2;194
3113008;Caraí;3159357;Santa Rita de Minas;1;1;2;301
3102803;Andrelândia;3159308;Santa Rita de Jacutinga;1;1;2;51
3106200;Belo Horizonte;3159308;Santa Rita de Jacutinga;1;1;2;247
3107505;Bom Jardim de Minas;3159308;Santa Rita de Jacutinga;1;1;2;22
3136702;Juiz de Fora;3159308;Santa Rita de Jacutinga;1;1;2;89
3138609;Lima Duarte;3159308;Santa Rita de Jacutinga;1;1;2;45
3102605;Andradas;3159209;Santa Rita de Caldas;1;1;2;24
3104007;Araxá;3159209;Santa Rita de Caldas;1;1;2;277
3106200;Belo Horizonte;3159209;Santa Rita de Caldas;1;1;2;338
3117900;Congonhal;3159209;Santa Rita de Caldas;1;1;2;34
3128709;Guaxupé;3159209;Santa Rita de Caldas;1;1;2;89
3134905;Jacutinga;3159209;Santa Rita de Caldas;1;1;2;40
3106200;Belo Horizonte;3159100;Santana dos Montes;1;1;2;103
3113107;Caranaíba;3159100;Santana dos Montes;1;1;2;11
3157807;Santa Luzia;3159001;Santana do Riacho;1;1;2;68
3105400;Barão de Cocais;3158953;Santana do Paraíso;1;1;2;118
3119401;Coronel Fabriciano;3158953;Santana do Paraíso;1;1;2;18
3127701;Governador Valadares;3158953;Santana do Paraíso;1;1;2;87
3133808;Itaúna;3158953;Santana do Paraíso;1;1;2;228
3138203;Lavras;3158953;Santana do Paraíso;1;1;2;330
3144805;Nova Lima;3158953;Santana do Paraíso;1;1;2;154
3149309;Pedro Leopoldo;3158953;Santana do Paraíso;1;1;2;159
3149952;Periquito;3158953;Santana do Paraíso;1;1;2;42
3157203;Santa Bárbara;3158953;Santana do Paraíso;1;1;2;111
3102050;Alto Caparaó;3158904;Santana do Manhuaçu;1;1;2;37
3106200;Belo Horizonte;3158904;Santana do Manhuaçu;1;1;2;216
3157906;Santa Margarida;3158904;Santana do Manhuaçu;1;1;2;46
3106200;Belo Horizonte;3158805;Santana do Jacaré;1;1;2;163
3145604;Oliveira;3158805;Santana do Jacaré;1;1;2;36
3149903;Perdões;3158805;Santana do Jacaré;1;1;2;21
3105608;Barbacena;3158706;Santana do Garambéu;1;1;2;55
3136702;Juiz de Fora;3158607;Santana do Deserto;1;1;2;28
3140803;Matias Barbosa;3158607;Santana do Deserto;1;1;2;18
3141603;Mercês;3158607;Santana do Deserto;1;1;2;86
3106200;Belo Horizonte;3158409;Santana de Cataguases;1;1;2;213
3115300;Cataguases;3158409;Santana de Cataguases;1;1;2;16
3146701;Palma;3158409;Santana de Cataguases;1;1;2;27
3104007;Araxá;3158300;Santana da Vargem;1;1;2;237
3106200;Belo Horizonte;3158300;Santana da Vargem;1;1;2;217
3107109;Boa Esperança;3158300;Santana da Vargem;1;1;2;19
3111606;Campos Gerais;3158300;Santana da Vargem;1;1;2;26
3144607;Nepomuceno;3158300;Santana da Vargem;1;1;2;28
3100609;Água Boa;3158201;Santa Maria do Suaçuí;1;1;2;21
3104007;Araxá;3158201;Santa Maria do Suaçuí;1;1;2;506
3128006;Guanhães;3158201;Santa Maria do Suaçuí;1;1;2;82
3136553;José Raydan;3158201;Santa Maria do Suaçuí;1;1;2;10
3148509;Pavão;3158201;Santa Maria do Suaçuí;1;1;2;169
3106200;Belo Horizonte;3158102;Santa Maria do Salto;1;1;2;578
3106309;Belo Oriente;3158003;Santa Maria de Itabira;1;1;2;71
3107505;Bom Jardim de Minas;3158003;Santa Maria de Itabira;1;1;2;299
3136207;João Monlevade;3158003;Santa Maria de Itabira;1;1;2;40
3106200;Belo Horizonte;3157906;Santa Margarida;1;1;2;188
3113305;Carangola;3157906;Santa Margarida;1;1;2;45
3138674;Luisburgo;3157906;Santa Margarida;1;1;2;17
3148756;Pedra Bonita;3157906;Santa Margarida;1;1;2;18
1302603;Manaus;3157807;Santa Luzia;1;1;2;2467
1501303;Barcarena;3157807;Santa Luzia;1;1;2;2077
1505437;Ourilândia do Norte;3157807;Santa Luzia;1;1;2;1617
1722107;Xambioá;3157807;Santa Luzia;1;1;2;1551
2503001;Caaporã;3157807;Santa Luzia;1;1;2;1633
2605707;Floresta;3157807;Santa Luzia;1;1;2;1348
2611606;Recife;3157807;Santa Luzia;1;1;2;1577
2904605;Brumado;3157807;Santa Luzia;1;1;2;657
2910057;Dias d'Ávila;3157807;Santa Luzia;1;1;2;976
2930709;Simões Filho;3157807;Santa Luzia;1;1;2;955
3105608;Barbacena;3157807;Santa Luzia;1;1;2;158
3107703;Bom Jesus do Amparo;3157807;Santa Luzia;1;1;2;40
3113305;Carangola;3157807;Santa Luzia;1;1;2;219
3118304;Conselheiro Lafaiete;3157807;Santa Luzia;1;1;2;98
3136207;João Monlevade;3157807;Santa Luzia;1;1;2;71
3136702;Juiz de Fora;3157807;Santa Luzia;1;1;2;226
3137601;Lagoa Santa;3157807;Santa Luzia;1;1;2;16
3145901;Ouro Branco;3157807;Santa Luzia;1;1;2;85
3147105;Pará de Minas;3157807;Santa Luzia;1;1;2;81
3153608;Prudente de Morais;3157807;Santa Luzia;1;1;2;45
3154804;Rio Acima;3157807;Santa Luzia;1;1;2;36
3103504;Araguari;3157708;Santa Juliana;1;1;2;103
3106200;Belo Horizonte;3157708;Santa Juliana;1;1;2;379
3130705;Indianópolis;3157708;Santa Juliana;1;1;2;51
3131604;Iraí de Minas;3157708;Santa Juliana;1;1;2;37
3137205;Lagoa da Prata;3157708;Santa Juliana;1;1;2;224
3143104;Monte Carmelo;3157708;Santa Juliana;1;1;2;65
3146008;Ouro Fino;3157708;Santa Juliana;1;1;2;351
3148004;Patos de Minas;3157708;Santa Juliana;1;1;2;134
3149200;Pedrinópolis;3157708;Santa Juliana;1;1;2;11
3151602;Planura;3157708;Santa Juliana;1;1;2;154
3100906;Águas Formosas;3157658;Santa Helena de Minas;1;1;2;34
3106200;Belo Horizonte;3157658;Santa Helena de Minas;1;1;2;479
3113701;Carlos Chagas;3157658;Santa Helena de Minas;1;1;2;83
3120151;Crisólita;3157658;Santa Helena de Minas;1;1;2;37
3106200;Belo Horizonte;3157609;Santa Fé de Minas;1;1;2;387
3107307;Bocaiúva;3157609;Santa Fé de Minas;1;1;2;176
3109402;Buritizeiro;3157609;Santa Fé de Minas;1;1;2;88
3143500;Morada Nova de Minas;3157609;Santa Fé de Minas;1;1;2;208
3145455;Olhos-d'Água;3157609;Santa Fé de Minas;1;1;2;212
3106200;Belo Horizonte;3157500;Santa Efigênia de Minas;1;1;2;201
3127701;Governador Valadares;3157500;Santa Efigênia de Minas;1;1;2;49
3128006;Guanhães;3157500;Santa Efigênia de Minas;1;1;2;52
3106002;Bela Vista de Minas;3157401;Santa Cruz do Escalvado;1;1;2;53
3106200;Belo Horizonte;3157401;Santa Cruz do Escalvado;1;1;2;127
3118601;Contagem;3157401;Santa Cruz do Escalvado;1;1;2;137
2905206;Caetité;3157377;Santa Cruz de Salinas;1;1;2;237
3109907;Caetanópolis;3157377;Santa Cruz de Salinas;1;1;2;456
3133303;Itaobim;3157377;Santa Cruz de Salinas;1;1;2;55
3141405;Medina;3157377;Santa Cruz de Salinas;1;1;2;28
3148707;Pedra Azul;3157377;Santa Cruz de Salinas;1;1;2;49
3105608;Barbacena;3157336;Santa Cruz de Minas;1;1;2;47
3118601;Contagem;3157336;Santa Cruz de Minas;1;1;2;133
3132602;Itamarati de Minas;3157336;Santa Cruz de Minas;1;1;2;150
3136702;Juiz de Fora;3157336;Santa Cruz de Minas;1;1;2;118
3140001;Mariana;3157336;Santa Cruz de Minas;1;1;2;119
3138609;Lima Duarte;3157278;Santa Bárbara do Monte Verde;1;1;2;16
3106200;Belo Horizonte;3157252;Santa Bárbara do Leste;1;1;2;193
3102308;Alvinópolis;3157203;Santa Bárbara;1;1;2;42
3119401;Coronel Fabriciano;3157203;Santa Bárbara;1;1;2;96
3125101;Extrema;3157203;Santa Bárbara;1;1;2;444
3125903;Ferros;3157203;Santa Bárbara;1;1;2;90
3131307;Ipatinga;3157203;Santa Bárbara;1;1;2;106
3136603;Nova União;3157203;Santa Bárbara;1;1;2;34
3136702;Juiz de Fora;3157203;Santa Bárbara;1;1;2;199
3140001;Mariana;3157203;Santa Bárbara;1;1;2;46
3144706;Nova Era;3157203;Santa Bárbara;1;1;2;45
3146107;Ouro Preto;3157203;Santa Bárbara;1;1;2;48
3153905;Raposos;3157203;Santa Bárbara;1;1;2;41
3101706;Almenara;3157104;Salto da Divisa;1;1;2;82
3105202;Bandeira;3157104;Salto da Divisa;1;1;2;65
3106200;Belo Horizonte;3157104;Salto da Divisa;1;1;2;611
3118601;Contagem;3157104;Salto da Divisa;1;1;2;621
2304400;Fortaleza;3157005;Salinas;1;1;2;1428
3104007;Araxá;3157005;Salinas;1;1;2;628
3108602;Brasília de Minas;3157005;Salinas;1;1;2;227
3112307;Capelinha;3157005;Salinas;1;1;2;168
3118601;Contagem;3157005;Salinas;1;1;2;457
3120300;Cristália;3157005;Salinas;1;1;2;92
3122306;Divinópolis;3157005;Salinas;1;1;2;522
3126505;Francisco Badaró;3157005;Salinas;1;1;2;90
3135209;Januária;3157005;Salinas;1;1;2;237
3135456;Jenipapo de Minas;3157005;Salinas;1;1;2;100
3143104;Monte Carmelo;3157005;Salinas;1;1;2;628
3144300;Nanuque;3157005;Salinas;1;1;2;278
3144656;Ninheira;3157005;Salinas;1;1;2;111
3148707;Pedra Azul;3157005;Salinas;1;1;2;108
3102704;Cachoeira de Pajeú;3156908;Sacramento;1;1;2;751
3106200;Belo Horizonte;3156908;Sacramento;1;1;2;363
3117306;Conceição das Alagoas;3156908;Sacramento;1;1;2;99
3118205;Conquista;3156908;Sacramento;1;1;2;14
3134202;Ituiutaba;3156908;Sacramento;1;1;2;232
3136306;João Pinheiro;3156908;Sacramento;1;1;2;266
3143104;Monte Carmelo;3156908;Sacramento;1;1;2;126
3149804;Perdizes;3156908;Sacramento;1;1;2;58
3151206;Pirapora;3156908;Sacramento;1;1;2;385
3106309;Belo Oriente;3156809;Sabinópolis;1;1;2;88
3120904;Curvelo;3156809;Sabinópolis;1;1;2;147
3131703;Itabira;3156809;Sabinópolis;1;1;2;108
1501402;Belém;3156700;Sabará;1;1;2;2098
2105302;Imperatriz;3156700;Sabará;1;1;2;1631
2304400;Fortaleza;3156700;Sabará;1;1;2;1860
2927408;Salvador;3156700;Sabará;1;1;2;940
3105400;Barão de Cocais;3156700;Sabará;1;1;2;33
3109006;Brumadinho;3156700;Sabará;1;1;2;50
3112505;Capim Branco;3156700;Sabará;1;1;2;50
3121605;Diamantina;3156700;Sabará;1;1;2;185
3122306;Divinópolis;3156700;Sabará;1;1;2;116
3124104;Esmeraldas;3156700;Sabará;1;1;2;53
3125903;Ferros;3156700;Sabará;1;1;2;110
3131307;Ipatinga;3156700;Sabará;1;1;2;141
3131703;Itabira;3156700;Sabará;1;1;2;66
3134608;Jaboticatubas;3156700;Sabará;1;1;2;41
3136207;João Monlevade;3156700;Sabará;1;1;2;68
3144706;Nova Era;3156700;Sabará;1;1;2;82
3144805;Nova Lima;3156700;Sabará;1;1;2;16
3147907;Passos;3156700;Sabará;1;1;2;309
3106200;Belo Horizonte;3156601;Rubim;1;1;2;535
3135803;Jequitinhonha;3156601;Rubim;1;1;2;48
3136009;Joaíma;3156601;Rubim;1;1;2;63
3106200;Belo Horizonte;3156502;Rubelita;1;1;2;429
3119500;Coronel Murta;3156502;Rubelita;1;1;2;25
3131901;Itabirito;3156502;Rubelita;1;1;2;462
3141405;Medina;3156502;Rubelita;1;1;2;83
3143906;Muriaé;3156452;Rosário da Limeira;1;1;2;21
3100104;Abadia dos Dourados;3156403;Romaria;1;1;2;48
3152808;Prata;3156403;Romaria;1;1;2;155
3128402;Guarani;3156304;Rodeiro;1;1;2;25
3128808;Guidoval;3156304;Rodeiro;1;1;2;9
3106200;Belo Horizonte;3156106;Ritápolis;1;1;2;129
3122306;Divinópolis;3156106;Ritápolis;1;1;2;112
3132602;Itamarati de Minas;3156106;Ritápolis;1;1;2;161
3138708;Luminárias;3156106;Ritápolis;1;1;2;81
3154200;Resende Costa;3156106;Ritápolis;1;1;2;14
3106200;Belo Horizonte;3156007;Rio Vermelho;1;1;2;205
3106309;Belo Oriente;3156007;Rio Vermelho;1;1;2;117
3111606;Campos Gerais;3156007;Rio Vermelho;1;1;2;438
3112307;Capelinha;3156007;Rio Vermelho;1;1;2;85
3116803;Coluna;3156007;Rio Vermelho;1;1;2;19
3128105;Guapé;3156007;Rio Vermelho;1;1;2;413
3132503;Itamarandiba;3156007;Rio Vermelho;1;1;2;51
3124906;Eugenópolis;3155900;Rio Preto;1;1;2;202
3104007;Araxá;3155801;Rio Pomba;1;1;2;432
3104601;Astolfo Dutra;3155801;Rio Pomba;1;1;2;32
3118304;Conselheiro Lafaiete;3155801;Rio Pomba;1;1;2;95
3121308;Descoberto;3155801;Rio Pomba;1;1;2;30
3123304;Dores do Turvo;3155801;Rio Pomba;1;1;2;33
3124005;Ervália;3155801;Rio Pomba;1;1;2;72
3124906;Eugenópolis;3155801;Rio Pomba;1;1;2;105
3134608;Jaboticatubas;3155801;Rio Pomba;1;1;2;204
3138401;Leopoldina;3155801;Rio Pomba;1;1;2;59
3140803;Matias Barbosa;3155801;Rio Pomba;1;1;2;67
3143906;Muriaé;3155801;Rio Pomba;1;1;2;90
3150802;Piranga;3155801;Rio Pomba;1;1;2;67
3152808;Prata;3155801;Rio Pomba;1;1;2;637
3102308;Alvinópolis;3155702;Rio Piracicaba;1;1;2;26
3105400;Barão de Cocais;3155702;Rio Piracicaba;1;1;2;33
3106200;Belo Horizonte;3155702;Rio Piracicaba;1;1;2;82
3106309;Belo Oriente;3155702;Rio Piracicaba;1;1;2;108
3144805;Nova Lima;3155702;Rio Piracicaba;1;1;2;70
3104007;Araxá;3155603;Rio Pardo de Minas;1;1;2;650
3122306;Divinópolis;3155603;Rio Pardo de Minas;1;1;2;564
3124302;Espinosa;3155603;Rio Pardo de Minas;1;1;2;81
3135100;Janaúba;3155603;Rio Pardo de Minas;1;1;2;88
3135209;Januária;3155603;Rio Pardo de Minas;1;1;2;198
3146255;Padre Carvalho;3155603;Rio Pardo de Minas;1;1;2;83
3152204;Porteirinha;3155603;Rio Pardo de Minas;1;1;2;53
3106200;Belo Horizonte;3155504;Rio Paranaíba;1;1;2;251
3128709;Guaxupé;3155504;Rio Paranaíba;1;1;2;239
3143906;Muriaé;3155504;Rio Paranaíba;1;1;2;463
3148004;Patos de Minas;3155504;Rio Paranaíba;1;1;2;73
3151503;Piumhi;3155504;Rio Paranaíba;1;1;2;144
3102506;Amparo do Serra;3155405;Rio Novo;1;1;2;110
3104601;Astolfo Dutra;3155405;Rio Novo;1;1;2;30
3106903;Bicas;3155405;Rio Novo;1;1;2;28
3124005;Ervália;3155405;Rio Novo;1;1;2;84
3124906;Eugenópolis;3155405;Rio Novo;1;1;2;105
3139805;Mar de Espanha;3155405;Rio Novo;1;1;2;47
3151305;Piraúba;3155405;Rio Novo;1;1;2;23
3108107;Bonfim;3155306;Rio Manso;1;1;2;10
3118601;Contagem;3155306;Rio Manso;1;1;2;45
3120607;Crucilândia;3155306;Rio Manso;1;1;2;14
3130101;Igarapé;3155306;Rio Manso;1;1;2;22
3133808;Itaúna;3155306;Rio Manso;1;1;2;34
3118304;Conselheiro Lafaiete;3155207;Rio Espera;1;1;2;42
3106200;Belo Horizonte;3155108;Rio do Prado;1;1;2;517
3146750;Palmópolis;3155108;Rio do Prado;1;1;2;21
3122702;Dom Silvério;3155009;Rio Doce;1;1;2;9
3100302;Abre Campo;3154903;Rio Casca;1;1;2;21
3102308;Alvinópolis;3154903;Rio Casca;1;1;2;42
3106200;Belo Horizonte;3154903;Rio Casca;1;1;2;142
3117504;Conceição do Mato Dentro;3154903;Rio Casca;1;1;2;154
3130903;Inhapim;3154903;Rio Casca;1;1;2;92
3136207;João Monlevade;3154903;Rio Casca;1;1;2;70
3139409;Manhuaçu;3154903;Rio Casca;1;1;2;63
3150208;Piedade de Ponte Nova;3154903;Rio Casca;1;1;2;7
3150539;Pingo-d'Água;3154903;Rio Casca;1;1;2;62
3152105;Ponte Nova;3154903;Rio Casca;1;1;2;32
2304400;Fortaleza;3154804;Rio Acima;1;1;2;1882
3118601;Contagem;3154804;Rio Acima;1;1;2;36
3153905;Raposos;3154804;Rio Acima;1;1;2;13
3106200;Belo Horizonte;3154705;Ribeirão Vermelho;1;1;2;181
3149903;Perdões;3154705;Ribeirão Vermelho;1;1;2;9
2804805;Nossa Senhora do Socorro;3154606;Ribeirão das Neves;1;1;2;1216
3100203;Abaeté;3154606;Ribeirão das Neves;1;1;2;159
3110004;Caeté;3154606;Ribeirão das Neves;1;1;2;45
3113404;Caratinga;3154606;Ribeirão das Neves;1;1;2;197
3118007;Congonhas;3154606;Ribeirão das Neves;1;1;2;83
3119401;Coronel Fabriciano;3154606;Ribeirão das Neves;1;1;2;155
3120904;Curvelo;3154606;Ribeirão das Neves;1;1;2;119
3127701;Governador Valadares;3154606;Ribeirão das Neves;1;1;2;244
3130101;Igarapé;3154606;Ribeirão das Neves;1;1;2;42
3131703;Itabira;3154606;Ribeirão das Neves;1;1;2;90
3136652;Juatuba;3154606;Ribeirão das Neves;1;1;2;34
3137205;Lagoa da Prata;3154606;Ribeirão das Neves;1;1;2;154
3140159;Mário Campos;3154606;Ribeirão das Neves;1;1;2;34
3145901;Ouro Branco;3154606;Ribeirão das Neves;1;1;2;93
3151206;Pirapora;3154606;Ribeirão das Neves;1;1;2;284
3152006;Pompéu;3154606;Ribeirão das Neves;1;1;2;107
2917359;Jaborandi;3154507;Riacho dos Machados;1;1;2;306
3127800;Grão Mogol;3154507;Riacho dos Machados;1;1;2;64
3152204;Porteirinha;3154507;Riacho dos Machados;1;1;2;30
3104502;Arinos;3154457;Riachinho;1;1;2;37
3106705;Betim;3154457;Riachinho;1;1;2;456
3120201;Cristais;3154457;Riachinho;1;1;2;517
3136306;João Pinheiro;3154457;Riachinho;1;1;2;170
3101631;Alfredo Vasconcelos;3154408;Ressaquinha;1;1;2;9
3106903;Bicas;3154408;Ressaquinha;1;1;2;100
3113206;Carandaí;3154408;Ressaquinha;1;1;2;16
3120409;Cristiano Otoni;3154408;Ressaquinha;1;1;2;26
3121506;Desterro do Melo;3154408;Ressaquinha;1;1;2;27
3104007;Araxá;3154309;Resplendor;1;1;2;606
3106200;Belo Horizonte;3154309;Resplendor;1;1;2;300
3104007;Araxá;3154200;Resende Costa;1;1;2;317
3119708;Coronel Xavier Chaves;3154200;Resende Costa;1;1;2;11
3137403;Lagoa Dourada;3154200;Resende Costa;1;1;2;17
3152709;Prados;3154200;Resende Costa;1;1;2;22
3102050;Alto Caparaó;3154150;Reduto;1;1;2;27
3120839;Cuparaque;3154150;Reduto;1;1;2;166
3123528;Durandé;3154150;Reduto;1;1;2;19
3136702;Juiz de Fora;3154150;Reduto;1;1;2;222
3136702;Juiz de Fora;3154101;Recreio;1;1;2;93
3138401;Leopoldina;3154101;Recreio;1;1;2;23
3143906;Muriaé;3154101;Recreio;1;1;2;52
3100302;Abre Campo;3154002;Raul Soares;1;1;2;23
3102506;Amparo do Serra;3154002;Raul Soares;1;1;2;59
3104007;Araxá;3154002;Raul Soares;1;1;2;474
3106200;Belo Horizonte;3154002;Raul Soares;1;1;2;162
3107802;Bom Jesus do Galho;3154002;Raul Soares;1;1;2;32
3122702;Dom Silvério;3154002;Raul Soares;1;1;2;56
3124203;Espera Feliz;3154002;Raul Soares;1;1;2;83
3139508;Manhumirim;3154002;Raul Soares;1;1;2;58
3152303;Porto Firme;3154002;Raul Soares;1;1;2;93
3106200;Belo Horizonte;3153806;Queluzito;1;1;2;94
3100203;Abaeté;3153707;Quartel Geral;1;1;2;18
3106200;Belo Horizonte;3153707;Quartel Geral;1;1;2;180
3118601;Contagem;3153608;Prudente de Morais;1;1;2;49
3149309;Pedro Leopoldo;3153608;Prudente de Morais;1;1;2;17
3102050;Alto Caparaó;3153509;Alto Jequitibá;1;1;2;10
3106200;Belo Horizonte;3153509;Alto Jequitibá;1;1;2;218
3112109;Caparaó;3153509;Alto Jequitibá;1;1;2;13
3124203;Espera Feliz;3153509;Alto Jequitibá;1;1;2;26
3104007;Araxá;3153400;Presidente Olegário;1;1;2;141
3106200;Belo Horizonte;3153400;Presidente Olegário;1;1;2;306
3119302;Coromandel;3153400;Presidente Olegário;1;1;2;83
3136306;João Pinheiro;3153400;Presidente Olegário;1;1;2;77
3137106;Lagamar;3153400;Presidente Olegário;1;1;2;49
3147006;Paracatu;3153400;Presidente Olegário;1;1;2;142
3148103;Patrocínio;3153400;Presidente Olegário;1;1;2;84
3128006;Guanhães;3153301;Presidente Kubitschek;1;1;2;68
3106200;Belo Horizonte;3153202;Presidente Juscelino;1;1;2;139
3120904;Curvelo;3153202;Presidente Juscelino;1;1;2;44
3129509;Ibiá;3153004;Pratinha;1;1;2;38
3138203;Lavras;3153004;Pratinha;1;1;2;218
3104007;Araxá;3152907;Pratápolis;1;1;2;128
3115102;Cássia;3152907;Pratápolis;1;1;2;20
3122306;Divinópolis;3152907;Pratápolis;1;1;2;215
3133758;Itaú de Minas;3152907;Pratápolis;1;1;2;8
3147907;Passos;3152907;Pratápolis;1;1;2;24
1708254;Fortaleza do Tabocão;3152808;Prata;1;1;2;1136
2910503;Entre Rios;3152808;Prata;1;1;2;1389
3103504;Araguari;3152808;Prata;1;1;2;111
3104007;Araxá;3152808;Prata;1;1;2;216
3106200;Belo Horizonte;3152808;Prata;1;1;2;531
3127008;Fronteira;3152808;Prata;1;1;2;108
3133402;Itapagipe;3152808;Prata;1;1;2;78
3143104;Monte Carmelo;3152808;Prata;1;1;2;168
3123007;Dores de Campos;3152709;Prados;1;1;2;8
3144508;Nazareno;3152709;Prados;1;1;2;58
3110707;Cambuquira;3152600;Pouso Alto;1;1;2;50
1302603;Manaus;3152501;Pouso Alegre;1;1;2;2531
1502400;Castanhal;3152501;Pouso Alegre;1;1;2;2322
1503044;Floresta do Araguaia;3152501;Pouso Alegre;1;1;2;1664
2605202;Escada;3152501;Pouso Alegre;1;1;2;1868
2611606;Recife;3152501;Pouso Alegre;1;1;2;1906
3101201;Aiuruoca;3152501;Pouso Alegre;1;1;2;140
3102605;Andradas;3152501;Pouso Alegre;1;1;2;66
3104007;Araxá;3152501;Pouso Alegre;1;1;2;308
3107109;Boa Esperança;3152501;Pouso Alegre;1;1;2;131
3109105;Bueno Brandão;3152501;Pouso Alegre;1;1;2;48
3110509;Camanducaia;3152501;Pouso Alegre;1;1;2;63
3111002;Campestre;3152501;Pouso Alegre;1;1;2;64
3111200;Campo Belo;3152501;Pouso Alegre;1;1;2;162
3120508;Cristina;3152501;Pouso Alegre;1;1;2;71
3123601;Elói Mendes;3152501;Pouso Alegre;1;1;2;78
3124401;Espírito Santo do Dourado;3152501;Pouso Alegre;1;1;2;19
3131307;Ipatinga;3152501;Pouso Alegre;1;1;2;462
3133600;Itapeva;3152501;Pouso Alegre;1;1;2;67
3134905;Jacutinga;3152501;Pouso Alegre;1;1;2;69
3139904;Maria da Fé;3152501;Pouso Alegre;1;1;2;60
3140704;Mateus Leme;3152501;Pouso Alegre;1;1;2;292
3143302;Montes Claros;3152501;Pouso Alegre;1;1;2;642
3144805;Nova Lima;3152501;Pouso Alegre;1;1;2;324
3146107;Ouro Preto;3152501;Pouso Alegre;1;1;2;320
3147204;Paraguaçu;3152501;Pouso Alegre;1;1;2;77
3149309;Pedro Leopoldo;3152501;Pouso Alegre;1;1;2;347
3149903;Perdões;3152501;Pouso Alegre;1;1;2;153
3151701;Poço Fundo;3152501;Pouso Alegre;1;1;2;48
3104007;Araxá;3152402;Poté;1;1;2;584
3104700;Ataléia;3152402;Poté;1;1;2;76
3115458;Catuji;3152402;Poté;1;1;2;62
3126752;Franciscópolis;3152402;Poté;1;1;2;29
3131802;Itabirinha de Mantena;3152402;Poté;1;1;2;103
3145307;Novo Cruzeiro;3152402;Poté;1;1;2;39
3104601;Astolfo Dutra;3152303;Porto Firme;1;1;2;74
3106200;Belo Horizonte;3152303;Porto Firme;1;1;2;126
3150802;Piranga;3152303;Porto Firme;1;1;2;23
2304400;Fortaleza;3152204;Porteirinha;1;1;2;1405
2921807;Mortugaba;3152204;Porteirinha;1;1;2;105
3104007;Araxá;3152204;Porteirinha;1;1;2;602
3106200;Belo Horizonte;3152204;Porteirinha;1;1;2;472
3124302;Espinosa;3152204;Porteirinha;1;1;2;93
3125101;Extrema;3152204;Porteirinha;1;1;2;867
3143104;Monte Carmelo;3152204;Porteirinha;1;1;2;587
3127701;Governador Valadares;3152170;Ponto dos Volantes;1;1;2;233
3133303;Itaobim;3152170;Ponto dos Volantes;1;1;2;22
3141405;Medina;3152170;Ponto dos Volantes;1;1;2;59
3146305;Padre Paraíso;3152170;Ponto dos Volantes;1;1;2;36
3151206;Pirapora;3152170;Ponto dos Volantes;1;1;2;369
3135605;Jequitaí;3152131;Ponto Chique;1;1;2;91
3136306;João Pinheiro;3152131;Ponto Chique;1;1;2;174
1302603;Manaus;3152105;Ponte Nova;1;1;2;2576
1721000;Palmas;3152105;Ponte Nova;1;1;2;1243
2105302;Imperatriz;3152105;Ponte Nova;1;1;2;1710
2111300;São Luís;3152105;Ponte Nova;1;1;2;1982
2112209;Timon;3152105;Ponte Nova;1;1;2;1690
2304400;Fortaleza;3152105;Ponte Nova;1;1;2;1893
2305506;Iguatu;3152105;Ponte Nova;1;1;2;1597
2504009;Campina Grande;3152105;Ponte Nova;1;1;2;1623
2700300;Arapiraca;3152105;Ponte Nova;1;1;2;1336
2918407;Juazeiro;3152105;Ponte Nova;1;1;2;1234
2927408;Salvador;3152105;Ponte Nova;1;1;2;938
3102001;Alterosa;3152105;Ponte Nova;1;1;2;351
3104007;Araxá;3152105;Ponte Nova;1;1;2;431
3113305;Carangola;3152105;Ponte Nova;1;1;2;98
3115300;Cataguases;3152105;Ponte Nova;1;1;2;109
3118601;Contagem;3152105;Ponte Nova;1;1;2;135
3127701;Governador Valadares;3152105;Ponte Nova;1;1;2;201
3131703;Itabira;3152105;Ponte Nova;1;1;2;93
3143906;Muriaé;3152105;Ponte Nova;1;1;2;94
3144003;Mutum;3152105;Ponte Nova;1;1;2;167
3145851;Oratórios;3152105;Ponte Nova;1;1;2;11
3145901;Ouro Branco;3152105;Ponte Nova;1;1;2;83
3147105;Pará de Minas;3152105;Ponte Nova;1;1;2;189
3148004;Patos de Minas;3152105;Ponte Nova;1;1;2;425
3148103;Patrocínio;3152105;Ponte Nova;1;1;2;453
3148301;Paula Cândido;3152105;Ponte Nova;1;1;2;52
3151800;Poços de Caldas;3152105;Ponte Nova;1;1;2;410
3100302;Abre Campo;3152006;Pompéu;1;1;2;285
3104007;Araxá;3152006;Pompéu;1;1;2;216
3106705;Betim;3152006;Pompéu;1;1;2;113
3125705;Felixlândia;3152006;Pompéu;1;1;2;52
3137205;Lagoa da Prata;3152006;Pompéu;1;1;2;108
3139706;Maravilhas;3152006;Pompéu;1;1;2;42
3143104;Monte Carmelo;3152006;Pompéu;1;1;2;276
3143302;Montes Claros;3152006;Pompéu;1;1;2;297
3143500;Morada Nova de Minas;3152006;Pompéu;1;1;2;87
3145208;Nova Serrana;3152006;Pompéu;1;1;2;72
3145901;Ouro Branco;3152006;Pompéu;1;1;2;195
3146404;Paineiras;3152006;Pompéu;1;1;2;72
3147402;Paraopeba;3152006;Pompéu;1;1;2;57
3151206;Pirapora;3152006;Pompéu;1;1;2;210
3137700;Lajinha;3151909;Pocrane;1;1;2;60
3139409;Manhuaçu;3151909;Pocrane;1;1;2;82
1100189;Pimenta Bueno;3151800;Poços de Caldas;1;1;2;1852
1302603;Manaus;3151800;Poços de Caldas;1;1;2;2461
1501303;Barcarena;3151800;Poços de Caldas;1;1;2;2251
1504208;Marabá;3151800;Poços de Caldas;1;1;2;1832
1505502;Paragominas;3151800;Poços de Caldas;1;1;2;2075
1721000;Palmas;3151800;Poços de Caldas;1;1;2;1276
2503209;Cabedelo;3151800;Poços de Caldas;1;1;2;2003
2602308;Bonito;3151800;Poços de Caldas;1;1;2;1826
2607752;Itapissuma;3151800;Poços de Caldas;1;1;2;1935
2927408;Salvador;3151800;Poços de Caldas;1;1;2;1268
2930709;Simões Filho;3151800;Poços de Caldas;1;1;2;1289
3101508;Além Paraíba;3151800;Poços de Caldas;1;1;2;396
3102100;Alto Rio Doce;3151800;Poços de Caldas;1;1;2;334
3102803;Andrelândia;3151800;Poços de Caldas;1;1;2;228
3106705;Betim;3151800;Poços de Caldas;1;1;2;314
3109501;Cabo Verde;3151800;Poços de Caldas;1;1;2;36
3110608;Cambuí;3151800;Poços de Caldas;1;1;2;105
3114402;Carmo do Rio Claro;3151800;Poços de Caldas;1;1;2;98
3114501;Carmópolis de Minas;3151800;Poços de Caldas;1;1;2;239
3117108;Conceição da Aparecida;3151800;Poços de Caldas;1;1;2;83
3122405;Divisa Nova;3151800;Poços de Caldas;1;1;2;46
3123601;Elói Mendes;3151800;Poços de Caldas;1;1;2;103
3124500;Estiva;3151800;Poços de Caldas;1;1;2;94
3128600;Guarda-Mor;3151800;Poços de Caldas;1;1;2;446
3129509;Ibiá;3151800;Poços de Caldas;1;1;2;258
3131307;Ipatinga;3151800;Poços de Caldas;1;1;2;483
3131505;Ipuiúna;3151800;Poços de Caldas;1;1;2;52
3139409;Manhuaçu;3151800;Poços de Caldas;1;1;2;491
3143005;Monte Belo;3151800;Poços de Caldas;1;1;2;52
3143401;Monte Sião;3151800;Poços de Caldas;1;1;2;74
3144102;Muzambinho;3151800;Poços de Caldas;1;1;2;44
3145109;Nova Resende;3151800;Poços de Caldas;1;1;2;72
3145802;Onça de Pitangui;3151800;Poços de Caldas;1;1;2;288
3147204;Paraguaçu;3151800;Poços de Caldas;1;1;2;87
3147907;Passos;3151800;Poços de Caldas;1;1;2;118
3148004;Patos de Minas;3151800;Poços de Caldas;1;1;2;353
3104007;Araxá;3151701;Poço Fundo;1;1;2;263
3104304;Areado;3151701;Poço Fundo;1;1;2;50
3106200;Belo Horizonte;3151701;Poço Fundo;1;1;2;292
3111606;Campos Gerais;3151701;Poço Fundo;1;1;2;64
3123601;Elói Mendes;3151701;Poço Fundo;1;1;2;45
3146008;Ouro Fino;3151701;Poço Fundo;1;1;2;70
3147204;Paraguaçu;3151701;Poço Fundo;1;1;2;35
3103504;Araguari;3151602;Planura;1;1;2;173
3104007;Araxá;3151602;Planura;1;1;2;193
3106200;Belo Horizonte;3151602;Planura;1;1;2;494
3111408;Campo Florido;3151602;Planura;1;1;2;44
3112604;Capinópolis;3151602;Planura;1;1;2;184
2913200;Ibotirama;3151503;Piumhi;1;1;2;959
3104007;Araxá;3151503;Piumhi;1;1;2;142
3107406;Bom Despacho;3151503;Piumhi;1;1;2;109
3109501;Cabo Verde;3151503;Piumhi;1;1;2;120
3110400;Camacho;3151503;Piumhi;1;1;2;86
3112000;Candeias;3151503;Piumhi;1;1;2;79
3123403;Doresópolis;3151503;Piumhi;1;1;2;21
3125101;Extrema;3151503;Piumhi;1;1;2;267
3130507;Ilicínea;3151503;Piumhi;1;1;2;53
3133808;Itaúna;3151503;Piumhi;1;1;2;149
3137601;Lagoa Santa;3151503;Piumhi;1;1;2;235
3139003;Machado;3151503;Piumhi;1;1;2;134
3145604;Oliveira;3151503;Piumhi;1;1;2;118
3100302;Abre Campo;3151404;Pitangui;1;1;2;262
3101003;Águas Vermelhas;3151404;Pitangui;1;1;2;559
3104007;Araxá;3151404;Pitangui;1;1;2;218
3109006;Brumadinho;3151404;Pitangui;1;1;2;89
3116605;Cláudio;3151404;Pitangui;1;1;2;88
3130200;Igaratinga;3151404;Pitangui;1;1;2;38
3130309;Iguatama;3151404;Pitangui;1;1;2;105
3137205;Lagoa da Prata;3151404;Pitangui;1;1;2;80
3138807;Luz;3151404;Pitangui;1;1;2;88
3139706;Maravilhas;3151404;Pitangui;1;1;2;26
3140704;Mateus Leme;3151404;Pitangui;1;1;2;60
3142403;Moema;3151404;Pitangui;1;1;2;60
3142700;Montalvânia;3151404;Pitangui;1;1;2;575
3143302;Montes Claros;3151404;Pitangui;1;1;2;340
3147402;Paraopeba;3151404;Pitangui;1;1;2;66
3149705;Perdigão;3151404;Pitangui;1;1;2;40
3149903;Perdões;3151404;Pitangui;1;1;2;160
3151206;Pirapora;3151404;Pitangui;1;1;2;258
3143906;Muriaé;3151305;Piraúba;1;1;2;75
2111300;São Luís;3151206;Pirapora;1;1;2;1638
2304400;Fortaleza;3151206;Pirapora;1;1;2;1638
2922003;Mucuri;3151206;Pirapora;1;1;2;574
3101003;Águas Vermelhas;3151206;Pirapora;1;1;2;405
3104007;Araxá;3151206;Pirapora;1;1;2;332
3106507;Berilo;3151206;Pirapora;1;1;2;263
3107307;Bocaiúva;3151206;Pirapora;1;1;2;117
3109204;Buenópolis;3151206;Pirapora;1;1;2;99
3111200;Campo Belo;3151206;Pirapora;1;1;2;397
3113404;Caratinga;3151206;Pirapora;1;1;2;400
3117504;Conceição do Mato Dentro;3151206;Pirapora;1;1;2;247
3118304;Conselheiro Lafaiete;3151206;Pirapora;1;1;2;387
3119401;Coronel Fabriciano;3151206;Pirapora;1;1;2;344
3124104;Esmeraldas;3151206;Pirapora;1;1;2;277
3126703;Francisco Sá;3151206;Pirapora;1;1;2;174
3129608;Ibiaí;3151206;Pirapora;1;1;2;52
3133303;Itaobim;3151206;Pirapora;1;1;2;365
3136520;José Gonçalves de Minas;3151206;Pirapora;1;1;2;249
3143104;Monte Carmelo;3151206;Pirapora;1;1;2;317
3143500;Morada Nova de Minas;3151206;Pirapora;1;1;2;147
3145455;Olhos-d'Água;3151206;Pirapora;1;1;2;143
3106903;Bicas;3151107;Pirapetinga;1;1;2;77
3124609;Estrela Dalva;3151107;Pirapetinga;1;1;2;15
3124906;Eugenópolis;3151107;Pirapetinga;1;1;2;64
3138401;Leopoldina;3151107;Pirapetinga;1;1;2;38
3106200;Belo Horizonte;3151008;Piranguinho;1;1;2;320
3108909;Brasópolis;3151008;Piranguinho;1;1;2;9
3115300;Cataguases;3150802;Piranga;1;1;2;100
3115409;Catas Altas da Noruega;3150802;Piranga;1;1;2;21
3118304;Conselheiro Lafaiete;3150802;Piranga;1;1;2;54
3106200;Belo Horizonte;3150703;Pirajuba;1;1;2;494
3111408;Campo Florido;3150703;Pirajuba;1;1;2;21
3115805;Centralina;3150703;Pirajuba;1;1;2;157
3116902;Comendador Gomes;3150703;Pirajuba;1;1;2;46
3117306;Conceição das Alagoas;3150703;Pirajuba;1;1;2;33
3104007;Araxá;3150604;Piracema;1;1;2;276
3114501;Carmópolis de Minas;3150604;Piracema;1;1;2;16
3147709;Passa Tempo;3150604;Piracema;1;1;2;16
3106200;Belo Horizonte;3150570;Pintópolis;1;1;2;444
3106200;Belo Horizonte;3150539;Pingo-d'Água;1;1;2;166
3106309;Belo Oriente;3150539;Pingo-d'Água;1;1;2;57
3107802;Bom Jesus do Galho;3150539;Pingo-d'Água;1;1;2;15
3113404;Caratinga;3150539;Pingo-d'Água;1;1;2;23
3131158;Ipaba;3150539;Pingo-d'Água;1;1;2;35
3131307;Ipatinga;3150539;Pingo-d'Água;1;1;2;32
3144359;Naque;3150539;Pingo-d'Água;1;1;2;56
3104007;Araxá;3150505;Pimenta;1;1;2;155
3122306;Divinópolis;3150505;Pimenta;1;1;2;102
3147105;Pará de Minas;3150505;Pimenta;1;1;2;141
3147709;Passa Tempo;3150505;Pimenta;1;1;2;137
3123908;Entre Rios de Minas;3150406;Piedade dos Gerais;1;1;2;28
3130101;Igarapé;3150406;Piedade dos Gerais;1;1;2;45
3106200;Belo Horizonte;3150307;Piedade do Rio Grande;1;1;2;175
3138203;Lavras;3150307;Piedade do Rio Grande;1;1;2;88
3142601;Monsenhor Paulo;3150307;Piedade do Rio Grande;1;1;2;143
3106200;Belo Horizonte;3150208;Piedade de Ponte Nova;1;1;2;135
3106200;Belo Horizonte;3150158;Piedade de Caratinga;1;1;2;200
3127701;Governador Valadares;3150158;Piedade de Caratinga;1;1;2;106
3119609;Coronel Pacheco;3150109;Piau;1;1;2;11
3127388;Goianá;3150109;Piau;1;1;2;13
3136702;Juiz de Fora;3150109;Piau;1;1;2;27
3106200;Belo Horizonte;3150000;Pescador;1;1;2;305
3110806;Campanário;3150000;Pescador;1;1;2;21
3144904;Nova Módica;3150000;Pescador;1;1;2;14
3106200;Belo Horizonte;3149952;Periquito;1;1;2;201
3131307;Ipatinga;3149952;Periquito;1;1;2;48
3104007;Araxá;3149903;Perdões;1;1;2;252
3105103;Bambuí;3149903;Perdões;1;1;2;150
3106705;Betim;3149903;Perdões;1;1;2;156
3108008;Bom Sucesso;3149903;Perdões;1;1;2;37
3111903;Cana Verde;3149903;Perdões;1;1;2;11
3112000;Candeias;3149903;Perdões;1;1;2;39
3118601;Contagem;3149903;Perdões;1;1;2;166
3119104;Corinto;3149903;Perdões;1;1;2;307
3123601;Elói Mendes;3149903;Perdões;1;1;2;76
3133501;Itapecerica;3149903;Perdões;1;1;2;67
3137205;Lagoa da Prata;3149903;Perdões;1;1;2;126
3137809;Lambari;3149903;Perdões;1;1;2;100
3143203;Monte Santo de Minas;3149903;Perdões;1;1;2;202
3147907;Passos;3149903;Perdões;1;1;2;164
2927408;Salvador;3149804;Perdizes;1;1;2;1152
3101904;Alpinópolis;3149804;Perdizes;1;1;2;193
3106200;Belo Horizonte;3149804;Perdizes;1;1;2;354
3124807;Estrela do Sul;3149804;Perdizes;1;1;2;79
3129509;Ibiá;3149804;Perdizes;1;1;2;80
3143104;Monte Carmelo;3149804;Perdizes;1;1;2;73
3148103;Patrocínio;3149804;Perdizes;1;1;2;55
3149200;Pedrinópolis;3149804;Perdizes;1;1;2;23
3104007;Araxá;3149705;Perdigão;1;1;2;199
3106200;Belo Horizonte;3149705;Perdigão;1;1;2;116
3137205;Lagoa da Prata;3149705;Perdigão;1;1;2;48
3140704;Mateus Leme;3149705;Perdigão;1;1;2;69
3147105;Pará de Minas;3149705;Perdigão;1;1;2;50
3139706;Maravilhas;3149606;Pequi;1;1;2;13
2923209;Oliveira dos Brejinhos;3149507;Pequeri;1;1;2;1053
3104403;Argirita;3149507;Pequeri;1;1;2;38
3106200;Belo Horizonte;3149507;Pequeri;1;1;2;232
3106903;Bicas;3149507;Pequeri;1;1;2;15
3119609;Coronel Pacheco;3149507;Pequeri;1;1;2;31
3128501;Guarará;3149507;Pequeri;1;1;2;14
1400100;Boa Vista;3149309;Pedro Leopoldo;1;1;2;3002
1504208;Marabá;3149309;Pedro Leopoldo;1;1;2;1657
1505536;Parauapebas;3149309;Pedro Leopoldo;1;1;2;1616
2607208;Ipojuca;3149309;Pedro Leopoldo;1;1;2;1544
2607901;Jaboatão dos Guararapes;3149309;Pedro Leopoldo;1;1;2;1571
2612505;Santa Cruz do Capibaribe;3149309;Pedro Leopoldo;1;1;2;1519
2910727;Eunápolis;3149309;Pedro Leopoldo;1;1;2;587
2910800;Feira de Santana;3149309;Pedro Leopoldo;1;1;2;965
3102308;Alvinópolis;3149309;Pedro Leopoldo;1;1;2;120
3105400;Barão de Cocais;3149309;Pedro Leopoldo;1;1;2;68
3105608;Barbacena;3149309;Pedro Leopoldo;1;1;2;178
3110004;Caeté;3149309;Pedro Leopoldo;1;1;2;51
3118304;Conselheiro Lafaiete;3149309;Pedro Leopoldo;1;1;2;119
3127701;Governador Valadares;3149309;Pedro Leopoldo;1;1;2;235
3129806;Ibirité;3149309;Pedro Leopoldo;1;1;2;45
3131000;Inhaúma;3149309;Pedro Leopoldo;1;1;2;37
3136702;Juiz de Fora;3149309;Pedro Leopoldo;1;1;2;249
3138203;Lavras;3149309;Pedro Leopoldo;1;1;2;205
3140803;Matias Barbosa;3149309;Pedro Leopoldo;1;1;2;262
3143500;Morada Nova de Minas;3149309;Pedro Leopoldo;1;1;2;181
3104007;Araxá;3149200;Pedrinópolis;1;1;2;67
3106200;Belo Horizonte;3149200;Pedrinópolis;1;1;2;374
3132107;Itacarambi;3149150;Pedras de Maria da Cruz;1;1;2;63
3143302;Montes Claros;3149150;Pedras de Maria da Cruz;1;1;2;136
3106200;Belo Horizonte;3149101;Pedralva;1;1;2;301
3132404;Itajubá;3149101;Pedralva;1;1;2;19
3139904;Maria da Fé;3149101;Pedralva;1;1;2;12
3144409;Natércia;3149101;Pedralva;1;1;2;14
3103108;Antônio Prado de Minas;3149002;Pedra Dourada;1;1;2;21
3106200;Belo Horizonte;3149002;Pedra Dourada;1;1;2;216
3106200;Belo Horizonte;3148905;Pedra do Indaiá;1;1;2;134
3147105;Pará de Minas;3148905;Pedra do Indaiá;1;1;2;76
3106200;Belo Horizonte;3148806;Pedra do Anta;1;1;2;153
3136702;Juiz de Fora;3148806;Pedra do Anta;1;1;2;144
3100906;Águas Formosas;3148707;Pedra Azul;1;1;2;121
3102704;Cachoeira de Pajeú;3148707;Pedra Azul;1;1;2;24
3103405;Araçuaí;3148707;Pedra Azul;1;1;2;122
3104007;Araxá;3148707;Pedra Azul;1;1;2;726
3118601;Contagem;3148707;Pedra Azul;1;1;2;524
3120870;Curral de Dentro;3148707;Pedra Azul;1;1;2;60
3133501;Itapecerica;3148707;Pedra Azul;1;1;2;642
3136009;Joaíma;3148707;Pedra Azul;1;1;2;71
3106309;Belo Oriente;3148608;Peçanha;1;1;2;75
3119203;Coroaci;3148608;Peçanha;1;1;2;30
3127701;Governador Valadares;3148608;Peçanha;1;1;2;67
3131307;Ipatinga;3148608;Peçanha;1;1;2;102
3131703;Itabira;3148608;Peçanha;1;1;2;140
3113701;Carlos Chagas;3148509;Pavão;1;1;2;42
3127701;Governador Valadares;3148509;Pavão;1;1;2;184
3144300;Nanuque;3148509;Pavão;1;1;2;86
3106200;Belo Horizonte;3148400;Paulistas;1;1;2;201
3106309;Belo Oriente;3148400;Paulistas;1;1;2;97
3128006;Guanhães;3148400;Paulistas;1;1;2;35
3106200;Belo Horizonte;3148301;Paula Cândido;1;1;2;150
3105509;Barão de Monte Alto;3148202;Patrocínio do Muriaé;1;1;2;10
3106200;Belo Horizonte;3148202;Patrocínio do Muriaé;1;1;2;229
2106607;Matões;3148103;Patrocínio;1;1;2;1535
2211001;Teresina;3148103;Patrocínio;1;1;2;1592
3100104;Abadia dos Dourados;3148103;Patrocínio;1;1;2;68
3109402;Buritizeiro;3148103;Patrocínio;1;1;2;274
3111507;Campos Altos;3148103;Patrocínio;1;1;2;119
3114303;Carmo do Paranaíba;3148103;Patrocínio;1;1;2;66
3126109;Formiga;3148103;Patrocínio;1;1;2;235
3133808;Itaúna;3148103;Patrocínio;1;1;2;283
3134202;Ituiutaba;3148103;Patrocínio;1;1;2;261
3137502;Lagoa Formosa;3148103;Patrocínio;1;1;2;63
3140001;Mariana;3148103;Patrocínio;1;1;2;409
3143302;Montes Claros;3148103;Patrocínio;1;1;2;407
3147907;Passos;3148103;Patrocínio;1;1;2;198
1302603;Manaus;3148004;Patos de Minas;1;1;2;2202
1500503;Almeirim;3148004;Patos de Minas;1;1;2;1989
1502400;Castanhal;3148004;Patos de Minas;1;1;2;1917
1502939;Dom Eliseu;3148004;Patos de Minas;1;1;2;1581
1701002;Ananás;3148004;Patos de Minas;1;1;2;1360
1703701;Brejinho de Nazaré;3148004;Patos de Minas;1;1;2;864
1708205;Formoso do Araguaia;3148004;Patos de Minas;1;1;2;814
1714203;Natividade;3148004;Patos de Minas;1;1;2;769
2102804;Carolina;3148004;Patos de Minas;1;1;2;1244
2104800;Grajaú;3148004;Patos de Minas;1;1;2;1413
2105302;Imperatriz;3148004;Patos de Minas;1;1;2;1449
2109007;Porto Franco;3148004;Patos de Minas;1;1;2;1355
2111300;São Luís;3148004;Patos de Minas;1;1;2;1790
2304400;Fortaleza;3148004;Patos de Minas;1;1;2;1830
2408003;Mossoró;3148004;Patos de Minas;1;1;2;1755
2803609;Laranjeiras;3148004;Patos de Minas;1;1;2;1294
2919553;Luís Eduardo magalhães;3148004;Patos de Minas;1;1;2;720
3101607;Alfenas;3148004;Patos de Minas;1;1;2;318
3103801;Arapuá;3148004;Patos de Minas;1;1;2;62
3106705;Betim;3148004;Patos de Minas;1;1;2;289
3107505;Bom Jardim de Minas;3148004;Patos de Minas;1;1;2;447
3111507;Campos Altos;3148004;Patos de Minas;1;1;2;129
3122306;Divinópolis;3148004;Patos de Minas;1;1;2;245
3124807;Estrela do Sul;3148004;Patos de Minas;1;1;2;127
3126307;Fortaleza de Minas;3148004;Patos de Minas;1;1;2;253
3131703;Itabira;3148004;Patos de Minas;1;1;2;364
3134202;Ituiutaba;3148004;Patos de Minas;1;1;2;315
3136207;João Monlevade;3148004;Patos de Minas;1;1;2;378
3136702;Juiz de Fora;3148004;Patos de Minas;1;1;2;488
3138807;Luz;3148004;Patos de Minas;1;1;2;160
3139409;Manhuaçu;3148004;Patos de Minas;1;1;2;506
3141207;Matutina;3148004;Patos de Minas;1;1;2;91
3145901;Ouro Branco;3148004;Patos de Minas;1;1;2;368
3146404;Paineiras;3148004;Patos de Minas;1;1;2;109
3147105;Pará de Minas;3148004;Patos de Minas;1;1;2;245
3147907;Passos;3148004;Patos de Minas;1;1;2;236
3106200;Belo Horizonte;3147956;Patis;1;1;2;423
3138658;Lontra;3147956;Patis;1;1;2;31
3142007;Mirabela;3147956;Patis;1;1;2;22
3143302;Montes Claros;3147956;Patis;1;1;2;76
3104205;Arcos;3147907;Passos;1;1;2;122
3104908;Baependi;3147907;Passos;1;1;2;229
3110509;Camanducaia;3147907;Passos;1;1;2;233
3110905;Campanha;3147907;Passos;1;1;2;179
3115102;Cássia;3147907;Passos;1;1;2;34
3117108;Conceição da Aparecida;3147907;Passos;1;1;2;62
3121209;Delfinópolis;3147907;Passos;1;1;2;46
3123601;Elói Mendes;3147907;Passos;1;1;2;150
3126307;Fortaleza de Minas;3147907;Passos;1;1;2;21
3127107;Frutal;3147907;Passos;1;1;2;253
3127701;Governador Valadares;3147907;Passos;1;1;2;525
3131703;Itabira;3147907;Passos;1;1;2;371
3132404;Itajubá;3147907;Passos;1;1;2;225
3134806;Jacuí;3147907;Passos;1;1;2;37
3143203;Monte Santo de Minas;3147907;Passos;1;1;2;68
3145604;Oliveira;3147907;Passos;1;1;2;184
2909307;Correntina;3147709;Passa Tempo;1;1;2;809
3102803;Andrelândia;3147709;Passa Tempo;1;1;2;120
3104007;Araxá;3147709;Passa Tempo;1;1;2;281
3115201;Conceição da Barra de Minas;3147709;Passa Tempo;1;1;2;53
3122306;Divinópolis;3147709;Passa Tempo;1;1;2;68
3132206;Itaguara;3147709;Passa Tempo;1;1;2;29
3145604;Oliveira;3147709;Passa Tempo;1;1;2;38
3123601;Elói Mendes;3147600;Passa Quatro;1;1;2;106
1504208;Marabá;3147402;Paraopeba;1;1;2;1611
2111300;São Luís;3147402;Paraopeba;1;1;2;1851
2301000;Aquiraz;3147402;Paraopeba;1;1;2;1806
3103207;Araçaí;3147402;Paraopeba;1;1;2;17
3104007;Araxá;3147402;Paraopeba;1;1;2;271
3109600;Cachoeira da Prata;3147402;Paraopeba;1;1;2;29
3117504;Conceição do Mato Dentro;3147402;Paraopeba;1;1;2;106
3118601;Contagem;3147402;Paraopeba;1;1;2;79
3118809;Coração de Jesus;3147402;Paraopeba;1;1;2;285
3119104;Corinto;3147402;Paraopeba;1;1;2;99
3122306;Divinópolis;3147402;Paraopeba;1;1;2;112
3131000;Inhaúma;3147402;Paraopeba;1;1;2;25
3131703;Itabira;3147402;Paraopeba;1;1;2;128
3136207;João Monlevade;3147402;Paraopeba;1;1;2;142
3137304;Lagoa dos Patos;3147402;Paraopeba;1;1;2;254
3140506;Martinho Campos;3147402;Paraopeba;1;1;2;88
3141108;Matozinhos;3147402;Paraopeba;1;1;2;46
3147105;Pará de Minas;3147402;Paraopeba;1;1;2;69
3101607;Alfenas;3147303;Paraisópolis;1;1;2;129
3104007;Araxá;3147303;Paraisópolis;1;1;2;349
3110509;Camanducaia;3147303;Paraisópolis;1;1;2;44
3110608;Cambuí;3147303;Paraisópolis;1;1;2;31
3118601;Contagem;3147303;Paraisópolis;1;1;2;339
3145901;Ouro Branco;3147303;Paraisópolis;1;1;2;310
2901106;Amélia Rodrigues;3147204;Paraguaçu;1;1;2;1233
3102001;Alterosa;3147204;Paraguaçu;1;1;2;53
3104007;Araxá;3147204;Paraguaçu;1;1;2;250
3107109;Boa Esperança;3147204;Paraguaçu;1;1;2;54
3108008;Bom Sucesso;3147204;Paraguaçu;1;1;2;116
3111002;Campestre;3147204;Paraguaçu;1;1;2;56
3111606;Campos Gerais;3147204;Paraguaçu;1;1;2;35
3114402;Carmo do Rio Claro;3147204;Paraguaçu;1;1;2;74
3119005;Cordislândia;3147204;Paraguaçu;1;1;2;28
3143005;Monte Belo;3147204;Paraguaçu;1;1;2;70
3143203;Monte Santo de Minas;3147204;Paraguaçu;1;1;2;141
3144102;Muzambinho;3147204;Paraguaçu;1;1;2;84
3103504;Araguari;3147105;Pará de Minas;1;1;2;398
3104205;Arcos;3147105;Pará de Minas;1;1;2;109
3104809;Augusto de Lima;3147105;Pará de Minas;1;1;2;197
3105608;Barbacena;3147105;Pará de Minas;1;1;2;172
3106705;Betim;3147105;Pará de Minas;1;1;2;46
3107000;Biquinhas;3147105;Pará de Minas;1;1;2;150
3107109;Boa Esperança;3147105;Pará de Minas;1;1;2;169
3111606;Campos Gerais;3147105;Pará de Minas;1;1;2;194
3113404;Caratinga;3147105;Pará de Minas;1;1;2;253
3113503;Carbonita;3147105;Pará de Minas;1;1;2;307
3116704;Coimbra;3147105;Pará de Minas;1;1;2;221
3117603;Conceição do Pará;3147105;Pará de Minas;1;1;2;31
3120904;Curvelo;3147105;Pará de Minas;1;1;2;122
3124708;Estrela do Indaiá;3147105;Pará de Minas;1;1;2;128
3126109;Formiga;3147105;Pará de Minas;1;1;2;108
3130101;Igarapé;3147105;Pará de Minas;1;1;2;39
3131703;Itabira;3147105;Pará de Minas;1;1;2;146
3135605;Jequitaí;3147105;Pará de Minas;1;1;2;295
3136652;Juatuba;3147105;Pará de Minas;1;1;2;31
3138302;Leandro Ferreira;3147105;Pará de Minas;1;1;2;45
3138807;Luz;3147105;Pará de Minas;1;1;2;113
3143104;Monte Carmelo;3147105;Pará de Minas;1;1;2;326
3143302;Montes Claros;3147105;Pará de Minas;1;1;2;354
3145604;Oliveira;3147105;Pará de Minas;1;1;2;97
3146404;Paineiras;3147105;Pará de Minas;1;1;2;142
2101608;Barra do Corda;3147006;Paracatu;1;1;2;1308
2909802;Cruz das Almas;3147006;Paracatu;1;1;2;967
3103504;Araguari;3147006;Paracatu;1;1;2;208
3104502;Arinos;3147006;Paracatu;1;1;2;169
3106705;Betim;3147006;Paracatu;1;1;2;421
3108552;Brasilândia de Minas;3147006;Paracatu;1;1;2;101
3109303;Buritis;3147006;Paracatu;1;1;2;185
3109402;Buritizeiro;3147006;Paracatu;1;1;2;208
3111101;Campina Verde;3147006;Paracatu;1;1;2;373
3114303;Carmo do Paranaíba;3147006;Paracatu;1;1;2;206
3119302;Coromandel;3147006;Paracatu;1;1;2;140
3122306;Divinópolis;3147006;Paracatu;1;1;2;391
3129509;Ibiá;3147006;Paracatu;1;1;2;248
3131901;Itabirito;3147006;Paracatu;1;1;2;473
3137536;Lagoa Grande;3147006;Paracatu;1;1;2;80
3143104;Monte Carmelo;3147006;Paracatu;1;1;2;177
2205516;Juazeiro do Piauí;3146909;Papagaios;1;1;2;1609
3100203;Abaeté;3146909;Papagaios;1;1;2;81
3104007;Araxá;3146909;Papagaios;1;1;2;232
3104908;Baependi;3146909;Papagaios;1;1;2;277
3106200;Belo Horizonte;3146909;Papagaios;1;1;2;95
3126406;Fortuna de Minas;3146909;Papagaios;1;1;2;32
3127602;Gouveia;3146909;Papagaios;1;1;2;153
3135605;Jequitaí;3146909;Papagaios;1;1;2;252
3136306;João Pinheiro;3146909;Papagaios;1;1;2;242
3137536;Lagoa Grande;3146909;Papagaios;1;1;2;257
3143609;Morro da Garça;3146909;Papagaios;1;1;2;101
3138005;Laranjal;3146701;Palma;1;1;2;17
3115474;Catuti;3146552;Pai Pedro;1;1;2;19
2902807;Barra da Estiva;3146503;Pains;1;1;2;869
3104007;Araxá;3146503;Pains;1;1;2;160
3106200;Belo Horizonte;3146503;Pains;1;1;2;183
3112802;Capitólio;3146503;Pains;1;1;2;49
3119955;Córrego Fundo;3146503;Pains;1;1;2;14
3122306;Divinópolis;3146503;Pains;1;1;2;84
3130309;Iguatama;3146503;Pains;1;1;2;22
3106200;Belo Horizonte;3146404;Paineiras;1;1;2;197
3107000;Biquinhas;3146404;Paineiras;1;1;2;14
3120904;Curvelo;3146404;Paineiras;1;1;2;112
3133808;Itaúna;3146404;Paineiras;1;1;2;166
3143500;Morada Nova de Minas;3146404;Paineiras;1;1;2;40
3104007;Araxá;3146305;Padre Paraíso;1;1;2;643
3104700;Ataléia;3146305;Padre Paraíso;1;1;2;116
3106200;Belo Horizonte;3146305;Padre Paraíso;1;1;2;408
3112307;Capelinha;3146305;Padre Paraíso;1;1;2;125
3113701;Carlos Chagas;3146305;Padre Paraíso;1;1;2;108
3133303;Itaobim;3146305;Padre Paraíso;1;1;2;58
3106200;Belo Horizonte;3146255;Padre Carvalho;1;1;2;422
3109402;Buritizeiro;3146255;Padre Carvalho;1;1;2;286
3106200;Belo Horizonte;3146206;Ouro Verde de Minas;1;1;2;352
3113701;Carlos Chagas;3146206;Ouro Verde de Minas;1;1;2;65
3126802;Frei Gaspar;3146206;Ouro Verde de Minas;1;1;2;19
1502152;Canaã dos Carajás;3146107;Ouro Preto;1;1;2;1664
1505536;Parauapebas;3146107;Ouro Preto;1;1;2;1713
2111532;São Pedro da Água Branca;3146107;Ouro Preto;1;1;2;1758
2930709;Simões Filho;3146107;Ouro Preto;1;1;2;991
3104007;Araxá;3146107;Ouro Preto;1;1;2;365
3105608;Barbacena;3146107;Ouro Preto;1;1;2;95
3107802;Bom Jesus do Galho;3146107;Ouro Preto;1;1;2;141
3115359;Catas Altas;3146107;Ouro Preto;1;1;2;36
3119500;Coronel Murta;3146107;Ouro Preto;1;1;2;439
3122306;Divinópolis;3146107;Ouro Preto;1;1;2;142
3128006;Guanhães;3146107;Ouro Preto;1;1;2;192
3132602;Itamarati de Minas;3146107;Ouro Preto;1;1;2;137
3134905;Jacutinga;3146107;Ouro Preto;1;1;2;386
3136207;João Monlevade;3146107;Ouro Preto;1;1;2;73
3139508;Manhumirim;3146107;Ouro Preto;1;1;2;165
3102605;Andradas;3146008;Ouro Fino;1;1;2;31
3104007;Araxá;3146008;Ouro Fino;1;1;2;304
3105608;Barbacena;3146008;Ouro Fino;1;1;2;290
3111309;Campo do Meio;3146008;Ouro Fino;1;1;2;141
3117702;Conceição do Rio Verde;3146008;Ouro Fino;1;1;2;139
3118601;Contagem;3146008;Ouro Fino;1;1;2;351
3120508;Cristina;3146008;Ouro Fino;1;1;2;114
3123601;Elói Mendes;3146008;Ouro Fino;1;1;2;111
3132404;Itajubá;3146008;Ouro Fino;1;1;2;94
3133006;Itamonte;3146008;Ouro Fino;1;1;2;154
3138203;Lavras;3146008;Ouro Fino;1;1;2;182
3139003;Machado;3146008;Ouro Fino;1;1;2;82
2611606;Recife;3145901;Ouro Branco;1;1;2;1633
2927408;Salvador;3145901;Ouro Branco;1;1;2;989
3104007;Araxá;3145901;Ouro Branco;1;1;2;354
3105400;Barão de Cocais;3145901;Ouro Branco;1;1;2;67
3105905;Barroso;3145901;Ouro Branco;1;1;2;79
3114006;Carmo da Mata;3145901;Ouro Branco;1;1;2;123
3120904;Curvelo;3145901;Ouro Branco;1;1;2;211
3122306;Divinópolis;3145901;Ouro Branco;1;1;2;131
3131901;Itabirito;3145901;Ouro Branco;1;1;2;30
3138609;Lima Duarte;3145901;Ouro Branco;1;1;2;147
3139805;Mar de Espanha;3145901;Ouro Branco;1;1;2;165
3143302;Montes Claros;3145901;Ouro Branco;1;1;2;420
3144607;Nepomuceno;3145901;Ouro Branco;1;1;2;180
3144805;Nova Lima;3145901;Ouro Branco;1;1;2;58
3145208;Nova Serrana;3145901;Ouro Branco;1;1;2;152
3124203;Espera Feliz;3145877;Orizânia;1;1;2;35
3139409;Manhuaçu;3145877;Orizânia;1;1;2;33
3106200;Belo Horizonte;3145802;Onça de Pitangui;1;1;2;89
3106705;Betim;3145802;Onça de Pitangui;1;1;2;69
3118601;Contagem;3145802;Onça de Pitangui;1;1;2;78
3145208;Nova Serrana;3145802;Onça de Pitangui;1;1;2;25
3105608;Barbacena;3145703;Oliveira Fortes;1;1;2;36
3101904;Alpinópolis;3145604;Oliveira;1;1;2;160
3104007;Araxá;3145604;Oliveira;1;1;2;249
3107109;Boa Esperança;3145604;Oliveira;1;1;2;86
3110400;Camacho;3145604;Oliveira;1;1;2;32
3112000;Candeias;3145604;Oliveira;1;1;2;44
3118601;Contagem;3145604;Oliveira;1;1;2;118
3123601;Elói Mendes;3145604;Oliveira;1;1;2;125
3136702;Juiz de Fora;3145604;Oliveira;1;1;2;198
3137403;Lagoa Dourada;3145604;Oliveira;1;1;2;85
3144805;Nova Lima;3145604;Oliveira;1;1;2;129
3107901;Bom Repouso;3145505;Olímpio Noronha;1;1;2;100
3107307;Bocaiúva;3145455;Olhos-d'Água;1;1;2;40
3109402;Buritizeiro;3145455;Olhos-d'Água;1;1;2;149
3126604;Francisco Dumont;3145455;Olhos-d'Água;1;1;2;71
3128253;Guaraciama;3145455;Olhos-d'Água;1;1;2;44
3138609;Lima Duarte;3145406;Olaria;1;1;2;18
3126752;Franciscópolis;3145356;Novo Oriente de Minas;1;1;2;104
3104007;Araxá;3145307;Novo Cruzeiro;1;1;2;591
3106200;Belo Horizonte;3145307;Novo Cruzeiro;1;1;2;351
3113008;Caraí;3145307;Novo Cruzeiro;1;1;2;36
3119500;Coronel Murta;3145307;Novo Cruzeiro;1;1;2;99
3127701;Governador Valadares;3145307;Novo Cruzeiro;1;1;2;149
3129301;Iapu;3145307;Novo Cruzeiro;1;1;2;221
3141405;Medina;3145307;Novo Cruzeiro;1;1;2;143
3141801;Minas Novas;3145307;Novo Cruzeiro;1;1;2;81
2512507;Queimadas;3145208;Nova Serrana;1;1;2;1668
2611606;Recife;3145208;Nova Serrana;1;1;2;1655
2927408;Salvador;3145208;Nova Serrana;1;1;2;1014
3100203;Abaeté;3145208;Nova Serrana;1;1;2;95
3111200;Campo Belo;3145208;Nova Serrana;1;1;2;116
3112307;Capelinha;3145208;Nova Serrana;1;1;2;353
3114204;Carmo do Cajuru;3145208;Nova Serrana;1;1;2;41
3117603;Conceição do Pará;3145208;Nova Serrana;1;1;2;16
3123205;Dores do Indaiá;3145208;Nova Serrana;1;1;2;79
3123601;Elói Mendes;3145208;Nova Serrana;1;1;2;201
3126109;Formiga;3145208;Nova Serrana;1;1;2;80
3127701;Governador Valadares;3145208;Nova Serrana;1;1;2;335
3138302;Leandro Ferreira;3145208;Nova Serrana;1;1;2;18
3140803;Matias Barbosa;3145208;Nova Serrana;1;1;2;282
3143104;Monte Carmelo;3145208;Nova Serrana;1;1;2;292
3144805;Nova Lima;3145208;Nova Serrana;1;1;2;119
3101607;Alfenas;3145109;Nova Resende;1;1;2;57
3101904;Alpinópolis;3145109;Nova Resende;1;1;2;29
3104007;Araxá;3145109;Nova Resende;1;1;2;179
3106200;Belo Horizonte;3145109;Nova Resende;1;1;2;287
3107604;Bom Jesus da Penha;3145109;Nova Resende;1;1;2;16
3114402;Carmo do Rio Claro;3145109;Nova Resende;1;1;2;36
3117108;Conceição da Aparecida;3145109;Nova Resende;1;1;2;23
3143203;Monte Santo de Minas;3145109;Nova Resende;1;1;2;65
3143302;Montes Claros;3145059;Nova Porteirinha;1;1;2;120
2905701;Camaçari;3145000;Nova Ponte;1;1;2;1202
3106200;Belo Horizonte;3145000;Nova Ponte;1;1;2;400
3111408;Campo Florido;3145000;Nova Ponte;1;1;2;116
3127107;Frutal;3145000;Nova Ponte;1;1;2;174
3106200;Belo Horizonte;3144904;Nova Módica;1;1;2;309
3132305;Itaipé;3144904;Nova Módica;1;1;2;116
1100106;Guajará-Mirim;3144805;Nova Lima;1;1;2;2421
1302603;Manaus;3144805;Nova Lima;1;1;2;2484
1501303;Barcarena;3144805;Nova Lima;1;1;2;2103
1505536;Parauapebas;3144805;Nova Lima;1;1;2;1665
1600600;Santana;3144805;Nova Lima;1;1;2;2333
1707009;Dianópolis;3144805;Nova Lima;1;1;2;977
2611606;Recife;3144805;Nova Lima;1;1;2;1599
2903276;Barrocas;3144805;Nova Lima;1;1;2;1060
2905909;Campo Alegre de Lourdes;3144805;Nova Lima;1;1;2;1165
2913606;Ilhéus;3144805;Nova Lima;1;1;2;757
2927408;Salvador;3144805;Nova Lima;1;1;2;954
3115300;Cataguases;3144805;Nova Lima;1;1;2;194
3120904;Curvelo;3144805;Nova Lima;1;1;2;154
3122306;Divinópolis;3144805;Nova Lima;1;1;2;109
3126901;Frei Inocêncio;3144805;Nova Lima;1;1;2;259
3128006;Guanhães;3144805;Nova Lima;1;1;2;171
3130101;Igarapé;3144805;Nova Lima;1;1;2;49
3131000;Inhaúma;3144805;Nova Lima;1;1;2;81
3131307;Ipatinga;3144805;Nova Lima;1;1;2;150
3131703;Itabira;3144805;Nova Lima;1;1;2;77
3133808;Itaúna;3144805;Nova Lima;1;1;2;77
3136207;João Monlevade;3144805;Nova Lima;1;1;2;75
3136702;Juiz de Fora;3144805;Nova Lima;1;1;2;200
3138203;Lavras;3144805;Nova Lima;1;1;2;180
3140001;Mariana;3144805;Nova Lima;1;1;2;61
3140803;Matias Barbosa;3144805;Nova Lima;1;1;2;212
3143906;Muriaé;3144805;Nova Lima;1;1;2;197
1504208;Marabá;3144706;Nova Era;1;1;2;1707
3117504;Conceição do Mato Dentro;3144706;Nova Era;1;1;2;90
3118007;Congonhas;3144706;Nova Era;1;1;2;120
3118601;Contagem;3144706;Nova Era;1;1;2;111
3119401;Coronel Fabriciano;3144706;Nova Era;1;1;2;51
3124104;Esmeraldas;3144706;Nova Era;1;1;2;133
3138203;Lavras;3144706;Nova Era;1;1;2;263
3127701;Governador Valadares;3144672;Nova Belém;1;1;2;106
2933307;Vitória da Conquista;3144656;Ninheira;1;1;2;110
3106655;Berizal;3144656;Ninheira;1;1;2;32
3129608;Ibiaí;3144656;Ninheira;1;1;2;379
3104007;Araxá;3144607;Nepomuceno;1;1;2;254
3107109;Boa Esperança;3144607;Nepomuceno;1;1;2;38
3111200;Campo Belo;3144607;Nepomuceno;1;1;2;38
3111606;Campos Gerais;3144607;Nepomuceno;1;1;2;54
3112000;Candeias;3144607;Nepomuceno;1;1;2;52
3113909;Carmo da Cachoeira;3144607;Nepomuceno;1;1;2;25
3120201;Cristais;3144607;Nepomuceno;1;1;2;49
3123601;Elói Mendes;3144607;Nepomuceno;1;1;2;54
3130002;Ibituruna;3144607;Nepomuceno;1;1;2;51
3137205;Lagoa da Prata;3144607;Nepomuceno;1;1;2;138
3144508;Nazareno;3144607;Nepomuceno;1;1;2;65
3104007;Araxá;3144508;Nazareno;1;1;2;301
3108008;Bom Sucesso;3144508;Nazareno;1;1;2;25
3115201;Conceição da Barra de Minas;3144508;Nazareno;1;1;2;17
3138203;Lavras;3144508;Nazareno;1;1;2;41
3106200;Belo Horizonte;3144409;Natércia;1;1;2;292
3117207;Conceição das Pedras;3144409;Natércia;1;1;2;7
3129202;Heliodora;3144409;Natércia;1;1;2;7
2913705;Inhambupe;3144359;Naque;1;1;2;920
3100500;Açucena;3144359;Naque;1;1;2;29
3106200;Belo Horizonte;3144359;Naque;1;1;2;189
3131307;Ipatinga;3144359;Naque;1;1;2;35
2912806;Ibirapuã;3144300;Nanuque;1;1;2;34
2918902;Lajedão;3144300;Nanuque;1;1;2;29
2921104;Medeiros Neto;3144300;Nanuque;1;1;2;59
3101706;Almenara;3144300;Nanuque;1;1;2;194
3103405;Araçuaí;3144300;Nanuque;1;1;2;207
3104007;Araxá;3144300;Nanuque;1;1;2;726
3113404;Caratinga;3144300;Nanuque;1;1;2;290
3118601;Contagem;3144300;Nanuque;1;1;2;457
3133303;Itaobim;3144300;Nanuque;1;1;2;193
3138906;Machacalis;3144300;Nanuque;1;1;2;95
3106200;Belo Horizonte;3144201;Nacip Raydan;1;1;2;243
3140100;Marilac;3144201;Nacip Raydan;1;1;2;18
3102001;Alterosa;3144102;Muzambinho;1;1;2;42
3104007;Araxá;3144102;Muzambinho;1;1;2;203
3104205;Arcos;3144102;Muzambinho;1;1;2;157
3104304;Areado;3144102;Muzambinho;1;1;2;39
3106200;Belo Horizonte;3144102;Muzambinho;1;1;2;309
3108404;Botelhos;3144102;Muzambinho;1;1;2;32
3111002;Campestre;3144102;Muzambinho;1;1;2;47
3111606;Campos Gerais;3144102;Muzambinho;1;1;2;81
3117108;Conceição da Aparecida;3144102;Muzambinho;1;1;2;46
3123601;Elói Mendes;3144102;Muzambinho;1;1;2;103
3128303;Guaranésia;3144102;Muzambinho;1;1;2;30
3143203;Monte Santo de Minas;3144102;Muzambinho;1;1;2;58
1500602;Altamira;3144003;Mutum;1;1;2;2141
3104007;Araxá;3144003;Mutum;1;1;2;577
3106200;Belo Horizonte;3144003;Mutum;1;1;2;267
3127701;Governador Valadares;3144003;Mutum;1;1;2;124
3131208;Ipanema;3144003;Mutum;1;1;2;28
2931004;Tanhaçu;3143906;Muriaé;1;1;2;789
3101201;Aiuruoca;3143906;Muriaé;1;1;2;257
3104007;Araxá;3143906;Muriaé;1;1;2;504
3105905;Barroso;3143906;Muriaé;1;1;2;171
3106705;Betim;3143906;Muriaé;1;1;2;228
3112109;Caparaó;3143906;Muriaé;1;1;2;76
3112307;Capelinha;3143906;Muriaé;1;1;2;376
3116704;Coimbra;3143906;Muriaé;1;1;2;54
3118304;Conselheiro Lafaiete;3143906;Muriaé;1;1;2;160
3119401;Coronel Fabriciano;3143906;Muriaé;1;1;2;175
3121605;Diamantina;3143906;Muriaé;1;1;2;342
3122306;Divinópolis;3143906;Muriaé;1;1;2;282
3123601;Elói Mendes;3143906;Muriaé;1;1;2;341
3124005;Ervália;3143906;Muriaé;1;1;2;42
3131307;Ipatinga;3143906;Muriaé;1;1;2;179
3133808;Itaúna;3143906;Muriaé;1;1;2;256
3139805;Mar de Espanha;3143906;Muriaé;1;1;2;112
3140803;Matias Barbosa;3143906;Muriaé;1;1;2;135
3141603;Mercês;3143906;Muriaé;1;1;2;105
3106200;Belo Horizonte;3143807;Munhoz;1;1;2;386
3110608;Cambuí;3143807;Munhoz;1;1;2;29
2917201;Ituaçu;3143708;Morro do Pilar;1;1;2;636
3106200;Belo Horizonte;3143708;Morro do Pilar;1;1;2;99
3106200;Belo Horizonte;3143609;Morro da Garça;1;1;2;164
3125705;Felixlândia;3143609;Morro da Garça;1;1;2;39
3104007;Araxá;3143500;Morada Nova de Minas;1;1;2;199
3107406;Bom Despacho;3143500;Morada Nova de Minas;1;1;2;129
3120904;Curvelo;3143500;Morada Nova de Minas;1;1;2;99
3124302;Espinosa;3143500;Morada Nova de Minas;1;1;2;486
3125705;Felixlândia;3143500;Morada Nova de Minas;1;1;2;57
3129608;Ibiaí;3143500;Morada Nova de Minas;1;1;2;197
3133808;Itaúna;3143450;Montezuma;1;1;2;591
3141009;Mato Verde;3143450;Montezuma;1;1;2;47
3101409;Albertina;3143401;Monte Sião;1;1;2;26
3102605;Andradas;3143401;Monte Sião;1;1;2;40
3106200;Belo Horizonte;3143401;Monte Sião;1;1;2;386
3107505;Bom Jardim de Minas;3143401;Monte Sião;1;1;2;251
3108008;Bom Sucesso;3143401;Monte Sião;1;1;2;242
3108305;Borda da Mata;3143401;Monte Sião;1;1;2;46
3109105;Bueno Brandão;3143401;Monte Sião;1;1;2;23
3113404;Caratinga;3143401;Monte Sião;1;1;2;532
3123601;Elói Mendes;3143401;Monte Sião;1;1;2;138
3130606;Inconfidentes;3143401;Monte Sião;1;1;2;28
3136900;Juruaia;3143401;Monte Sião;1;1;2;131
1100122;Ji-Paraná;3143302;Montes Claros;1;1;2;2004
2407104;Macaíba;3143302;Montes Claros;1;1;2;1496
2408102;Natal;3143302;Montes Claros;1;1;2;1506
2412005;São Gonçalo do Amarante;3143302;Montes Claros;1;1;2;1503
2504009;Campina Grande;3143302;Montes Claros;1;1;2;1344
2507507;João Pessoa;3143302;Montes Claros;1;1;2;1415
2611606;Recife;3143302;Montes Claros;1;1;2;1336
2804805;Nossa Senhora do Socorro;3143302;Montes Claros;1;1;2;962
2906501;Candeias;3143302;Montes Claros;1;1;2;720
2908705;Condeúba;3143302;Montes Claros;1;1;2;286
2928109;Santa Maria da Vitória;3143302;Montes Claros;1;1;2;376
3101508;Além Paraíba;3143302;Montes Claros;1;1;2;577
3101706;Almenara;3143302;Montes Claros;1;1;2;342
3102852;Angelândia;3143302;Montes Claros;1;1;2;207
3103405;Araçuaí;3143302;Montes Claros;1;1;2;197
3104007;Araxá;3143302;Montes Claros;1;1;2;457
3104205;Arcos;3143302;Montes Claros;1;1;2;433
3104809;Augusto de Lima;3143302;Montes Claros;1;1;2;158
3105608;Barbacena;3143302;Montes Claros;1;1;2;495
3107406;Bom Despacho;3143302;Montes Claros;1;1;2;364
3108503;Botumirim;3143302;Montes Claros;1;1;2;94
3109204;Buenópolis;3143302;Montes Claros;1;1;2;131
3109402;Buritizeiro;3143302;Montes Claros;1;1;2;137
3111200;Campo Belo;3143302;Montes Claros;1;1;2;484
3115508;Caxambu;3143302;Montes Claros;1;1;2;590
3116506;Claro dos Poções;3143302;Montes Claros;1;1;2;56
3118007;Congonhas;3143302;Montes Claros;1;1;2;417
3118304;Conselheiro Lafaiete;3143302;Montes Claros;1;1;2;435
3119104;Corinto;3143302;Montes Claros;1;1;2;192
3119401;Coronel Fabriciano;3143302;Montes Claros;1;1;2;336
3124302;Espinosa;3143302;Montes Claros;1;1;2;230
3127354;Glaucilândia;3143302;Montes Claros;1;1;2;25
3127800;Grão Mogol;3143302;Montes Claros;1;1;2;107
3129806;Ibirité;3143302;Montes Claros;1;1;2;365
3131703;Itabira;3143302;Montes Claros;1;1;2;328
3132107;Itacarambi;3143302;Montes Claros;1;1;2;181
3135605;Jequitaí;3143302;Montes Claros;1;1;2;79
3136579;Josenópolis;3143302;Montes Claros;1;1;2;146
3137304;Lagoa dos Patos;3143302;Montes Claros;1;1;2;80
3139003;Machado;3143302;Montes Claros;1;1;2;590
3141009;Mato Verde;3143302;Montes Claros;1;1;2;182
3142007;Mirabela;3143302;Montes Claros;1;1;2;60
3142700;Montalvânia;3143302;Montes Claros;1;1;2;257
3104007;Araxá;3143203;Monte Santo de Minas;1;1;2;177
3106200;Belo Horizonte;3143203;Monte Santo de Minas;1;1;2;347
3108404;Botelhos;3143203;Monte Santo de Minas;1;1;2;84
3123205;Dores do Indaiá;3143203;Monte Santo de Minas;1;1;2;242
3126109;Formiga;3143203;Monte Santo de Minas;1;1;2;186
3128303;Guaranésia;3143203;Monte Santo de Minas;1;1;2;28
3132909;Itamogi;3143203;Monte Santo de Minas;1;1;2;11
3134806;Jacuí;3143203;Monte Santo de Minas;1;1;2;36
3133303;Itaobim;3143153;Monte Formoso;1;1;2;47
3135803;Jequitinhonha;3143153;Monte Formoso;1;1;2;51
2904605;Brumado;3143104;Monte Carmelo;1;1;2;789
2905008;Caculé;3143104;Monte Carmelo;1;1;2;719
2905206;Caetité;3143104;Monte Carmelo;1;1;2;732
2910727;Eunápolis;3143104;Monte Carmelo;1;1;2;869
2911709;Guanambi;3143104;Monte Carmelo;1;1;2;695
2913606;Ilhéus;3143104;Monte Carmelo;1;1;2;977
2913903;Ipiaú;3143104;Monte Carmelo;1;1;2;962
2918001;Jequié;3143104;Monte Carmelo;1;1;2;946
2919504;Livramento de Nossa Senhora;3143104;Monte Carmelo;1;1;2;816
2927408;Salvador;3143104;Monte Carmelo;1;1;2;1133
3100104;Abadia dos Dourados;3143104;Monte Carmelo;1;1;2;29
3104205;Arcos;3143104;Monte Carmelo;1;1;2;271
3105103;Bambuí;3143104;Monte Carmelo;1;1;2;215
3107307;Bocaiúva;3143104;Monte Carmelo;1;1;2;425
3108552;Brasilândia de Minas;3143104;Monte Carmelo;1;1;2;246
3108602;Brasília de Minas;3143104;Monte Carmelo;1;1;2;428
3109303;Buritis;3143104;Monte Carmelo;1;1;2;361
3109402;Buritizeiro;3143104;Monte Carmelo;1;1;2;306
3111101;Campina Verde;3143104;Monte Carmelo;1;1;2;227
3112307;Capelinha;3143104;Monte Carmelo;1;1;2;536
3112604;Capinópolis;3143104;Monte Carmelo;1;1;2;218
3113404;Caratinga;3143104;Monte Carmelo;1;1;2;574
3114303;Carmo do Paranaíba;3143104;Monte Carmelo;1;1;2;125
3117306;Conceição das Alagoas;3143104;Monte Carmelo;1;1;2;161
3118304;Conselheiro Lafaiete;3143104;Monte Carmelo;1;1;2;446
3119104;Corinto;3143104;Monte Carmelo;1;1;2;324
3120904;Curvelo;3143104;Monte Carmelo;1;1;2;320
3121258;Delta;3143104;Monte Carmelo;1;1;2;139
3121605;Diamantina;3143104;Monte Carmelo;1;1;2;414
3122306;Divinópolis;3143104;Monte Carmelo;1;1;2;320
3127107;Frutal;3143104;Monte Carmelo;1;1;2;219
3128600;Guarda-Mor;3143104;Monte Carmelo;1;1;2;114
3128709;Guaxupé;3143104;Monte Carmelo;1;1;2;298
3128907;Guimarânia;3143104;Monte Carmelo;1;1;2;76
3129103;Gurinhatã;3143104;Monte Carmelo;1;1;2;247
3129509;Ibiá;3143104;Monte Carmelo;1;1;2;130
3133402;Itapagipe;3143104;Monte Carmelo;1;1;2;238
3133808;Itaúna;3143104;Monte Carmelo;1;1;2;345
3134202;Ituiutaba;3143104;Monte Carmelo;1;1;2;208
3135050;Jaíba;3143104;Monte Carmelo;1;1;2;548
3137205;Lagoa da Prata;3143104;Monte Carmelo;1;1;2;253
3137502;Lagoa Formosa;3143104;Monte Carmelo;1;1;2;116
3138401;Leopoldina;3143104;Monte Carmelo;1;1;2;600
3138807;Luz;3143104;Monte Carmelo;1;1;2;225
3142809;Monte Alegre de Minas;3143104;Monte Carmelo;1;1;2;146
3142908;Monte Azul;3143104;Monte Carmelo;1;1;2;625
2919553;Luís Eduardo magalhães;3143005;Monte Belo;1;1;2;1022
3102001;Alterosa;3143005;Monte Belo;1;1;2;25
3104007;Araxá;3143005;Monte Belo;1;1;2;202
3106200;Belo Horizonte;3143005;Monte Belo;1;1;2;293
3107505;Bom Jardim de Minas;3143005;Monte Belo;1;1;2;237
3108404;Botelhos;3143005;Monte Belo;1;1;2;34
3109501;Cabo Verde;3143005;Monte Belo;1;1;2;16
3117801;Conceição dos Ouros;3143005;Monte Belo;1;1;2;134
3122405;Divisa Nova;3143005;Monte Belo;1;1;2;27
3128303;Guaranésia;3143005;Monte Belo;1;1;2;45
2304400;Fortaleza;3142908;Monte Azul;1;1;2;1340
2905206;Caetité;3142908;Monte Azul;1;1;2;125
3104007;Araxá;3142908;Monte Azul;1;1;2;661
3106200;Belo Horizonte;3142908;Monte Azul;1;1;2;539
3115474;Catuti;3142908;Monte Azul;1;1;2;27
3137205;Lagoa da Prata;3142908;Monte Azul;1;1;2;611
3104007;Araxá;3142809;Monte Alegre de Minas;1;1;2;219
3112604;Capinópolis;3142809;Monte Alegre de Minas;1;1;2;75
3127107;Frutal;3142809;Monte Alegre de Minas;1;1;2;138
3134202;Ituiutaba;3142809;Monte Alegre de Minas;1;1;2;62
2304400;Fortaleza;3142700;Montalvânia;1;1;2;1337
3104007;Araxá;3142700;Montalvânia;1;1;2;630
3135209;Januária;3142700;Montalvânia;1;1;2;110
2507507;João Pessoa;3142601;Monsenhor Paulo;1;1;2;1932
3104007;Araxá;3142601;Monsenhor Paulo;1;1;2;280
3106200;Belo Horizonte;3142601;Monsenhor Paulo;1;1;2;261
3110905;Campanha;3142601;Monsenhor Paulo;1;1;2;17
3106200;Belo Horizonte;3142502;Monjolos;1;1;2;175
3120904;Curvelo;3142502;Monjolos;1;1;2;61
3104007;Araxá;3142403;Moema;1;1;2;163
3106200;Belo Horizonte;3142403;Moema;1;1;2;150
3123205;Dores do Indaiá;3142403;Moema;1;1;2;47
3106408;Belo Vale;3142304;Moeda;1;1;2;9
3106200;Belo Horizonte;3142254;Miravânia;1;1;2;573
3101508;Além Paraíba;3142205;Miraí;1;1;2;70
3106200;Belo Horizonte;3142205;Miraí;1;1;2;201
3113305;Carangola;3142205;Miraí;1;1;2;79
3124906;Eugenópolis;3142205;Miraí;1;1;2;46
3133808;Itaúna;3142205;Miraí;1;1;2;237
3136702;Juiz de Fora;3142205;Miraí;1;1;2;97
3106200;Belo Horizonte;3142106;Miradouro;1;1;2;200
3124203;Espera Feliz;3142106;Miradouro;1;1;2;54
3104007;Araxá;3142007;Mirabela;1;1;2;475
3106200;Belo Horizonte;3142007;Mirabela;1;1;2;403
3126703;Francisco Sá;3142007;Mirabela;1;1;2;75
3102803;Andrelândia;3141900;Minduri;1;1;2;30
3106200;Belo Horizonte;3141900;Minduri;1;1;2;207
3110707;Cambuquira;3141900;Minduri;1;1;2;73
3102852;Angelândia;3141801;Minas Novas;1;1;2;62
3103405;Araçuaí;3141801;Minas Novas;1;1;2;70
3104007;Araxá;3141801;Minas Novas;1;1;2;535
3121605;Diamantina;3141801;Minas Novas;1;1;2;155
3132503;Itamarandiba;3141801;Minas Novas;1;1;2;76
3106309;Belo Oriente;3141702;Mesquita;1;1;2;13
3106200;Belo Horizonte;3141603;Mercês;1;1;2;158
3115300;Cataguases;3141603;Mercês;1;1;2;71
3128402;Guarani;3141603;Mercês;1;1;2;35
3106200;Belo Horizonte;3141504;Mendes Pimentel;1;1;2;305
3115706;Central de Minas;3141504;Mendes Pimentel;1;1;2;15
2915304;Itagimirim;3141405;Medina;1;1;2;204
2923605;Paramirim;3141405;Medina;1;1;2;317
2931806;Tremedal;3141405;Medina;1;1;2;138
2933307;Vitória da Conquista;3141405;Medina;1;1;2;166
3104007;Araxá;3141405;Medina;1;1;2;695
3106200;Belo Horizonte;3141405;Medina;1;1;2;487
3120870;Curral de Dentro;3141405;Medina;1;1;2;47
3122355;Divisa Alegre;3141405;Medina;1;1;2;58
3122454;Divisópolis;3141405;Medina;1;1;2;77
3134004;Itinga;3141405;Medina;1;1;2;51
3140555;Mata Verde;3141405;Medina;1;1;2;99
3104007;Araxá;3141306;Medeiros;1;1;2;88
3106200;Belo Horizonte;3141306;Medeiros;1;1;2;235
3137502;Lagoa Formosa;3141207;Matutina;1;1;2;67
2612208;Salgueiro;3141108;Matozinhos;1;1;2;1361
2804805;Nossa Senhora do Socorro;3141108;Matozinhos;1;1;2;1198
3104205;Arcos;3141108;Matozinhos;1;1;2;174
3106705;Betim;3141108;Matozinhos;1;1;2;46
3118304;Conselheiro Lafaiete;3141108;Matozinhos;1;1;2;125
3120904;Curvelo;3141108;Matozinhos;1;1;2;98
3131000;Inhaúma;3141108;Matozinhos;1;1;2;33
3131307;Ipatinga;3141108;Matozinhos;1;1;2;162
3140803;Matias Barbosa;3141108;Matozinhos;1;1;2;268
3104007;Araxá;3141009;Mato Verde;1;1;2;641
3106200;Belo Horizonte;3141009;Mato Verde;1;1;2;513
3115474;Catuti;3141009;Mato Verde;1;1;2;17
3124302;Espinosa;3141009;Mato Verde;1;1;2;53
3129905;Ibitiúra de Minas;3141009;Mato Verde;1;1;2;835
3104007;Araxá;3140902;Matipó;1;1;2;486
3140001;Mariana;3140902;Matipó;1;1;2;112
2802908;Itabaiana;3140852;Matias Cardoso;1;1;2;830
3123908;Entre Rios de Minas;3140852;Matias Cardoso;1;1;2;644
3124807;Estrela do Sul;3140852;Matias Cardoso;1;1;2;599
3139300;Manga;3140852;Matias Cardoso;1;1;2;14
2507507;João Pessoa;3140803;Matias Barbosa;1;1;2;1830
2611606;Recife;3140803;Matias Barbosa;1;1;2;1736
2910800;Feira de Santana;3140803;Matias Barbosa;1;1;2;1147
3105905;Barroso;3140803;Matias Barbosa;1;1;2;101
3122306;Divinópolis;3140803;Matias Barbosa;1;1;2;248
3124906;Eugenópolis;3140803;Matias Barbosa;1;1;2;145
3127701;Governador Valadares;3140803;Matias Barbosa;1;1;2;365
3138203;Lavras;3140803;Matias Barbosa;1;1;2;188
3138609;Lima Duarte;3140803;Matias Barbosa;1;1;2;49
3104007;Araxá;3140704;Mateus Leme;1;1;2;267
3106705;Betim;3140704;Mateus Leme;1;1;2;25
3107406;Bom Despacho;3140704;Mateus Leme;1;1;2;92
3114501;Carmópolis de Minas;3140704;Mateus Leme;1;1;2;65
3134905;Jacutinga;3140704;Mateus Leme;1;1;2;343
3106200;Belo Horizonte;3140605;Materlândia;1;1;2;186
3106309;Belo Oriente;3140605;Materlândia;1;1;2;103
3113503;Carbonita;3140605;Materlândia;1;1;2;105
3118809;Coração de Jesus;3140605;Materlândia;1;1;2;241
3106200;Belo Horizonte;3140555;Mata Verde;1;1;2;579
3106200;Belo Horizonte;3140530;Martins Soares;1;1;2;223
3123528;Durandé;3140530;Martins Soares;1;1;2;10
3104007;Araxá;3140506;Martinho Campos;1;1;2;182
3109402;Buritizeiro;3140506;Martinho Campos;1;1;2;220
3121605;Diamantina;3140506;Martinho Campos;1;1;2;210
3129509;Ibiá;3140506;Martinho Campos;1;1;2;137
3133501;Itapecerica;3140506;Martinho Campos;1;1;2;127
3138104;Lassance;3140506;Martinho Campos;1;1;2;174
3138302;Leandro Ferreira;3140506;Martinho Campos;1;1;2;48
3106309;Belo Oriente;3140308;Marliéria;1;1;2;60
3119401;Coronel Fabriciano;3140308;Marliéria;1;1;2;24
3131307;Ipatinga;3140308;Marliéria;1;1;2;33
3135001;Jaguaraçu;3140308;Marliéria;1;1;2;7
3106200;Belo Horizonte;3140209;Maripá de Minas;1;1;2;225
3128501;Guarará;3140209;Maripá de Minas;1;1;2;11
3118601;Contagem;3140159;Mário Campos;1;1;2;19
3106200;Belo Horizonte;3140100;Marilac;1;1;2;253
2927408;Salvador;3140001;Mariana;1;1;2;961
3104007;Araxá;3140001;Mariana;1;1;2;378
3106309;Belo Oriente;3140001;Mariana;1;1;2;160
3107802;Bom Jesus do Galho;3140001;Mariana;1;1;2;129
3118007;Congonhas;3140001;Mariana;1;1;2;51
3119401;Coronel Fabriciano;3140001;Mariana;1;1;2;125
3131307;Ipatinga;3140001;Mariana;1;1;2;135
3136702;Juiz de Fora;3140001;Mariana;1;1;2;153
3139409;Manhuaçu;3140001;Mariana;1;1;2;141
3108008;Bom Sucesso;3139904;Maria da Fé;1;1;2;155
3123601;Elói Mendes;3139904;Maria da Fé;1;1;2;80
3127404;Gonçalves;3139904;Maria da Fé;1;1;2;63
3100203;Abaeté;3139805;Mar de Espanha;1;1;2;392
3106200;Belo Horizonte;3139805;Mar de Espanha;1;1;2;239
3115300;Cataguases;3139805;Mar de Espanha;1;1;2;65
3124906;Eugenópolis;3139805;Mar de Espanha;1;1;2;120
3128501;Guarará;3139805;Mar de Espanha;1;1;2;17
3104007;Araxá;3139706;Maravilhas;1;1;2;239
3104007;Araxá;3139607;Mantena;1;1;2;630
3118403;Conselheiro Pena;3139607;Mantena;1;1;2;63
3131307;Ipatinga;3139607;Mantena;1;1;2;175
3101607;Alfenas;3139508;Manhumirim;1;1;2;435
3102050;Alto Caparaó;3139508;Manhumirim;1;1;2;13
3104007;Araxá;3139508;Manhumirim;1;1;2;527
3105608;Barbacena;3139508;Manhumirim;1;1;2;214
3107406;Bom Despacho;3139508;Manhumirim;1;1;2;351
3112901;Caputira;3139508;Manhumirim;1;1;2;39
3127701;Governador Valadares;3139508;Manhumirim;1;1;2;171
3137700;Lajinha;3139508;Manhumirim;1;1;2;41
2312908;Sobral;3139409;Manhuaçu;1;1;2;1841
3100302;Abre Campo;3139409;Manhuaçu;1;1;2;44
3101607;Alfenas;3139409;Manhuaçu;1;1;2;428
3104007;Araxá;3139409;Manhuaçu;1;1;2;514
3112109;Caparaó;3139409;Manhuaçu;1;1;2;36
3112901;Caputira;3139409;Manhuaçu;1;1;2;23
3118601;Contagem;3139409;Manhuaçu;1;1;2;214
3119401;Coronel Fabriciano;3139409;Manhuaçu;1;1;2;99
3122009;Divino;3139409;Manhuaçu;1;1;2;43
3122306;Divinópolis;3139409;Manhuaçu;1;1;2;295
3128709;Guaxupé;3139409;Manhuaçu;1;1;2;502
3129301;Iapu;3139409;Manhuaçu;1;1;2;90
3130556;Imbé de Minas;3139409;Manhuaçu;1;1;2;71
3136207;João Monlevade;3139409;Manhuaçu;1;1;2;125
3138203;Lavras;3139409;Manhuaçu;1;1;2;327
3138674;Luisburgo;3139409;Manhuaçu;1;1;2;23
3104007;Araxá;3139300;Manga;1;1;2;626
3106200;Belo Horizonte;3139300;Manga;1;1;2;568
3118809;Coração de Jesus;3139300;Manga;1;1;2;218
3124302;Espinosa;3139300;Manga;1;1;2;125
3125101;Extrema;3139300;Manga;1;1;2;933
3132107;Itacarambi;3139300;Manga;1;1;2;42
3136959;Juvenília;3139300;Manga;1;1;2;60
3127339;Gameleiras;3139250;Mamonas;1;1;2;17
3104007;Araxá;3139201;Malacacheta;1;1;2;554
3112307;Capelinha;3139201;Malacacheta;1;1;2;51
3126752;Franciscópolis;3139201;Malacacheta;1;1;2;15
3102803;Andrelândia;3139102;Madre de Deus de Minas;1;1;2;27
3106200;Belo Horizonte;3139102;Madre de Deus de Minas;1;1;2;179
3136702;Juiz de Fora;3139102;Madre de Deus de Minas;1;1;2;108
3138203;Lavras;3139102;Madre de Deus de Minas;1;1;2;75
2501807;Bayeux;3139003;Machado;1;1;2;1948
2915502;Itajuípe;3139003;Machado;1;1;2;1020
2919553;Luís Eduardo magalhães;3139003;Machado;1;1;2;1060
3102605;Andradas;3139003;Machado;1;1;2;80
3104007;Araxá;3139003;Machado;1;1;2;254
3105608;Barbacena;3139003;Machado;1;1;2;226
3106200;Belo Horizonte;3139003;Machado;1;1;2;280
3107109;Boa Esperança;3139003;Machado;1;1;2;74
3111606;Campos Gerais;3139003;Machado;1;1;2;51
3118601;Contagem;3139003;Machado;1;1;2;271
3119005;Cordislândia;3139003;Machado;1;1;2;26
3126109;Formiga;3139003;Machado;1;1;2;143
3128709;Guaxupé;3139003;Machado;1;1;2;92
3131901;Itabirito;3139003;Machado;1;1;2;264
3133501;Itapecerica;3139003;Machado;1;1;2;156
3136702;Juiz de Fora;3139003;Machado;1;1;2;268
3106200;Belo Horizonte;3138906;Machacalis;1;1;2;469
3113701;Carlos Chagas;3138906;Machacalis;1;1;2;72
3127701;Governador Valadares;3138906;Machacalis;1;1;2;235
3119807;Córrego Danta;3138807;Luz;1;1;2;22
3122306;Divinópolis;3138807;Luz;1;1;2;94
3124708;Estrela do Indaiá;3138807;Luz;1;1;2;32
3126109;Formiga;3138807;Luz;1;1;2;79
3134202;Ituiutaba;3138807;Luz;1;1;2;404
3136652;Juatuba;3138807;Luz;1;1;2;143
3105608;Barbacena;3138708;Luminárias;1;1;2;119
3106200;Belo Horizonte;3138708;Luminárias;1;1;2;202
3114600;Carrancas;3138708;Luminárias;1;1;2;27
3120805;Cruzília;3138708;Luminárias;1;1;2;38
3130804;Ingaí;3138708;Luminárias;1;1;2;12
3134301;Itumirim;3138708;Luminárias;1;1;2;22
3122009;Divino;3138674;Luisburgo;1;1;2;20
3108602;Brasília de Minas;3138658;Lontra;1;1;2;35
3135100;Janaúba;3138658;Lontra;1;1;2;104
3135357;Japonvar;3138658;Lontra;1;1;2;11
3104007;Araxá;3138625;Limeira do Oeste;1;1;2;381
3106200;Belo Horizonte;3138625;Limeira do Oeste;1;1;2;695
3133402;Itapagipe;3138625;Limeira do Oeste;1;1;2;132
3124906;Eugenópolis;3138609;Lima Duarte;1;1;2;185
3138401;Leopoldina;3138609;Lima Duarte;1;1;2;119
3106200;Belo Horizonte;3138500;Liberdade;1;1;2;238
3107505;Bom Jardim de Minas;3138500;Liberdade;1;1;2;16
2927408;Salvador;3138401;Leopoldina;1;1;2;1037
3102100;Alto Rio Doce;3138401;Leopoldina;1;1;2;94
3104007;Araxá;3138401;Leopoldina;1;1;2;489
3104601;Astolfo Dutra;3138401;Leopoldina;1;1;2;32
3105608;Barbacena;3138401;Leopoldina;1;1;2;121
3113404;Caratinga;3138401;Leopoldina;1;1;2;198
3132602;Itamarati de Minas;3138401;Leopoldina;1;1;2;21
3116100;Chapada do Norte;3138351;Leme do Prado;1;1;2;17
3126505;Francisco Badaró;3138351;Leme do Prado;1;1;2;38
3122306;Divinópolis;3138302;Leandro Ferreira;1;1;2;51
2611606;Recife;3138203;Lavras;1;1;2;1768
2905701;Camaçari;3138203;Lavras;1;1;2;1162
2925303;Porto Seguro;3138203;Lavras;1;1;2;802
3104007;Araxá;3138203;Lavras;1;1;2;271
3107406;Bom Despacho;3138203;Lavras;1;1;2;168
3110301;Caldas;3138203;Lavras;1;1;2;163
3112000;Candeias;3138203;Lavras;1;1;2;58
3121258;Delta;3138203;Lavras;1;1;2;324
3125101;Extrema;3138203;Lavras;1;1;2;226
3126109;Formiga;3138203;Lavras;1;1;2;95
3132404;Itajubá;3138203;Lavras;1;1;2;140
3133808;Itaúna;3138203;Lavras;1;1;2;132
3109402;Buritizeiro;3138104;Lassance;1;1;2;70
2607901;Jaboatão dos Guararapes;3138005;Laranjal;1;1;2;1646
2930709;Simões Filho;3138005;Laranjal;1;1;2;1036
3106200;Belo Horizonte;3138005;Laranjal;1;1;2;225
3115300;Cataguases;3138005;Laranjal;1;1;2;21
3106200;Belo Horizonte;3137908;Lamim;1;1;2;112
3101607;Alfenas;3137809;Lambari;1;1;2;85
3102605;Andradas;3137809;Lambari;1;1;2;124
3104007;Araxá;3137809;Lambari;1;1;2;307
3117702;Conceição do Rio Verde;3137809;Lambari;1;1;2;31
3123601;Elói Mendes;3137809;Lambari;1;1;2;42
3132404;Itajubá;3137809;Lambari;1;1;2;53
3104007;Araxá;3137700;Lajinha;1;1;2;559
3106200;Belo Horizonte;3137700;Lajinha;1;1;2;248
3112109;Caparaó;3137700;Lajinha;1;1;2;50
3113305;Carangola;3137700;Lajinha;1;1;2;76
3116001;Chalé;3137700;Lajinha;1;1;2;14
3117405;Conceição de Ipanema;3137700;Lajinha;1;1;2;27
3122009;Divino;3137700;Lajinha;1;1;2;74
3124906;Eugenópolis;3137700;Lajinha;1;1;2;120
3131208;Ipanema;3137700;Lajinha;1;1;2;41
2607901;Jaboatão dos Guararapes;3137601;Lagoa Santa;1;1;2;1562
3109006;Brumadinho;3137601;Lagoa Santa;1;1;2;66
3112505;Capim Branco;3137601;Lagoa Santa;1;1;2;28
3129806;Ibirité;3137601;Lagoa Santa;1;1;2;47
3104007;Araxá;3137536;Lagoa Grande;1;1;2;199
3106200;Belo Horizonte;3137536;Lagoa Grande;1;1;2;354
3120904;Curvelo;3137536;Lagoa Grande;1;1;2;239
3128907;Guimarânia;3137536;Lagoa Grande;1;1;2;116
3104007;Araxá;3137502;Lagoa Formosa;1;1;2;106
3114303;Carmo do Paranaíba;3137502;Lagoa Formosa;1;1;2;26
3113206;Carandaí;3137403;Lagoa Dourada;1;1;2;22
3130101;Igarapé;3137403;Lagoa Dourada;1;1;2;97
3132206;Itaguara;3137403;Lagoa Dourada;1;1;2;72
3118601;Contagem;3137304;Lagoa dos Patos;1;1;2;329
3129608;Ibiaí;3137304;Lagoa dos Patos;1;1;2;37
2307304;Juazeiro do Norte;3137205;Lagoa da Prata;1;1;2;1550
2611606;Recife;3137205;Lagoa da Prata;1;1;2;1701
3100203;Abaeté;3137205;Lagoa da Prata;1;1;2;97
3104908;Baependi;3137205;Lagoa da Prata;1;1;2;225
3107901;Bom Repouso;3137205;Lagoa da Prata;1;1;2;279
3108008;Bom Sucesso;3137205;Lagoa da Prata;1;1;2;139
3111507;Campos Altos;3137205;Lagoa da Prata;1;1;2;75
3112000;Candeias;3137205;Lagoa da Prata;1;1;2;87
3112802;Capitólio;3137205;Lagoa da Prata;1;1;2;85
3114204;Carmo do Cajuru;3137205;Lagoa da Prata;1;1;2;82
3114303;Carmo do Paranaíba;3137205;Lagoa da Prata;1;1;2;141
3116605;Cláudio;3137205;Lagoa da Prata;1;1;2;93
3118601;Contagem;3137205;Lagoa da Prata;1;1;2;152
3119302;Coromandel;3137205;Lagoa da Prata;1;1;2;244
3122900;Dona Eusébia;3137205;Lagoa da Prata;1;1;2;320
3123205;Dores do Indaiá;3137205;Lagoa da Prata;1;1;2;62
3129509;Ibiá;3137205;Lagoa da Prata;1;1;2;122
3130101;Igarapé;3137205;Lagoa da Prata;1;1;2;127
3130309;Iguatama;3137205;Lagoa da Prata;1;1;2;25
3133501;Itapecerica;3137205;Lagoa da Prata;1;1;2;66
3133808;Itaúna;3137205;Lagoa da Prata;1;1;2;100
3104007;Araxá;3137106;Lagamar;1;1;2;157
3106200;Belo Horizonte;3137106;Lagamar;1;1;2;356
3118809;Coração de Jesus;3136959;Juvenília;1;1;2;269
3104007;Araxá;3136900;Juruaia;1;1;2;188
3122306;Divinópolis;3136900;Juruaia;1;1;2;213
3128303;Guaranésia;3136900;Juruaia;1;1;2;24
3106200;Belo Horizonte;3136801;Juramento;1;1;2;340
1302603;Manaus;3136702;Juiz de Fora;1;1;2;2647
2609600;Olinda;3136702;Juiz de Fora;1;1;2;1740
3100203;Abaeté;3136702;Juiz de Fora;1;1;2;362
3103306;Aracitaba;3136702;Juiz de Fora;1;1;2;47
3104601;Astolfo Dutra;3136702;Juiz de Fora;1;1;2;68
3106101;Belmiro Braga;3136702;Juiz de Fora;1;1;2;23
3107505;Bom Jardim de Minas;3136702;Juiz de Fora;1;1;2;91
3113206;Carandaí;3136702;Juiz de Fora;1;1;2;104
3114204;Carmo do Cajuru;3136702;Juiz de Fora;1;1;2;228
3115508;Caxambu;3136702;Juiz de Fora;1;1;2;172
3116605;Cláudio;3136702;Juiz de Fora;1;1;2;207
3119401;Coronel Fabriciano;3136702;Juiz de Fora;1;1;2;258
3122306;Divinópolis;3136702;Juiz de Fora;1;1;2;238
3123007;Dores de Campos;3136702;Juiz de Fora;1;1;2;101
3123601;Elói Mendes;3136702;Juiz de Fora;1;1;2;231
3124203;Espera Feliz;3136702;Juiz de Fora;1;1;2;191
3128501;Guarará;3136702;Juiz de Fora;1;1;2;29
3128709;Guaxupé;3136702;Juiz de Fora;1;1;2;353
3133808;Itaúna;3136702;Juiz de Fora;1;1;2;224
2602902;Cabo de Santo Agostinho;3136652;Juatuba;1;1;2;1602
2905701;Camaçari;3136652;Juatuba;1;1;2;1013
3104007;Araxá;3136652;Juatuba;1;1;2;275
3118601;Contagem;3136652;Juatuba;1;1;2;27
3124104;Esmeraldas;3136652;Juatuba;1;1;2;21
3130200;Igaratinga;3136652;Juatuba;1;1;2;38
2800308;Aracaju;3136603;Nova União;1;1;2;1179
3107505;Bom Jardim de Minas;3136603;Nova União;1;1;2;258
3118601;Contagem;3136603;Nova União;1;1;2;59
3106200;Belo Horizonte;3136579;Josenópolis;1;1;2;403
3106200;Belo Horizonte;3136553;José Raydan;1;1;2;244
2916401;Itapetinga;3136504;Jordânia;1;1;2;69
2916807;Itarantim;3136504;Jordânia;1;1;2;29
2933307;Vitória da Conquista;3136504;Jordânia;1;1;2;135
3104007;Araxá;3136504;Jordânia;1;1;2;838
3106200;Belo Horizonte;3136504;Jordânia;1;1;2;604
3109204;Buenópolis;3136405;Joaquim Felício;1;1;2;13
3126604;Francisco Dumont;3136405;Joaquim Felício;1;1;2;49
3135100;Janaúba;3136405;Joaquim Felício;1;1;2;234
2101608;Barra do Corda;3136306;João Pinheiro;1;1;2;1358
2903201;Barreiras;3136306;João Pinheiro;1;1;2;626
3104007;Araxá;3136306;João Pinheiro;1;1;2;218
3104502;Arinos;3136306;João Pinheiro;1;1;2;204
3112307;Capelinha;3136306;João Pinheiro;1;1;2;390
3114204;Carmo do Cajuru;3136306;João Pinheiro;1;1;2;310
3118601;Contagem;3136306;João Pinheiro;1;1;2;329
3120201;Cristais;3136306;João Pinheiro;1;1;2;353
3123205;Dores do Indaiá;3136306;João Pinheiro;1;1;2;200
3127701;Governador Valadares;3136306;João Pinheiro;1;1;2;464
3128600;Guarda-Mor;3136306;João Pinheiro;1;1;2;95
2804805;Nossa Senhora do Socorro;3136207;João Monlevade;1;1;2;1168
3105608;Barbacena;3136207;João Monlevade;1;1;2;167
3106309;Belo Oriente;3136207;João Monlevade;1;1;2;97
3106705;Betim;3136207;João Monlevade;1;1;2;108
3109006;Brumadinho;3136207;João Monlevade;1;1;2;114
3117504;Conceição do Mato Dentro;3136207;João Monlevade;1;1;2;90
3118007;Congonhas;3136207;João Monlevade;1;1;2;107
3120904;Curvelo;3136207;João Monlevade;1;1;2;179
3121803;Dionísio;3136207;João Monlevade;1;1;2;42
3122702;Dom Silvério;3136207;João Monlevade;1;1;2;44
3125903;Ferros;3136207;João Monlevade;1;1;2;66
3128006;Guanhães;3136207;João Monlevade;1;1;2;121
3131208;Ipanema;3136207;João Monlevade;1;1;2;154
3132206;Itaguara;3136207;João Monlevade;1;1;2;152
3106200;Belo Horizonte;3136108;Joanésia;1;1;2;159
3108800;Braúnas;3136108;Joanésia;1;1;2;13
2915304;Itagimirim;3136009;Joaíma;1;1;2;169
3104007;Araxá;3136009;Joaíma;1;1;2;709
3106200;Belo Horizonte;3136009;Joaíma;1;1;2;475
3135803;Jequitinhonha;3136009;Joaíma;1;1;2;22
3110707;Cambuquira;3135902;Jesuânia;1;1;2;16
3117702;Conceição do Rio Verde;3135902;Jesuânia;1;1;2;25
2927408;Salvador;3135803;Jequitinhonha;1;1;2;469
3103405;Araçuaí;3135803;Jequitinhonha;1;1;2;120
3104007;Araxá;3135803;Jequitinhonha;1;1;2;727
3135209;Januária;3135803;Jequitinhonha;1;1;2;377
3106200;Belo Horizonte;3135704;Jequitibá;1;1;2;74
3122306;Divinópolis;3135704;Jequitibá;1;1;2;137
3127701;Governador Valadares;3135704;Jequitibá;1;1;2;220
3107307;Bocaiúva;3135605;Jequitaí;1;1;2;65
3120904;Curvelo;3135605;Jequitaí;1;1;2;174
3126703;Francisco Sá;3135605;Jequitaí;1;1;2;124
3129608;Ibiaí;3135605;Jequitaí;1;1;2;61
3118304;Conselheiro Lafaiete;3135506;Jequeri;1;1;2;123
3126505;Francisco Badaró;3135456;Jenipapo de Minas;1;1;2;14
1600402;Mazagão;3135407;Jeceaba;1;1;2;2373
1600600;Santana;3135407;Jeceaba;1;1;2;2382
3105608;Barbacena;3135407;Jeceaba;1;1;2;76
2304400;Fortaleza;3135209;Januária;1;1;2;1432
2903904;Bom Jesus da Lapa;3135209;Januária;1;1;2;265
3104007;Araxá;3135209;Januária;1;1;2;535
3108255;Bonito de Minas;3135209;Januária;1;1;2;43
3116159;Chapada Gaúcha;3135209;Januária;1;1;2;134
3117836;Cônego Marinho;3135209;Januária;1;1;2;19
3122306;Divinópolis;3135209;Januária;1;1;2;523
1505536;Parauapebas;3135100;Janaúba;1;1;2;1282
1702109;Araguaína;3135100;Janaúba;1;1;2;1081
2201903;Bom Jesus;3135100;Janaúba;1;1;2;754
2304400;Fortaleza;3135100;Janaúba;1;1;2;1423
2911709;Guanambi;3135100;Janaúba;1;1;2;177
3104007;Araxá;3135100;Janaúba;1;1;2;573
3105400;Barão de Cocais;3135100;Janaúba;1;1;2;458
3108602;Brasília de Minas;3135100;Janaúba;1;1;2;124
3111200;Campo Belo;3135100;Janaúba;1;1;2;601
3112703;Capitão Enéas;3135100;Janaúba;1;1;2;70
3121209;Delfinópolis;3135100;Janaúba;1;1;2;631
3121605;Diamantina;3135100;Janaúba;1;1;2;269
3126703;Francisco Sá;3135100;Janaúba;1;1;2;80
3127701;Governador Valadares;3135100;Janaúba;1;1;2;364
3127800;Grão Mogol;3135100;Janaúba;1;1;2;97
3126752;Franciscópolis;3135076;Jampruca;1;1;2;60
3127701;Governador Valadares;3135076;Jampruca;1;1;2;43
3104007;Araxá;3135050;Jaíba;1;1;2;590
3126703;Francisco Sá;3135050;Jaíba;1;1;2;134
3103009;Antônio Dias;3135001;Jaguaraçu;1;1;2;13
3101409;Albertina;3134905;Jacutinga;1;1;2;9
3104007;Araxá;3134905;Jacutinga;1;1;2;301
3106200;Belo Horizonte;3134905;Jacutinga;1;1;2;377
3109105;Bueno Brandão;3134905;Jacutinga;1;1;2;32
3111309;Campo do Meio;3134905;Jacutinga;1;1;2;153
3111606;Campos Gerais;3134905;Jacutinga;1;1;2;146
3123601;Elói Mendes;3134905;Jacutinga;1;1;2;131
3128709;Guaxupé;3134905;Jacutinga;1;1;2;109
3104007;Araxá;3134806;Jacuí;1;1;2;160
3106200;Belo Horizonte;3134806;Jacuí;1;1;2;312
3128303;Guaranésia;3134806;Jacuí;1;1;2;32
3106200;Belo Horizonte;3134707;Jacinto;1;1;2;576
3110004;Caeté;3134608;Jaboticatubas;1;1;2;41
3130408;Ijaci;3134509;Itutinga;1;1;2;31
2702306;Coruripe;3134400;Iturama;1;1;2;1786
2704302;Maceió;3134400;Iturama;1;1;2;1853
3104007;Araxá;3134400;Iturama;1;1;2;341
3112604;Capinópolis;3134400;Iturama;1;1;2;133
3108008;Bom Sucesso;3134301;Itumirim;1;1;2;34
3114600;Carrancas;3134301;Itumirim;1;1;2;30
3115201;Conceição da Barra de Minas;3134301;Itumirim;1;1;2;46
3130002;Ibituruna;3134301;Itumirim;1;1;2;22
3130408;Ijaci;3134301;Itumirim;1;1;2;17
3130804;Ingaí;3134301;Itumirim;1;1;2;10
2304400;Fortaleza;3134202;Ituiutaba;1;1;2;2018
3111507;Campos Altos;3134202;Ituiutaba;1;1;2;356
3127107;Frutal;3134202;Ituiutaba;1;1;2;136
3106200;Belo Horizonte;3134103;Itueta;1;1;2;301
3109006;Brumadinho;3134103;Itueta;1;1;2;330
3118403;Conselheiro Pena;3134103;Itueta;1;1;2;41
3104007;Araxá;3134004;Itinga;1;1;2;648
3106200;Belo Horizonte;3133907;Itaverava;1;1;2;94
3115409;Catas Altas da Noruega;3133907;Itaverava;1;1;2;12
1504208;Marabá;3133808;Itaúna;1;1;2;1693
3100203;Abaeté;3133808;Itaúna;1;1;2;139
3103504;Araguari;3133808;Itaúna;1;1;2;410
3105103;Bambuí;3133808;Itaúna;1;1;2;147
3105608;Barbacena;3133808;Itaúna;1;1;2;147
3111200;Campo Belo;3133808;Itaúna;1;1;2;113
3111507;Campos Altos;3133808;Itaúna;1;1;2;171
3117108;Conceição da Aparecida;3133808;Itaúna;1;1;2;202
3117603;Conceição do Pará;3133808;Itaúna;1;1;2;50
3120607;Crucilândia;3133808;Itaúna;1;1;2;41
3123205;Dores do Indaiá;3133808;Itaúna;1;1;2;127
3123601;Elói Mendes;3133808;Itaúna;1;1;2;196
3125705;Felixlândia;3133808;Itaúna;1;1;2;152
3126208;Formoso;3133808;Itaúna;1;1;2;595
3129806;Ibirité;3133808;Itaúna;1;1;2;56
3131901;Itabirito;3133808;Itaúna;1;1;2;81
3104007;Araxá;3133758;Itaú de Minas;1;1;2;129
3106200;Belo Horizonte;3133758;Itaú de Minas;1;1;2;306
3112802;Capitólio;3133758;Itaú de Minas;1;1;2;78
3117108;Conceição da Aparecida;3133758;Itaú de Minas;1;1;2;72
3129707;Ibiraci;3133758;Itaú de Minas;1;1;2;47
1500602;Altamira;3133709;Itatiaiuçu;1;1;2;2042
2101608;Barra do Corda;3133709;Itatiaiuçu;1;1;2;1626
3104007;Araxá;3133709;Itatiaiuçu;1;1;2;272
3105103;Bambuí;3133709;Itatiaiuçu;1;1;2;165
3106705;Betim;3133709;Itatiaiuçu;1;1;2;36
3114204;Carmo do Cajuru;3133709;Itatiaiuçu;1;1;2;37
3122603;Dom Joaquim;3133709;Itatiaiuçu;1;1;2;182
3123205;Dores do Indaiá;3133709;Itatiaiuçu;1;1;2;148
2312304;São Benedito;3133600;Itapeva;1;1;2;2136
3106200;Belo Horizonte;3133600;Itapeva;1;1;2;391
3124500;Estiva;3133600;Itapeva;1;1;2;40
3125101;Extrema;3133600;Itapeva;1;1;2;13
3104007;Araxá;3133501;Itapecerica;1;1;2;213
3107406;Bom Despacho;3133501;Itapecerica;1;1;2;83
3110400;Camacho;3133501;Itapecerica;1;1;2;17
3111200;Campo Belo;3133501;Itapecerica;1;1;2;49
3114501;Carmópolis de Minas;3133501;Itapecerica;1;1;2;52
3118601;Contagem;3133501;Itapecerica;1;1;2;125
3123205;Dores do Indaiá;3133501;Itapecerica;1;1;2;122
3125101;Extrema;3133501;Itapecerica;1;1;2;292
3126109;Formiga;3133501;Itapecerica;1;1;2;31
3130200;Igaratinga;3133501;Itapecerica;1;1;2;72
3104007;Araxá;3133402;Itapagipe;1;1;2;257
3106200;Belo Horizonte;3133402;Itapagipe;1;1;2;566
2926657;Ribeirão do Largo;3133303;Itaobim;1;1;2;150
3101706;Almenara;3133303;Itaobim;1;1;2;101
3104007;Araxá;3133303;Itaobim;1;1;2;669
3113404;Caratinga;3133303;Itaobim;1;1;2;366
3106200;Belo Horizonte;3133204;Itanhomi;1;1;2;237
3113404;Caratinga;3133204;Itanhomi;1;1;2;79
3118403;Conselheiro Pena;3133204;Itanhomi;1;1;2;39
3119401;Coronel Fabriciano;3133204;Itanhomi;1;1;2;89
3104908;Baependi;3133105;Itanhandu;1;1;2;39
3120805;Cruzília;3133105;Itanhandu;1;1;2;52
3121209;Delfinópolis;3133105;Itanhandu;1;1;2;292
3123601;Elói Mendes;3133105;Itanhandu;1;1;2;100
3106200;Belo Horizonte;3133006;Itamonte;1;1;2;279
3111200;Campo Belo;3133006;Itamonte;1;1;2;159
3117702;Conceição do Rio Verde;3133006;Itamonte;1;1;2;50
3123601;Elói Mendes;3133006;Itamonte;1;1;2;103
3132404;Itajubá;3133006;Itamonte;1;1;2;64
3104007;Araxá;3132909;Itamogi;1;1;2;165
3104106;Arceburgo;3132909;Itamogi;1;1;2;34
3106200;Belo Horizonte;3132909;Itamogi;1;1;2;343
3128709;Guaxupé;3132909;Itamogi;1;1;2;43
3104007;Araxá;3132701;Itambacuri;1;1;2;585
3125101;Extrema;3132701;Itambacuri;1;1;2;729
3127701;Governador Valadares;3132701;Itambacuri;1;1;2;91
3132305;Itaipé;3132701;Itambacuri;1;1;2;70
3104601;Astolfo Dutra;3132602;Itamarati de Minas;1;1;2;12
3115300;Cataguases;3132602;Itamarati de Minas;1;1;2;16
3104007;Araxá;3132503;Itamarandiba;1;1;2;476
3107307;Bocaiúva;3132503;Itamarandiba;1;1;2;131
3118601;Contagem;3132503;Itamarandiba;1;1;2;263
3105608;Barbacena;3132404;Itajubá;1;1;2;218
3106705;Betim;3132404;Itajubá;1;1;2;301
3107109;Boa Esperança;3132404;Itajubá;1;1;2;147
3108008;Bom Sucesso;3132404;Itajubá;1;1;2;169
3118601;Contagem;3132404;Itajubá;1;1;2;310
3121100;Delfim Moreira;3132404;Itajubá;1;1;2;22
3121605;Diamantina;3132404;Itajubá;1;1;2;501
3122306;Divinópolis;3132404;Itajubá;1;1;2;256
3123601;Elói Mendes;3132404;Itajubá;1;1;2;89
3106200;Belo Horizonte;3132305;Itaipé;1;1;2;371
3112307;Capelinha;3132305;Itaipé;1;1;2;96
3104007;Araxá;3132206;Itaguara;1;1;2;271
3104205;Arcos;3132206;Itaguara;1;1;2;111
3106705;Betim;3132206;Itaguara;1;1;2;57
3108107;Bonfim;3132206;Itaguara;1;1;2;27
3111200;Campo Belo;3132206;Itaguara;1;1;2;99
3118601;Contagem;3132206;Itaguara;1;1;2;67
3120607;Crucilândia;3132206;Itaguara;1;1;2;16
3122306;Divinópolis;3132206;Itaguara;1;1;2;49
3104007;Araxá;3132107;Itacarambi;1;1;2;584
3108602;Brasília de Minas;3132107;Itacarambi;1;1;2;125
3127206;Funilândia;3132107;Itacarambi;1;1;2;471
3109402;Buritizeiro;3132008;Itacambira;1;1;2;181
3120904;Curvelo;3132008;Itacambira;1;1;2;225
3125705;Felixlândia;3132008;Itacambira;1;1;2;253
1502152;Canaã dos Carajás;3131901;Itabirito;1;1;2;1643
2111300;São Luís;3131901;Itabirito;1;1;2;1964
3102308;Alvinópolis;3131901;Itabirito;1;1;2;85
3102506;Amparo do Serra;3131901;Itabirito;1;1;2;111
3105400;Barão de Cocais;3131901;Itabirito;1;1;2;52
3110004;Caeté;3131901;Itabirito;1;1;2;48
3118601;Contagem;3131901;Itabirito;1;1;2;48
3119401;Coronel Fabriciano;3131901;Itabirito;1;1;2;152
3123908;Entre Rios de Minas;3131901;Itabirito;1;1;2;49
3127073;Fruta de Leite;3131901;Itabirito;1;1;2;479
3128204;Guaraciaba;3131901;Itabirito;1;1;2;93
3131703;Itabira;3131901;Itabirito;1;1;2;96
3106200;Belo Horizonte;3131802;Itabirinha de Mantena;1;1;2;326
3115706;Central de Minas;3131802;Itabirinha de Mantena;1;1;2;23
1400100;Boa Vista;3131703;Itabira;1;1;2;3051
1501402;Belém;3131703;Itabira;1;1;2;2086
1503606;Itaituba;3131703;Itabira;1;1;2;2140
2211001;Teresina;3131703;Itabira;1;1;2;1609
2408102;Natal;3131703;Itabira;1;1;2;1731
2504009;Campina Grande;3131703;Itabira;1;1;2;1565
2910800;Feira de Santana;3131703;Itabira;1;1;2;924
2927408;Salvador;3131703;Itabira;1;1;2;884
2933307;Vitória da Conquista;3131703;Itabira;1;1;2;583
3101607;Alfenas;3131703;Itabira;1;1;2;347
3102308;Alvinópolis;3131703;Itabira;1;1;2;57
3105608;Barbacena;3131703;Itabira;1;1;2;183
3106309;Belo Oriente;3131703;Itabira;1;1;2;92
3106705;Betim;3131703;Itabira;1;1;2;106
3107406;Bom Despacho;3131703;Itabira;1;1;2;212
3107703;Bom Jesus do Amparo;3131703;Itabira;1;1;2;26
3109006;Brumadinho;3131703;Itabira;1;1;2;115
3110004;Caeté;3131703;Itabira;1;1;2;53
3111200;Campo Belo;3131703;Itabira;1;1;2;255
3113404;Caratinga;3131703;Itabira;1;1;2;111
3118007;Congonhas;3131703;Itabira;1;1;2;117
3119401;Coronel Fabriciano;3131703;Itabira;1;1;2;66
3121605;Diamantina;3131703;Itabira;1;1;2;161
3122306;Divinópolis;3131703;Itabira;1;1;2;182
3126109;Formiga;3131703;Itabira;1;1;2;247
3129806;Ibirité;3131703;Itabira;1;1;2;96
3104007;Araxá;3131604;Iraí de Minas;1;1;2;86
3119302;Coromandel;3131604;Iraí de Minas;1;1;2;64
3102605;Andradas;3131505;Ipuiúna;1;1;2;39
3104007;Araxá;3131505;Ipuiúna;1;1;2;289
3106200;Belo Horizonte;3131505;Ipuiúna;1;1;2;332
3107406;Bom Despacho;3131505;Ipuiúna;1;1;2;279
3110608;Cambuí;3131505;Ipuiúna;1;1;2;58
2408102;Natal;3131307;Ipatinga;1;1;2;1683
2910727;Eunápolis;3131307;Ipatinga;1;1;2;460
2910800;Feira de Santana;3131307;Ipatinga;1;1;2;876
2929206;São Francisco do Conde;3131307;Ipatinga;1;1;2;855
3101805;Alpercata;3131307;Ipatinga;1;1;2;81
3103009;Antônio Dias;3131307;Ipatinga;1;1;2;40
3106002;Bela Vista de Minas;3131307;Ipatinga;1;1;2;70
3108800;Braúnas;3131307;Ipatinga;1;1;2;49
3115359;Catas Altas;3131307;Ipatinga;1;1;2;113
3118304;Conselheiro Lafaiete;3131307;Ipatinga;1;1;2;188
3122306;Divinópolis;3131307;Ipatinga;1;1;2;258
3130903;Inhapim;3131307;Ipatinga;1;1;2;46
3104007;Araxá;3131208;Ipanema;1;1;2;549
3117405;Conceição de Ipanema;3131208;Ipanema;1;1;2;15
3122009;Divino;3131208;Ipanema;1;1;2;102
3124203;Espera Feliz;3131208;Ipanema;1;1;2;97
3127701;Governador Valadares;3131208;Ipanema;1;1;2;113
3103009;Antônio Dias;3131158;Ipaba;1;1;2;54
3106200;Belo Horizonte;3131158;Ipaba;1;1;2;173
3127701;Governador Valadares;3131158;Ipaba;1;1;2;81
3129301;Iapu;3131158;Ipaba;1;1;2;21
3104007;Araxá;3131000;Inhaúma;1;1;2;269
3102209;Alvarenga;3130903;Inhapim;1;1;2;45
3104007;Araxá;3130903;Inhapim;1;1;2;506
3118403;Conselheiro Pena;3130903;Inhapim;1;1;2;80
3122504;Dom Cavati;3130903;Inhapim;1;1;2;22
3123700;Engenheiro Caldas;3130903;Inhapim;1;1;2;40
3129301;Iapu;3130903;Inhapim;1;1;2;18
3106200;Belo Horizonte;3130804;Ingaí;1;1;2;192
3123007;Dores de Campos;3130804;Ingaí;1;1;2;98
3103504;Araguari;3130705;Indianópolis;1;1;2;54
3106200;Belo Horizonte;3130705;Indianópolis;1;1;2;426
3117306;Conceição das Alagoas;3130705;Indianópolis;1;1;2;109
3106200;Belo Horizonte;3130655;Indaiabira;1;1;2;525
3102605;Andradas;3130606;Inconfidentes;1;1;2;37
3104007;Araxá;3130606;Inconfidentes;1;1;2;309
3106200;Belo Horizonte;3130606;Inconfidentes;1;1;2;359
3106200;Belo Horizonte;3130556;Imbé de Minas;1;1;2;214
3107802;Bom Jesus do Galho;3130556;Imbé de Minas;1;1;2;44
3104007;Araxá;3130507;Ilicínea;1;1;2;189
3106200;Belo Horizonte;3130507;Ilicínea;1;1;2;224
3120201;Cristais;3130507;Ilicínea;1;1;2;33
3123601;Elói Mendes;3130507;Ilicínea;1;1;2;80
3108008;Bom Sucesso;3130408;Ijaci;1;1;2;23
3114006;Carmo da Mata;3130408;Ijaci;1;1;2;68
3104007;Araxá;3130309;Iguatama;1;1;2;144
3105103;Bambuí;3130309;Iguatama;1;1;2;34
3106200;Belo Horizonte;3130309;Iguatama;1;1;2;183
3123403;Doresópolis;3130309;Iguatama;1;1;2;24
2304400;Fortaleza;3130200;Igaratinga;1;1;2;1896
3104007;Araxá;3130200;Igaratinga;1;1;2;238
3106705;Betim;3130200;Igaratinga;1;1;2;54
3107406;Bom Despacho;3130200;Igaratinga;1;1;2;63
3126000;Florestal;3130200;Igaratinga;1;1;2;30
2304400;Fortaleza;3130101;Igarapé;1;1;2;1896
2930709;Simões Filho;3130101;Igarapé;1;1;2;1009
3108107;Bonfim;3130101;Igarapé;1;1;2;30
3108305;Borda da Mata;3130101;Igarapé;1;1;2;312
3109006;Brumadinho;3130101;Igarapé;1;1;2;15
3114204;Carmo do Cajuru;3130101;Igarapé;1;1;2;48
3117504;Conceição do Mato Dentro;3130101;Igarapé;1;1;2;149
3124104;Esmeraldas;3130101;Igarapé;1;1;2;34
3121605;Diamantina;3130002;Ibituruna;1;1;2;345
3101607;Alfenas;3129905;Ibitiúra de Minas;1;1;2;88
3117900;Congonhal;3129905;Ibitiúra de Minas;1;1;2;43
1302603;Manaus;3129806;Ibirité;1;1;2;2471
2611606;Recife;3129806;Ibirité;1;1;2;1611
3113701;Carlos Chagas;3129806;Ibirité;1;1;2;425
3122306;Divinópolis;3129806;Ibirité;1;1;2;88
3104007;Araxá;3129707;Ibiraci;1;1;2;99
3106200;Belo Horizonte;3129707;Ibiraci;1;1;2;333
3116407;Claraval;3129707;Ibiraci;1;1;2;17
3128303;Guaranésia;3129707;Ibiraci;1;1;2;98
3106200;Belo Horizonte;3129608;Ibiaí;1;1;2;351
3109204;Buenópolis;3129608;Ibiaí;1;1;2;136
3109402;Buritizeiro;3129608;Ibiaí;1;1;2;57
3104205;Arcos;3129509;Ibiá;1;1;2;141
3107406;Bom Despacho;3129509;Ibiá;1;1;2;137
3125705;Felixlândia;3129509;Ibiá;1;1;2;187
3102803;Andrelândia;3129400;Ibertioga;1;1;2;50
3102902;Antônio Carlos;3129400;Ibertioga;1;1;2;26
3106200;Belo Horizonte;3129400;Ibertioga;1;1;2;169
2922003;Mucuri;3129301;Iapu;1;1;2;320
2923001;Nova Viçosa;3129301;Iapu;1;1;2;333
3103405;Araçuaí;3129301;Iapu;1;1;2;283
3106200;Belo Horizonte;3129301;Iapu;1;1;2;192
3106309;Belo Oriente;3129301;Iapu;1;1;2;37
3106200;Belo Horizonte;3129202;Heliodora;1;1;2;288
3113602;Careaçu;3129202;Heliodora;1;1;2;16
3104007;Araxá;3129103;Gurinhatã;1;1;2;302
3106200;Belo Horizonte;3129103;Gurinhatã;1;1;2;617
3111101;Campina Verde;3129103;Gurinhatã;1;1;2;46
3106200;Belo Horizonte;3129004;Guiricema;1;1;2;179
3100104;Abadia dos Dourados;3128907;Guimarânia;1;1;2;75
3104007;Araxá;3128907;Guimarânia;1;1;2;84
3120201;Cristais;3128907;Guimarânia;1;1;2;262
3101904;Alpinópolis;3128709;Guaxupé;1;1;2;60
3103504;Araguari;3128709;Guaxupé;1;1;2;332
3104007;Araxá;3128709;Guaxupé;1;1;2;192
3104106;Arceburgo;3128709;Guaxupé;1;1;2;24
3105608;Barbacena;3128709;Guaxupé;1;1;2;303
3106705;Betim;3128709;Guaxupé;1;1;2;301
3107109;Boa Esperança;3128709;Guaxupé;1;1;2;122
3110301;Caldas;3128709;Guaxupé;1;1;2;77
3111606;Campos Gerais;3128709;Guaxupé;1;1;2;100
3114402;Carmo do Rio Claro;3128709;Guaxupé;1;1;2;72
3117108;Conceição da Aparecida;3128709;Guaxupé;1;1;2;58
3119302;Coromandel;3128709;Guaxupé;1;1;2;318
3122405;Divisa Nova;3128709;Guaxupé;1;1;2;59
3123601;Elói Mendes;3128709;Guaxupé;1;1;2;124
3104007;Araxá;3128600;Guarda-Mor;1;1;2;202
3106200;Belo Horizonte;3128600;Guarda-Mor;1;1;2;408
3106200;Belo Horizonte;3128501;Guarará;1;1;2;223
3104601;Astolfo Dutra;3128402;Guarani;1;1;2;18
3106200;Belo Horizonte;3128402;Guarani;1;1;2;187
3122900;Dona Eusébia;3128402;Guarani;1;1;2;25
3104007;Araxá;3128303;Guaranésia;1;1;2;190
3104304;Areado;3128303;Guaranésia;1;1;2;69
3106200;Belo Horizonte;3128303;Guaranésia;1;1;2;330
3106200;Belo Horizonte;3128253;Guaraciama;1;1;2;321
3106200;Belo Horizonte;3128204;Guaraciaba;1;1;2;125
3104007;Araxá;3128105;Guapé;1;1;2;168
3106200;Belo Horizonte;3128105;Guapé;1;1;2;223
3107406;Bom Despacho;3128105;Guapé;1;1;2;133
3100609;Água Boa;3128006;Guanhães;1;1;2;100
3104007;Araxá;3128006;Guanhães;1;1;2;435
3108800;Braúnas;3128006;Guanhães;1;1;2;42
3116803;Coluna;3128006;Guanhães;1;1;2;57
3120904;Curvelo;3128006;Guanhães;1;1;2;163
3127701;Governador Valadares;3128006;Guanhães;1;1;2;100
3103504;Araguari;3127909;Grupiara;1;1;2;54
3107307;Bocaiúva;3127800;Grão Mogol;1;1;2;118
3109402;Buritizeiro;3127800;Grão Mogol;1;1;2;240
3118601;Contagem;3127800;Grão Mogol;1;1;2;393
1506161;Rio Maria;3127701;Governador Valadares;1;1;2;1517
1721000;Palmas;3127701;Governador Valadares;1;1;2;1144
2408102;Natal;3127701;Governador Valadares;1;1;2;1595
2408904;Parelhas;3127701;Governador Valadares;1;1;2;1448
2704302;Maceió;3127701;Governador Valadares;1;1;2;1201
2706307;Palmeira dos Índios;3127701;Governador Valadares;1;1;2;1174
2903201;Barreiras;3127701;Governador Valadares;1;1;2;793
2905602;Camacan;3127701;Governador Valadares;1;1;2;455
2907301;Castro Alves;3127701;Governador Valadares;1;1;2;719
2914802;Itabuna;3127701;Governador Valadares;1;1;2;527
2925303;Porto Seguro;3127701;Governador Valadares;1;1;2;398
2931350;Teixeira de Freitas;3127701;Governador Valadares;1;1;2;276
2933307;Vitória da Conquista;3127701;Governador Valadares;1;1;2;452
3102704;Cachoeira de Pajeú;3127701;Governador Valadares;1;1;2;319
3104700;Ataléia;3127701;Governador Valadares;1;1;2;125
3106002;Bela Vista de Minas;3127701;Governador Valadares;1;1;2;163
3106606;Bertópolis;3127701;Governador Valadares;1;1;2;243
3107307;Bocaiúva;3127701;Governador Valadares;1;1;2;269
3107406;Bom Despacho;3127701;Governador Valadares;1;1;2;361
3112307;Capelinha;3127701;Governador Valadares;1;1;2;137
3118007;Congonhas;3127701;Governador Valadares;1;1;2;275
3118304;Conselheiro Lafaiete;3127701;Governador Valadares;1;1;2;283
3119500;Coronel Murta;3127701;Governador Valadares;1;1;2;243
3120904;Curvelo;3127701;Governador Valadares;1;1;2;263
3122009;Divino;3127701;Governador Valadares;1;1;2;201
3122108;Divino das Laranjeiras;3127701;Governador Valadares;1;1;2;53
3122207;Divinolândia de Minas;3127701;Governador Valadares;1;1;2;66
3122306;Divinópolis;3127701;Governador Valadares;1;1;2;342
3123908;Entre Rios de Minas;3127701;Governador Valadares;1;1;2;302
3124203;Espera Feliz;3127701;Governador Valadares;1;1;2;204
3104007;Araxá;3127602;Gouveia;1;1;2;362
3106200;Belo Horizonte;3127602;Gouveia;1;1;2;164
3117504;Conceição do Mato Dentro;3127602;Gouveia;1;1;2;75
3120904;Curvelo;3127602;Gouveia;1;1;2;85
3122603;Dom Joaquim;3127602;Gouveia;1;1;2;79
3106309;Belo Oriente;3127503;Gonzaga;1;1;2;45
3110509;Camanducaia;3127404;Gonçalves;1;1;2;32
3110608;Cambuí;3127404;Gonçalves;1;1;2;23
3124302;Espinosa;3127339;Gameleiras;1;1;2;38
1506161;Rio Maria;3127305;Galiléia;1;1;2;1559
3123700;Engenheiro Caldas;3127305;Galiléia;1;1;2;59
3126752;Franciscópolis;3127305;Galiléia;1;1;2;125
2914802;Itabuna;3127107;Frutal;1;1;2;1160
3104007;Araxá;3127107;Frutal;1;1;2;220
3105608;Barbacena;3127107;Frutal;1;1;2;557
3111101;Campina Verde;3127107;Frutal;1;1;2;85
3111408;Campo Florido;3127107;Frutal;1;1;2;57
3111804;Canápolis;3127107;Frutal;1;1;2;155
3117306;Conceição das Alagoas;3127107;Frutal;1;1;2;65
3106200;Belo Horizonte;3127057;Fronteira dos Vales;1;1;2;468
3104007;Araxá;3127008;Fronteira;1;1;2;246
3106200;Belo Horizonte;3127008;Fronteira;1;1;2;546
2925006;Planalto;3126901;Frei Inocêncio;1;1;2;455
3106200;Belo Horizonte;3126901;Frei Inocêncio;1;1;2;265
3106200;Belo Horizonte;3126802;Frei Gaspar;1;1;2;337
3104007;Araxá;3126703;Francisco Sá;1;1;2;504
3106200;Belo Horizonte;3126703;Francisco Sá;1;1;2;379
3112307;Capelinha;3126703;Francisco Sá;1;1;2;167
3119104;Corinto;3126703;Francisco Sá;1;1;2;230
3120300;Cristália;3126703;Francisco Sá;1;1;2;76
3107307;Bocaiúva;3126604;Francisco Dumont;1;1;2;48
3123809;Engenheiro Navarro;3126604;Francisco Dumont;1;1;2;30
3103405;Araçuaí;3126505;Francisco Badaró;1;1;2;36
3106200;Belo Horizonte;3126505;Francisco Badaró;1;1;2;366
3106200;Belo Horizonte;3126406;Fortuna de Minas;1;1;2;63
3106200;Belo Horizonte;3126307;Fortaleza de Minas;1;1;2;306
1502772;Curionópolis;3126109;Formiga;1;1;2;1648
2408003;Mossoró;3126109;Formiga;1;1;2;1876
2904605;Brumado;3126109;Formiga;1;1;2;794
3112802;Capitólio;3126109;Formiga;1;1;2;68
3123601;Elói Mendes;3126109;Formiga;1;1;2;128
3101607;Alfenas;3126000;Florestal;1;1;2;232
3104007;Araxá;3126000;Florestal;1;1;2;265
3124104;Esmeraldas;3126000;Florestal;1;1;2;19
3122009;Divino;3125952;Fervedouro;1;1;2;19
3124203;Espera Feliz;3125952;Fervedouro;1;1;2;41
3106309;Belo Oriente;3125903;Ferros;1;1;2;57
3113800;Carmésia;3125903;Ferros;1;1;2;20
3106200;Belo Horizonte;3125804;Fernandes Tourinho;1;1;2;215
3123700;Engenheiro Caldas;3125804;Fernandes Tourinho;1;1;2;10
2906303;Canavieiras;3125705;Felixlândia;1;1;2;703
3100203;Abaeté;3125705;Felixlândia;1;1;2;72
3104007;Araxá;3125705;Felixlândia;1;1;2;235
3118304;Conselheiro Lafaiete;3125705;Felixlândia;1;1;2;239
3118908;Cordisburgo;3125705;Felixlândia;1;1;2;73
3120102;Couto de Magalhães de Minas;3125507;São Gonçalo do Rio Preto;1;1;2;11
3120102;Couto de Magalhães de Minas;3125408;Felício dos Santos;1;1;2;24
3106200;Belo Horizonte;3125309;Faria Lemos;1;1;2;226
3100906;Águas Formosas;3125101;Extrema;1;1;2;834
3102803;Andrelândia;3125101;Extrema;1;1;2;238
3107901;Bom Repouso;3125101;Extrema;1;1;2;46
3108305;Borda da Mata;3125101;Extrema;1;1;2;66
3118601;Contagem;3125101;Extrema;1;1;2;396
3119104;Corinto;3125101;Extrema;1;1;2;531
3123601;Elói Mendes;3125101;Extrema;1;1;2;158
3124302;Espinosa;3125101;Extrema;1;1;2;946
1200401;Rio Branco;3124906;Eugenópolis;1;1;2;2869
3106200;Belo Horizonte;3124906;Eugenópolis;1;1;2;228
3106903;Bicas;3124906;Eugenópolis;1;1;2;115
3124005;Ervália;3124906;Eugenópolis;1;1;2;57
3100104;Abadia dos Dourados;3124807;Estrela do Sul;1;1;2;42
3104007;Araxá;3124807;Estrela do Sul;1;1;2;122
3106200;Belo Horizonte;3124807;Estrela do Sul;1;1;2;413
3123205;Dores do Indaiá;3124708;Estrela do Indaiá;1;1;2;21
3106200;Belo Horizonte;3124609;Estrela Dalva;1;1;2;257
3104007;Araxá;3124500;Estiva;1;1;2;332
3106200;Belo Horizonte;3124500;Estiva;1;1;2;352
3108305;Borda da Mata;3124500;Estiva;1;1;2;26
3110509;Camanducaia;3124500;Estiva;1;1;2;35
3124401;Espírito Santo do Dourado;3124500;Estiva;1;1;2;47
2905008;Caculé;3124302;Espinosa;1;1;2;75
2932606;Urandi;3124302;Espinosa;1;1;2;24
2933307;Vitória da Conquista;3124302;Espinosa;1;1;2;211
3101706;Almenara;3124302;Espinosa;1;1;2;263
3104007;Araxá;3124302;Espinosa;1;1;2;685
3106200;Belo Horizonte;3124302;Espinosa;1;1;2;565
2507507;João Pessoa;3124203;Espera Feliz;1;1;2;1650
3104007;Araxá;3124203;Espera Feliz;1;1;2;537
3106200;Belo Horizonte;3124203;Espera Feliz;1;1;2;231
3123528;Durandé;3124203;Espera Feliz;1;1;2;51
3109600;Cachoeira da Prata;3124104;Esmeraldas;1;1;2;30
3113404;Caratinga;3124104;Esmeraldas;1;1;2;221
3103702;Araponga;3124005;Ervália;1;1;2;24
3104007;Araxá;3124005;Ervália;1;1;2;466
3106200;Belo Horizonte;3124005;Ervália;1;1;2;172
3105608;Barbacena;3123908;Entre Rios de Minas;1;1;2;65
3105905;Barroso;3123908;Entre Rios de Minas;1;1;2;58
3106408;Belo Vale;3123908;Entre Rios de Minas;1;1;2;29
3107307;Bocaiúva;3123908;Entre Rios de Minas;1;1;2;393
3108107;Bonfim;3123908;Entre Rios de Minas;1;1;2;42
3114501;Carmópolis de Minas;3123908;Entre Rios de Minas;1;1;2;61
3118601;Contagem;3123908;Entre Rios de Minas;1;1;2;83
3120409;Cristiano Otoni;3123908;Entre Rios de Minas;1;1;2;32
3121407;Desterro de Entre Rios;3123908;Entre Rios de Minas;1;1;2;28
3106200;Belo Horizonte;3123858;Entre Folhas;1;1;2;184
3113404;Caratinga;3123858;Entre Folhas;1;1;2;22
3122504;Dom Cavati;3123858;Entre Folhas;1;1;2;32
3101805;Alpercata;3123700;Engenheiro Caldas;1;1;2;28
3106200;Belo Horizonte;3123700;Engenheiro Caldas;1;1;2;217
3101607;Alfenas;3123601;Elói Mendes;1;1;2;47
3102803;Andrelândia;3123601;Elói Mendes;1;1;2;128
3104205;Arcos;3123601;Elói Mendes;1;1;2;146
3105608;Barbacena;3123601;Elói Mendes;1;1;2;188
3106200;Belo Horizonte;3123601;Elói Mendes;1;1;2;250
3107109;Boa Esperança;3123601;Elói Mendes;1;1;2;58
3108008;Bom Sucesso;3123601;Elói Mendes;1;1;2;105
3110301;Caldas;3123601;Elói Mendes;1;1;2;92
3110608;Cambuí;3123601;Elói Mendes;1;1;2;123
3110707;Cambuquira;3123601;Elói Mendes;1;1;2;39
3110905;Campanha;3123601;Elói Mendes;1;1;2;30
3111200;Campo Belo;3123601;Elói Mendes;1;1;2;85
3111606;Campos Gerais;3123601;Elói Mendes;1;1;2;46
3112802;Capitólio;3123601;Elói Mendes;1;1;2;121
3115300;Cataguases;3123601;Elói Mendes;1;1;2;300
3115508;Caxambu;3123601;Elói Mendes;1;1;2;71
3116605;Cláudio;3123601;Elói Mendes;1;1;2;153
3118304;Conselheiro Lafaiete;3123601;Elói Mendes;1;1;2;208
3120805;Cruzília;3123601;Elói Mendes;1;1;2;82
3122306;Divinópolis;3123601;Elói Mendes;1;1;2;175
3102050;Alto Caparaó;3123528;Durandé;1;1;2;27
3106200;Belo Horizonte;3123528;Durandé;1;1;2;230
3104007;Araxá;3123205;Dores do Indaiá;1;1;2;142
3105103;Bambuí;3123205;Dores do Indaiá;1;1;2;73
3111606;Campos Gerais;3123205;Dores do Indaiá;1;1;2;197
3118601;Contagem;3123205;Dores do Indaiá;1;1;2;167
3118809;Coração de Jesus;3123205;Dores do Indaiá;1;1;2;333
3106309;Belo Oriente;3123106;Dores de Guanhães;1;1;2;50
3108800;Braúnas;3123106;Dores de Guanhães;1;1;2;22
1100205;Porto Velho;3123007;Dores de Campos;1;1;2;2422
3104007;Araxá;3123007;Dores de Campos;1;1;2;346
3105905;Barroso;3123007;Dores de Campos;1;1;2;10
3112703;Capitão Enéas;3123007;Dores de Campos;1;1;2;534
3104403;Argirita;3122900;Dona Eusébia;1;1;2;33
3104601;Astolfo Dutra;3122900;Dona Eusébia;1;1;2;7
3106200;Belo Horizonte;3122900;Dona Eusébia;1;1;2;198
3115300;Cataguases;3122900;Dona Eusébia;1;1;2;15
3105400;Barão de Cocais;3122702;Dom Silvério;1;1;2;62
3106200;Belo Horizonte;3122603;Dom Joaquim;1;1;2;128
3117504;Conceição do Mato Dentro;3122603;Dom Joaquim;1;1;2;18
3112653;Capitão Andrade;3122504;Dom Cavati;1;1;2;43
3106200;Belo Horizonte;3122454;Divisópolis;1;1;2;564
3106200;Belo Horizonte;3122405;Divisa Nova;1;1;2;290
3108404;Botelhos;3122405;Divisa Nova;1;1;2;25
2925303;Porto Seguro;3122355;Divisa Alegre;1;1;2;249
3103207;Araçaí;3122355;Divisa Alegre;1;1;2;496
3103405;Araçuaí;3122355;Divisa Alegre;1;1;2;148
3106200;Belo Horizonte;3122355;Divisa Alegre;1;1;2;543
3120870;Curral de Dentro;3122355;Divisa Alegre;1;1;2;58
2111300;São Luís;3122306;Divinópolis;1;1;2;1951
2911709;Guanambi;3122306;Divinópolis;1;1;2;685
2917359;Jaborandi;3122306;Divinópolis;1;1;2;727
2925303;Porto Seguro;3122306;Divinópolis;1;1;2;724
3103504;Araguari;3122306;Divinópolis;1;1;2;385
3104908;Baependi;3122306;Divinópolis;1;1;2;198
3105608;Barbacena;3122306;Divinópolis;1;1;2;162
3110905;Campanha;3122306;Divinópolis;1;1;2;193
3112307;Capelinha;3122306;Divinópolis;1;1;2;368
3114006;Carmo da Mata;3122306;Divinópolis;1;1;2;44
3114501;Carmópolis de Minas;3122306;Divinópolis;1;1;2;50
3116159;Chapada Gaúcha;3122306;Divinópolis;1;1;2;543
3118809;Coração de Jesus;3122306;Divinópolis;1;1;2;388
3119955;Córrego Fundo;3122306;Divinópolis;1;1;2;77
3120904;Curvelo;3122306;Divinópolis;1;1;2;161
3121605;Diamantina;3122306;Divinópolis;1;1;2;253
3106309;Belo Oriente;3122207;Divinolândia de Minas;1;1;2;48
3104007;Araxá;3122009;Divino;1;1;2;511
3106200;Belo Horizonte;3122009;Divino;1;1;2;206
3109402;Buritizeiro;3121803;Dionísio;1;1;2;358
3118601;Contagem;3121803;Dionísio;1;1;2;137
2927408;Salvador;3121605;Diamantina;1;1;2;789
3100609;Água Boa;3121605;Diamantina;1;1;2;132
3103405;Araçuaí;3121605;Diamantina;1;1;2;222
3104007;Araxá;3121605;Diamantina;1;1;2;385
3107406;Bom Despacho;3121605;Diamantina;1;1;2;242
3109204;Buenópolis;3121605;Diamantina;1;1;2;71
3112307;Capelinha;3121605;Diamantina;1;1;2;129
3116803;Coluna;3121605;Diamantina;1;1;2;82
3117504;Conceição do Mato Dentro;3121605;Diamantina;1;1;2;93
3121001;Datas;3121605;Diamantina;1;1;2;26
3105608;Barbacena;3121506;Desterro do Melo;1;1;2;30
3106200;Belo Horizonte;3121506;Desterro do Melo;1;1;2;146
3114006;Carmo da Mata;3121407;Desterro de Entre Rios;1;1;2;57
3106200;Belo Horizonte;3121308;Descoberto;1;1;2;202
2704302;Maceió;3121258;Delta;1;1;2;1679
3117306;Conceição das Alagoas;3121258;Delta;1;1;2;59
3118205;Conquista;3121258;Delta;1;1;2;29
3102704;Cachoeira de Pajeú;3120904;Curvelo;1;1;2;439
3104007;Araxá;3120904;Curvelo;1;1;2;277
3104809;Augusto de Lima;3120904;Curvelo;1;1;2;75
3107406;Bom Despacho;3120904;Curvelo;1;1;2;136
3108552;Brasilândia de Minas;3120904;Curvelo;1;1;2;252
3109204;Buenópolis;3120904;Curvelo;1;1;2;103
3110509;Camanducaia;3120904;Curvelo;1;1;2;477
3112505;Capim Branco;3120904;Curvelo;1;1;2;94
3117504;Conceição do Mato Dentro;3120904;Curvelo;1;1;2;116
3117009;Comercinho;3120870;Curral de Dentro;1;1;2;40
3104007;Araxá;3120805;Cruzília;1;1;2;332
3106200;Belo Horizonte;3120805;Cruzília;1;1;2;231
3107406;Bom Despacho;3120805;Cruzília;1;1;2;238
3117702;Conceição do Rio Verde;3120805;Cruzília;1;1;2;29
3104007;Araxá;3120607;Crucilândia;1;1;2;286
3118601;Contagem;3120607;Crucilândia;1;1;2;58
3104007;Araxá;3120508;Cristina;1;1;2;338
3115508;Caxambu;3120508;Cristina;1;1;2;41
3105608;Barbacena;3120409;Cristiano Otoni;1;1;2;41
3118304;Conselheiro Lafaiete;3120409;Cristiano Otoni;1;1;2;19
3106200;Belo Horizonte;3120300;Cristália;1;1;2;364
3107307;Bocaiúva;3120300;Cristália;1;1;2;109
3100807;Aguanil;3120201;Cristais;1;1;2;15
3104007;Araxá;3120201;Cristais;1;1;2;206
3106200;Belo Horizonte;3120201;Cristais;1;1;2;193
3107109;Boa Esperança;3120201;Cristais;1;1;2;24
3108552;Brasilândia de Minas;3120201;Cristais;1;1;2;431
3114303;Carmo do Paranaíba;3120201;Cristais;1;1;2;224
3100906;Águas Formosas;3120151;Crisólita;1;1;2;17
3106200;Belo Horizonte;3120151;Crisólita;1;1;2;442
3106200;Belo Horizonte;3120102;Couto de Magalhães de Minas;1;1;2;210
3108503;Botumirim;3120102;Couto de Magalhães de Minas;1;1;2;141
3106200;Belo Horizonte;3120003;Córrego Novo;1;1;2;166
3106309;Belo Oriente;3120003;Córrego Novo;1;1;2;68
3118601;Contagem;3119955;Córrego Fundo;1;1;2;164
3105103;Bambuí;3119807;Córrego Danta;1;1;2;23
3106200;Belo Horizonte;3119807;Córrego Danta;1;1;2;202
3107406;Bom Despacho;3119807;Córrego Danta;1;1;2;68
3106200;Belo Horizonte;3119708;Coronel Xavier Chaves;1;1;2;127
3106200;Belo Horizonte;3119500;Coronel Murta;1;1;2;411
3111200;Campo Belo;3119500;Coronel Murta;1;1;2;579
2304400;Fortaleza;3119401;Coronel Fabriciano;1;1;2;1791
3100500;Açucena;3119401;Coronel Fabriciano;1;1;2;50
3106309;Belo Oriente;3119401;Coronel Fabriciano;1;1;2;36
3114501;Carmópolis de Minas;3119401;Coronel Fabriciano;1;1;2;240
3106200;Belo Horizonte;3119203;Coroaci;1;1;2;228
3106309;Belo Oriente;3119203;Coroaci;1;1;2;69
3104007;Araxá;3119104;Corinto;1;1;2;297
3104809;Augusto de Lima;3119104;Corinto;1;1;2;35
3109204;Buenópolis;3119104;Corinto;1;1;2;62
3109907;Caetanópolis;3119104;Corinto;1;1;2;102
3106200;Belo Horizonte;3119005;Cordislândia;1;1;2;274
3104007;Araxá;3118809;Coração de Jesus;1;1;2;424
3106200;Belo Horizonte;3118809;Coração de Jesus;1;1;2;358
3108602;Brasília de Minas;3118809;Coração de Jesus;1;1;2;54
3109402;Buritizeiro;3118809;Coração de Jesus;1;1;2;99
3104007;Araxá;3118700;Coqueiral;1;1;2;236
1500800;Ananindeua;3118601;Contagem;1;1;2;2097
1501402;Belém;3118601;Contagem;1;1;2;2097
1502152;Canaã dos Carajás;3118601;Contagem;1;1;2;1597
1502400;Castanhal;3118601;Contagem;1;1;2;2095
1504208;Marabá;3118601;Contagem;1;1;2;1688
1600303;Macapá;3118601;Contagem;1;1;2;2322
1716109;Paraíso do Tocantins;3118601;Contagem;1;1;2;1186
2100055;Açailândia;3118601;Contagem;1;1;2;1690
2103000;Caxias;3118601;Contagem;1;1;2;1668
2105302;Imperatriz;3118601;Contagem;1;1;2;1630
2303204;Caririaçu;3118601;Contagem;1;1;2;1506
2510808;Patos;3118601;Contagem;1;1;2;1586
2600054;Abreu e Lima;3118601;Contagem;1;1;2;1625
2609600;Olinda;3118601;Contagem;1;1;2;1616
2612208;Salgueiro;3118601;Contagem;1;1;2;1398
2704708;Marechal Deodoro;3118601;Contagem;1;1;2;1405
2902401;Aurelino Leal;3118601;Contagem;1;1;2;790
2910057;Dias d'Ávila;3118601;Contagem;1;1;2;1003
2914802;Itabuna;3118601;Contagem;1;1;2;754
2917508;Jacobina;3118601;Contagem;1;1;2;1028
2922003;Mucuri;3118601;Contagem;1;1;2;516
2928000;Santaluz;3118601;Contagem;1;1;2;1073
2928703;Santo Antônio de Jesus;3118601;Contagem;1;1;2;913
2930204;Sento Sé;3118601;Contagem;1;1;2;1135
3101607;Alfenas;3118601;Contagem;1;1;2;257
3103504;Araguari;3118601;Contagem;1;1;2;453
3106309;Belo Oriente;3118601;Contagem;1;1;2;184
3109402;Buritizeiro;3118601;Contagem;1;1;2;298
3109907;Caetanópolis;3118601;Contagem;1;1;2;77
3110004;Caeté;3118601;Contagem;1;1;2;44
3111200;Campo Belo;3118601;Contagem;1;1;2;164
3111507;Campos Altos;3118601;Contagem;1;1;2;220
3113008;Caraí;3118601;Contagem;1;1;2;391
3113206;Carandaí;3118601;Contagem;1;1;2;118
3114204;Carmo do Cajuru;3118601;Contagem;1;1;2;78
3114501;Carmópolis de Minas;3118601;Contagem;1;1;2;90
3115300;Cataguases;3118601;Contagem;1;1;2;218
3115359;Catas Altas;3118601;Contagem;1;1;2;73
3117504;Conceição do Mato Dentro;3118601;Contagem;1;1;2;121
3117876;Confins;3118601;Contagem;1;1;2;33
2923001;Nova Viçosa;3118403;Conselheiro Pena;1;1;2;254
3102209;Alvarenga;3118403;Conselheiro Pena;1;1;2;36
3104007;Araxá;3118403;Conselheiro Pena;1;1;2;576
3115706;Central de Minas;3118403;Conselheiro Pena;1;1;2;50
3118304;Conselheiro Lafaiete;3118403;Conselheiro Pena;1;1;2;296
2101251;Bacabeira;3118304;Conselheiro Lafaiete;1;1;2;1957
2900108;Abaíra;3118304;Conselheiro Lafaiete;1;1;2;849
2930709;Simões Filho;3118304;Conselheiro Lafaiete;1;1;2;1032
3101631;Alfredo Vasconcelos;3118304;Conselheiro Lafaiete;1;1;2;54
3106408;Belo Vale;3118304;Conselheiro Lafaiete;1;1;2;35
3112208;Capela Nova;3118304;Conselheiro Lafaiete;1;1;2;36
3115300;Cataguases;3118304;Conselheiro Lafaiete;1;1;2;143
3106200;Belo Horizonte;3118205;Conquista;1;1;2;373
3117306;Conceição das Alagoas;3118205;Conquista;1;1;2;89
3117504;Conceição do Mato Dentro;3118106;Congonhas do Norte;1;1;2;37
3104007;Araxá;3118007;Congonhas;1;1;2;334
3104205;Arcos;3118007;Congonhas;1;1;2;174
3105905;Barroso;3118007;Congonhas;1;1;2;77
3109006;Brumadinho;3118007;Congonhas;1;1;2;51
3113206;Carandaí;3118007;Congonhas;1;1;2;52
3106200;Belo Horizonte;3117900;Congonhal;1;1;2;327
2611606;Recife;3117876;Confins;1;1;2;1574
2927408;Salvador;3117876;Confins;1;1;2;929
3106200;Belo Horizonte;3117801;Conceição dos Ouros;1;1;2;334
3108909;Brasópolis;3117801;Conceição dos Ouros;1;1;2;21
3101201;Aiuruoca;3117702;Conceição do Rio Verde;1;1;2;50
3101607;Alfenas;3117702;Conceição do Rio Verde;1;1;2;104
3102605;Andradas;3117702;Conceição do Rio Verde;1;1;2;155
3104007;Araxá;3117702;Conceição do Rio Verde;1;1;2;318
3104908;Baependi;3117702;Conceição do Rio Verde;1;1;2;22
3106200;Belo Horizonte;3117702;Conceição do Rio Verde;1;1;2;247
3115508;Caxambu;3117702;Conceição do Rio Verde;1;1;2;13
2307650;Maracanaú;3117603;Conceição do Pará;1;1;2;1869
2611606;Recife;3117603;Conceição do Pará;1;1;2;1640
2919207;Lauro de Freitas;3117603;Conceição do Pará;1;1;2;1018
2704302;Maceió;3117306;Conceição das Alagoas;1;1;2;1720
3104007;Araxá;3117306;Conceição das Alagoas;1;1;2;155
3101904;Alpinópolis;3117108;Conceição da Aparecida;1;1;2;32
3104007;Araxá;3117108;Conceição da Aparecida;1;1;2;184
3106200;Belo Horizonte;3117108;Conceição da Aparecida;1;1;2;265
3102704;Cachoeira de Pajeú;3117009;Comercinho;1;1;2;48
3106200;Belo Horizonte;3117009;Comercinho;1;1;2;463
3106200;Belo Horizonte;3116902;Comendador Gomes;1;1;2;536
3106309;Belo Oriente;3116803;Coluna;1;1;2;115
3113503;Carbonita;3116803;Coluna;1;1;2;80
3106200;Belo Horizonte;3116704;Coimbra;1;1;2;162
1504208;Marabá;3116605;Cláudio;1;1;2;1724
3106705;Betim;3116605;Cláudio;1;1;2;80
3107406;Bom Despacho;3116605;Cláudio;1;1;2;94
3106200;Belo Horizonte;3116506;Claro dos Poções;1;1;2;315
3107307;Bocaiúva;3116506;Claro dos Poções;1;1;2;46
3109402;Buritizeiro;3116506;Claro dos Poções;1;1;2;83
2927408;Salvador;3116100;Chapada do Norte;1;1;2;623
3106200;Belo Horizonte;3116100;Chapada do Norte;1;1;2;348
2104057;Estreito;3115904;Chácara;1;1;2;1722
3104007;Araxá;3115805;Centralina;1;1;2;266
3111804;Canápolis;3115805;Centralina;1;1;2;16
3100203;Abaeté;3115607;Cedro do Abaeté;1;1;2;27
3106200;Belo Horizonte;3115607;Cedro do Abaeté;1;1;2;201
3101300;Alagoa;3115508;Caxambu;1;1;2;43
3101607;Alfenas;3115508;Caxambu;1;1;2;117
3107109;Boa Esperança;3115508;Caxambu;1;1;2;112
3110905;Campanha;3115508;Caxambu;1;1;2;45
3114105;Carmo de Minas;3115508;Caxambu;1;1;2;25
3106200;Belo Horizonte;3115474;Catuti;1;1;2;514
2910800;Feira de Santana;3115458;Catuji;1;1;2;617
3106200;Belo Horizonte;3115458;Catuji;1;1;2;389
3105400;Barão de Cocais;3115359;Catas Altas;1;1;2;19
3106309;Belo Oriente;3115359;Catas Altas;1;1;2;135
1100122;Ji-Paraná;3115300;Cataguases;1;1;2;2258
1100205;Porto Velho;3115300;Cataguases;1;1;2;2546
1100304;Vilhena;3115300;Cataguases;1;1;2;2009
1200401;Rio Branco;3115300;Cataguases;1;1;2;2830
2602902;Cabo de Santo Agostinho;3115300;Cataguases;1;1;2;1639
2611606;Recife;3115300;Cataguases;1;1;2;1659
3106804;Bias Fortes;3115300;Cataguases;1;1;2;115
3109600;Cachoeira da Prata;3115300;Cataguases;1;1;2;274
3113404;Caratinga;3115300;Cataguases;1;1;2;180
3106200;Belo Horizonte;3115201;Conceição da Barra de Minas;1;1;2;145
3108008;Bom Sucesso;3115201;Conceição da Barra de Minas;1;1;2;31
3101904;Alpinópolis;3115102;Cássia;1;1;2;65
3104007;Araxá;3115102;Cássia;1;1;2;109
3106200;Belo Horizonte;3115102;Cássia;1;1;2;316
3106200;Belo Horizonte;3115003;Cascalho Rico;1;1;2;438
3101201;Aiuruoca;3114808;Carvalhos;1;1;2;16
3106200;Belo Horizonte;3114808;Carvalhos;1;1;2;238
3107208;Bocaina de Minas;3114808;Carvalhos;1;1;2;20
3106200;Belo Horizonte;3114709;Carvalhópolis;1;1;2;283
3111002;Campestre;3114709;Carvalhópolis;1;1;2;43
3102803;Andrelândia;3114600;Carrancas;1;1;2;41
2702306;Coruripe;3114550;Carneirinho;1;1;2;1825
3104007;Araxá;3114550;Carneirinho;1;1;2;392
3106200;Belo Horizonte;3114550;Carneirinho;1;1;2;704
3101607;Alfenas;3114501;Carmópolis de Minas;1;1;2;168
3104007;Araxá;3114501;Carmópolis de Minas;1;1;2;263
3114204;Carmo do Cajuru;3114501;Carmópolis de Minas;1;1;2;42
3104007;Araxá;3114402;Carmo do Rio Claro;1;1;2;176
3104304;Areado;3114402;Carmo do Rio Claro;1;1;2;43
3106200;Belo Horizonte;3114402;Carmo do Rio Claro;1;1;2;252
3107109;Boa Esperança;3114402;Carmo do Rio Claro;1;1;2;59
3107604;Bom Jesus da Penha;3114402;Carmo do Rio Claro;1;1;2;42
3110301;Caldas;3114402;Carmo do Rio Claro;1;1;2;109
3103801;Arapuá;3114303;Carmo do Paranaíba;1;1;2;22
3106200;Belo Horizonte;3114303;Carmo do Paranaíba;1;1;2;270
2919207;Lauro de Freitas;3114204;Carmo do Cajuru;1;1;2;1044
2927408;Salvador;3114204;Carmo do Cajuru;1;1;2;1025
3104007;Araxá;3114204;Carmo do Cajuru;1;1;2;237
3104007;Araxá;3114105;Carmo de Minas;1;1;2;337
3104908;Baependi;3114105;Carmo de Minas;1;1;2;32
3104007;Araxá;3114006;Carmo da Mata;1;1;2;241
3111200;Campo Belo;3114006;Carmo da Mata;1;1;2;56
3104007;Araxá;3113909;Carmo da Cachoeira;1;1;2;273
3111606;Campos Gerais;3113909;Carmo da Cachoeira;1;1;2;61
3104007;Araxá;3113701;Carlos Chagas;1;1;2;690
3104700;Ataléia;3113701;Carlos Chagas;1;1;2;50
2408102;Natal;3113602;Careaçu;1;1;2;2074
2611606;Recife;3113602;Careaçu;1;1;2;1877
3104007;Araxá;3113602;Careaçu;1;1;2;300
3106200;Belo Horizonte;3113602;Careaçu;1;1;2;296
3107307;Bocaiúva;3113503;Carbonita;1;1;2;97
3109402;Buritizeiro;3113503;Carbonita;1;1;2;209
3112307;Capelinha;3113503;Carbonita;1;1;2;55
2607901;Jaboatão dos Guararapes;3113404;Caratinga;1;1;2;1486
2611101;Petrolina;3113404;Caratinga;1;1;2;1175
2704302;Maceió;3113404;Caratinga;1;1;2;1304
2800308;Aracaju;3113404;Caratinga;1;1;2;1117
2910727;Eunápolis;3113404;Caratinga;1;1;2;467
2910800;Feira de Santana;3113404;Caratinga;1;1;2;896
2914802;Itabuna;3113404;Caratinga;1;1;2;632
2933307;Vitória da Conquista;3113404;Caratinga;1;1;2;565
3101706;Almenara;3113404;Caratinga;1;1;2;433
3103405;Araçuaí;3113404;Caratinga;1;1;2;324
3104007;Araxá;3113404;Caratinga;1;1;2;497
3112307;Capelinha;3113404;Caratinga;1;1;2;238
3112901;Caputira;3113404;Caratinga;1;1;2;41
3100302;Abre Campo;3113305;Carangola;1;1;2;67
3102050;Alto Caparaó;3113305;Carangola;1;1;2;37
3104007;Araxá;3113305;Carangola;1;1;2;526
3102100;Alto Rio Doce;3113206;Carandaí;1;1;2;49
3105905;Barroso;3113206;Carandaí;1;1;2;27
3112208;Capela Nova;3113107;Caranaíba;1;1;2;14
3103405;Araçuaí;3113008;Caraí;1;1;2;49
3106200;Belo Horizonte;3113008;Caraí;1;1;2;387
3106200;Belo Horizonte;3112901;Caputira;1;1;2;181
3104007;Araxá;3112802;Capitólio;1;1;2;147
3111200;Campo Belo;3112802;Capitólio;1;1;2;87
3104007;Araxá;3112703;Capitão Enéas;1;1;2;502
3106200;Belo Horizonte;3112703;Capitão Enéas;1;1;2;400
3104007;Araxá;3112406;Capetinga;1;1;2;114
3106200;Belo Horizonte;3112406;Capetinga;1;1;2;329
2304400;Fortaleza;3112307;Capelinha;1;1;2;1593
2933307;Vitória da Conquista;3112307;Capelinha;1;1;2;359
3102605;Andradas;3112307;Capelinha;1;1;2;652
3104007;Araxá;3112307;Capelinha;1;1;2;517
3106507;Berilo;3112307;Capelinha;1;1;2;81
3109006;Brumadinho;3112307;Capelinha;1;1;2;326
3105608;Barbacena;3112208;Capela Nova;1;1;2;36
3106309;Belo Oriente;3112059;Cantagalo;1;1;2;79
3104007;Araxá;3112000;Candeias;1;1;2;217
3110301;Caldas;3112000;Candeias;1;1;2;173
3110400;Camacho;3112000;Candeias;1;1;2;20
3106200;Belo Horizonte;3111903;Cana Verde;1;1;2;176
2700409;Atalaia;3111804;Canápolis;1;1;2;1701
2709301;União dos Palmares;3111804;Canápolis;1;1;2;1715
3104007;Araxá;3111804;Canápolis;1;1;2;257
3106200;Belo Horizonte;3111804;Canápolis;1;1;2;568
3111101;Campina Verde;3111804;Canápolis;1;1;2;93
3106200;Belo Horizonte;3111705;Canaã;1;1;2;166
3104007;Araxá;3111606;Campos Gerais;1;1;2;220
3104304;Areado;3111606;Campos Gerais;1;1;2;42
3110608;Cambuí;3111606;Campos Gerais;1;1;2;156
3110905;Campanha;3111606;Campos Gerais;1;1;2;76
3105608;Barbacena;3111507;Campos Altos;1;1;2;300
2702306;Coruripe;3111408;Campo Florido;1;1;2;1657
2704302;Maceió;3111408;Campo Florido;1;1;2;1724
3104007;Araxá;3111408;Campo Florido;1;1;2;171
3106200;Belo Horizonte;3111408;Campo Florido;1;1;2;482
3104007;Araxá;3111309;Campo do Meio;1;1;2;204
3104304;Areado;3111309;Campo do Meio;1;1;2;43
3105103;Bambuí;3111200;Campo Belo;1;1;2;123
3106705;Betim;3111200;Campo Belo;1;1;2;152
3110301;Caldas;3111200;Campo Belo;1;1;2;163
3109402;Buritizeiro;3111150;Campo Azul;1;1;2;96
2933000;Valente;3111101;Campina Verde;1;1;2;1367
3103504;Araguari;3111101;Campina Verde;1;1;2;166
3102605;Andradas;3111002;Campestre;1;1;2;52
3105301;Bandeira do Sul;3111002;Campestre;1;1;2;15
3105608;Barbacena;3111002;Campestre;1;1;2;259
3106200;Belo Horizonte;3111002;Campestre;1;1;2;307
3107109;Boa Esperança;3111002;Campestre;1;1;2;98
3109501;Cabo Verde;3111002;Campestre;1;1;2;31
3110301;Caldas;3111002;Campestre;1;1;2;28
3110707;Cambuquira;3110905;Campanha;1;1;2;11
3101607;Alfenas;3110707;Cambuquira;1;1;2;84
3104007;Araxá;3110707;Cambuquira;1;1;2;303
3106200;Belo Horizonte;3110707;Cambuquira;1;1;2;255
3107901;Bom Repouso;3110608;Cambuí;1;1;2;17
3109105;Bueno Brandão;3110608;Cambuí;1;1;2;34
3102001;Alterosa;3110509;Camanducaia;1;1;2;167
3104007;Araxá;3110509;Camanducaia;1;1;2;360
3107901;Bom Repouso;3110509;Camanducaia;1;1;2;31
3106200;Belo Horizonte;3110400;Camacho;1;1;2;146
3104007;Araxá;3110301;Caldas;1;1;2;265
3105608;Barbacena;3110301;Caldas;1;1;2;279
3109501;Cabo Verde;3110301;Caldas;1;1;2;50
3109709;Cachoeira de Minas;3110301;Caldas;1;1;2;79
3106200;Belo Horizonte;3110202;Cajuri;1;1;2;157
3106200;Belo Horizonte;3110103;Caiana;1;1;2;231
2403103;Currais Novos;3110004;Caeté;1;1;2;1673
2507507;João Pessoa;3110004;Caeté;1;1;2;1665
3100500;Açucena;3110004;Caeté;1;1;2;148
3106309;Belo Oriente;3110004;Caeté;1;1;2;144
3105608;Barbacena;3109907;Caetanópolis;1;1;2;221
3109402;Buritizeiro;3109907;Caetanópolis;1;1;2;222
3104007;Araxá;3109709;Cachoeira de Minas;1;1;2;329
3106200;Belo Horizonte;3109709;Cachoeira de Minas;1;1;2;328
3104007;Araxá;3109501;Cabo Verde;1;1;2;216
3104304;Areado;3109501;Cabo Verde;1;1;2;29
3106200;Belo Horizonte;3109501;Cabo Verde;1;1;2;304
3108404;Botelhos;3109501;Cabo Verde;1;1;2;18
2100055;Açailândia;3109402;Buritizeiro;1;1;2;1396
2900702;Alagoinhas;3109402;Buritizeiro;1;1;2;899
2900801;Alcobaça;3109402;Buritizeiro;1;1;2;611
2910404;Encruzilhada;3109402;Buritizeiro;1;1;2;476
2910503;Entre Rios;3109402;Buritizeiro;1;1;2;940
2910602;Esplanada;3109402;Buritizeiro;1;1;2;956
2910727;Eunápolis;3109402;Buritizeiro;1;1;2;581
2913705;Inhambupe;3109402;Buritizeiro;1;1;2;929
2922003;Mucuri;3109402;Buritizeiro;1;1;2;580
2923001;Nova Viçosa;3109402;Buritizeiro;1;1;2;585
2925501;Prado;3109402;Buritizeiro;1;1;2;606
3100203;Abaeté;3109402;Buritizeiro;1;1;2;204
3104007;Araxá;3109402;Buritizeiro;1;1;2;324
3108503;Botumirim;3109402;Buritizeiro;1;1;2;216
3108602;Brasília de Minas;3109402;Buritizeiro;1;1;2;141
3109204;Buenópolis;3109402;Buritizeiro;1;1;2;102
1708205;Formoso do Araguaia;3109303;Buritis;1;1;2;539
3104007;Araxá;3109303;Buritis;1;1;2;441
3104502;Arinos;3109303;Buritis;1;1;2;46
3106309;Belo Oriente;3109253;Bugre;1;1;2;31
3104809;Augusto de Lima;3109204;Buenópolis;1;1;2;28
3106200;Belo Horizonte;3109204;Buenópolis;1;1;2;225
3104007;Araxá;3109105;Bueno Brandão;1;1;2;322
1716604;Peixe;3109006;Brumadinho;1;1;2;1001
2109007;Porto Franco;3109006;Brumadinho;1;1;2;1559
2907103;Carinhanha;3109006;Brumadinho;1;1;2;654
3101508;Além Paraíba;3109006;Brumadinho;1;1;2;242
3106705;Betim;3109006;Brumadinho;1;1;2;21
3108107;Bonfim;3109006;Brumadinho;1;1;2;21
3106200;Belo Horizonte;3108909;Brasópolis;1;1;2;330
3106200;Belo Horizonte;3108800;Braúnas;1;1;2;163
3106309;Belo Oriente;3108800;Braúnas;1;1;2;30
2304400;Fortaleza;3108602;Brasília de Minas;1;1;2;1506
2909802;Cruz das Almas;3108602;Brasília de Minas;1;1;2;687
3104007;Araxá;3108602;Brasília de Minas;1;1;2;464
3104502;Arinos;3108602;Brasília de Minas;1;1;2;184
3107307;Bocaiúva;3108602;Brasília de Minas;1;1;2;120
3100203;Abaeté;3108552;Brasilândia de Minas;1;1;2;243
3104007;Araxá;3108552;Brasilândia de Minas;1;1;2;303
3106200;Belo Horizonte;3108552;Brasilândia de Minas;1;1;2;387
3106200;Belo Horizonte;3108503;Botumirim;1;1;2;351
3107307;Bocaiúva;3108503;Botumirim;1;1;2;92
3104007;Araxá;3108404;Botelhos;1;1;2;233
3105301;Bandeira do Sul;3108404;Botelhos;1;1;2;11
3105608;Barbacena;3108404;Botelhos;1;1;2;273
3106200;Belo Horizonte;3108404;Botelhos;1;1;2;314
3104007;Araxá;3108305;Borda da Mata;1;1;2;308
3105608;Barbacena;3108305;Borda da Mata;1;1;2;271
3106200;Belo Horizonte;3108305;Borda da Mata;1;1;2;345
3107901;Bom Repouso;3108305;Borda da Mata;1;1;2;22
3102001;Alterosa;3108008;Bom Sucesso;1;1;2;146
3104007;Araxá;3108008;Bom Sucesso;1;1;2;278
3105608;Barbacena;3108008;Bom Sucesso;1;1;2;101
3106200;Belo Horizonte;3108008;Bom Sucesso;1;1;2;149
3104007;Araxá;3107901;Bom Repouso;1;1;2;330
3102308;Alvinópolis;3107802;Bom Jesus do Galho;1;1;2;83
3106200;Belo Horizonte;3107802;Bom Jesus do Galho;1;1;2;174
3106309;Belo Oriente;3107802;Bom Jesus do Galho;1;1;2;70
3106200;Belo Horizonte;3107703;Bom Jesus do Amparo;1;1;2;57
3106309;Belo Oriente;3107703;Bom Jesus do Amparo;1;1;2;117
3106200;Belo Horizonte;3107604;Bom Jesus da Penha;1;1;2;291
3103009;Antônio Dias;3107505;Bom Jardim de Minas;1;1;2;288
3104007;Araxá;3107406;Bom Despacho;1;1;2;177
3107109;Boa Esperança;3107406;Bom Despacho;1;1;2;154
2909307;Correntina;3107307;Bocaiúva;1;1;2;427
2910727;Eunápolis;3107307;Bocaiúva;1;1;2;457
2922003;Mucuri;3107307;Bocaiúva;1;1;2;464
3104007;Araxá;3107307;Bocaiúva;1;1;2;431
3106200;Belo Horizonte;3107307;Bocaiúva;1;1;2;307
3104908;Baependi;3107208;Bocaina de Minas;1;1;2;56
3104007;Araxá;3107109;Boa Esperança;1;1;2;219
3104304;Areado;3107109;Boa Esperança;1;1;2;67
3106200;Belo Horizonte;3107109;Boa Esperança;1;1;2;211
3106200;Belo Horizonte;3107000;Biquinhas;1;1;2;203
3106200;Belo Horizonte;3106903;Bicas;1;1;2;220
3106705;Betim;3106903;Bicas;1;1;2;224
1500800;Ananindeua;3106705;Betim;1;1;2;2099
1501402;Belém;3106705;Betim;1;1;2;2099
1504422;Marituba;3106705;Betim;1;1;2;2100
1505536;Parauapebas;3106705;Betim;1;1;2;1647
1709500;Gurupi;3106705;Betim;1;1;2;1040
1721000;Palmas;3106705;Betim;1;1;2;1145
2211001;Teresina;3106705;Betim;1;1;2;1651
2403251;Parnamirim;3106705;Betim;1;1;2;1798
2602902;Cabo de Santo Agostinho;3106705;Betim;1;1;2;1593
2607208;Ipojuca;3106705;Betim;1;1;2;1581
2611606;Recife;3106705;Betim;1;1;2;1613
2704302;Maceió;3106705;Betim;1;1;2;1430
2801504;Carmópolis;3106705;Betim;1;1;2;1266
2910404;Encruzilhada;3106705;Betim;1;1;2;596
2913606;Ilhéus;3106705;Betim;1;1;2;775
2918001;Jequié;3106705;Betim;1;1;2;801
2930709;Simões Filho;3106705;Betim;1;1;2;992
2933307;Vitória da Conquista;3106705;Betim;1;1;2;661
3100203;Abaeté;3106705;Betim;1;1;2;160
3104502;Arinos;3106705;Betim;1;1;2;489
3105400;Barão de Cocais;3106705;Betim;1;1;2;71
3106002;Bela Vista de Minas;3106705;Betim;1;1;2;116
3106200;Belo Horizonte;3106655;Berizal;1;1;2;533
2931350;Teixeira de Freitas;3106606;Bertópolis;1;1;2;105
3106200;Belo Horizonte;3106606;Bertópolis;1;1;2;482
2927408;Salvador;3106507;Berilo;1;1;2;608
3102852;Angelândia;3106507;Berilo;1;1;2;79
3103405;Araçuaí;3106507;Berilo;1;1;2;47
3104007;Araxá;3106507;Berilo;1;1;2;562
3106200;Belo Horizonte;3106507;Berilo;1;1;2;365
1302603;Manaus;3106309;Belo Oriente;1;1;2;2524
3102308;Alvinópolis;3106309;Belo Oriente;1;1;2;115
3105400;Barão de Cocais;3106309;Belo Oriente;1;1;2;134
3106002;Bela Vista de Minas;3106309;Belo Oriente;1;1;2;93
1100023;Ariquemes;3106200;Belo Horizonte;1;1;2;2237
1100049;Cacoal;3106200;Belo Horizonte;1;1;2;2023
1100114;Jaru;3106200;Belo Horizonte;1;1;2;2171
1100122;Ji-Paraná;3106200;Belo Horizonte;1;1;2;2087
1100155;Ouro Preto do Oeste;3106200;Belo Horizonte;1;1;2;2132
1100262;Rio Crespo;3106200;Belo Horizonte;1;1;2;2238
1100809;Candeias do Jamari;3106200;Belo Horizonte;1;1;2;2355
1200344;Manoel Urbano;3106200;Belo Horizonte;1;1;2;2857
1301704;Humaitá;3106200;Belo Horizonte;1;1;2;2376
1302009;Itapiranga;3106200;Belo Horizonte;1;1;2;2372
1303536;Presidente Figueiredo;3106200;Belo Horizonte;1;1;2;2558
1500206;Acará;3106200;Belo Horizonte;1;1;2;2035
1500305;Afuá;3106200;Belo Horizonte;1;1;2;2275
1500800;Ananindeua;3106200;Belo Horizonte;1;1;2;2097
1500859;Anapu;3106200;Belo Horizonte;1;1;2;1958
1502400;Castanhal;3106200;Belo Horizonte;1;1;2;2096
1502707;Conceição do Araguaia;3106200;Belo Horizonte;1;1;2;1398
1502772;Curionópolis;3106200;Belo Horizonte;1;1;2;1634
1504422;Marituba;3106200;Belo Horizonte;1;1;2;2098
1506138;Redenção;3106200;Belo Horizonte;1;1;2;1451
1506161;Rio Maria;3106200;Belo Horizonte;1;1;2;1523
1506807;Santarém;3106200;Belo Horizonte;1;1;2;2213
1507300;São Félix do Xingu;3106200;Belo Horizonte;1;1;2;1671
1507458;São Geraldo do Araguaia;3106200;Belo Horizonte;1;1;2;1569
1600055;Serra do Navio;3106200;Belo Horizonte;1;1;2;2439
1600600;Santana;3106200;Belo Horizonte;1;1;2;2317
1702109;Araguaína;3106200;Belo Horizonte;1;1;2;1470
1703008;Babaçulândia;3106200;Belo Horizonte;1;1;2;1457
1716208;Paranã;3106200;Belo Horizonte;1;1;2;895
1716604;Peixe;3106200;Belo Horizonte;1;1;2;988
1718840;Sandolândia;3106200;Belo Horizonte;1;1;2;1018
1720903;Taguatinga;3106200;Belo Horizonte;1;1;2;867
1722107;Xambioá;3106200;Belo Horizonte;1;1;2;1561
2101202;Bacabal;3106200;Belo Horizonte;1;1;2;1737
2104305;Godofredo Viana;3106200;Belo Horizonte;1;1;2;2054
2109106;Presidente Dutra;3106200;Belo Horizonte;1;1;2;1615
2109601;Rosário;3106200;Belo Horizonte;1;1;2;1879
2207702;Parnaíba;3106200;Belo Horizonte;1;1;2;1896
2303709;Caucaia;3106200;Belo Horizonte;1;1;2;1868
2304285;Eusébio;3106200;Belo Horizonte;1;1;2;1857
2307304;Juazeiro do Norte;3106200;Belo Horizonte;1;1;2;1480
2308708;Morada Nova;3106200;Belo Horizonte;1;1;2;1730
2311801;Russas;3106200;Belo Horizonte;1;1;2;1764
2312908;Sobral;3106200;Belo Horizonte;1;1;2;1832
2407203;Macau;3106200;Belo Horizonte;1;1;2;1797
2501302;Aroeiras;3106200;Belo Horizonte;1;1;2;1605
2501807;Bayeux;3106200;Belo Horizonte;1;1;2;1686
2503209;Cabedelo;3106200;Belo Horizonte;1;1;2;1697
2510808;Patos;3106200;Belo Horizonte;1;1;2;1579
2611101;Petrolina;3106200;Belo Horizonte;1;1;2;1224
2613909;Serra Talhada;3106200;Belo Horizonte;1;1;2;1443
2700300;Arapiraca;3106200;Belo Horizonte;1;1;2;1346
2707701;Rio Largo;3106200;Belo Horizonte;1;1;2;1420
2802908;Itabaiana;3106200;Belo Horizonte;1;1;2;1225
2803302;Japaratuba;3106200;Belo Horizonte;1;1;2;1256
2803500;Lagarto;3106200;Belo Horizonte;1;1;2;1187
2806107;Rosário do Catete;3106200;Belo Horizonte;1;1;2;1242
2900702;Alagoinhas;3106200;Belo Horizonte;1;1;2;1031
2903102;Barra do Rocha;3106200;Belo Horizonte;1;1;2;777
2903904;Bom Jesus da Lapa;3106200;Belo Horizonte;1;1;2;736
2905909;Campo Alegre de Lourdes;3106200;Belo Horizonte;1;1;2;1153
2906006;Campo Formoso;3106200;Belo Horizonte;1;1;2;1105
2907202;Casa Nova;3106200;Belo Horizonte;1;1;2;1234
2908903;Coração de Maria;3106200;Belo Horizonte;1;1;2;1004
2910602;Esplanada;3106200;Belo Horizonte;1;1;2;1086
2913002;Ibitiara;3106200;Belo Horizonte;1;1;2;822
2913903;Ipiaú;3106200;Belo Horizonte;1;1;2;780
2914604;Irecê;3106200;Belo Horizonte;1;1;2;971
2914901;Itacaré;3106200;Belo Horizonte;1;1;2;806
2915205;Itagibá;3106200;Belo Horizonte;1;1;2;754
2916401;Itapetinga;3106200;Belo Horizonte;1;1;2;640
2917508;Jacobina;3106200;Belo Horizonte;1;1;2;1022
2918407;Juazeiro;3106200;Belo Horizonte;1;1;2;1206
2919553;Luís Eduardo magalhães;3106200;Belo Horizonte;1;1;2;883
2922656;Nordestina;3106200;Belo Horizonte;1;1;2;1107
2923001;Nova Viçosa;3106200;Belo Horizonte;1;1;2;518
2924009;Paulo Afonso;3106200;Belo Horizonte;1;1;2;1296
2925204;Pojuca;3106200;Belo Horizonte;1;1;2;1010
2930204;Sento Sé;3106200;Belo Horizonte;1;1;2;1131
2930501;Serrinha;3106200;Belo Horizonte;1;1;2;1046
2931509;Teofilândia;3106200;Belo Horizonte;1;1;2;1061
2932903;Valença;3106200;Belo Horizonte;1;1;2;881
3100104;Abadia dos Dourados;3106200;Belo Horizonte;1;1;2;390
3100302;Abre Campo;3106200;Belo Horizonte;1;1;2;164
3100708;Água Comprida;3106200;Belo Horizonte;1;1;2;433
3100906;Águas Formosas;3106200;Belo Horizonte;1;1;2;440
3101508;Além Paraíba;3106200;Belo Horizonte;1;1;2;251
3101631;Alfredo Vasconcelos;3106200;Belo Horizonte;1;1;2;139
3101805;Alpercata;3106200;Belo Horizonte;1;1;2;234
3102001;Alterosa;3106200;Belo Horizonte;1;1;2;272
3102209;Alvarenga;3106200;Belo Horizonte;1;1;2;241
3102506;Amparo do Serra;3106200;Belo Horizonte;1;1;2;141
3102605;Andradas;3106200;Belo Horizonte;1;1;2;364
3102704;Cachoeira de Pajeú;3106200;Belo Horizonte;1;1;2;506
3102803;Andrelândia;3106200;Belo Horizonte;1;1;2;205
3102852;Angelândia;3106200;Belo Horizonte;1;1;2;317
3103108;Antônio Prado de Minas;3106200;Belo Horizonte;1;1;2;229
3103207;Araçaí;3106200;Belo Horizonte;1;1;2;83
3103702;Araponga;3106200;Belo Horizonte;1;1;2;175
3104106;Arceburgo;3106200;Belo Horizonte;1;1;2;351
3104304;Areado;3106200;Belo Horizonte;1;1;2;279
3104452;Aricanduva;3106200;Belo Horizonte;1;1;2;268
3104601;Astolfo Dutra;3106200;Belo Horizonte;1;1;2;195
3104700;Ataléia;3106200;Belo Horizonte;1;1;2;363
3104809;Augusto de Lima;3106200;Belo Horizonte;1;1;2;200
3105202;Bandeira;3106200;Belo Horizonte;1;1;2;568
3105509;Barão de Monte Alto;3106200;Belo Horizonte;1;1;2;236
3105707;Barra Longa;3106200;Belo Horizonte;1;1;2;107
3105905;Barroso;3106200;Belo Horizonte;1;1;2;142
3106101;Belmiro Braga;3106200;Belo Horizonte;1;1;2;235
2930709;Simões Filho;3105608;Barbacena;1;1;2;1080
3101508;Além Paraíba;3105608;Barbacena;1;1;2;132
3102100;Alto Rio Doce;3105608;Barbacena;1;1;2;45
3102605;Andradas;3105608;Barbacena;1;1;2;304
3104007;Araxá;3105608;Barbacena;1;1;2;371
3104304;Areado;3105608;Barbacena;1;1;2;245
3104908;Baependi;3105608;Barbacena;1;1;2;140
3102308;Alvinópolis;3105400;Barão de Cocais;1;1;2;52
3101706;Almenara;3105202;Bandeira;1;1;2;34
2111300;São Luís;3105004;Baldim;1;1;2;1854
3101201;Aiuruoca;3104908;Baependi;1;1;2;28
3104007;Araxá;3104700;Ataléia;1;1;2;644
2611606;Recife;3104601;Astolfo Dutra;1;1;2;1663
2913606;Ilhéus;3104601;Astolfo Dutra;1;1;2;817
3100203;Abaeté;3104502;Arinos;1;1;2;364
3104007;Araxá;3104502;Arinos;1;1;2;416
3104007;Araxá;3104304;Areado;1;1;2;213
2910057;Dias d'Ávila;3104205;Arcos;1;1;2;1128
2910727;Eunápolis;3104205;Arcos;1;1;2;752
2304400;Fortaleza;3104007;Araxá;1;1;2;1947
2901205;Anagé;3104007;Araxá;1;1;2;811
2902005;Aracatu;3104007;Araxá;1;1;2;805
2902906;Barra do Choça;3104007;Araxá;1;1;2;840
2904605;Brumado;3104007;Araxá;1;1;2;809
2905008;Caculé;3104007;Araxá;1;1;2;743
2905206;Caetité;3104007;Araxá;1;1;2;763
2906709;Cândido Sales;3104007;Araxá;1;1;2;746
2907103;Carinhanha;3104007;Araxá;1;1;2;674
2911709;Guanambi;3104007;Araxá;1;1;2;727
2919504;Livramento de Nossa Senhora;3104007;Araxá;1;1;2;845
2919801;Macaúbas;3104007;Araxá;1;1;2;846
2923407;Palmas de Monte Alto;3104007;Araxá;1;1;2;707
2923605;Paramirim;3104007;Araxá;1;1;2;834
2925006;Planalto;3104007;Araxá;1;1;2;860
2931053;Tanque Novo;3104007;Araxá;1;1;2;812
2932606;Urandi;3104007;Araxá;1;1;2;694
3100104;Abadia dos Dourados;3104007;Araxá;1;1;2;131
3100906;Águas Formosas;3104007;Araxá;1;1;2;680
3101102;Aimorés;3104007;Araxá;1;1;2;615
3101607;Alfenas;3104007;Araxá;1;1;2;227
3101706;Almenara;3104007;Araxá;1;1;2;751
3101904;Alpinópolis;3104007;Araxá;1;1;2;153
3102001;Alterosa;3104007;Araxá;1;1;2;203
3102605;Andradas;3104007;Araxá;1;1;2;278
3103405;Araçuaí;3104007;Araxá;1;1;2;592
3103801;Arapuá;3104007;Araxá;1;1;2;103
3103900;Araújos;3104007;Araxá;1;1;2;189
3100203;Abaeté;3103900;Araújos;1;1;2;93
1500602;Altamira;3103504;Araguari;1;1;2;1761
1716109;Paraíso do Tocantins;3103504;Araguari;1;1;2;941
1718204;Porto Nacional;3103504;Araguari;1;1;2;878
2101251;Bacabeira;3103504;Araguari;1;1;2;1778
2109007;Porto Franco;3103504;Araguari;1;1;2;1362
2111300;São Luís;3103504;Araguari;1;1;2;1828
2304285;Eusébio;3103504;Araguari;1;1;2;1914
2304400;Fortaleza;3103504;Araguari;1;1;2;1921
2906501;Candeias;3103504;Araguari;1;1;2;1202
2910800;Feira de Santana;3103504;Araguari;1;1;2;1190
2913200;Ibotirama;3103504;Araguari;1;1;2;883
3100104;Abadia dos Dourados;3103504;Araguari;1;1;2;87
3100906;Águas Formosas;3103405;Araçuaí;1;1;2;115
2900702;Alagoinhas;3102803;Andrelândia;1;1;2;1217
2910404;Encruzilhada;3102704;Cachoeira de Pajeú;1;1;2;79
3101904;Alpinópolis;3102001;Alterosa;1;1;2;50
2304400;Fortaleza;3101706;Almenara;1;1;2;1388
2910727;Eunápolis;3101706;Almenara;1;1;2;122
2916401;Itapetinga;3101706;Almenara;1;1;2;108
2919553;Luís Eduardo magalhães;3101607;Alfenas;1;1;2;1030
2918407;Juazeiro;3101508;Além Paraíba;1;1;2;1383
2906709;Cândido Sales;3101003;Águas Vermelhas;1;1;2;37
2912806;Ibirapuã;3100906;Águas Formosas;1;1;2;113
1301852;Iranduba;3100104;Abadia dos Dourados;1;1;2;2136
2507507;João Pessoa;2933604;Xique-Xique;1;1;2;944
2903904;Bom Jesus da Lapa;2933604;Xique-Xique;1;1;2;282
2905305;Cafarnaum;2933604;Xique-Xique;1;1;2;168
2914703;Itaberaba;2933604;Xique-Xique;1;1;2;329
2918407;Juazeiro;2933604;Xique-Xique;1;1;2;281
2929909;Seabra;2933604;Xique-Xique;1;1;2;210
2911204;Gandu;2933505;Wenceslau Guimarães;1;1;2;7
2912905;Ibirataia;2933505;Wenceslau Guimarães;1;1;2;46
2914703;Itaberaba;2933505;Wenceslau Guimarães;1;1;2;152
2915205;Itagibá;2933505;Wenceslau Guimarães;1;1;2;77
2903904;Bom Jesus da Lapa;2933455;Wanderley;1;1;2;140
2909406;Cotegipe;2933455;Wanderley;1;1;2;42
2611101;Petrolina;2933406;Wagner;1;1;2;337
2927408;Salvador;2933406;Wagner;1;1;2;304
1721000;Palmas;2933307;Vitória da Conquista;1;1;2;945
2101202;Bacabal;2933307;Vitória da Conquista;1;1;2;1248
2101608;Barra do Corda;2933307;Vitória da Conquista;1;1;2;1133
2103000;Caxias;2933307;Vitória da Conquista;1;1;2;1137
2103307;Codó;2933307;Vitória da Conquista;1;1;2;1194
2109908;Santa Inês;2933307;Vitória da Conquista;1;1;2;1313
2111201;São José de Ribamar;2933307;Vitória da Conquista;1;1;2;1406
2112209;Timon;2933307;Vitória da Conquista;1;1;2;1098
2207702;Parnaíba;2933307;Vitória da Conquista;1;1;2;1330
2208403;Piripiri;2933307;Vitória da Conquista;1;1;2;1175
2303709;Caucaia;2933307;Vitória da Conquista;1;1;2;1253
2304202;Crato;2933307;Vitória da Conquista;1;1;2;860
2304285;Eusébio;2933307;Vitória da Conquista;1;1;2;1240
2307304;Juazeiro do Norte;2933307;Vitória da Conquista;1;1;2;861
2309607;Pacajus;2933307;Vitória da Conquista;1;1;2;1209
2312908;Sobral;2933307;Vitória da Conquista;1;1;2;1240
2313401;Tianguá;2933307;Vitória da Conquista;1;1;2;1231
2400208;Açu;2933307;Vitória da Conquista;1;1;2;1109
2403251;Parnamirim;2933307;Vitória da Conquista;1;1;2;1153
2407500;Maxaranguape;2933307;Vitória da Conquista;1;1;2;1192
2408953;Rio do Fogo;2933307;Vitória da Conquista;1;1;2;1202
2506301;Guarabira;2933307;Vitória da Conquista;1;1;2;1053
2510808;Patos;2933307;Vitória da Conquista;1;1;2;947
2602902;Cabo de Santo Agostinho;2933307;Vitória da Conquista;1;1;2;955
2606002;Garanhuns;2933307;Vitória da Conquista;1;1;2;808
2610707;Paulista;2933307;Vitória da Conquista;1;1;2;994
2612208;Salgueiro;2933307;Vitória da Conquista;1;1;2;766
2612505;Santa Cruz do Capibaribe;2933307;Vitória da Conquista;1;1;2;909
2613701;São Lourenço da Mata;2933307;Vitória da Conquista;1;1;2;978
2614501;Surubim;2933307;Vitória da Conquista;1;1;2;949
2615300;Timbaúba;2933307;Vitória da Conquista;1;1;2;1004
2616407;Vitória de Santo Antão;2933307;Vitória da Conquista;1;1;2;951
2702405;Delmiro Gouveia;2933307;Vitória da Conquista;1;1;2;681
2706307;Palmeira dos Índios;2933307;Vitória da Conquista;1;1;2;749
2706703;Penedo;2933307;Vitória da Conquista;1;1;2;684
2707701;Rio Largo;2933307;Vitória da Conquista;1;1;2;798
2708006;Santana do Ipanema;2933307;Vitória da Conquista;1;1;2;720
2708600;São Miguel dos Campos;2933307;Vitória da Conquista;1;1;2;756
2709301;União dos Palmares;2933307;Vitória da Conquista;1;1;2;806
2802908;Itabaiana;2933307;Vitória da Conquista;1;1;2;593
2803203;Itaporanga d'Ajuda;2933307;Vitória da Conquista;1;1;2;570
2803500;Lagarto;2933307;Vitória da Conquista;1;1;2;554
2807402;Tobias Barreto;2933307;Vitória da Conquista;1;1;2;511
2903102;Barra do Rocha;2933307;Vitória da Conquista;1;1;2;153
2905008;Caculé;2933307;Vitória da Conquista;1;1;2;156
2907509;Catu;2933307;Vitória da Conquista;1;1;2;384
2908408;Conceição do Coité;2933307;Vitória da Conquista;1;1;2;410
2908705;Condeúba;2933307;Vitória da Conquista;1;1;2;121
2908804;Contendas do Sincorá;2933307;Vitória da Conquista;1;1;2;124
2910057;Dias d'Ávila;2933307;Vitória da Conquista;1;1;2;369
2910107;Dom Basílio;2933307;Vitória da Conquista;1;1;2;158
2911204;Gandu;2933307;Vitória da Conquista;1;1;2;191
2911501;Gongogi;2933307;Vitória da Conquista;1;1;2;159
2912004;Ibiassucê;2933307;Vitória da Conquista;1;1;2;166
2914653;Itabela;2933307;Vitória da Conquista;1;1;2;235
2914703;Itaberaba;2933307;Vitória da Conquista;1;1;2;260
2915601;Itamaraju;2933307;Vitória da Conquista;1;1;2;279
2916807;Itarantim;2933307;Vitória da Conquista;1;1;2;122
2916856;Itatim;2933307;Vitória da Conquista;1;1;2;268
2919504;Livramento de Nossa Senhora;2933307;Vitória da Conquista;1;1;2;173
2919553;Luís Eduardo magalhães;2933307;Vitória da Conquista;1;1;2;613
2920502;Maracás;2933307;Vitória da Conquista;1;1;2;163
2920908;Mascote;2933307;Vitória da Conquista;1;1;2;183
2921807;Mortugaba;2933307;Vitória da Conquista;1;1;2;165
2923605;Paramirim;2933307;Vitória da Conquista;1;1;2;218
2923803;Paripiranga;2933307;Vitória da Conquista;1;1;2;561
2924009;Paulo Afonso;2933307;Vitória da Conquista;1;1;2;660
2925709;Presidente Jânio Quadros;2933307;Vitória da Conquista;1;1;2;92
2926301;Riachão do Jacuípe;2933307;Vitória da Conquista;1;1;2;376
2926608;Ribeira do Pombal;2933307;Vitória da Conquista;1;1;2;510
2928000;Santaluz;2933307;Vitória da Conquista;1;1;2;429
2928109;Santa Maria da Vitória;2933307;Vitória da Conquista;1;1;2;399
2929057;São Félix do Coribe;2933307;Vitória da Conquista;1;1;2;394
2929503;São Sebastião do Passé;2933307;Vitória da Conquista;1;1;2;362
2932705;Uruçuca;2933307;Vitória da Conquista;1;1;2;171
2932903;Valença;2933307;Vitória da Conquista;1;1;2;250
2910800;Feira de Santana;2933208;Vera Cruz;1;1;2;86
2918001;Jequié;2933208;Vera Cruz;1;1;2;180
2919553;Luís Eduardo magalhães;2933208;Vera Cruz;1;1;2;783
2922201;Muniz Ferreira;2933208;Vera Cruz;1;1;2;51
2922508;Nazaré;2933208;Vera Cruz;1;1;2;43
2918803;Laje;2933174;Varzedo;1;1;2;24
2928703;Santo Antônio de Jesus;2933174;Varzedo;1;1;2;10
2904050;Bonito;2933158;Várzea Nova;1;1;2;86
2914604;Irecê;2933158;Várzea Nova;1;1;2;101
2921708;Morro do Chapéu;2933158;Várzea Nova;1;1;2;40
2927408;Salvador;2933158;Várzea Nova;1;1;2;331
2906873;Capim Grosso;2933109;Várzea do Poço;1;1;2;37
2917508;Jacobina;2933109;Várzea do Poço;1;1;2;36
2921203;Miguel Calmon;2933109;Várzea do Poço;1;1;2;32
2922102;Mundo Novo;2933109;Várzea do Poço;1;1;2;33
2927408;Salvador;2933109;Várzea do Poço;1;1;2;259
2929370;São José do Jacuípe;2933109;Várzea do Poço;1;1;2;51
2905701;Camaçari;2933059;Várzea da Roça;1;1;2;231
2917508;Jacobina;2933059;Várzea da Roça;1;1;2;55
2925808;Queimadas;2933059;Várzea da Roça;1;1;2;91
2902104;Araci;2933000;Valente;1;1;2;57
2906873;Capim Grosso;2933000;Valente;1;1;2;60
2917508;Jacobina;2933000;Valente;1;1;2;113
2921500;Monte Santo;2933000;Valente;1;1;2;109
2922730;Nova Fátima;2933000;Valente;1;1;2;28
2925907;Quijingue;2933000;Valente;1;1;2;78
2925931;Quixabeira;2933000;Valente;1;1;2;73
2927408;Salvador;2933000;Valente;1;1;2;205
2930501;Serrinha;2933000;Valente;1;1;2;55
2403251;Parnamirim;2932903;Valença;1;1;2;919
2704302;Maceió;2932903;Valença;1;1;2;547
2800308;Aracaju;2932903;Valença;1;1;2;348
2804805;Nossa Senhora do Socorro;2932903;Valença;1;1;2;349
2900702;Alagoinhas;2932903;Valença;1;1;2;154
2902401;Aurelino Leal;2932903;Valença;1;1;2;110
2903904;Bom Jesus da Lapa;2932903;Valença;1;1;2;461
2904902;Cachoeira;2932903;Valença;1;1;2;81
2907301;Castro Alves;2932903;Valença;1;1;2;72
2907509;Catu;2932903;Valença;1;1;2;137
2910057;Dias d'Ávila;2932903;Valença;1;1;2;120
2913606;Ilhéus;2932903;Valença;1;1;2;160
2914703;Itaberaba;2932903;Valença;1;1;2;154
2919207;Lauro de Freitas;2932903;Valença;1;1;2;100
2919553;Luís Eduardo magalhães;2932903;Valença;1;1;2;737
2922607;Nilo Peçanha;2932903;Valença;1;1;2;30
2924009;Paulo Afonso;2932903;Valença;1;1;2;443
2927309;Salinas da Margarida;2932903;Valença;1;1;2;62
2928604;Santo Amaro;2932903;Valença;1;1;2;99
2928802;Santo Estêvão;2932903;Valença;1;1;2;102
2929503;São Sebastião do Passé;2932903;Valença;1;1;2;114
2929602;Sapeaçu;2932903;Valença;1;1;2;69
2930709;Simões Filho;2932903;Valença;1;1;2;99
2931350;Teixeira de Freitas;2932903;Valença;1;1;2;470
2932101;Ubaíra;2932903;Valença;1;1;2;60
2932200;Ubaitaba;2932903;Valença;1;1;2;104
2901304;Andaraí;2932804;Utinga;1;1;2;85
2906873;Capim Grosso;2932804;Utinga;1;1;2;139
2914604;Irecê;2932804;Utinga;1;1;2;121
2914703;Itaberaba;2932804;Utinga;1;1;2;98
2919603;Macajuba;2932804;Utinga;1;1;2;76
2920106;Mairi;2932804;Utinga;1;1;2;108
2922102;Mundo Novo;2932804;Utinga;1;1;2;74
2927408;Salvador;2932804;Utinga;1;1;2;299
2905800;Camamu;2932705;Uruçuca;1;1;2;74
2915502;Itajuípe;2932705;Uruçuca;1;1;2;14
2916203;Itapé;2932705;Uruçuca;1;1;2;37
2916401;Itapetinga;2932705;Uruçuca;1;1;2;129
2927408;Salvador;2932705;Uruçuca;1;1;2;197
2932507;Una;2932705;Uruçuca;1;1;2;79
2930709;Simões Filho;2932606;Urandi;1;1;2;506
2800308;Aracaju;2932507;Una;1;1;2;532
2914802;Itabuna;2932507;Una;1;1;2;58
2927804;Santa Cruz da Vitória;2932507;Una;1;1;2;84
2928059;Santa Luzia;2932507;Una;1;1;2;29
2923357;Ourolândia;2932457;Umburanas;1;1;2;37
2927408;Salvador;2932457;Umburanas;1;1;2;401
2907608;Central;2932408;Uibaí;1;1;2;27
2911303;Gentio do Ouro;2932408;Uibaí;1;1;2;42
2927408;Salvador;2932408;Uibaí;1;1;2;441
2900900;Almadina;2932309;Ubatã;1;1;2;59
2911204;Gandu;2932309;Ubatã;1;1;2;48
2915205;Itagibá;2932309;Ubatã;1;1;2;36
2928604;Santo Amaro;2932309;Ubatã;1;1;2;201
2611606;Recife;2932200;Ubaitaba;1;1;2;826
2904704;Buerarema;2932200;Ubaitaba;1;1;2;77
2905800;Camamu;2932200;Ubaitaba;1;1;2;42
2910727;Eunápolis;2932200;Ubaitaba;1;1;2;235
2912707;Ibirapitanga;2932200;Ubaitaba;1;1;2;12
2913606;Ilhéus;2932200;Ubaitaba;1;1;2;63
2913903;Ipiaú;2932200;Ubaitaba;1;1;2;43
2914901;Itacaré;2932200;Ubaitaba;1;1;2;36
2916401;Itapetinga;2932200;Ubaitaba;1;1;2;150
2922409;Mutuípe;2932200;Ubaitaba;1;1;2;116
2901007;Amargosa;2932101;Ubaíra;1;1;2;27
2910800;Feira de Santana;2932101;Ubaíra;1;1;2;132
2918209;Jiquiriçá;2932101;Ubaíra;1;1;2;10
2920502;Maracás;2932101;Ubaíra;1;1;2;84
2922300;Muritiba;2932101;Ubaíra;1;1;2;101
2922409;Mutuípe;2932101;Ubaíra;1;1;2;18
2927408;Salvador;2932101;Ubaíra;1;1;2;132
2211001;Teresina;2932002;Uauá;1;1;2;641
2601607;Belém de São Francisco;2932002;Uauá;1;1;2;141
2612208;Salgueiro;2932002;Uauá;1;1;2;196
2905701;Camaçari;2932002;Uauá;1;1;2;336
2906808;Cansanção;2932002;Uauá;1;1;2;89
2906873;Capim Grosso;2932002;Uauá;1;1;2;178
2909901;Curaçá;2932002;Uauá;1;1;2;107
2910701;Euclides da Cunha;2932002;Uauá;1;1;2;85
2910800;Feira de Santana;2932002;Uauá;1;1;2;273
2927408;Salvador;2932002;Uauá;1;1;2;362
2308401;Missão Velha;2931905;Tucano;1;1;2;412
2905701;Camaçari;2931905;Tucano;1;1;2;199
2907806;Cícero Dantas;2931905;Tucano;1;1;2;57
2907905;Cipó;2931905;Tucano;1;1;2;36
2910800;Feira de Santana;2931905;Tucano;1;1;2;147
2917508;Jacobina;2931905;Tucano;1;1;2;185
2921500;Monte Santo;2931905;Tucano;1;1;2;81
2925907;Quijingue;2931905;Tucano;1;1;2;49
2927408;Salvador;2931905;Tucano;1;1;2;227
2901205;Anagé;2931806;Tremedal;1;1;2;44
2919959;Maetinga;2931806;Tremedal;1;1;2;36
2924702;Piripá;2931806;Tremedal;1;1;2;33
2925709;Presidente Jânio Quadros;2931806;Tremedal;1;1;2;43
2919207;Lauro de Freitas;2931707;Terra Nova;1;1;2;63
2927408;Salvador;2931707;Terra Nova;1;1;2;68
2911204;Gandu;2931608;Teolândia;1;1;2;19
2918001;Jequié;2931608;Teolândia;1;1;2;68
2927408;Salvador;2931608;Teolândia;1;1;2;128
2928703;Santo Antônio de Jesus;2931608;Teolândia;1;1;2;71
2926608;Ribeira do Pombal;2931509;Teofilândia;1;1;2;89
2927408;Salvador;2931509;Teofilândia;1;1;2;176
2930501;Serrinha;2931509;Teofilândia;1;1;2;17
2910800;Feira de Santana;2931400;Teodoro Sampaio;1;1;2;37
2928802;Santo Estêvão;2931400;Teodoro Sampaio;1;1;2;69
2105302;Imperatriz;2931350;Teixeira de Freitas;1;1;2;1553
2312908;Sobral;2931350;Teixeira de Freitas;1;1;2;1537
2507507;João Pessoa;2931350;Teixeira de Freitas;1;1;2;1252
2611606;Recife;2931350;Teixeira de Freitas;1;1;2;1155
2804508;Nossa Senhora da Glória;2931350;Teixeira de Freitas;1;1;2;846
2900702;Alagoinhas;2931350;Teixeira de Freitas;1;1;2;615
2912806;Ibirapuã;2931350;Teixeira de Freitas;1;1;2;44
2913903;Ipiaú;2931350;Teixeira de Freitas;1;1;2;383
2914901;Itacaré;2931350;Teixeira de Freitas;1;1;2;369
2916005;Itanhém;2931350;Teixeira de Freitas;1;1;2;77
2918001;Jequié;2931350;Teixeira de Freitas;1;1;2;415
2925105;Poções;2931350;Teixeira de Freitas;1;1;2;344
2927705;Santa Cruz Cabrália;2931350;Teixeira de Freitas;1;1;2;155
2928703;Santo Antônio de Jesus;2931350;Teixeira de Freitas;1;1;2;509
2922102;Mundo Novo;2931301;Tapiramutá;1;1;2;38
2924801;Piritiba;2931301;Tapiramutá;1;1;2;29
2927200;Ruy Barbosa;2931301;Tapiramutá;1;1;2;60
2927408;Salvador;2931301;Tapiramutá;1;1;2;283
2905800;Camamu;2931202;Taperoá;1;1;2;45
2922201;Muniz Ferreira;2931202;Taperoá;1;1;2;59
2925758;Presidente Tancredo Neves;2931202;Taperoá;1;1;2;33
2612208;Salgueiro;2931103;Tanquinho;1;1;2;426
2910800;Feira de Santana;2931103;Tanquinho;1;1;2;37
2927507;Santa Bárbara;2931103;Tanquinho;1;1;2;14
2928604;Santo Amaro;2931103;Tanquinho;1;1;2;76
2904209;Botuporã;2931053;Tanque Novo;1;1;2;18
2907558;Caturama;2931053;Tanque Novo;1;1;2;32
2911709;Guanambi;2931053;Tanque Novo;1;1;2;88
2919504;Livramento de Nossa Senhora;2931053;Tanque Novo;1;1;2;72
2923209;Oliveira dos Brejinhos;2931053;Tanque Novo;1;1;2;142
2926400;Riacho de Santana;2931053;Tanque Novo;1;1;2;53
2911709;Guanambi;2931004;Tanhaçu;1;1;2;172
2916401;Itapetinga;2931004;Tanhaçu;1;1;2;175
2918001;Jequié;2931004;Tanhaçu;1;1;2;127
2927408;Salvador;2931004;Tanhaçu;1;1;2;318
2211001;Teresina;2930907;Tabocas do Brejo Velho;1;1;2;852
2902500;Baianópolis;2930907;Tabocas do Brejo Velho;1;1;2;72
2903201;Barreiras;2930907;Tabocas do Brejo Velho;1;1;2;119
2918357;João Dourado;2930808;Souto Soares;1;1;2;81
2922052;Mulungu do Morro;2930808;Souto Soares;1;1;2;13
2927408;Salvador;2930808;Souto Soares;1;1;2;364
2203909;Floriano;2930774;Sobradinho;1;1;2;381
2211001;Teresina;2930774;Sobradinho;1;1;2;532
2611606;Recife;2930774;Sobradinho;1;1;2;664
2612208;Salgueiro;2930774;Sobradinho;1;1;2;237
2905909;Campo Alegre de Lourdes;2930774;Sobradinho;1;1;2;240
2907202;Casa Nova;2930774;Sobradinho;1;1;2;42
2924405;Pilão Arcado;2930774;Sobradinho;1;1;2;190
2927408;Salvador;2930774;Sobradinho;1;1;2;467
2930204;Sento Sé;2930774;Sobradinho;1;1;2;129
2901601;Antas;2930766;Sítio do Quinto;1;1;2;14
2907806;Cícero Dantas;2930766;Sítio do Quinto;1;1;2;37
2909208;Coronel João Sá;2930766;Sítio do Quinto;1;1;2;33
2918100;Jeremoabo;2930766;Sítio do Quinto;1;1;2;34
2923803;Paripiranga;2930766;Sítio do Quinto;1;1;2;51
2927408;Salvador;2930766;Sítio do Quinto;1;1;2;293
2910008;Dário Meira;2930758;Sítio do Mato;1;1;2;412
2926400;Riacho de Santana;2930758;Sítio do Mato;1;1;2;79
2927408;Salvador;2930758;Sítio do Mato;1;1;2;541
2930154;Serra do Ramalho;2930758;Sítio do Mato;1;1;2;56
1500800;Ananindeua;2930709;Simões Filho;1;1;2;1653
1505536;Parauapebas;2930709;Simões Filho;1;1;2;1440
2111300;São Luís;2930709;Simões Filho;1;1;2;1294
2205581;Lagoa do Piauí;2930709;Simões Filho;1;1;2;933
2211001;Teresina;2930709;Simões Filho;1;1;2;973
2303709;Caucaia;2930709;Simões Filho;1;1;2;1002
2304285;Eusébio;2930709;Simões Filho;1;1;2;984
2502151;Boa Vista;2930709;Simões Filho;1;1;2;654
2604106;Caruaru;2930709;Simões Filho;1;1;2;562
2609402;Moreno;2930709;Simões Filho;1;1;2;627
2611101;Petrolina;2930709;Simões Filho;1;1;2;449
2704302;Maceió;2930709;Simões Filho;1;1;2;451
2800308;Aracaju;2930709;Simões Filho;1;1;2;253
2804003;Maruim;2930709;Simões Filho;1;1;2;269
2807105;Simão Dias;2930709;Simões Filho;1;1;2;241
2906808;Cansanção;2930709;Simões Filho;1;1;2;262
2909109;Coribe;2930709;Simões Filho;1;1;2;675
2909307;Correntina;2930709;Simões Filho;1;1;2;680
2914000;Ipirá;2930709;Simões Filho;1;1;2;160
2915205;Itagibá;2930709;Simões Filho;1;1;2;228
2918001;Jequié;2930709;Simões Filho;1;1;2;214
2920601;Maragogipe;2930709;Simões Filho;1;1;2;60
2921005;Mata de São João;2930709;Simões Filho;1;1;2;30
2922409;Mutuípe;2930709;Simões Filho;1;1;2;129
2922508;Nazaré;2930709;Simões Filho;1;1;2;74
2922656;Nordestina;2930709;Simões Filho;1;1;2;244
2924009;Paulo Afonso;2930709;Simões Filho;1;1;2;373
2925204;Pojuca;2930709;Simões Filho;1;1;2;40
2925758;Presidente Tancredo Neves;2930709;Simões Filho;1;1;2;133
2926608;Ribeira do Pombal;2930709;Simões Filho;1;1;2;218
2929503;São Sebastião do Passé;2930709;Simões Filho;1;1;2;32
2929909;Seabra;2930709;Simões Filho;1;1;2;364
2900405;Água Fria;2930600;Serrolândia;1;1;2;175
2917508;Jacobina;2930600;Serrolândia;1;1;2;27
2304400;Fortaleza;2930501;Serrinha;1;1;2;873
2507507;João Pessoa;2930501;Serrinha;1;1;2;667
2704302;Maceió;2930501;Serrinha;1;1;2;418
2804805;Nossa Senhora do Socorro;2930501;Serrinha;1;1;2;222
2903201;Barreiras;2930501;Serrinha;1;1;2;654
2903607;Biritinga;2930501;Serrinha;1;1;2;24
2913101;Ibititá;2930501;Serrinha;1;1;2;324
2914604;Irecê;2930501;Serrinha;1;1;2;312
2925808;Queimadas;2930501;Serrinha;1;1;2;99
2928703;Santo Antônio de Jesus;2930501;Serrinha;1;1;2;149
2928950;São Domingos;2930501;Serrinha;1;1;2;60
2929305;São Gonçalo dos Campos;2930501;Serrinha;1;1;2;87
2904753;Buritirama;2930303;Serra Dourada;1;1;2;232
2905206;Caetité;2930303;Serra Dourada;1;1;2;219
2913408;Igaporã;2930303;Serra Dourada;1;1;2;179
2927408;Salvador;2930303;Serra Dourada;1;1;2;601
2928109;Santa Maria da Vitória;2930303;Serra Dourada;1;1;2;68
2211001;Teresina;2930204;Sento Sé;1;1;2;535
2612208;Salgueiro;2930204;Sento Sé;1;1;2;360
2905909;Campo Alegre de Lourdes;2930204;Sento Sé;1;1;2;123
2909901;Curaçá;2930204;Sento Sé;1;1;2;245
2914703;Itaberaba;2930204;Sento Sé;1;1;2;351
2923357;Ourolândia;2930204;Sento Sé;1;1;2;156
2926004;Remanso;2930204;Sento Sé;1;1;2;36
2927408;Salvador;2930204;Sento Sé;1;1;2;517
2930105;Senhor do Bonfim;2930204;Sento Sé;1;1;2;202
2211001;Teresina;2930154;Serra do Ramalho;1;1;2;942
2903201;Barreiras;2930154;Serra do Ramalho;1;1;2;212
2911709;Guanambi;2930154;Serra do Ramalho;1;1;2;118
2203909;Floriano;2930105;Senhor do Bonfim;1;1;2;506
2304400;Fortaleza;2930105;Senhor do Bonfim;1;1;2;759
2507507;João Pessoa;2930105;Senhor do Bonfim;1;1;2;684
2601102;Araripina;2930105;Senhor do Bonfim;1;1;2;320
2603009;Cabrobó;2930105;Senhor do Bonfim;1;1;2;242
2611606;Recife;2930105;Senhor do Bonfim;1;1;2;629
2612604;Santa Maria da Boa Vista;2930105;Senhor do Bonfim;1;1;2;191
2804805;Nossa Senhora do Socorro;2930105;Senhor do Bonfim;1;1;2;338
2903201;Barreiras;2930105;Senhor do Bonfim;1;1;2;561
2905701;Camaçari;2930105;Senhor do Bonfim;1;1;2;323
2913101;Ibititá;2930105;Senhor do Bonfim;1;1;2;231
2925808;Queimadas;2930105;Senhor do Bonfim;1;1;2;87
2926608;Ribeira do Pombal;2930105;Senhor do Bonfim;1;1;2;185
2920205;Malhada;2930006;Sebastião Laranjeiras;1;1;2;94
2903201;Barreiras;2929909;Seabra;1;1;2;353
2904001;Boninal;2929909;Seabra;1;1;2;30
2906204;Canarana;2929909;Seabra;1;1;2;84
2907400;Catolândia;2929909;Seabra;1;1;2;339
2913101;Ibititá;2929909;Seabra;1;1;2;103
2914109;Ipupiara;2929909;Seabra;1;1;2;120
2917508;Jacobina;2929909;Seabra;1;1;2;191
2919801;Macaúbas;2929909;Seabra;1;1;2;125
2923506;Palmeiras;2929909;Seabra;1;1;2;22
2928901;São Desidério;2929909;Seabra;1;1;2;351
2905107;Caém;2929800;Saúde;1;1;2;16
2917508;Jacobina;2929800;Saúde;1;1;2;34
2927408;Salvador;2929800;Saúde;1;1;2;312
2910800;Feira de Santana;2929750;Saubara;1;1;2;54
2927408;Salvador;2929750;Saubara;1;1;2;43
2909604;Crisópolis;2929701;Sátiro Dias;1;1;2;50
2913705;Inhambupe;2929701;Sátiro Dias;1;1;2;34
2925204;Pojuca;2929701;Sátiro Dias;1;1;2;97
2908309;Conceição do Almeida;2929602;Sapeaçu;1;1;2;9
2908507;Conceição do Jacuípe;2929602;Sapeaçu;1;1;2;62
2909802;Cruz das Almas;2929602;Sapeaçu;1;1;2;14
2911600;Governador Mangabeira;2929602;Sapeaçu;1;1;2;21
2918308;Jitaúna;2929602;Sapeaçu;1;1;2;158
2928703;Santo Antônio de Jesus;2929602;Sapeaçu;1;1;2;29
2408003;Mossoró;2929503;São Sebastião do Passé;1;1;2;820
2607901;Jaboatão dos Guararapes;2929503;São Sebastião do Passé;1;1;2;613
2804805;Nossa Senhora do Socorro;2929503;São Sebastião do Passé;1;1;2;235
2901106;Amélia Rodrigues;2929503;São Sebastião do Passé;1;1;2;31
2905701;Camaçari;2929503;São Sebastião do Passé;1;1;2;27
2925204;Pojuca;2929503;São Sebastião do Passé;1;1;2;20
2927002;Rio Real;2929503;São Sebastião do Passé;1;1;2;132
2901007;Amargosa;2929404;São Miguel das Matas;1;1;2;16
2918803;Laje;2929404;São Miguel das Matas;1;1;2;15
2927408;Salvador;2929404;São Miguel das Matas;1;1;2;107
2928604;Santo Amaro;2929404;São Miguel das Matas;1;1;2;98
2917508;Jacobina;2929370;São José do Jacuípe;1;1;2;70
2902252;Arataca;2929354;São José da Vitória;1;1;2;21
2904704;Buerarema;2929354;São José da Vitória;1;1;2;14
2918555;Jussari;2929354;São José da Vitória;1;1;2;21
2400208;Açu;2929305;São Gonçalo dos Campos;1;1;2;791
2612208;Salgueiro;2929305;São Gonçalo dos Campos;1;1;2;477
2704302;Maceió;2929305;São Gonçalo dos Campos;1;1;2;465
2800308;Aracaju;2929305;São Gonçalo dos Campos;1;1;2;265
2804805;Nossa Senhora do Socorro;2929305;São Gonçalo dos Campos;1;1;2;264
2904902;Cachoeira;2929305;São Gonçalo dos Campos;1;1;2;22
2907509;Catu;2929305;São Gonçalo dos Campos;1;1;2;67
2908507;Conceição do Jacuípe;2929305;São Gonçalo dos Campos;1;1;2;24
2928802;Santo Estêvão;2929305;São Gonçalo dos Campos;1;1;2;31
2929008;São Félix;2929305;São Gonçalo dos Campos;1;1;2;25
2503704;Cajazeiras;2929255;São Gabriel;1;1;2;600
2912400;Ibipeba;2929255;São Gabriel;1;1;2;47
2918357;João Dourado;2929255;São Gabriel;1;1;2;30
2925600;Presidente Dutra;2929255;São Gabriel;1;1;2;11
2927408;Salvador;2929255;São Gabriel;1;1;2;424
2408102;Natal;2929206;São Francisco do Conde;1;1;2;839
2804805;Nossa Senhora do Socorro;2929206;São Francisco do Conde;1;1;2;258
2918001;Jequié;2929206;São Francisco do Conde;1;1;2;200
2928604;Santo Amaro;2929206;São Francisco do Conde;1;1;2;10
2909802;Cruz das Almas;2929107;São Felipe;1;1;2;15
2928703;Santo Antônio de Jesus;2929107;São Felipe;1;1;2;26
2903201;Barreiras;2929057;São Félix do Coribe;1;1;2;157
2909307;Correntina;2929057;São Félix do Coribe;1;1;2;48
2909802;Cruz das Almas;2929008;São Félix;1;1;2;10
2914000;Ipirá;2929008;São Félix;1;1;2;97
2928604;Santo Amaro;2929008;São Félix;1;1;2;33
2906873;Capim Grosso;2928950;São Domingos;1;1;2;53
2907301;Castro Alves;2928950;São Domingos;1;1;2;140
2927408;Salvador;2928950;São Domingos;1;1;2;202
1708205;Formoso do Araguaia;2928901;São Desidério;1;1;2;500
2607901;Jaboatão dos Guararapes;2928901;São Desidério;1;1;2;1172
2700300;Arapiraca;2928901;São Desidério;1;1;2;941
2902500;Baianópolis;2928901;São Desidério;1;1;2;48
2306405;Itapipoca;2928802;Santo Estêvão;1;1;2;988
2800308;Aracaju;2928802;Santo Estêvão;1;1;2;289
2804805;Nossa Senhora do Socorro;2928802;Santo Estêvão;1;1;2;288
2901106;Amélia Rodrigues;2928802;Santo Estêvão;1;1;2;54
2913903;Ipiaú;2928802;Santo Estêvão;1;1;2;190
2914703;Itaberaba;2928802;Santo Estêvão;1;1;2;115
2916856;Itatim;2928802;Santo Estêvão;1;1;2;58
2918001;Jequié;2928802;Santo Estêvão;1;1;2;177
2919553;Luís Eduardo magalhães;2928802;Santo Estêvão;1;1;2;714
2925956;Rafael Jambeiro;2928802;Santo Estêvão;1;1;2;27
2926301;Riachão do Jacuípe;2928802;Santo Estêvão;1;1;2;71
2304400;Fortaleza;2928703;Santo Antônio de Jesus;1;1;2;1020
2412005;São Gonçalo do Amarante;2928703;Santo Antônio de Jesus;1;1;2;900
2507507;João Pessoa;2928703;Santo Antônio de Jesus;1;1;2;797
2602902;Cabo de Santo Agostinho;2928703;Santo Antônio de Jesus;1;1;2;692
2604106;Caruaru;2928703;Santo Antônio de Jesus;1;1;2;628
2616407;Vitória de Santo Antão;2928703;Santo Antônio de Jesus;1;1;2;688
2704302;Maceió;2928703;Santo Antônio de Jesus;1;1;2;531
2900702;Alagoinhas;2928703;Santo Antônio de Jesus;1;1;2;132
2904605;Brumado;2928703;Santo Antônio de Jesus;1;1;2;291
2907509;Catu;2928703;Santo Antônio de Jesus;1;1;2;122
2910305;Elísio Medrado;2928703;Santo Antônio de Jesus;1;1;2;24
2913606;Ilhéus;2928703;Santo Antônio de Jesus;1;1;2;203
2915700;Itamari;2928703;Santo Antônio de Jesus;1;1;2;99
2916401;Itapetinga;2928703;Santo Antônio de Jesus;1;1;2;277
2916856;Itatim;2928703;Santo Antônio de Jesus;1;1;2;52
2917300;Ituberá;2928703;Santo Antônio de Jesus;1;1;2;87
2918209;Jiquiriçá;2928703;Santo Antônio de Jesus;1;1;2;44
2919207;Lauro de Freitas;2928703;Santo Antônio de Jesus;1;1;2;106
2922300;Muritiba;2928703;Santo Antônio de Jesus;1;1;2;49
2925006;Planalto;2928703;Santo Antônio de Jesus;1;1;2;230
2927002;Rio Real;2928703;Santo Antônio de Jesus;1;1;2;224
2927507;Santa Bárbara;2928703;Santo Antônio de Jesus;1;1;2;117
2507507;João Pessoa;2928604;Santo Amaro;1;1;2;723
2906501;Candeias;2928604;Santo Amaro;1;1;2;23
2907301;Castro Alves;2928604;Santo Amaro;1;1;2;82
2908507;Conceição do Jacuípe;2928604;Santo Amaro;1;1;2;24
2909802;Cruz das Almas;2928604;Santo Amaro;1;1;2;42
2914000;Ipirá;2928604;Santo Amaro;1;1;2;119
2914604;Irecê;2928604;Santo Amaro;1;1;2;367
2914802;Itabuna;2928604;Santo Amaro;1;1;2;256
2916104;Itaparica;2928604;Santo Amaro;1;1;2;45
2917508;Jacobina;2928604;Santo Amaro;1;1;2;240
2918001;Jequié;2928604;Santo Amaro;1;1;2;204
2927002;Rio Real;2928604;Santo Amaro;1;1;2;148
2927507;Santa Bárbara;2928604;Santo Amaro;1;1;2;71
2910305;Elísio Medrado;2928505;Santa Teresinha;1;1;2;19
2910602;Esplanada;2928505;Santa Teresinha;1;1;2;196
2927408;Salvador;2928505;Santa Teresinha;1;1;2;117
2211001;Teresina;2928406;Santa Rita de Cássia;1;1;2;678
2902708;Barra;2928406;Santa Rita de Cássia;1;1;2;143
2903904;Bom Jesus da Lapa;2928406;Santa Rita de Cássia;1;1;2;284
2911105;Formosa do Rio Preto;2928406;Santa Rita de Cássia;1;1;2;69
2914604;Irecê;2928406;Santa Rita de Cássia;1;1;2;294
2926202;Riachão das Neves;2928406;Santa Rita de Cássia;1;1;2;94
2904605;Brumado;2928208;Santana;1;1;2;295
2909406;Cotegipe;2928208;Santana;1;1;2;107
2909703;Cristópolis;2928208;Santana;1;1;2;91
2910800;Feira de Santana;2928208;Santana;1;1;2;558
2913200;Ibotirama;2928208;Santana;1;1;2;128
2913606;Ilhéus;2928208;Santana;1;1;2;574
2919553;Luís Eduardo magalhães;2928208;Santana;1;1;2;213
1721000;Palmas;2928109;Santa Maria da Vitória;1;1;2;556
2211001;Teresina;2928109;Santa Maria da Vitória;1;1;2;926
2304400;Fortaleza;2928109;Santa Maria da Vitória;1;1;2;1221
2904407;Brejolândia;2928109;Santa Maria da Vitória;1;1;2;99
2905206;Caetité;2928109;Santa Maria da Vitória;1;1;2;203
2906105;Canápolis;2928109;Santa Maria da Vitória;1;1;2;31
2908101;Cocos;2928109;Santa Maria da Vitória;1;1;2;98
2909109;Coribe;2928109;Santa Maria da Vitória;1;1;2;62
2920205;Malhada;2928109;Santa Maria da Vitória;1;1;2;120
2923704;Paratinga;2928109;Santa Maria da Vitória;1;1;2;132
2926400;Riacho de Santana;2928109;Santa Maria da Vitória;1;1;2;138
2902252;Arataca;2928059;Santa Luzia;1;1;2;20
2903409;Belmonte;2928059;Santa Luzia;1;1;2;66
2905602;Camacan;2928059;Santa Luzia;1;1;2;21
2910727;Eunápolis;2928059;Santa Luzia;1;1;2;108
2920908;Mascote;2928059;Santa Luzia;1;1;2;15
2513703;Santa Rita;2928000;Santaluz;1;1;2;659
2602902;Cabo de Santo Agostinho;2928000;Santaluz;1;1;2;576
2902104;Araci;2928000;Santaluz;1;1;2;47
2906808;Cansanção;2928000;Santaluz;1;1;2;66
2907301;Castro Alves;2928000;Santaluz;1;1;2;167
2907509;Catu;2928000;Santaluz;1;1;2;165
2910503;Entre Rios;2928000;Santaluz;1;1;2;155
2917706;Jaguarari;2928000;Santaluz;1;1;2;142
2925808;Queimadas;2928000;Santaluz;1;1;2;41
2925931;Quixabeira;2928000;Santaluz;1;1;2;84
2926301;Riachão do Jacuípe;2928000;Santaluz;1;1;2;60
2903706;Boa Nova;2927903;Santa Inês;1;1;2;126
2909505;Cravolândia;2927903;Santa Inês;1;1;2;7
2916708;Itaquara;2927903;Santa Inês;1;1;2;22
2925105;Poções;2927903;Santa Inês;1;1;2;145
2927408;Salvador;2927903;Santa Inês;1;1;2;149
2903300;Governador Lomanto Júnior;2927804;Santa Cruz da Vitória;1;1;2;41
2915403;Itaju do Colônia;2927804;Santa Cruz da Vitória;1;1;2;22
2916203;Itapé;2927804;Santa Cruz da Vitória;1;1;2;43
2903409;Belmonte;2927705;Santa Cruz Cabrália;1;1;2;45
2910727;Eunápolis;2927705;Santa Cruz Cabrália;1;1;2;56
2914653;Itabela;2927705;Santa Cruz Cabrália;1;1;2;60
2927408;Salvador;2927705;Santa Cruz Cabrália;1;1;2;370
2804508;Nossa Senhora da Glória;2927606;Santa Brígida;1;1;2;94
2918100;Jeremoabo;2927606;Santa Brígida;1;1;2;44
2924207;Pedro Alexandre;2927606;Santa Brígida;1;1;2;40
2927408;Salvador;2927606;Santa Brígida;1;1;2;362
2900702;Alagoinhas;2927507;Santa Bárbara;1;1;2;63
2902104;Araci;2927507;Santa Bárbara;1;1;2;70
2908507;Conceição do Jacuípe;2927507;Santa Bárbara;1;1;2;48
2914505;Irará;2927507;Santa Bárbara;1;1;2;25
2914703;Itaberaba;2927507;Santa Bárbara;1;1;2;159
2917508;Jacobina;2927507;Santa Bárbara;1;1;2;182
1100049;Cacoal;2927408;Salvador;1;1;2;2494
1100189;Pimenta Bueno;2927408;Salvador;1;1;2;2470
1100304;Vilhena;2927408;Salvador;1;1;2;2355
1200401;Rio Branco;2927408;Salvador;1;1;2;3188
1500602;Altamira;2927408;Salvador;1;1;2;1830
1501709;Bragança;2927408;Salvador;1;1;2;1590
1502202;Capanema;2927408;Salvador;1;1;2;1594
1502301;Capitão Poço;2927408;Salvador;1;1;2;1546
1502905;Curuçá;2927408;Salvador;1;1;2;1682
1503200;Igarapé-Açu;2927408;Salvador;1;1;2;1634
1503507;Irituia;2927408;Salvador;1;1;2;1568
1504109;Magalhães Barata;2927408;Salvador;1;1;2;1664
1504208;Marabá;2927408;Salvador;1;1;2;1417
1504307;Maracanã;2927408;Salvador;1;1;2;1654
1505403;Ourém;2927408;Salvador;1;1;2;1567
1506203;Salinópolis;2927408;Salvador;1;1;2;1657
1506559;Santa Luzia do Pará;2927408;Salvador;1;1;2;1558
1506609;Santa Maria do Pará;2927408;Salvador;1;1;2;1611
1506906;Santarém Novo;2927408;Salvador;1;1;2;1639
1507607;São Miguel do Guamá;2927408;Salvador;1;1;2;1584
1507755;Sapucaia;2927408;Salvador;1;1;2;1377
1508100;Tucuruí;2927408;Salvador;1;1;2;1580
1508209;Vigia;2927408;Salvador;1;1;2;1691
1508308;Viseu;2927408;Salvador;1;1;2;1543
1702406;Arraias;2927408;Salvador;1;1;2;920
2103000;Caxias;2927408;Salvador;1;1;2;1039
2107506;Paço do Lumiar;2927408;Salvador;1;1;2;1304
2110104;Santa Quitéria do Maranhão;2927408;Salvador;1;1;2;1138
2111201;São José de Ribamar;2927408;Salvador;1;1;2;1302
2301604;Assaré;2927408;Salvador;1;1;2;694
2303709;Caucaia;2927408;Salvador;1;1;2;1025
2304202;Crato;2927408;Salvador;1;1;2;647
2306256;Itaitinga;2927408;Salvador;1;1;2;998
2307254;Jijoca de Jericoacoara;2927408;Salvador;1;1;2;1146
2307809;Marco;2927408;Salvador;1;1;2;1106
2309706;Pacatuba;2927408;Salvador;1;1;2;996
2312908;Sobral;2927408;Salvador;1;1;2;1051
2400703;Alto do Rodrigues;2927408;Salvador;1;1;2;871
2402204;Canguaretama;2927408;Salvador;1;1;2;815
2407104;Macaíba;2927408;Salvador;1;1;2;857
2502805;Brejo do Cruz;2927408;Salvador;1;1;2;742
2601904;Bezerros;2927408;Salvador;1;1;2;600
2605202;Escada;2927408;Salvador;1;1;2;620
2606200;Goiana;2927408;Salvador;1;1;2;707
2607752;Itapissuma;2927408;Salvador;1;1;2;691
2607802;Itaquitinga;2927408;Salvador;1;1;2;691
2614808;Tacaratu;2927408;Salvador;1;1;2;431
2704104;Lagoa da Canoa;2927408;Salvador;1;1;2;397
2708600;São Miguel dos Campos;2927408;Salvador;1;1;2;437
2800670;Boquim;2927408;Salvador;1;1;2;224
2802106;Estância;2927408;Salvador;1;1;2;221
2803005;Itabaianinha;2927408;Salvador;1;1;2;204
2803203;Itaporanga d'Ajuda;2927408;Salvador;1;1;2;254
2805703;Propriá;2927408;Salvador;1;1;2;353
2807600;Umbaúba;2927408;Salvador;1;1;2;199
2900108;Abaíra;2927408;Salvador;1;1;2;348
2900306;Acajutiba;2927408;Salvador;1;1;2;155
2900355;Adustina;2927408;Salvador;1;1;2;275
2901304;Andaraí;2927408;Salvador;1;1;2;310
2901601;Antas;2927408;Salvador;1;1;2;287
2901700;Antônio Cardoso;2927408;Salvador;1;1;2;93
2901809;Antônio Gonçalves;2927408;Salvador;1;1;2;331
2901908;Aporá;2927408;Salvador;1;1;2;153
2902054;Araças;2927408;Salvador;1;1;2;90
2902104;Araci;2927408;Salvador;1;1;2;191
2902252;Arataca;2927408;Salvador;1;1;2;272
2902401;Aurelino Leal;2927408;Salvador;1;1;2;174
2902807;Barra da Estiva;2927408;Salvador;1;1;2;319
2902906;Barra do Choça;2927408;Salvador;1;1;2;310
2903102;Barra do Rocha;2927408;Salvador;1;1;2;180
2903300;Governador Lomanto Júnior;2927408;Salvador;1;1;2;228
2903706;Boa Nova;2927408;Salvador;1;1;2;242
2904001;Boninal;2927408;Salvador;1;1;2;365
2904100;Boquira;2927408;Salvador;1;1;2;462
2904753;Buritirama;2927408;Salvador;1;1;2;612
2904803;Caatiba;2927408;Salvador;1;1;2;305
2904852;Cabaceiras do Paraguaçu;2927408;Salvador;1;1;2;93
2905008;Caculé;2927408;Salvador;1;1;2;444
2905305;Cafarnaum;2927408;Salvador;1;1;2;354
2905503;Caldeirão Grande;2927408;Salvador;1;1;2;294
2905909;Campo Alegre de Lourdes;2927408;Salvador;1;1;2;622
2906303;Canavieiras;2927408;Salvador;1;1;2;301
2906808;Cansanção;2927408;Salvador;1;1;2;279
2906824;Canudos;2927408;Salvador;1;1;2;347
2906907;Caravelas;2927408;Salvador;1;1;2;532
2907004;Cardeal da Silva;2927408;Salvador;1;1;2;129
2907103;Carinhanha;2927408;Salvador;1;1;2;598
2907608;Central;2927408;Salvador;1;1;2;446
2907707;Chorrochó;2927408;Salvador;1;1;2;449
2907806;Cícero Dantas;2927408;Salvador;1;1;2;265
2907905;Cipó;2927408;Salvador;1;1;2;209
2908200;Conceição da Feira;2927408;Salvador;1;1;2;78
2908606;Conde;2927408;Salvador;1;1;2;160
2908705;Condeúba;2927408;Salvador;1;1;2;436
2908804;Contendas do Sincorá;2927408;Salvador;1;1;2;292
2909307;Correntina;2927408;Salvador;1;1;2;670
2909604;Crisópolis;2927408;Salvador;1;1;2;167
2910008;Dário Meira;2927408;Salvador;1;1;2;225
2910750;Fátima;2927408;Salvador;1;1;2;266
2911105;Formosa do Rio Preto;2927408;Salvador;1;1;2;755
2911303;Gentio do Ouro;2927408;Salvador;1;1;2;469
2911501;Gongogi;2927408;Salvador;1;1;2;182
2911600;Governador Mangabeira;2927408;Salvador;1;1;2;75
2911808;Guaratinga;2927408;Salvador;1;1;2;425
2911907;Iaçu;2927408;Salvador;1;1;2;185
2912103;Ibicaraí;2927408;Salvador;1;1;2;237
2912301;Ibicuí;2927408;Salvador;1;1;2;263
2912400;Ibipeba;2927408;Salvador;1;1;2;411
2912806;Ibirapuã;2927408;Salvador;1;1;2;550
2913002;Ibitiara;2927408;Salvador;1;1;2;408
2913101;Ibititá;2927408;Salvador;1;1;2;412
2914208;Irajuba;2927408;Salvador;1;1;2;177
2914406;Iraquara;2927408;Salvador;1;1;2;351
2915007;Itaeté;2927408;Salvador;1;1;2;273
2915304;Itagimirim;2927408;Salvador;1;1;2;365
2915353;Itaguaçu da Bahia;2927408;Salvador;1;1;2;477
2915403;Itaju do Colônia;2927408;Salvador;1;1;2;274
2915502;Itajuípe;2927408;Salvador;1;1;2;211
2915601;Itamaraju;2927408;Salvador;1;1;2;461
2916203;Itapé;2927408;Salvador;1;1;2;235
2916609;Itapitanga;2927408;Salvador;1;1;2;198
2916708;Itaquara;2927408;Salvador;1;1;2;167
2917003;Itiúba;2927408;Salvador;1;1;2;294
2917102;Itororó;2927408;Salvador;1;1;2;290
2917201;Ituaçu;2927408;Salvador;1;1;2;320
2918100;Jeremoabo;2927408;Salvador;1;1;2;323
2918357;João Dourado;2927408;Salvador;1;1;2;390
2918456;Jucuruçu;2927408;Salvador;1;1;2;464
2918555;Jussari;2927408;Salvador;1;1;2;268
2918803;Laje;2927408;Salvador;1;1;2;105
2918902;Lajedão;2927408;Salvador;1;1;2;551
2919058;Lajedo do Tabocal;2927408;Salvador;1;1;2;198
2919157;Lapão;2927408;Salvador;1;1;2;405
2919306;Lençóis;2927408;Salvador;1;1;2;319
2919702;Macarani;2927408;Salvador;1;1;2;356
2919801;Macaúbas;2927408;Salvador;1;1;2;462
2920106;Mairi;2927408;Salvador;1;1;2;230
2920205;Malhada;2927408;Salvador;1;1;2;596
2920403;Manoel Vitorino;2927408;Salvador;1;1;2;227
2920502;Maracás;2927408;Salvador;1;1;2;217
2921104;Medeiros Neto;2927408;Salvador;1;1;2;520
2921203;Miguel Calmon;2927408;Salvador;1;1;2;287
2921500;Monte Santo;2927408;Salvador;1;1;2;297
2921609;Morpará;2927408;Salvador;1;1;2;541
2922052;Mulungu do Morro;2927408;Salvador;1;1;2;361
2922102;Mundo Novo;2927408;Salvador;1;1;2;251
2922201;Muniz Ferreira;2927408;Salvador;1;1;2;69
2922250;Muquém de São Francisco;2927408;Salvador;1;1;2;559
2922607;Nilo Peçanha;2927408;Salvador;1;1;2;98
2922706;Nova Canaã;2927408;Salvador;1;1;2;270
2922854;Nova Redenção;2927408;Salvador;1;1;2;282
2923001;Nova Viçosa;2927408;Salvador;1;1;2;550
2923100;Olindina;2927408;Salvador;1;1;2;180
2923605;Paramirim;2927408;Salvador;1;1;2;414
2923704;Paratinga;2927408;Salvador;1;1;2;510
2923803;Paripiranga;2927408;Salvador;1;1;2;264
2923902;Pau Brasil;2927408;Salvador;1;1;2;302
2924306;Piatã;2927408;Salvador;1;1;2;359
2924405;Pilão Arcado;2927408;Salvador;1;1;2;548
2924678;Piraí do Norte;2927408;Salvador;1;1;2;130
2924801;Piritiba;2927408;Salvador;1;1;2;265
2924900;Planaltino;2927408;Salvador;1;1;2;208
2925105;Poções;2927408;Salvador;1;1;2;264
2925253;Ponto Novo;2927408;Salvador;1;1;2;296
2925501;Prado;2927408;Salvador;1;1;2;486
2925758;Presidente Tancredo Neves;2927408;Salvador;1;1;2;115
2925808;Queimadas;2927408;Salvador;1;1;2;255
2925907;Quijingue;2927408;Salvador;1;1;2;260
2925956;Rafael Jambeiro;2927408;Salvador;1;1;2;129
2926103;Retirolândia;2927408;Salvador;1;1;2;195
2926202;Riachão das Neves;2927408;Salvador;1;1;2;710
2926657;Ribeirão do Largo;2927408;Salvador;1;1;2;368
2926707;Rio de Contas;2927408;Salvador;1;1;2;368
2927309;Salinas da Margarida;2927408;Salvador;1;1;2;34
2916104;Itaparica;2927309;Salinas da Margarida;1;1;2;12
2920601;Maragogipe;2927309;Salinas da Margarida;1;1;2;24
2903805;Boa Vista do Tupim;2927200;Ruy Barbosa;1;1;2;41
2904308;Brejões;2927200;Ruy Barbosa;1;1;2;117
2910800;Feira de Santana;2927200;Ruy Barbosa;1;1;2;166
2917508;Jacobina;2927200;Ruy Barbosa;1;1;2;117
2919603;Macajuba;2927200;Ruy Barbosa;1;1;2;23
2921203;Miguel Calmon;2927200;Ruy Barbosa;1;1;2;97
2922854;Nova Redenção;2927200;Ruy Barbosa;1;1;2;85
2924801;Piritiba;2927200;Ruy Barbosa;1;1;2;64
2612208;Salgueiro;2927101;Rodelas;1;1;2;90
2919900;Macururé;2927101;Rodelas;1;1;2;46
2801306;Capela;2927002;Rio Real;1;1;2;139
2804003;Maruim;2927002;Rio Real;1;1;2;121
2807600;Umbaúba;2927002;Rio Real;1;1;2;29
2900306;Acajutiba;2927002;Rio Real;1;1;2;24
2900702;Alagoinhas;2927002;Rio Real;1;1;2;93
2909604;Crisópolis;2927002;Rio Real;1;1;2;27
2910503;Entre Rios;2927002;Rio Real;1;1;2;53
2910602;Esplanada;2927002;Rio Real;1;1;2;38
2910800;Feira de Santana;2927002;Rio Real;1;1;2;147
2917607;Jaguaquara;2927002;Rio Real;1;1;2;319
2904100;Boquira;2926905;Rio do Pires;1;1;2;60
2912509;Ibipitanga;2926905;Rio do Pires;1;1;2;30
2913408;Igaporã;2926905;Rio do Pires;1;1;2;88
2919504;Livramento de Nossa Senhora;2926905;Rio do Pires;1;1;2;74
2919801;Macaúbas;2926905;Rio do Pires;1;1;2;51
2903201;Barreiras;2926806;Rio do Antônio;1;1;2;395
2903904;Bom Jesus da Lapa;2926806;Rio do Antônio;1;1;2;188
2904605;Brumado;2926806;Rio do Antônio;1;1;2;51
2911659;Guajeru;2926806;Rio do Antônio;1;1;2;21
2921807;Mortugaba;2926806;Rio do Antônio;1;1;2;75
2904605;Brumado;2926707;Rio de Contas;1;1;2;71
2919504;Livramento de Nossa Senhora;2926707;Rio de Contas;1;1;2;6
2919702;Macarani;2926657;Ribeirão do Largo;1;1;2;36
2920007;Maiquinique;2926657;Ribeirão do Largo;1;1;2;54
2507507;João Pessoa;2926608;Ribeira do Pombal;1;1;2;568
2702405;Delmiro Gouveia;2926608;Ribeira do Pombal;1;1;2;173
2704302;Maceió;2926608;Ribeira do Pombal;1;1;2;333
2802106;Estância;2926608;Ribeira do Pombal;1;1;2;127
2807105;Simão Dias;2926608;Ribeira do Pombal;1;1;2;83
2900355;Adustina;2926608;Ribeira do Pombal;1;1;2;59
2922904;Nova Soure;2926608;Ribeira do Pombal;1;1;2;46
2304400;Fortaleza;2926509;Ribeira do Amparo;1;1;2;805
2907905;Cipó;2926509;Ribeira do Amparo;1;1;2;11
2903201;Barreiras;2926400;Riacho de Santana;1;1;2;266
2905503;Caldeirão Grande;2926301;Riachão do Jacuípe;1;1;2;135
2905701;Camaçari;2926301;Riachão do Jacuípe;1;1;2;149
2906501;Candeias;2926301;Riachão do Jacuípe;1;1;2;130
2906857;Capela do Alto Alegre;2926301;Riachão do Jacuípe;1;1;2;56
2926103;Retirolândia;2926301;Riachão do Jacuípe;1;1;2;34
2211001;Teresina;2926202;Riachão das Neves;1;1;2;771
2903904;Bom Jesus da Lapa;2926202;Riachão das Neves;1;1;2;238
2918407;Juazeiro;2926202;Riachão das Neves;1;1;2;539
2922656;Nordestina;2926103;Retirolândia;1;1;2;74
2203909;Floriano;2926004;Remanso;1;1;2;322
2211001;Teresina;2926004;Remanso;1;1;2;501
2603009;Cabrobó;2926004;Remanso;1;1;2;332
2611101;Petrolina;2926004;Remanso;1;1;2;174
2904704;Buerarema;2925956;Rafael Jambeiro;1;1;2;283
2905701;Camaçari;2925956;Rafael Jambeiro;1;1;2;131
2906204;Canarana;2925956;Rafael Jambeiro;1;1;2;259
2907301;Castro Alves;2925956;Rafael Jambeiro;1;1;2;40
2918407;Juazeiro;2925956;Rafael Jambeiro;1;1;2;343
2925105;Poções;2925956;Rafael Jambeiro;1;1;2;249
2920106;Mairi;2925931;Quixabeira;1;1;2;33
2921203;Miguel Calmon;2925931;Quixabeira;1;1;2;51
2922102;Mundo Novo;2925931;Quixabeira;1;1;2;56
2925303;Porto Seguro;2925931;Quixabeira;1;1;2;565
2612208;Salgueiro;2925907;Quijingue;1;1;2;291
2906824;Canudos;2925907;Quijingue;1;1;2;91
2909604;Crisópolis;2925907;Quijingue;1;1;2;143
2910800;Feira de Santana;2925907;Quijingue;1;1;2;172
2922656;Nordestina;2925907;Quijingue;1;1;2;25
2905701;Camaçari;2925808;Queimadas;1;1;2;237
2906006;Campo Formoso;2925808;Queimadas;1;1;2;92
2908408;Conceição do Coité;2925808;Queimadas;1;1;2;73
2911253;Gavião;2925808;Queimadas;1;1;2;59
2917508;Jacobina;2925808;Queimadas;1;1;2;100
2920106;Mairi;2925808;Queimadas;1;1;2;101
2922102;Mundo Novo;2925808;Queimadas;1;1;2;130
2925204;Pojuca;2925808;Queimadas;1;1;2;215
2925253;Ponto Novo;2925808;Queimadas;1;1;2;58
2913606;Ilhéus;2925758;Presidente Tancredo Neves;1;1;2;152
2917300;Ituberá;2925758;Presidente Tancredo Neves;1;1;2;43
2918803;Laje;2925758;Presidente Tancredo Neves;1;1;2;30
2904605;Brumado;2925709;Presidente Jânio Quadros;1;1;2;54
2908705;Condeúba;2925709;Presidente Jânio Quadros;1;1;2;40
2909000;Cordeiros;2925709;Presidente Jânio Quadros;1;1;2;48
2912806;Ibirapuã;2925501;Prado;1;1;2;98
2913606;Ilhéus;2925501;Prado;1;1;2;280
2918001;Jequié;2925501;Prado;1;1;2;397
2923001;Nova Viçosa;2925501;Prado;1;1;2;65
2913606;Ilhéus;2925402;Potiraguá;1;1;2;120
2920908;Mascote;2925402;Potiraguá;1;1;2;62
2925303;Porto Seguro;2925402;Potiraguá;1;1;2;122
2900801;Alcobaça;2925303;Porto Seguro;1;1;2;118
2905404;Cairu;2925303;Porto Seguro;1;1;2;327
2905701;Camaçari;2925303;Porto Seguro;1;1;2;422
2906501;Candeias;2925303;Porto Seguro;1;1;2;420
2912202;Ibicoara;2925303;Porto Seguro;1;1;2;404
2912301;Ibicuí;2925303;Porto Seguro;1;1;2;197
2916302;Itapebi;2925303;Porto Seguro;1;1;2;68
2918001;Jequié;2925303;Porto Seguro;1;1;2;306
2920502;Maracás;2925303;Porto Seguro;1;1;2;356
2923001;Nova Viçosa;2925303;Porto Seguro;1;1;2;163
2925105;Poções;2925303;Porto Seguro;1;1;2;249
2910800;Feira de Santana;2925253;Ponto Novo;1;1;2;203
2910859;Filadélfia;2925253;Ponto Novo;1;1;2;13
2610707;Paulista;2925204;Pojuca;1;1;2;621
2900405;Água Fria;2925204;Pojuca;1;1;2;79
2901908;Aporá;2925204;Pojuca;1;1;2;89
2906808;Cansanção;2925204;Pojuca;1;1;2;232
2907004;Cardeal da Silva;2925204;Pojuca;1;1;2;68
2917003;Itiúba;2925204;Pojuca;1;1;2;252
2921500;Monte Santo;2925204;Pojuca;1;1;2;246
2923100;Olindina;2925204;Pojuca;1;1;2;118
2923308;Ouriçangas;2925204;Pojuca;1;1;2;56
2903953;Bom Jesus da Serra;2925105;Poções;1;1;2;22
2906501;Candeias;2925105;Poções;1;1;2;280
2906709;Cândido Sales;2925105;Poções;1;1;2;146
2910800;Feira de Santana;2925105;Poções;1;1;2;286
2911709;Guanambi;2925105;Poções;1;1;2;264
2911907;Iaçu;2925105;Poções;1;1;2;189
2915007;Itaeté;2925105;Poções;1;1;2;179
2916856;Itatim;2925105;Poções;1;1;2;210
2917607;Jaguaquara;2925105;Poções;1;1;2;117
2921302;Milagres;2925105;Poções;1;1;2;188
2908507;Conceição do Jacuípe;2925006;Planalto;1;1;2;318
2918803;Laje;2925006;Planalto;1;1;2;201
2920403;Manoel Vitorino;2925006;Planalto;1;1;2;70
2920403;Manoel Vitorino;2924900;Planaltino;1;1;2;92
2906873;Capim Grosso;2924801;Piritiba;1;1;2;71
2911907;Iaçu;2924801;Piritiba;1;1;2;126
2914000;Ipirá;2924801;Piritiba;1;1;2;102
2921203;Miguel Calmon;2924801;Piritiba;1;1;2;34
2908705;Condeúba;2924702;Piripá;1;1;2;27
2914000;Ipirá;2924652;Pintadas;1;1;2;47
2920106;Mairi;2924652;Pintadas;1;1;2;28
2906006;Campo Formoso;2924603;Pindobaçu;1;1;2;27
2906873;Capim Grosso;2924603;Pindobaçu;1;1;2;80
2913200;Ibotirama;2924603;Pindobaçu;1;1;2;350
2914604;Irecê;2924603;Pindobaçu;1;1;2;177
2905206;Caetité;2924504;Pindaí;1;1;2;50
2210607;São Raimundo Nonato;2924405;Pilão Arcado;1;1;2;113
2211001;Teresina;2924405;Pilão Arcado;1;1;2;540
2918407;Juazeiro;2924405;Pilão Arcado;1;1;2;223
2908507;Conceição do Jacuípe;2924108;Pedrão;1;1;2;25
2906873;Capim Grosso;2924058;Pé de Serra;1;1;2;66
2907301;Castro Alves;2924058;Pé de Serra;1;1;2;105
2910800;Feira de Santana;2924058;Pé de Serra;1;1;2;87
2922730;Nova Fátima;2924058;Pé de Serra;1;1;2;25
2504009;Campina Grande;2924009;Paulo Afonso;1;1;2;361
2507507;João Pessoa;2924009;Paulo Afonso;1;1;2;453
2607901;Jaboatão dos Guararapes;2924009;Paulo Afonso;1;1;2;389
2609154;Manari;2924009;Paulo Afonso;1;1;2;92
2609600;Olinda;2924009;Paulo Afonso;1;1;2;407
2705705;Olho d'Água das Flores;2924009;Paulo Afonso;1;1;2;115
2707107;Piranhas;2924009;Paulo Afonso;1;1;2;67
2802908;Itabaiana;2924009;Paulo Afonso;1;1;2;166
2906501;Candeias;2924009;Paulo Afonso;1;1;2;362
2909802;Cruz das Almas;2924009;Paulo Afonso;1;1;2;375
2910800;Feira de Santana;2924009;Paulo Afonso;1;1;2;326
2911402;Glória;2924009;Paulo Afonso;1;1;2;8
2914604;Irecê;2924009;Paulo Afonso;1;1;2;444
2916500;Itapicuru;2924009;Paulo Afonso;1;1;2;209
2917607;Jaguaquara;2924009;Paulo Afonso;1;1;2;489
2919553;Luís Eduardo magalhães;2924009;Paulo Afonso;1;1;2;878
2923803;Paripiranga;2924009;Paulo Afonso;1;1;2;148
2912103;Ibicaraí;2923902;Pau Brasil;1;1;2;69
2914802;Itabuna;2923902;Pau Brasil;1;1;2;84
2918555;Jussari;2923902;Pau Brasil;1;1;2;35
2700300;Arapiraca;2923803;Paripiranga;1;1;2;164
2909208;Coronel João Sá;2923803;Paripiranga;1;1;2;43
2910750;Fátima;2923803;Paripiranga;1;1;2;38
2916401;Itapetinga;2923803;Paripiranga;1;1;2;573
2903201;Barreiras;2923704;Paratinga;1;1;2;205
2903201;Barreiras;2923605;Paramirim;1;1;2;324
2912509;Ibipitanga;2923605;Paramirim;1;1;2;63
2908507;Conceição do Jacuípe;2923506;Palmeiras;1;1;2;304
2914406;Iraquara;2923506;Palmeiras;1;1;2;32
2921906;Mucugê;2923506;Palmeiras;1;1;2;56
2903904;Bom Jesus da Lapa;2923407;Palmas de Monte Alto;1;1;2;112
2905008;Caculé;2923407;Palmas de Monte Alto;1;1;2;102
2905206;Caetité;2923407;Palmas de Monte Alto;1;1;2;74
2906600;Candiba;2923407;Palmas de Monte Alto;1;1;2;36
2917334;Iuiú;2923407;Palmas de Monte Alto;1;1;2;45
2800308;Aracaju;2923357;Ourolândia;1;1;2;435
2900702;Alagoinhas;2923308;Ouriçangas;1;1;2;24
2913705;Inhambupe;2923308;Ouriçangas;1;1;2;39
2903201;Barreiras;2923209;Oliveira dos Brejinhos;1;1;2;226
2904100;Boquira;2923209;Oliveira dos Brejinhos;1;1;2;58
2904506;Brotas de Macaúbas;2923209;Oliveira dos Brejinhos;1;1;2;47
2910800;Feira de Santana;2923209;Oliveira dos Brejinhos;1;1;2;428
2913002;Ibitiara;2923209;Oliveira dos Brejinhos;1;1;2;83
2913200;Ibotirama;2923209;Oliveira dos Brejinhos;1;1;2;38
2917607;Jaguaquara;2923209;Oliveira dos Brejinhos;1;1;2;347
2918001;Jequié;2923209;Oliveira dos Brejinhos;1;1;2;350
2919801;Macaúbas;2923209;Oliveira dos Brejinhos;1;1;2;80
2921609;Morpará;2923209;Oliveira dos Brejinhos;1;1;2;92
2611606;Recife;2923100;Olindina;1;1;2;515
2804805;Nossa Senhora do Socorro;2923100;Olindina;1;1;2;142
2900702;Alagoinhas;2923100;Olindina;1;1;2;85
2905701;Camaçari;2923100;Olindina;1;1;2;147
2907301;Castro Alves;2923100;Olindina;1;1;2;196
2909604;Crisópolis;2923100;Olindina;1;1;2;26
2916500;Itapicuru;2923100;Olindina;1;1;2;15
2922904;Nova Soure;2923100;Olindina;1;1;2;23
2900801;Alcobaça;2923001;Nova Viçosa;1;1;2;50
2906907;Caravelas;2923001;Nova Viçosa;1;1;2;29
2912806;Ibirapuã;2923001;Nova Viçosa;1;1;2;66
2918001;Jequié;2923001;Nova Viçosa;1;1;2;451
2918902;Lajedão;2923001;Nova Viçosa;1;1;2;93
2900306;Acajutiba;2922904;Nova Soure;1;1;2;70
2902104;Araci;2922904;Nova Soure;1;1;2;52
2909604;Crisópolis;2922904;Nova Soure;1;1;2;48
2914703;Itaberaba;2922904;Nova Soure;1;1;2;248
2912202;Ibicoara;2922854;Nova Redenção;1;1;2;70
2919603;Macajuba;2922854;Nova Redenção;1;1;2;108
2920502;Maracás;2922805;Nova Itarana;1;1;2;60
2906873;Capim Grosso;2922730;Nova Fátima;1;1;2;49
2914000;Ipirá;2922730;Nova Fátima;1;1;2;68
2913606;Ilhéus;2922706;Nova Canaã;1;1;2;110
2921500;Monte Santo;2922656;Nordestina;1;1;2;44
2917300;Ituberá;2922607;Nilo Peçanha;1;1;2;13
2303709;Caucaia;2922508;Nazaré;1;1;2;1030
2304400;Fortaleza;2922508;Nazaré;1;1;2;1026
2906501;Candeias;2922508;Nazaré;1;1;2;67
2910008;Dário Meira;2922508;Nazaré;1;1;2;183
2911204;Gandu;2922508;Nazaré;1;1;2;93
2917805;Jaguaripe;2922508;Nazaré;1;1;2;15
2918001;Jequié;2922508;Nazaré;1;1;2;142
2922201;Muniz Ferreira;2922508;Nazaré;1;1;2;9
2922409;Mutuípe;2922508;Nazaré;1;1;2;55
2907301;Castro Alves;2922409;Mutuípe;1;1;2;52
2918209;Jiquiriçá;2922409;Mutuípe;1;1;2;8
2804805;Nossa Senhora do Socorro;2922300;Muritiba;1;1;2;281
2907301;Castro Alves;2922300;Muritiba;1;1;2;48
2908200;Conceição da Feira;2922300;Muritiba;1;1;2;13
2908507;Conceição do Jacuípe;2922300;Muritiba;1;1;2;41
2911600;Governador Mangabeira;2922300;Muritiba;1;1;2;4
2611101;Petrolina;2922250;Muquém de São Francisco;1;1;2;447
2903201;Barreiras;2922250;Muquém de São Francisco;1;1;2;157
2913200;Ibotirama;2922250;Muquém de São Francisco;1;1;2;38
2304400;Fortaleza;2922102;Mundo Novo;1;1;2;912
2914000;Ipirá;2922102;Mundo Novo;1;1;2;88
1100023;Ariquemes;2922003;Mucuri;1;1;2;2597
1600600;Santana;2922003;Mucuri;1;1;2;2318
2607901;Jaboatão dos Guararapes;2922003;Mucuri;1;1;2;1189
2915304;Itagimirim;2922003;Mucuri;1;1;2;210
2918001;Jequié;2922003;Mucuri;1;1;2;465
2914703;Itaberaba;2921906;Mucugê;1;1;2;126
2918605;Jussiape;2921906;Mucugê;1;1;2;62
2304400;Fortaleza;2921708;Morro do Chapéu;1;1;2;907
2905305;Cafarnaum;2921708;Morro do Chapéu;1;1;2;38
2917508;Jacobina;2921708;Morro do Chapéu;1;1;2;80
2918357;João Dourado;2921708;Morro do Chapéu;1;1;2;61
2919207;Lauro de Freitas;2921708;Morro do Chapéu;1;1;2;342
2913200;Ibotirama;2921609;Morpará;1;1;2;68
2914109;Ipupiara;2921609;Morpará;1;1;2;74
2914604;Irecê;2921609;Morpará;1;1;2;154
2612208;Salgueiro;2921500;Monte Santo;1;1;2;256
2910800;Feira de Santana;2921500;Monte Santo;1;1;2;209
2917003;Itiúba;2921500;Monte Santo;1;1;2;59
2903706;Boa Nova;2921450;Mirante;1;1;2;62
2904605;Brumado;2921450;Mirante;1;1;2;95
2917201;Ituaçu;2921450;Mirante;1;1;2;74
2900702;Alagoinhas;2921401;Mirangaba;1;1;2;269
2901007;Amargosa;2921302;Milagres;1;1;2;33
2907301;Castro Alves;2921302;Milagres;1;1;2;48
2916856;Itatim;2921302;Milagres;1;1;2;25
2919553;Luís Eduardo magalhães;2921302;Milagres;1;1;2;651
2905701;Camaçari;2921203;Miguel Calmon;1;1;2;285
2918407;Juazeiro;2921203;Miguel Calmon;1;1;2;216
2304400;Fortaleza;2921104;Medeiros Neto;1;1;2;1513
2900801;Alcobaça;2921104;Medeiros Neto;1;1;2;106
2906907;Caravelas;2921104;Medeiros Neto;1;1;2;109
2915601;Itamaraju;2921104;Medeiros Neto;1;1;2;83
2913408;Igaporã;2921054;Matina;1;1;2;21
2800308;Aracaju;2921005;Mata de São João;1;1;2;224
2911600;Governador Mangabeira;2921005;Mata de São João;1;1;2;81
2919553;Luís Eduardo magalhães;2921005;Mata de São João;1;1;2;818
2903409;Belmonte;2920908;Mascote;1;1;2;52
2915809;Itambé;2920908;Mascote;1;1;2;146
2911907;Iaçu;2920809;Marcionílio Souza;1;1;2;45
2917607;Jaguaquara;2920809;Marcionílio Souza;1;1;2;80
2908002;Coaraci;2920700;Maraú;1;1;2;78
2910800;Feira de Santana;2920700;Maraú;1;1;2;201
2913903;Ipiaú;2920700;Maraú;1;1;2;74
2914802;Itabuna;2920700;Maraú;1;1;2;81
2914901;Itacaré;2920700;Maraú;1;1;2;19
2800308;Aracaju;2920601;Maragogipe;1;1;2;291
2905701;Camaçari;2920601;Maragogipe;1;1;2;69
2910800;Feira de Santana;2920601;Maragogipe;1;1;2;55
2911600;Governador Mangabeira;2920601;Maragogipe;1;1;2;22
2904605;Brumado;2920502;Maracás;1;1;2;158
2906204;Canarana;2920502;Maracás;1;1;2;244
2910727;Eunápolis;2920502;Maracás;1;1;2;335
2914653;Itabela;2920502;Maracás;1;1;2;358
2919058;Lajedo do Tabocal;2920502;Maracás;1;1;2;21
2204501;Guadalupe;2920452;Mansidão;1;1;2;438
2900207;Abaré;2920403;Manoel Vitorino;1;1;2;605
2907301;Castro Alves;2920403;Manoel Vitorino;1;1;2;170
2902005;Aracatu;2920304;Malhada de Pedras;1;1;2;45
2911659;Guajeru;2920304;Malhada de Pedras;1;1;2;19
2919959;Maetinga;2920304;Malhada de Pedras;1;1;2;52
2907103;Carinhanha;2920205;Malhada;1;1;2;11
2917334;Iuiú;2920205;Malhada;1;1;2;25
2906873;Capim Grosso;2920106;Mairi;1;1;2;39
2914000;Ipirá;2920106;Mairi;1;1;2;70
2914703;Itaberaba;2920106;Mairi;1;1;2;96
2916807;Itarantim;2920007;Maiquinique;1;1;2;22
2919702;Macarani;2920007;Maiquinique;1;1;2;18
2904605;Brumado;2919959;Maetinga;1;1;2;54
1302603;Manaus;2919926;Madre de Deus;1;1;2;2529
1501402;Belém;2919926;Madre de Deus;1;1;2;1637
1600600;Santana;2919926;Madre de Deus;1;1;2;1945
2313302;Tauá;2919926;Madre de Deus;1;1;2;768
2905701;Camaçari;2919926;Madre de Deus;1;1;2;32
2601607;Belém de São Francisco;2919900;Macururé;1;1;2;53
2612208;Salgueiro;2919900;Macururé;1;1;2;116
2905008;Caculé;2919801;Macaúbas;1;1;2;173
2905206;Caetité;2919801;Macaúbas;1;1;2;119
2910800;Feira de Santana;2919801;Macaúbas;1;1;2;416
2912509;Ibipitanga;2919801;Macaúbas;1;1;2;35
2913200;Ibotirama;2919801;Macaúbas;1;1;2;108
2915809;Itambé;2919702;Macarani;1;1;2;41
2914703;Itaberaba;2919603;Macajuba;1;1;2;49
1709302;Guaraí;2919553;Luís Eduardo magalhães;1;1;2;461
1709500;Gurupi;2919553;Luís Eduardo magalhães;1;1;2;356
1714203;Natividade;2919553;Luís Eduardo magalhães;1;1;2;218
1718204;Porto Nacional;2919553;Luís Eduardo magalhães;1;1;2;317
2204402;Gilbués;2919553;Luís Eduardo magalhães;1;1;2;255
2211209;Uruçuí;2919553;Luís Eduardo magalhães;1;1;2;557
2307650;Maracanaú;2919553;Luís Eduardo magalhães;1;1;2;1194
2408102;Natal;2919553;Luís Eduardo magalhães;1;1;2;1335
2700300;Arapiraca;2919553;Luís Eduardo magalhães;1;1;2;1022
2803609;Laranjeiras;2919553;Luís Eduardo magalhães;1;1;2;950
2901403;Angical;2919553;Luís Eduardo magalhães;1;1;2;122
2907608;Central;2919553;Luís Eduardo magalhães;1;1;2;417
2913200;Ibotirama;2919553;Luís Eduardo magalhães;1;1;2;283
2917359;Jaborandi;2919553;Luís Eduardo magalhães;1;1;2;222
2918407;Juazeiro;2919553;Luís Eduardo magalhães;1;1;2;643
2919207;Lauro de Freitas;2919553;Luís Eduardo magalhães;1;1;2;821
2903201;Barreiras;2919504;Livramento de Nossa Senhora;1;1;2;374
2904209;Botuporã;2919504;Livramento de Nossa Senhora;1;1;2;79
2905206;Caetité;2919504;Livramento de Nossa Senhora;1;1;2;88
2910107;Dom Basílio;2919504;Livramento de Nossa Senhora;1;1;2;16
2916401;Itapetinga;2919504;Livramento de Nossa Senhora;1;1;2;251
2918001;Jequié;2919504;Livramento de Nossa Senhora;1;1;2;192
2918605;Jussiape;2919504;Livramento de Nossa Senhora;1;1;2;29
2913606;Ilhéus;2919405;Licínio de Almeida;1;1;2;365
2917409;Jacaraci;2919405;Licínio de Almeida;1;1;2;20
2903201;Barreiras;2919306;Lençóis;1;1;2;393
2910800;Feira de Santana;2919306;Lençóis;1;1;2;265
1302603;Manaus;2919207;Lauro de Freitas;1;1;2;2563
1501402;Belém;2919207;Lauro de Freitas;1;1;2;1669
1600303;Macapá;2919207;Lauro de Freitas;1;1;2;1978
1716109;Paraíso do Tocantins;2919207;Lauro de Freitas;1;1;2;1182
2103000;Caxias;2919207;Lauro de Freitas;1;1;2;1037
2111300;São Luís;2919207;Lauro de Freitas;1;1;2;1308
2309607;Pacajus;2919207;Lauro de Freitas;1;1;2;963
2411809;São Fernando;2919207;Lauro de Freitas;1;1;2;730
2507507;João Pessoa;2919207;Lauro de Freitas;1;1;2;731
2601706;Belo Jardim;2919207;Lauro de Freitas;1;1;2;540
2604106;Caruaru;2919207;Lauro de Freitas;1;1;2;567
2609600;Olinda;2919207;Lauro de Freitas;1;1;2;654
2806701;São Cristóvão;2919207;Lauro de Freitas;1;1;2;244
2903201;Barreiras;2919207;Lauro de Freitas;1;1;2;725
2906873;Capim Grosso;2919207;Lauro de Freitas;1;1;2;247
2906907;Caravelas;2919207;Lauro de Freitas;1;1;2;547
2907509;Catu;2919207;Lauro de Freitas;1;1;2;58
2907806;Cícero Dantas;2919207;Lauro de Freitas;1;1;2;253
2907905;Cipó;2919207;Lauro de Freitas;1;1;2;198
2908507;Conceição do Jacuípe;2919207;Lauro de Freitas;1;1;2;77
2909802;Cruz das Almas;2919207;Lauro de Freitas;1;1;2;82
2910503;Entre Rios;2919207;Lauro de Freitas;1;1;2;111
2910727;Eunápolis;2919207;Lauro de Freitas;1;1;2;410
2911709;Guanambi;2919207;Lauro de Freitas;1;1;2;511
2911808;Guaratinga;2919207;Lauro de Freitas;1;1;2;442
2913705;Inhambupe;2919207;Lauro de Freitas;1;1;2;121
2914000;Ipirá;2919207;Lauro de Freitas;1;1;2;172
2916302;Itapebi;2919207;Lauro de Freitas;1;1;2;364
2916401;Itapetinga;2919207;Lauro de Freitas;1;1;2;339
2916500;Itapicuru;2919207;Lauro de Freitas;1;1;2;176
2917607;Jaguaquara;2919207;Lauro de Freitas;1;1;2;191
2918407;Juazeiro;2919207;Lauro de Freitas;1;1;2;445
2503704;Cajazeiras;2919157;Lapão;1;1;2;609
2912400;Ibipeba;2919157;Lapão;1;1;2;35
2913101;Ibititá;2919157;Lapão;1;1;2;24
2914000;Ipirá;2919157;Lapão;1;1;2;245
2915353;Itaguaçu da Bahia;2919157;Lapão;1;1;2;74
2903276;Barrocas;2919108;Lamarão;1;1;2;33
2904308;Brejões;2919058;Lajedo do Tabocal;1;1;2;62
2906501;Candeias;2919009;Lajedinho;1;1;2;259
2912608;Ibiquera;2919009;Lajedinho;1;1;2;33
2901106;Amélia Rodrigues;2918902;Lajedão;1;1;2;599
2901007;Amargosa;2918803;Laje;1;1;2;26
2917607;Jaguaquara;2918803;Laje;1;1;2;69
2918209;Jiquiriçá;2918803;Laje;1;1;2;18
2905008;Caculé;2918753;Lagoa Real;1;1;2;54
2905206;Caetité;2918753;Lagoa Real;1;1;2;39
2918001;Jequié;2918704;Lafaiete Coutinho;1;1;2;23
2900108;Abaíra;2918605;Jussiape;1;1;2;31
2904001;Boninal;2918605;Jussiape;1;1;2;94
2912202;Ibicoara;2918605;Jussiape;1;1;2;35
2902252;Arataca;2918555;Jussari;1;1;2;12
2911006;Floresta Azul;2918555;Jussari;1;1;2;41
2912103;Ibicaraí;2918555;Jussari;1;1;2;38
2914802;Itabuna;2918555;Jussari;1;1;2;50
2915502;Itajuípe;2918555;Jussari;1;1;2;58
2915601;Itamaraju;2918555;Jussari;1;1;2;203
1100205;Porto Velho;2918506;Jussara;1;1;2;2399
2903201;Barreiras;2918506;Jussara;1;1;2;354
2916005;Itanhém;2918456;Jucuruçu;1;1;2;41
2105302;Imperatriz;2918407;Juazeiro;1;1;2;874
2210607;São Raimundo Nonato;2918407;Juazeiro;1;1;2;249
2304285;Eusébio;2918407;Juazeiro;1;1;2;657
2306405;Itapipoca;2918407;Juazeiro;1;1;2;668
2307304;Juazeiro do Norte;2918407;Juazeiro;1;1;2;282
2307650;Maracanaú;2918407;Juazeiro;1;1;2;654
2408102;Natal;2918407;Juazeiro;1;1;2;704
2504603;Conde;2918407;Juazeiro;1;1;2;661
2604106;Caruaru;2918407;Juazeiro;1;1;2;513
2605152;Dormentes;2918407;Juazeiro;1;1;2;117
2605707;Floresta;2918407;Juazeiro;1;1;2;232
2606002;Garanhuns;2918407;Juazeiro;1;1;2;443
2609808;Orocó;2918407;Juazeiro;1;1;2;145
2615300;Timbaúba;2918407;Juazeiro;1;1;2;611
2704302;Maceió;2918407;Juazeiro;1;1;2;524
2900702;Alagoinhas;2918407;Juazeiro;1;1;2;374
2902401;Aurelino Leal;2918407;Juazeiro;1;1;2;552
2902708;Barra;2918407;Juazeiro;1;1;2;341
2903201;Barreiras;2918407;Juazeiro;1;1;2;578
2905701;Camaçari;2918407;Juazeiro;1;1;2;431
2905909;Campo Alegre de Lourdes;2918407;Juazeiro;1;1;2;274
2906501;Candeias;2918407;Juazeiro;1;1;2;415
2906873;Capim Grosso;2918407;Juazeiro;1;1;2;218
2910057;Dias d'Ávila;2918407;Juazeiro;1;1;2;425
2913606;Ilhéus;2918407;Juazeiro;1;1;2;608
2503704;Cajazeiras;2918357;João Dourado;1;1;2;595
2903904;Bom Jesus da Lapa;2918357;João Dourado;1;1;2;284
2905701;Camaçari;2918357;João Dourado;1;1;2;394
2900603;Aiquara;2918308;Jitaúna;1;1;2;16
2901957;Apuarema;2918308;Jitaúna;1;1;2;20
2915205;Itagibá;2918308;Jitaúna;1;1;2;34
2918001;Jequié;2918308;Jitaúna;1;1;2;28
2914703;Itaberaba;2918209;Jiquiriçá;1;1;2;109
2611606;Recife;2918100;Jeremoabo;1;1;2;431
2700300;Arapiraca;2918100;Jeremoabo;1;1;2;184
2901601;Antas;2918100;Jeremoabo;1;1;2;36
2907806;Cícero Dantas;2918100;Jeremoabo;1;1;2;59
2910750;Fátima;2918100;Jeremoabo;1;1;2;60
2910800;Feira de Santana;2918100;Jeremoabo;1;1;2;254
2604106;Caruaru;2918001;Jequié;1;1;2;751
2607208;Ipojuca;2918001;Jequié;1;1;2;804
2607901;Jaboatão dos Guararapes;2918001;Jequié;1;1;2;829
2704302;Maceió;2918001;Jequié;1;1;2;654
2800308;Aracaju;2918001;Jequié;1;1;2;455
2804805;Nossa Senhora do Socorro;2918001;Jequié;1;1;2;454
2900702;Alagoinhas;2918001;Jequié;1;1;2;257
2901007;Amargosa;2918001;Jequié;1;1;2;100
2901957;Apuarema;2918001;Jequié;1;1;2;36
2902401;Aurelino Leal;2918001;Jequié;1;1;2;98
2902609;Baixa Grande;2918001;Jequié;1;1;2;205
2903201;Barreiras;2918001;Jequié;1;1;2;558
2904308;Brejões;2918001;Jequié;1;1;2;84
2908408;Conceição do Coité;2918001;Jequié;1;1;2;271
2909505;Cravolândia;2918001;Jequié;1;1;2;57
2910008;Dário Meira;2918001;Jequié;1;1;2;70
2911501;Gongogi;2918001;Jequié;1;1;2;84
2912905;Ibirataia;2918001;Jequié;1;1;2;55
2915601;Itamaraju;2918001;Jequié;1;1;2;361
2916609;Itapitanga;2918001;Jequié;1;1;2;87
2916708;Itaquara;2918001;Jequié;1;1;2;42
2916906;Itiruçu;2918001;Jequié;1;1;2;32
2611606;Recife;2917805;Jaguaripe;1;1;2;703
1508084;Tucumã;2917706;Jaguarari;1;1;2;1257
2211001;Teresina;2917706;Jaguarari;1;1;2;638
2901353;Andorinha;2917706;Jaguarari;1;1;2;41
2906006;Campo Formoso;2917706;Jaguarari;1;1;2;30
2907202;Casa Nova;2917706;Jaguarari;1;1;2;149
2910701;Euclides da Cunha;2917706;Jaguarari;1;1;2;131
2913903;Ipiaú;2917706;Jaguarari;1;1;2;427
2507507;João Pessoa;2917607;Jaguaquara;1;1;2;888
2611002;Petrolândia;2917607;Jaguaquara;1;1;2;523
2901304;Andaraí;2917607;Jaguaquara;1;1;2;166
2903201;Barreiras;2917607;Jaguaquara;1;1;2;561
2903805;Boa Vista do Tupim;2917607;Jaguaquara;1;1;2;118
2909505;Cravolândia;2917607;Jaguaquara;1;1;2;23
2910800;Feira de Santana;2917607;Jaguaquara;1;1;2;173
2913903;Ipiaú;2917607;Jaguaquara;1;1;2;69
2914208;Irajuba;2917607;Jaguaquara;1;1;2;32
2914703;Itaberaba;2917607;Jaguaquara;1;1;2;111
2503704;Cajazeiras;2917508;Jacobina;1;1;2;523
2507507;João Pessoa;2917508;Jacobina;1;1;2;757
2804805;Nossa Senhora do Socorro;2917508;Jacobina;1;1;2;367
2904902;Cachoeira;2917508;Jacobina;1;1;2;229
2910057;Dias d'Ávila;2917508;Jacobina;1;1;2;283
2911600;Governador Mangabeira;2917508;Jacobina;1;1;2;218
2914000;Ipirá;2917508;Jacobina;1;1;2;133
2914703;Itaberaba;2917508;Jacobina;1;1;2;148
2903201;Barreiras;2917359;Jaborandi;1;1;2;164
2903904;Bom Jesus da Lapa;2917359;Jaborandi;1;1;2;123
2908101;Cocos;2917359;Jaborandi;1;1;2;64
2903904;Bom Jesus da Lapa;2917334;Iuiú;1;1;2;127
2908101;Cocos;2917334;Iuiú;1;1;2;110
2905404;Cairu;2917300;Ituberá;1;1;2;32
2914703;Itaberaba;2917300;Ituberá;1;1;2;179
2902906;Barra do Choça;2917201;Ituaçu;1;1;2;141
2904605;Brumado;2917201;Ituaçu;1;1;2;58
2901106;Amélia Rodrigues;2917102;Itororó;1;1;2;328
2909802;Cruz das Almas;2917102;Itororó;1;1;2;284
2910909;Firmino Alves;2917102;Itororó;1;1;2;19
2912103;Ibicaraí;2917102;Itororó;1;1;2;61
2913507;Iguaí;2917102;Itororó;1;1;2;38
2913606;Ilhéus;2917102;Itororó;1;1;2;106
2916203;Itapé;2917102;Itororó;1;1;2;72
2916906;Itiruçu;2917003;Itiúba;1;1;2;318
2904308;Brejões;2916856;Itatim;1;1;2;45
2907301;Castro Alves;2916856;Itatim;1;1;2;30
2909802;Cruz das Almas;2916856;Itatim;1;1;2;70
2911907;Iaçu;2916856;Itatim;1;1;2;52
2914000;Ipirá;2916856;Itatim;1;1;2;56
2910008;Dário Meira;2916807;Itarantim;1;1;2;136
2913606;Ilhéus;2916807;Itarantim;1;1;2;139
2807402;Tobias Barreto;2916500;Itapicuru;1;1;2;28
2900306;Acajutiba;2916500;Itapicuru;1;1;2;46
2906501;Candeias;2916500;Itapicuru;1;1;2;156
2910727;Eunápolis;2916500;Itapicuru;1;1;2;581
2910800;Feira de Santana;2916500;Itapicuru;1;1;2;137
2305233;Horizonte;2916401;Itapetinga;1;1;2;1250
2507507;João Pessoa;2916401;Itapetinga;1;1;2;1061
2706307;Palmeira dos Índios;2916401;Itapetinga;1;1;2;752
2802304;Frei Paulo;2916401;Itapetinga;1;1;2;598
2902906;Barra do Choça;2916401;Itapetinga;1;1;2;56
2903102;Barra do Rocha;2916401;Itapetinga;1;1;2;140
2905008;Caculé;2916401;Itapetinga;1;1;2;230
2905206;Caetité;2916401;Itapetinga;1;1;2;275
2905602;Camacan;2916401;Itapetinga;1;1;2;79
2906303;Canavieiras;2916401;Itapetinga;1;1;2;137
2908002;Coaraci;2916401;Itapetinga;1;1;2;108
2910404;Encruzilhada;2916401;Itapetinga;1;1;2;76
2910800;Feira de Santana;2916401;Itapetinga;1;1;2;359
2912301;Ibicuí;2916401;Itapetinga;1;1;2;56
2913606;Ilhéus;2916401;Itapetinga;1;1;2;133
2913903;Ipiaú;2916401;Itapetinga;1;1;2;145
2611606;Recife;2916302;Itapebi;1;1;2;992
2903201;Barreiras;2916203;Itapé;1;1;2;665
2912103;Ibicaraí;2916203;Itapé;1;1;2;15
2913606;Ilhéus;2916203;Itapé;1;1;2;34
2911600;Governador Mangabeira;2916104;Itaparica;1;1;2;56
2910503;Entre Rios;2915908;Itanagra;1;1;2;40
2905602;Camacan;2915809;Itambé;1;1;2;119
2909802;Cruz das Almas;2915809;Itambé;1;1;2;327
2901957;Apuarema;2915700;Itamari;1;1;2;11
2304400;Fortaleza;2915601;Itamaraju;1;1;2;1470
2507507;João Pessoa;2915601;Itamaraju;1;1;2;1192
2616407;Vitória de Santo Antão;2915601;Itamaraju;1;1;2;1080
2905602;Camacan;2915601;Itamaraju;1;1;2;178
2910800;Feira de Santana;2915601;Itamaraju;1;1;2;528
2911808;Guaratinga;2915601;Itamaraju;1;1;2;52
2913606;Ilhéus;2915601;Itamaraju;1;1;2;251
2905800;Camamu;2915502;Itajuípe;1;1;2;86
2908002;Coaraci;2915502;Itajuípe;1;1;2;19
2915106;Itagi;2915502;Itajuípe;1;1;2;89
2910727;Eunápolis;2915304;Itagimirim;1;1;2;31
2304400;Fortaleza;2915205;Itagibá;1;1;2;1171
2912301;Ibicuí;2915205;Itagibá;1;1;2;64
2905800;Camamu;2915106;Itagi;1;1;2;96
2901304;Andaraí;2915007;Itaeté;1;1;2;41
2911907;Iaçu;2915007;Itaeté;1;1;2;92
2913804;Ipecaetá;2915007;Itaeté;1;1;2;198
1503606;Itaituba;2914901;Itacaré;1;1;2;2119
2414209;Tibau do Sul;2914901;Itacaré;1;1;2;984
2905800;Camamu;2914901;Itacaré;1;1;2;40
1500602;Altamira;2914802;Itabuna;1;1;2;1878
2408102;Natal;2914802;Itabuna;1;1;2;1081
2606002;Garanhuns;2914802;Itabuna;1;1;2;719
2607901;Jaboatão dos Guararapes;2914802;Itabuna;1;1;2;865
2902005;Aracatu;2914802;Itabuna;1;1;2;238
2904605;Brumado;2914802;Itabuna;1;1;2;264
2905701;Camaçari;2914802;Itabuna;1;1;2;253
2906303;Canavieiras;2914802;Itabuna;1;1;2;99
2906501;Candeias;2914802;Itabuna;1;1;2;247
2908002;Coaraci;2914802;Itabuna;1;1;2;34
2908507;Conceição do Jacuípe;2914802;Itabuna;1;1;2;277
2911006;Floresta Azul;2914802;Itabuna;1;1;2;42
2911709;Guanambi;2914802;Itabuna;1;1;2;382
2914604;Irecê;2914802;Itabuna;1;1;2;471
2304400;Fortaleza;2914703;Itaberaba;1;1;2;992
2306405;Itapipoca;2914703;Itaberaba;1;1;2;1006
2804805;Nossa Senhora do Socorro;2914703;Itaberaba;1;1;2;391
2901007;Amargosa;2914703;Itaberaba;1;1;2;91
2901304;Andaraí;2914703;Itaberaba;1;1;2;115
2903201;Barreiras;2914703;Itaberaba;1;1;2;510
2905800;Camamu;2914703;Itaberaba;1;1;2;197
2907301;Castro Alves;2914703;Itaberaba;1;1;2;97
2909802;Cruz das Almas;2914703;Itaberaba;1;1;2;136
2203909;Floriano;2914604;Irecê;1;1;2;517
2304400;Fortaleza;2914604;Irecê;1;1;2;912
2611606;Recife;2914604;Irecê;1;1;2;833
2613909;Serra Talhada;2914604;Irecê;1;1;2;539
2800308;Aracaju;2914604;Irecê;1;1;2;522
2900355;Adustina;2914604;Irecê;1;1;2;420
2902609;Baixa Grande;2914604;Irecê;1;1;2;197
2904605;Brumado;2914604;Irecê;1;1;2;317
2907608;Central;2914604;Irecê;1;1;2;39
2908408;Conceição do Coité;2914604;Irecê;1;1;2;289
2910727;Eunápolis;2914604;Irecê;1;1;2;609
2911709;Guanambi;2914604;Irecê;1;1;2;341
2912400;Ibipeba;2914604;Irecê;1;1;2;37
2914505;Irará;2914604;Irecê;1;1;2;348
2804805;Nossa Senhora do Socorro;2914505;Irará;1;1;2;221
2900702;Alagoinhas;2914505;Irará;1;1;2;38
2913705;Inhambupe;2914505;Irará;1;1;2;54
2902807;Barra da Estiva;2914406;Iraquara;1;1;2;154
2902807;Barra da Estiva;2914307;Iramaia;1;1;2;55
2902708;Barra;2914109;Ipupiara;1;1;2;109
2903201;Barreiras;2914109;Ipupiara;1;1;2;263
2913002;Ibitiara;2914109;Ipupiara;1;1;2;106
2306306;Itapagé;2914000;Ipirá;1;1;2;943
2606002;Garanhuns;2914000;Ipirá;1;1;2;510
2901502;Anguera;2914000;Ipirá;1;1;2;56
2902807;Barra da Estiva;2914000;Ipirá;1;1;2;232
2903805;Boa Vista do Tupim;2914000;Ipirá;1;1;2;105
2906857;Capela do Alto Alegre;2914000;Ipirá;1;1;2;61
2907301;Castro Alves;2914000;Ipirá;1;1;2;71
2907509;Catu;2914000;Ipirá;1;1;2;153
2909802;Cruz das Almas;2914000;Ipirá;1;1;2;95
2910057;Dias d'Ávila;2914000;Ipirá;1;1;2;165
2910206;Dom Macedo Costa;2914000;Ipirá;1;1;2;98
2507507;João Pessoa;2913903;Ipiaú;1;1;2;921
2900702;Alagoinhas;2913903;Ipiaú;1;1;2;256
2903201;Barreiras;2913903;Ipiaú;1;1;2;605
2905800;Camamu;2913903;Ipiaú;1;1;2;62
2906501;Candeias;2913903;Ipiaú;1;1;2;200
2910800;Feira de Santana;2913804;Ipecaetá;1;1;2;37
2913200;Ibotirama;2913804;Ipecaetá;1;1;2;425
2800308;Aracaju;2913705;Inhambupe;1;1;2;169
2908408;Conceição do Coité;2913705;Inhambupe;1;1;2;100
2909604;Crisópolis;2913705;Inhambupe;1;1;2;37
2910503;Entre Rios;2913705;Inhambupe;1;1;2;29
2910727;Eunápolis;2913705;Inhambupe;1;1;2;525
1500602;Altamira;2913606;Ilhéus;1;1;2;1890
1721000;Palmas;2913606;Ilhéus;1;1;2;1102
2211001;Teresina;2913606;Ilhéus;1;1;2;1141
2900702;Alagoinhas;2913606;Ilhéus;1;1;2;304
2903201;Barreiras;2913606;Ilhéus;1;1;2;689
2903904;Bom Jesus da Lapa;2913606;Ilhéus;1;1;2;486
2904605;Brumado;2913606;Ilhéus;1;1;2;280
2905404;Cairu;2913606;Ilhéus;1;1;2;146
2912301;Ibicuí;2913606;Ilhéus;1;1;2;93
2913507;Iguaí;2913606;Ilhéus;1;1;2;104
2904902;Cachoeira;2913507;Iguaí;1;1;2;266
2906709;Cândido Sales;2913507;Iguaí;1;1;2;149
2910909;Firmino Alves;2913507;Iguaí;1;1;2;31
2905206;Caetité;2913408;Igaporã;1;1;2;41
2908408;Conceição do Coité;2913309;Ichu;1;1;2;27
2910800;Feira de Santana;2913309;Ichu;1;1;2;65
2211001;Teresina;2913200;Ibotirama;1;1;2;785
2611606;Recife;2913200;Ibotirama;1;1;2;1001
2904100;Boquira;2913200;Ibotirama;1;1;2;89
2905206;Caetité;2913200;Ibotirama;1;1;2;225
2909307;Correntina;2913200;Ibotirama;1;1;2;202
2911709;Guanambi;2913200;Ibotirama;1;1;2;238
2912400;Ibipeba;2913101;Ibititá;1;1;2;11
2904001;Boninal;2913002;Ibitiara;1;1;2;43
2901700;Antônio Cardoso;2912608;Ibiquera;1;1;2;198
2611606;Recife;2912202;Ibicoara;1;1;2;898
2900108;Abaíra;2912202;Ibicoara;1;1;2;45
2904704;Buerarema;2912103;Ibicaraí;1;1;2;29
2908002;Coaraci;2912103;Ibicaraí;1;1;2;28
2905206;Caetité;2912004;Ibiassucê;1;1;2;33
2903201;Barreiras;2911907;Iaçu;1;1;2;526
2904308;Brejões;2911907;Iaçu;1;1;2;52
2906873;Capim Grosso;2911907;Iaçu;1;1;2;158
2901601;Antas;2911857;Heliópolis;1;1;2;32
2907806;Cícero Dantas;2911857;Heliópolis;1;1;2;20
2304400;Fortaleza;2911709;Guanambi;1;1;2;1248
2507507;João Pessoa;2911709;Guanambi;1;1;2;1153
2902104;Araci;2911709;Guanambi;1;1;2;526
2902906;Barra do Choça;2911709;Guanambi;1;1;2;248
2905701;Camaçari;2911709;Guanambi;1;1;2;511
2611606;Recife;2911600;Governador Mangabeira;1;1;2;665
2904902;Cachoeira;2911600;Governador Mangabeira;1;1;2;12
2910800;Feira de Santana;2911600;Governador Mangabeira;1;1;2;36
2902708;Barra;2911303;Gentio do Ouro;1;1;2;92
2907301;Castro Alves;2911253;Gavião;1;1;2;148
2902807;Barra da Estiva;2911204;Gandu;1;1;2;200
1712702;Mateiros;2911105;Formosa do Rio Preto;1;1;2;148
2203008;Cristalândia do Piauí;2911105;Formosa do Rio Preto;1;1;2;44
2203206;Curimatá;2911105;Formosa do Rio Preto;1;1;2;145
2211001;Teresina;2911105;Formosa do Rio Preto;1;1;2;706
2903201;Barreiras;2911105;Formosa do Rio Preto;1;1;2;132
2903904;Bom Jesus da Lapa;2911105;Formosa do Rio Preto;1;1;2;316
2903300;Governador Lomanto Júnior;2911006;Floresta Azul;1;1;2;21
2304400;Fortaleza;2910909;Firmino Alves;1;1;2;1249
2903805;Boa Vista do Tupim;2910859;Filadélfia;1;1;2;219
2906873;Capim Grosso;2910859;Filadélfia;1;1;2;72
1100304;Vilhena;2910800;Feira de Santana;1;1;2;2311
1503457;Ipixuna do Pará;2910800;Feira de Santana;1;1;2;1413
1702109;Araguaína;2910800;Feira de Santana;1;1;2;1145
2103000;Caxias;2910800;Feira de Santana;1;1;2;946
2105302;Imperatriz;2910800;Feira de Santana;1;1;2;1181
2302503;Brejo Santo;2910800;Feira de Santana;1;1;2;531
2304285;Eusébio;2910800;Feira de Santana;1;1;2;930
2305233;Horizonte;2910800;Feira de Santana;1;1;2;907
2403251;Parnamirim;2910800;Feira de Santana;1;1;2;810
2510808;Patos;2910800;Feira de Santana;1;1;2;610
2513703;Santa Rita;2910800;Feira de Santana;1;1;2;713
2601706;Belo Jardim;2910800;Feira de Santana;1;1;2;514
2602308;Bonito;2910800;Feira de Santana;1;1;2;548
2604007;Carpina;2910800;Feira de Santana;1;1;2;635
2606200;Goiana;2910800;Feira de Santana;1;1;2;676
2612208;Salgueiro;2910800;Feira de Santana;1;1;2;461
2708808;São Sebastião;2910800;Feira de Santana;1;1;2;368
2800407;Arauá;2910800;Feira de Santana;1;1;2;185
2802106;Estância;2910800;Feira de Santana;1;1;2;199
2901700;Antônio Cardoso;2910800;Feira de Santana;1;1;2;23
2902609;Baixa Grande;2910800;Feira de Santana;1;1;2;136
2902708;Barra;2910800;Feira de Santana;1;1;2;483
2903904;Bom Jesus da Lapa;2910800;Feira de Santana;1;1;2;493
2904605;Brumado;2910800;Feira de Santana;1;1;2;362
2904704;Buerarema;2910800;Feira de Santana;1;1;2;298
2905206;Caetité;2910800;Feira de Santana;1;1;2;434
2905602;Camacan;2910800;Feira de Santana;1;1;2;352
2906402;Candeal;2910800;Feira de Santana;1;1;2;56
2906808;Cansanção;2910800;Feira de Santana;1;1;2;188
2907400;Catolândia;2910800;Feira de Santana;1;1;2;641
2907608;Central;2910800;Feira de Santana;1;1;2;366
2907806;Cícero Dantas;2910800;Feira de Santana;1;1;2;195
2908903;Coração de Maria;2910800;Feira de Santana;1;1;2;24
2908101;Cocos;2910776;Feira da Mata;1;1;2;28
2807105;Simão Dias;2910750;Fátima;1;1;2;46
2900355;Adustina;2910750;Fátima;1;1;2;15
1500602;Altamira;2910727;Eunápolis;1;1;2;1968
2507507;João Pessoa;2910727;Eunápolis;1;1;2;1130
2602902;Cabo de Santo Agostinho;2910727;Eunápolis;1;1;2;1015
2611606;Recife;2910727;Eunápolis;1;1;2;1035
2704302;Maceió;2910727;Eunápolis;1;1;2;848
2901205;Anagé;2910727;Eunápolis;1;1;2;250
2903201;Barreiras;2910727;Eunápolis;1;1;2;732
2904605;Brumado;2910727;Eunápolis;1;1;2;324
2905602;Camacan;2910727;Eunápolis;1;1;2;105
2507507;João Pessoa;2910701;Euclides da Cunha;1;1;2;584
2612208;Salgueiro;2910701;Euclides da Cunha;1;1;2;263
2804805;Nossa Senhora do Socorro;2910701;Euclides da Cunha;1;1;2;210
2900207;Abaré;2910701;Euclides da Cunha;1;1;2;198
2906402;Candeal;2910701;Euclides da Cunha;1;1;2;144
2907806;Cícero Dantas;2910701;Euclides da Cunha;1;1;2;65
2908408;Conceição do Coité;2910701;Euclides da Cunha;1;1;2;113
2910503;Entre Rios;2910701;Euclides da Cunha;1;1;2;185
2800308;Aracaju;2910602;Esplanada;1;1;2;141
2900306;Acajutiba;2910602;Esplanada;1;1;2;15
2901908;Aporá;2910602;Esplanada;1;1;2;17
2907301;Castro Alves;2910602;Esplanada;1;1;2;188
2907509;Catu;2910602;Esplanada;1;1;2;73
2909604;Crisópolis;2910602;Esplanada;1;1;2;35
2800308;Aracaju;2910503;Entre Rios;1;1;2;158
2804805;Nossa Senhora do Socorro;2910503;Entre Rios;1;1;2;157
2905701;Camaçari;2910503;Entre Rios;1;1;2;91
2907806;Cícero Dantas;2910503;Entre Rios;1;1;2;149
2908408;Conceição do Coité;2910503;Entre Rios;1;1;2;129
2908606;Conde;2910503;Entre Rios;1;1;2;56
2902005;Aracatu;2910107;Dom Basílio;1;1;2;81
1302603;Manaus;2910057;Dias d'Ávila;1;1;2;2556
2307650;Maracanaú;2910057;Dias d'Ávila;1;1;2;969
2602902;Cabo de Santo Agostinho;2910057;Dias d'Ávila;1;1;2;595
2605202;Escada;2910057;Dias d'Ávila;1;1;2;576
2607208;Ipojuca;2910057;Dias d'Ávila;1;1;2;582
2616407;Vitória de Santo Antão;2910057;Dias d'Ávila;1;1;2;594
2708600;São Miguel dos Campos;2910057;Dias d'Ávila;1;1;2;393
2801504;Carmópolis;2910057;Dias d'Ávila;1;1;2;259
2803500;Lagarto;2910057;Dias d'Ávila;1;1;2;204
2900702;Alagoinhas;2910057;Dias d'Ávila;1;1;2;55
2211001;Teresina;2909901;Curaçá;1;1;2;537
2601102;Araripina;2909901;Curaçá;1;1;2;172
2601607;Belém de São Francisco;2909901;Curaçá;1;1;2;108
2612208;Salgueiro;2909901;Curaçá;1;1;2;125
2906824;Canudos;2909901;Curaçá;1;1;2;129
2907202;Casa Nova;2909901;Curaçá;1;1;2;113
2507507;João Pessoa;2909802;Cruz das Almas;1;1;2;760
2804805;Nossa Senhora do Socorro;2909802;Cruz das Almas;1;1;2;293
2901106;Amélia Rodrigues;2909802;Cruz das Almas;1;1;2;47
2903201;Barreiras;2909802;Cruz das Almas;1;1;2;645
2905701;Camaçari;2909802;Cruz das Almas;1;1;2;79
2908507;Conceição do Jacuípe;2909802;Cruz das Almas;1;1;2;52
2211001;Teresina;2909703;Cristópolis;1;1;2;807
2900306;Acajutiba;2909604;Crisópolis;1;1;2;22
2901908;Aporá;2909604;Crisópolis;1;1;2;18
2903276;Barrocas;2909604;Crisópolis;1;1;2;100
2907806;Cícero Dantas;2909604;Crisópolis;1;1;2;106
2211001;Teresina;2909406;Cotegipe;1;1;2;783
2304400;Fortaleza;2909307;Correntina;1;1;2;1243
2908101;Cocos;2909307;Correntina;1;1;2;93
2802908;Itabaiana;2909208;Coronel João Sá;1;1;2;65
2903904;Bom Jesus da Lapa;2909109;Coribe;1;1;2;138
2905701;Camaçari;2908903;Coração de Maria;1;1;2;69
2901908;Aporá;2908606;Conde;1;1;2;54
2907004;Cardeal da Silva;2908606;Conde;1;1;2;39
1302603;Manaus;2908507;Conceição do Jacuípe;1;1;2;2501
2804805;Nossa Senhora do Socorro;2908507;Conceição do Jacuípe;1;1;2;241
2902054;Araças;2908507;Conceição do Jacuípe;1;1;2;63
2904308;Brejões;2908507;Conceição do Jacuípe;1;1;2;140
2304400;Fortaleza;2908408;Conceição do Coité;1;1;2;859
2507507;João Pessoa;2908408;Conceição do Coité;1;1;2;672
2804805;Nossa Senhora do Socorro;2908408;Conceição do Coité;1;1;2;238
2900702;Alagoinhas;2908408;Conceição do Coité;1;1;2;111
2903201;Barreiras;2908408;Conceição do Coité;1;1;2;634
2905701;Camaçari;2908408;Conceição do Coité;1;1;2;164
2906808;Cansanção;2908408;Conceição do Coité;1;1;2;97
2906873;Capim Grosso;2908408;Conceição do Coité;1;1;2;87
2907301;Castro Alves;2908309;Conceição do Almeida;1;1;2;29
2904902;Cachoeira;2908200;Conceição da Feira;1;1;2;16
2903201;Barreiras;2908101;Cocos;1;1;2;222
2903904;Bom Jesus da Lapa;2908101;Cocos;1;1;2;160
2905008;Caculé;2908101;Cocos;1;1;2;250
2900900;Almadina;2908002;Coaraci;1;1;2;17
2902104;Araci;2907905;Cipó;1;1;2;54
2304400;Fortaleza;2907806;Cícero Dantas;1;1;2;755
2611606;Recife;2907806;Cícero Dantas;1;1;2;471
2800407;Arauá;2907806;Cícero Dantas;1;1;2;117
2800605;Barra dos Coqueiros;2907806;Cícero Dantas;1;1;2;158
2805505;Poço Verde;2907806;Cícero Dantas;1;1;2;36
2900355;Adustina;2907806;Cícero Dantas;1;1;2;39
2900702;Alagoinhas;2907806;Cícero Dantas;1;1;2;170
2601607;Belém de São Francisco;2907707;Chorrochó;1;1;2;35
2612208;Salgueiro;2907707;Chorrochó;1;1;2;95
2900207;Abaré;2907707;Chorrochó;1;1;2;29
2906204;Canarana;2907608;Central;1;1;2;75
2304400;Fortaleza;2907509;Catu;1;1;2;951
2404853;Itajá;2907509;Catu;1;1;2;760
2408102;Natal;2907509;Catu;1;1;2;797
2507507;João Pessoa;2907509;Catu;1;1;2;685
2611606;Recife;2907509;Catu;1;1;2;597
2800308;Aracaju;2907509;Catu;1;1;2;213
2802502;General Maynard;2907509;Catu;1;1;2;238
2905701;Camaçari;2907509;Catu;1;1;2;37
2906501;Candeias;2907509;Catu;1;1;2;40
2905701;Camaçari;2907400;Catolândia;1;1;2;712
2203909;Floriano;2907202;Casa Nova;1;1;2;345
2211001;Teresina;2907202;Casa Nova;1;1;2;491
2408003;Mossoró;2907202;Casa Nova;1;1;2;584
2600203;Afrânio;2907202;Casa Nova;1;1;2;67
2608750;Lagoa Grande;2907202;Casa Nova;1;1;2;71
2612208;Salgueiro;2907202;Casa Nova;1;1;2;221
2901700;Antônio Cardoso;2907202;Casa Nova;1;1;2;417
2900702;Alagoinhas;2907004;Cardeal da Silva;1;1;2;56
2900801;Alcobaça;2906907;Caravelas;1;1;2;27
2903904;Bom Jesus da Lapa;2906907;Caravelas;1;1;2;655
2902005;Aracatu;2906899;Caraíbas;1;1;2;23
2902807;Barra da Estiva;2906899;Caraíbas;1;1;2;109
2905156;Caetanos;2906899;Caraíbas;1;1;2;54
2906006;Campo Formoso;2906873;Capim Grosso;1;1;2;102
2607406;Itacuruba;2906824;Canudos;1;1;2;135
2902906;Barra do Choça;2906709;Cândido Sales;1;1;2;98
2903201;Barreiras;2906709;Cândido Sales;1;1;2;537
2903508;Belo Campo;2906709;Cândido Sales;1;1;2;49
2906501;Candeias;2906600;Candiba;1;1;2;503
1302603;Manaus;2906501;Candeias;1;1;2;2534
1721000;Palmas;2906501;Candeias;1;1;2;1093
2403251;Parnamirim;2906501;Candeias;1;1;2;826
2408003;Mossoró;2906501;Candeias;1;1;2;838
2507507;João Pessoa;2906501;Candeias;1;1;2;725
2800605;Barra dos Coqueiros;2906501;Candeias;1;1;2;259
2804003;Maruim;2906501;Candeias;1;1;2;267
2902252;Arataca;2906501;Candeias;1;1;2;302
2904605;Brumado;2906501;Candeias;1;1;2;379
2904902;Cachoeira;2906501;Candeias;1;1;2;42
2905206;Caetité;2906501;Candeias;1;1;2;458
2902401;Aurelino Leal;2906303;Canavieiras;1;1;2;151
2905305;Cafarnaum;2906204;Canarana;1;1;2;33
2603009;Cabrobó;2906006;Campo Formoso;1;1;2;254
2612208;Salgueiro;2906006;Campo Formoso;1;1;2;292
2804805;Nossa Senhora do Socorro;2906006;Campo Formoso;1;1;2;349
2901809;Antônio Gonçalves;2906006;Campo Formoso;1;1;2;8
2903201;Barreiras;2906006;Campo Formoso;1;1;2;546
2900900;Almadina;2905800;Camamu;1;1;2;100
2904902;Cachoeira;2905800;Camamu;1;1;2;146
1100023;Ariquemes;2905701;Camaçari;1;1;2;2686
1100205;Porto Velho;2905701;Camaçari;1;1;2;2791
1504208;Marabá;2905701;Camaçari;1;1;2;1412
2101400;Balsas;2905701;Camaçari;1;1;2;1012
2408003;Mossoró;2905701;Camaçari;1;1;2;837
2507507;João Pessoa;2905701;Camaçari;1;1;2;714
2601706;Belo Jardim;2905701;Camaçari;1;1;2;521
2614204;Sirinhaém;2905701;Camaçari;1;1;2;569
2904902;Cachoeira;2905701;Camaçari;1;1;2;66
2304400;Fortaleza;2905602;Camacan;1;1;2;1293
2901007;Amargosa;2905404;Cairu;1;1;2;81
2901155;América Dourada;2905305;Cafarnaum;1;1;2;27
2902906;Barra do Choça;2905206;Caetité;1;1;2;226
2904407;Brejolândia;2905206;Caetité;1;1;2;238
2903904;Bom Jesus da Lapa;2905008;Caculé;1;1;2;183
2608750;Lagoa Grande;2904902;Cachoeira;1;1;2;427
2902708;Barra;2904753;Buritirama;1;1;2;55
2903201;Barreiras;2904753;Buritirama;1;1;2;223
2902252;Arataca;2904704;Buerarema;1;1;2;35
1302603;Manaus;2904605;Brumado;1;1;2;2303
2305506;Iguatu;2904605;Brumado;1;1;2;903
2307403;Jucás;2904605;Brumado;1;1;2;880
2507507;João Pessoa;2904605;Brumado;1;1;2;1061
2611101;Petrolina;2904605;Brumado;1;1;2;555
2900108;Abaíra;2904605;Brumado;1;1;2;105
2904308;Brejões;2904605;Brumado;1;1;2;234
2903805;Boa Vista do Tupim;2904308;Brejões;1;1;2;101
2611101;Petrolina;2904050;Bonito;1;1;2;305
1720903;Taguatinga;2903904;Bom Jesus da Lapa;1;1;2;345
1721000;Palmas;2903904;Bom Jesus da Lapa;1;1;2;628
2202901;Corrente;2903904;Bom Jesus da Lapa;1;1;2;368
2211001;Teresina;2903904;Bom Jesus da Lapa;1;1;2;908
2304400;Fortaleza;2903904;Bom Jesus da Lapa;1;1;2;1172
2507507;João Pessoa;2903904;Bom Jesus da Lapa;1;1;2;1135
2611101;Petrolina;2903904;Bom Jesus da Lapa;1;1;2;535
2611606;Recife;2903904;Bom Jesus da Lapa;1;1;2;1071
2800308;Aracaju;2903904;Bom Jesus da Lapa;1;1;2;727
2902906;Barra do Choça;2903904;Bom Jesus da Lapa;1;1;2;352
2304400;Fortaleza;2903276;Barrocas;1;1;2;860
2902104;Araci;2903276;Barrocas;1;1;2;26
2903003;Barra do Mendes;2903235;Barro Alto;1;1;2;17
1506708;Santana do Araguaia;2903201;Barreiras;1;1;2;666
2101400;Balsas;2903201;Barreiras;1;1;2;534
2202901;Corrente;2903201;Barreiras;1;1;2;197
2203107;Cristino Castro;2903201;Barreiras;1;1;2;384
2208007;Picos;2903201;Barreiras;1;1;2;682
2209757;São Gonçalo do Gurguéia;2903201;Barreiras;1;1;2;244
2211209;Uruçuí;2903201;Barreiras;1;1;2;554
2400208;Açu;2903201;Barreiras;1;1;2;1137
2507507;João Pessoa;2903201;Barreiras;1;1;2;1226
2700706;Batalha;2903201;Barreiras;1;1;2;896
2900702;Alagoinhas;2903201;Barreiras;1;1;2;713
2901106;Amélia Rodrigues;2903201;Barreiras;1;1;2;678
2901403;Angical;2903201;Barreiras;1;1;2;39
2902500;Baianópolis;2903201;Barreiras;1;1;2;50
1718451;Pugmil;2903102;Barra do Rocha;1;1;2;1078
2211001;Teresina;2902708;Barra;1;1;2;654
2900207;Abaré;2902658;Banzaê;1;1;2;212
2611606;Recife;2902609;Baixa Grande;1;1;2;708
2901403;Angical;2902500;Baianópolis;1;1;2;37
2804805;Nossa Senhora do Socorro;2902104;Araci;1;1;2;204
2211001;Teresina;2901403;Angical;1;1;2;792
2304400;Fortaleza;2901304;Andaraí;1;1;2;1045
2611101;Petrolina;2901106;Amélia Rodrigues;1;1;2;394
2100055;Açailândia;2900702;Alagoinhas;1;1;2;1256
2408003;Mossoró;2900702;Alagoinhas;1;1;2;777
2507507;João Pessoa;2900702;Alagoinhas;1;1;2;669
2607901;Jaboatão dos Guararapes;2900702;Alagoinhas;1;1;2;576
2803500;Lagarto;2900355;Adustina;1;1;2;54
2601607;Belém de São Francisco;2900207;Abaré;1;1;2;19
2800209;Aquidabã;2807600;Umbaúba;1;1;2;142
2800670;Boquim;2807600;Umbaúba;1;1;2;26
2804805;Nossa Senhora do Socorro;2807600;Umbaúba;1;1;2;81
2807402;Tobias Barreto;2807600;Umbaúba;1;1;2;52
2800308;Aracaju;2807501;Tomar do Geru;1;1;2;97
2304400;Fortaleza;2807402;Tobias Barreto;1;1;2;814
2800670;Boquim;2807402;Tobias Barreto;1;1;2;46
2803005;Itabaianinha;2807402;Tobias Barreto;1;1;2;33
2800308;Aracaju;2807303;Telha;1;1;2;80
2700300;Arapiraca;2807105;Simão Dias;1;1;2;158
2704302;Maceió;2807105;Simão Dias;1;1;2;253
2800670;Boquim;2807105;Simão Dias;1;1;2;55
2804805;Nossa Senhora do Socorro;2807105;Simão Dias;1;1;2;75
2805802;Riachão do Dantas;2807105;Simão Dias;1;1;2;43
2806206;Salgado;2807105;Simão Dias;1;1;2;53
2800308;Aracaju;2807006;São Miguel do Aleixo;1;1;2;63
2800308;Aracaju;2806909;São Francisco;1;1;2;65
2800308;Aracaju;2806800;São Domingos;1;1;2;52
2801009;Campo do Brito;2806800;São Domingos;1;1;2;10
2304400;Fortaleza;2806701;São Cristóvão;1;1;2;808
2408003;Mossoró;2806701;São Cristóvão;1;1;2;639
2507507;João Pessoa;2806701;São Cristóvão;1;1;2;489
2800506;Areia Branca;2806602;Santo Amaro das Brotas;1;1;2;31
2800308;Aracaju;2806503;Santa Rosa de Lima;1;1;2;31
2700300;Arapiraca;2806404;Santana do São Francisco;1;1;2;57
2800308;Aracaju;2806404;Santana do São Francisco;1;1;2;84
2611606;Recife;2806305;Santa Luzia do Itanhy;1;1;2;452
2800308;Aracaju;2806305;Santa Luzia do Itanhy;1;1;2;66
2802809;Indiaroba;2806305;Santa Luzia do Itanhy;1;1;2;15
2800308;Aracaju;2806206;Salgado;1;1;2;44
2804508;Nossa Senhora da Glória;2806206;Salgado;1;1;2;91
2804805;Nossa Senhora do Socorro;2806206;Salgado;1;1;2;41
2805109;Pedrinhas;2806206;Salgado;1;1;2;28
2611606;Recife;2806107;Rosário do Catete;1;1;2;365
2801504;Carmópolis;2806107;Rosário do Catete;1;1;2;7
2801009;Campo do Brito;2806008;Ribeirópolis;1;1;2;23
2801405;Carira;2806008;Ribeirópolis;1;1;2;37
2804607;Nossa Senhora das Dores;2806008;Ribeirópolis;1;1;2;25
2801504;Carmópolis;2805901;Riachuelo;1;1;2;25
2803906;Malhador;2805901;Riachuelo;1;1;2;14
2805505;Poço Verde;2805802;Riachão do Dantas;1;1;2;59
1302603;Manaus;2805703;Propriá;1;1;2;2636
2304400;Fortaleza;2805703;Propriá;1;1;2;735
2507507;João Pessoa;2805703;Propriá;1;1;2;400
2704302;Maceió;2805703;Propriá;1;1;2;138
2706703;Penedo;2805703;Propriá;1;1;2;36
2707503;Porto Real do Colégio;2805703;Propriá;1;1;2;9
2801207;Canindé de São Francisco;2805703;Propriá;1;1;2;122
2802908;Itabaiana;2805703;Propriá;1;1;2;77
2803807;Malhada dos Bois;2805703;Propriá;1;1;2;16
2804805;Nossa Senhora do Socorro;2805703;Propriá;1;1;2;77
2801504;Carmópolis;2805604;Porto da Folha;1;1;2;89
2804508;Nossa Senhora da Glória;2805604;Porto da Folha;1;1;2;36
2804805;Nossa Senhora do Socorro;2805604;Porto da Folha;1;1;2;106
2607208;Ipojuca;2805505;Poço Verde;1;1;2;426
2800209;Aquidabã;2805505;Poço Verde;1;1;2;134
2800407;Arauá;2805505;Poço Verde;1;1;2;82
2803500;Lagarto;2805505;Poço Verde;1;1;2;48
2804805;Nossa Senhora do Socorro;2805505;Poço Verde;1;1;2;112
2801207;Canindé de São Francisco;2805406;Poço Redondo;1;1;2;25
2400703;Alto do Rodrigues;2805307;Pirambu;1;1;2;595
2803302;Japaratuba;2805307;Pirambu;1;1;2;10
2800308;Aracaju;2805208;Pinhão;1;1;2;78
2800670;Boquim;2805109;Pedrinhas;1;1;2;8
2801702;Cristinápolis;2805109;Pedrinhas;1;1;2;33
2800308;Aracaju;2804904;Pacatuba;1;1;2;68
2802700;Ilha das Flores;2804904;Pacatuba;1;1;2;11
2802908;Itabaiana;2804904;Pacatuba;1;1;2;89
2804409;Neópolis;2804904;Pacatuba;1;1;2;14
1302603;Manaus;2804805;Nossa Senhora do Socorro;1;1;2;2622
1400100;Boa Vista;2804805;Nossa Senhora do Socorro;1;1;2;2960
1502202;Capanema;2804805;Nossa Senhora do Socorro;1;1;2;1516
1503606;Itaituba;2804805;Nossa Senhora do Socorro;1;1;2;2171
2103406;Coelho Neto;2804805;Nossa Senhora do Socorro;1;1;2;971
2111300;São Luís;2804805;Nossa Senhora do Socorro;1;1;2;1198
2211001;Teresina;2804805;Nossa Senhora do Socorro;1;1;2;884
2408003;Mossoró;2804805;Nossa Senhora do Socorro;1;1;2;627
2503209;Cabedelo;2804805;Nossa Senhora do Socorro;1;1;2;488
2510808;Patos;2804805;Nossa Senhora do Socorro;1;1;2;424
2606200;Goiana;2804805;Nossa Senhora do Socorro;1;1;2;432
2607208;Ipojuca;2804805;Nossa Senhora do Socorro;1;1;2;353
2610004;Palmares;2804805;Nossa Senhora do Socorro;1;1;2;293
2800209;Aquidabã;2804805;Nossa Senhora do Socorro;1;1;2;66
2800605;Barra dos Coqueiros;2804805;Nossa Senhora do Socorro;1;1;2;13
2801207;Canindé de São Francisco;2804805;Nossa Senhora do Socorro;1;1;2;153
2801405;Carira;2804805;Nossa Senhora do Socorro;1;1;2;81
2801504;Carmópolis;2804805;Nossa Senhora do Socorro;1;1;2;28
2801702;Cristinápolis;2804805;Nossa Senhora do Socorro;1;1;2;96
2803203;Itaporanga d'Ajuda;2804805;Nossa Senhora do Socorro;1;1;2;25
2803609;Laranjeiras;2804805;Nossa Senhora do Socorro;1;1;2;5
2804409;Neópolis;2804805;Nossa Senhora do Socorro;1;1;2;80
2804508;Nossa Senhora da Glória;2804805;Nossa Senhora do Socorro;1;1;2;76
2801504;Carmópolis;2804706;Nossa Senhora de Lourdes;1;1;2;66
2802106;Estância;2804706;Nossa Senhora de Lourdes;1;1;2;139
2304400;Fortaleza;2804607;Nossa Senhora das Dores;1;1;2;758
2800209;Aquidabã;2804607;Nossa Senhora das Dores;1;1;2;31
2801504;Carmópolis;2804607;Nossa Senhora das Dores;1;1;2;28
2802205;Feira Nova;2804607;Nossa Senhora das Dores;1;1;2;28
2803609;Laranjeiras;2804607;Nossa Senhora das Dores;1;1;2;35
1302603;Manaus;2804508;Nossa Senhora da Glória;1;1;2;2579
2606002;Garanhuns;2804508;Nossa Senhora da Glória;1;1;2;179
2702405;Delmiro Gouveia;2804508;Nossa Senhora da Glória;1;1;2;114
2706422;Pariconha;2804508;Nossa Senhora da Glória;1;1;2;124
2706703;Penedo;2804508;Nossa Senhora da Glória;1;1;2;96
2707503;Porto Real do Colégio;2804508;Nossa Senhora da Glória;1;1;2;67
2801405;Carira;2804508;Nossa Senhora da Glória;1;1;2;35
2802205;Feira Nova;2804508;Nossa Senhora da Glória;1;1;2;13
2803302;Japaratuba;2804508;Nossa Senhora da Glória;1;1;2;67
2803500;Lagarto;2804508;Nossa Senhora da Glória;1;1;2;79
2804409;Neópolis;2804508;Nossa Senhora da Glória;1;1;2;87
1302603;Manaus;2804409;Neópolis;1;1;2;2664
2304400;Fortaleza;2804409;Neópolis;1;1;2;755
2800605;Barra dos Coqueiros;2804409;Neópolis;1;1;2;73
2800704;Brejo Grande;2804409;Neópolis;1;1;2;21
2801405;Carira;2804409;Neópolis;1;1;2;117
2802700;Ilha das Flores;2804409;Neópolis;1;1;2;14
2704302;Maceió;2804300;Muribeca;1;1;2;158
2800308;Aracaju;2804201;Monte Alegre de Sergipe;1;1;2;108
2800308;Aracaju;2804102;Moita Bonita;1;1;2;43
2802908;Itabaiana;2804102;Moita Bonita;1;1;2;12
2304400;Fortaleza;2804003;Maruim;1;1;2;784
2704302;Maceió;2804003;Maruim;1;1;2;190
2802007;Divina Pastora;2803906;Malhador;1;1;2;16
2802908;Itabaiana;2803906;Malhador;1;1;2;15
2611606;Recife;2803807;Malhada dos Bois;1;1;2;329
2800308;Aracaju;2803807;Malhada dos Bois;1;1;2;63
2803401;Japoatã;2803807;Malhada dos Bois;1;1;2;17
2800308;Aracaju;2803708;Macambira;1;1;2;55
2801009;Campo do Brito;2803708;Macambira;1;1;2;10
2801504;Carmópolis;2803708;Macambira;1;1;2;61
2803500;Lagarto;2803708;Macambira;1;1;2;30
2111300;São Luís;2803609;Laranjeiras;1;1;2;1193
2408102;Natal;2803609;Laranjeiras;1;1;2;590
2607208;Ipojuca;2803609;Laranjeiras;1;1;2;351
2607901;Jaboatão dos Guararapes;2803609;Laranjeiras;1;1;2;377
2704302;Maceió;2803609;Laranjeiras;1;1;2;202
1302603;Manaus;2803500;Lagarto;1;1;2;2563
1502202;Capanema;2803500;Lagarto;1;1;2;1472
1506807;Santarém;2803500;Lagarto;1;1;2;2061
2700300;Arapiraca;2803500;Lagarto;1;1;2;166
2800605;Barra dos Coqueiros;2803500;Lagarto;1;1;2;77
2801009;Campo do Brito;2803500;Lagarto;1;1;2;30
2802304;Frei Paulo;2803500;Lagarto;1;1;2;40
2800209;Aquidabã;2803302;Japaratuba;1;1;2;38
2800605;Barra dos Coqueiros;2803302;Japaratuba;1;1;2;31
2800704;Brejo Grande;2803302;Japaratuba;1;1;2;55
2801306;Capela;2803302;Japaratuba;1;1;2;18
1302603;Manaus;2803203;Itaporanga d'Ajuda;1;1;2;2609
1500800;Ananindeua;2803203;Itaporanga d'Ajuda;1;1;2;1601
2105302;Imperatriz;2803203;Itaporanga d'Ajuda;1;1;2;1255
2111300;São Luís;2803203;Itaporanga d'Ajuda;1;1;2;1199
2208007;Picos;2803203;Itaporanga d'Ajuda;1;1;2;626
2211001;Teresina;2803203;Itaporanga d'Ajuda;1;1;2;883
2304400;Fortaleza;2803203;Itaporanga d'Ajuda;1;1;2;811
2307304;Juazeiro do Norte;2803203;Itaporanga d'Ajuda;1;1;2;471
2408102;Natal;2803203;Itaporanga d'Ajuda;1;1;2;615
2801504;Carmópolis;2803104;Itabi;1;1;2;62
2611606;Recife;2803005;Itabaianinha;1;1;2;467
2800670;Boquim;2803005;Itabaianinha;1;1;2;23
2801207;Canindé de São Francisco;2803005;Itabaianinha;1;1;2;180
2414100;Tenente Ananias;2802908;Itabaiana;1;1;2;467
2607901;Jaboatão dos Guararapes;2802908;Itabaiana;1;1;2;382
2700300;Arapiraca;2802908;Itabaiana;1;1;2;125
2802304;Frei Paulo;2802908;Itabaiana;1;1;2;13
2800308;Aracaju;2802700;Ilha das Flores;1;1;2;78
2800308;Aracaju;2802601;Gracho Cardoso;1;1;2;73
2304400;Fortaleza;2802403;Gararu;1;1;2;705
2800308;Aracaju;2802403;Gararu;1;1;2;99
2304400;Fortaleza;2802304;Frei Paulo;1;1;2;758
2704302;Maceió;2802304;Frei Paulo;1;1;2;219
2801405;Carira;2802304;Frei Paulo;1;1;2;28
2800308;Aracaju;2802205;Feira Nova;1;1;2;72
1302603;Manaus;2802106;Estância;1;1;2;2599
2503209;Cabedelo;2802106;Estância;1;1;2;544
2507507;João Pessoa;2802106;Estância;1;1;2;531
2611606;Recife;2802106;Estância;1;1;2;442
2800506;Areia Branca;2802106;Estância;1;1;2;57
2800605;Barra dos Coqueiros;2802106;Estância;1;1;2;65
2800308;Aracaju;2801900;Cumbe;1;1;2;59
2800308;Aracaju;2801603;Cedro de São João;1;1;2;75
2403251;Parnamirim;2801504;Carmópolis;1;1;2;556
2611606;Recife;2801504;Carmópolis;1;1;2;358
2800605;Barra dos Coqueiros;2801504;Carmópolis;1;1;2;24
2304400;Fortaleza;2801405;Carira;1;1;2;735
2801009;Campo do Brito;2801405;Carira;1;1;2;47
1302603;Manaus;2801306;Capela;1;1;2;2621
2611606;Recife;2801207;Canindé de São Francisco;1;1;2;360
2800308;Aracaju;2800704;Brejo Grande;1;1;2;86
1302603;Manaus;2800670;Boquim;1;1;2;2581
2304400;Fortaleza;2800670;Boquim;1;1;2;822
2304400;Fortaleza;2800605;Barra dos Coqueiros;1;1;2;801
2404507;Guamaré;2800605;Barra dos Coqueiros;1;1;2;641
2503209;Cabedelo;2800605;Barra dos Coqueiros;1;1;2;483
2704302;Maceió;2800605;Barra dos Coqueiros;1;1;2;194
1500602;Altamira;2800308;Aracaju;1;1;2;1848
1500800;Ananindeua;2800308;Aracaju;1;1;2;1611
1505536;Parauapebas;2800308;Aracaju;1;1;2;1486
2207801;Paulistana;2800308;Aracaju;1;1;2;528
2307304;Juazeiro do Norte;2800308;Aracaju;1;1;2;471
2403251;Parnamirim;2800308;Aracaju;1;1;2;584
2408003;Mossoró;2800308;Aracaju;1;1;2;631
2501807;Bayeux;2800308;Aracaju;1;1;2;478
2504009;Campina Grande;2800308;Aracaju;1;1;2;427
2513703;Santa Rita;2800308;Aracaju;1;1;2;474
2600054;Abreu e Lima;2800308;Aracaju;1;1;2;407
2602902;Cabo de Santo Agostinho;2800308;Aracaju;1;1;2;366
2604007;Carpina;2800308;Aracaju;1;1;2;393
2604502;Chã Grande;2800308;Aracaju;1;1;2;343
2606408;Gravatá;2800308;Aracaju;1;1;2;341
2608057;Jatobá;2800308;Aracaju;1;1;2;227
2609402;Moreno;2800308;Aracaju;1;1;2;375
2612208;Salgueiro;2800308;Aracaju;1;1;2;379
2612505;Santa Cruz do Capibaribe;2800308;Aracaju;1;1;2;338
2613701;São Lourenço da Mata;2800308;Aracaju;1;1;2;390
2615409;Toritama;2800308;Aracaju;1;1;2;340
2706901;Pilar;2800308;Aracaju;1;1;2;189
2707107;Piranhas;2800308;Aracaju;1;1;2;157
2708006;Santana do Ipanema;2800308;Aracaju;1;1;2;169
2708600;São Miguel dos Campos;2800308;Aracaju;1;1;2;163
2800100;Amparo de São Francisco;2800308;Aracaju;1;1;2;84
2300754;Amontada;2800209;Aquidabã;1;1;2;821
2607901;Jaboatão dos Guararapes;2709400;Viçosa;1;1;2;192
2700300;Arapiraca;2709400;Viçosa;1;1;2;66
2700409;Atalaia;2709400;Viçosa;1;1;2;28
2701704;Capela;2709400;Viçosa;1;1;2;19
2705507;Murici;2709400;Viçosa;1;1;2;33
2706307;Palmeira dos Índios;2709400;Viçosa;1;1;2;45
2706604;Paulo Jacinto;2709400;Viçosa;1;1;2;15
2707701;Rio Largo;2709400;Viçosa;1;1;2;44
2708501;São Luís do Quitunde;2709400;Viçosa;1;1;2;75
2304400;Fortaleza;2709301;União dos Palmares;1;1;2;656
2601706;Belo Jardim;2709301;União dos Palmares;1;1;2;98
2605004;Cupira;2709301;União dos Palmares;1;1;2;65
2607901;Jaboatão dos Guararapes;2709301;União dos Palmares;1;1;2;166
2610202;Panelas;2709301;União dos Palmares;1;1;2;59
2611507;Quipapá;2709301;União dos Palmares;1;1;2;42
2611606;Recife;2709301;União dos Palmares;1;1;2;174
2613008;São Bento do Una;2709301;União dos Palmares;1;1;2;78
2700300;Arapiraca;2709301;União dos Palmares;1;1;2;92
2700508;Barra de Santo Antônio;2709301;União dos Palmares;1;1;2;69
2703007;Ibateguara;2709301;União dos Palmares;1;1;2;29
2705101;Matriz de Camaragibe;2709301;União dos Palmares;1;1;2;66
2705200;Messias;2709301;União dos Palmares;1;1;2;35
2706307;Palmeira dos Índios;2709301;União dos Palmares;1;1;2;67
2707701;Rio Largo;2709301;União dos Palmares;1;1;2;42
2708402;São José da Tapera;2709301;União dos Palmares;1;1;2;147
2708600;São Miguel dos Campos;2709301;União dos Palmares;1;1;2;66
2702900;Girau do Ponciano;2709202;Traipu;1;1;2;21
2705804;Olho d'Água do Casado;2709202;Traipu;1;1;2;105
2701407;Campo Alegre;2709152;Teotônio Vilela;1;1;2;14
2704005;Junqueiro;2709152;Teotônio Vilela;1;1;2;14
2704302;Maceió;2709152;Teotônio Vilela;1;1;2;72
2705804;Olho d'Água do Casado;2709152;Teotônio Vilela;1;1;2;168
2706901;Pilar;2709152;Teotônio Vilela;1;1;2;55
2707701;Rio Largo;2709152;Teotônio Vilela;1;1;2;72
2708006;Santana do Ipanema;2709152;Teotônio Vilela;1;1;2;114
2702900;Girau do Ponciano;2709103;Taquarana;1;1;2;45
2704302;Maceió;2709103;Taquarana;1;1;2;82
2706307;Palmeira dos Índios;2709103;Taquarana;1;1;2;29
2708006;Santana do Ipanema;2709103;Taquarana;1;1;2;87
2700201;Anadia;2709004;Tanque d'Arca;1;1;2;22
2701209;Cacimbinhas;2708956;Senador Rui Palmeira;1;1;2;57
2701803;Carneiros;2708956;Senador Rui Palmeira;1;1;2;20
2704708;Marechal Deodoro;2708907;Satuba;1;1;2;18
2705507;Murici;2708907;Satuba;1;1;2;31
2706703;Penedo;2708907;Satuba;1;1;2;111
2408003;Mossoró;2708808;São Sebastião;1;1;2;532
2700201;Anadia;2708808;São Sebastião;1;1;2;39
2701407;Campo Alegre;2708808;São Sebastião;1;1;2;28
2702306;Coruripe;2708808;São Sebastião;1;1;2;47
2703106;Igaci;2708808;São Sebastião;1;1;2;45
2704302;Maceió;2708808;São Sebastião;1;1;2;94
2601201;Arcoverde;2708600;São Miguel dos Campos;1;1;2;182
2602902;Cabo de Santo Agostinho;2708600;São Miguel dos Campos;1;1;2;204
2610905;Pesqueira;2708600;São Miguel dos Campos;1;1;2;174
2705200;Messias;2708600;São Miguel dos Campos;1;1;2;53
2705804;Olho d'Água do Casado;2708600;São Miguel dos Campos;1;1;2;192
2706901;Pilar;2708600;São Miguel dos Campos;1;1;2;26
2707305;Porto Calvo;2708600;São Miguel dos Campos;1;1;2;112
2706505;Passo de Camaragibe;2708501;São Luís do Quitunde;1;1;2;12
2706901;Pilar;2708501;São Luís do Quitunde;1;1;2;54
2706000;Olivença;2708402;São José da Tapera;1;1;2;21
2707107;Piranhas;2708402;São José da Tapera;1;1;2;42
2708006;Santana do Ipanema;2708402;São José da Tapera;1;1;2;27
2611606;Recife;2708303;São José da Laje;1;1;2;158
2705507;Murici;2708303;São José da Laje;1;1;2;35
2700300;Arapiraca;2708204;São Brás;1;1;2;43
2706703;Penedo;2708204;São Brás;1;1;2;41
2304400;Fortaleza;2708006;Santana do Ipanema;1;1;2;635
2507507;João Pessoa;2708006;Santana do Ipanema;1;1;2;354
2600500;Águas Belas;2708006;Santana do Ipanema;1;1;2;28
2606002;Garanhuns;2708006;Santana do Ipanema;1;1;2;96
2701605;Canapi;2708006;Santana do Ipanema;1;1;2;48
2702405;Delmiro Gouveia;2708006;Santana do Ipanema;1;1;2;84
2705705;Olho d'Água das Flores;2708006;Santana do Ipanema;1;1;2;21
2706109;Ouro Branco;2708006;Santana do Ipanema;1;1;2;25
2706406;Pão de Açúcar;2708006;Santana do Ipanema;1;1;2;48
2706505;Passo de Camaragibe;2708006;Santana do Ipanema;1;1;2;192
2701209;Cacimbinhas;2707909;Santa Luzia do Norte;1;1;2;130
2705200;Messias;2707909;Santa Luzia do Norte;1;1;2;24
1302603;Manaus;2707701;Rio Largo;1;1;2;2729
1400100;Boa Vista;2707701;Rio Largo;1;1;2;3025
2408102;Natal;2707701;Rio Largo;1;1;2;410
2504355;Caturité;2707701;Rio Largo;1;1;2;228
2701209;Cacimbinhas;2707701;Rio Largo;1;1;2;125
2706448;Paripueira;2707701;Rio Largo;1;1;2;33
2615102;Terezinha;2707602;Quebrangulo;1;1;2;34
2704302;Maceió;2707602;Quebrangulo;1;1;2;87
2706307;Palmeira dos Índios;2707602;Quebrangulo;1;1;2;23
2611606;Recife;2707503;Porto Real do Colégio;1;1;2;304
2704302;Maceió;2707404;Porto de Pedras;1;1;2;73
2700300;Arapiraca;2707305;Porto Calvo;1;1;2;163
2702306;Coruripe;2707305;Porto Calvo;1;1;2;147
2704609;Maravilha;2707206;Poço das Trincheiras;1;1;2;11
2611606;Recife;2707107;Piranhas;1;1;2;351
2700102;Água Branca;2707107;Piranhas;1;1;2;45
2700300;Arapiraca;2707107;Piranhas;1;1;2;118
2701209;Cacimbinhas;2707107;Piranhas;1;1;2;88
2705804;Olho d'Água do Casado;2707107;Piranhas;1;1;2;16
2706000;Olivença;2707107;Piranhas;1;1;2;63
2304400;Fortaleza;2706901;Pilar;1;1;2;703
2507507;João Pessoa;2706901;Pilar;1;1;2;292
2700300;Arapiraca;2706901;Pilar;1;1;2;83
2701001;Boca da Mata;2706901;Pilar;1;1;2;29
2702306;Coruripe;2706901;Pilar;1;1;2;63
2705507;Murici;2706901;Pilar;1;1;2;32
2700300;Arapiraca;2706802;Piaçabuçu;1;1;2;76
2702306;Coruripe;2706802;Piaçabuçu;1;1;2;42
2304400;Fortaleza;2706703;Penedo;1;1;2;751
2610004;Palmares;2706703;Penedo;1;1;2;203
2701506;Campo Grande;2706703;Penedo;1;1;2;43
2704302;Maceió;2706604;Paulo Jacinto;1;1;2;75
2704302;Maceió;2706505;Passo de Camaragibe;1;1;2;53
2705101;Matriz de Camaragibe;2706505;Passo de Camaragibe;1;1;2;5
2700508;Barra de Santo Antônio;2706448;Paripueira;1;1;2;8
2704302;Maceió;2706448;Paripueira;1;1;2;29
2702405;Delmiro Gouveia;2706422;Pariconha;1;1;2;11
2706406;Pão de Açúcar;2706422;Pariconha;1;1;2;83
2700300;Arapiraca;2706406;Pão de Açúcar;1;1;2;81
2702355;Craíbas;2706406;Pão de Açúcar;1;1;2;75
1501402;Belém;2706307;Palmeira dos Índios;1;1;2;1562
2507507;João Pessoa;2706307;Palmeira dos Índios;1;1;2;316
2700409;Atalaia;2706307;Palmeira dos Índios;1;1;2;69
2700805;Belém;2706307;Palmeira dos Índios;1;1;2;23
2701001;Boca da Mata;2706307;Palmeira dos Índios;1;1;2;53
2702405;Delmiro Gouveia;2706307;Palmeira dos Índios;1;1;2;148
2600500;Águas Belas;2706109;Ouro Branco;1;1;2;26
2601201;Arcoverde;2706109;Ouro Branco;1;1;2;85
2704104;Lagoa da Canoa;2705804;Olho d'Água do Casado;1;1;2;126
2600500;Águas Belas;2705705;Olho d'Água das Flores;1;1;2;49
2602100;Bom Conselho;2705705;Olho d'Água das Flores;1;1;2;76
2702306;Coruripe;2705705;Olho d'Água das Flores;1;1;2;139
2702405;Delmiro Gouveia;2705705;Olho d'Água das Flores;1;1;2;80
2703304;Inhapi;2705705;Olho d'Água das Flores;1;1;2;62
2703403;Jacaré dos Homens;2705705;Olho d'Água das Flores;1;1;2;14
2702108;Colônia Leopoldina;2705606;Novo Lino;1;1;2;7
2103604;Coroatá;2705507;Murici;1;1;2;1061
2610707;Paulista;2705507;Murici;1;1;2;191
2611606;Recife;2705507;Murici;1;1;2;172
2702306;Coruripe;2705507;Murici;1;1;2;94
2704302;Maceió;2705507;Murici;1;1;2;42
2705200;Messias;2705507;Murici;1;1;2;14
2704302;Maceió;2705309;Minador do Negrão;1;1;2;128
2607901;Jaboatão dos Guararapes;2705200;Messias;1;1;2;166
2611606;Recife;2705200;Messias;1;1;2;171
2702108;Colônia Leopoldina;2705200;Messias;1;1;2;54
2703809;Joaquim Gomes;2705200;Messias;1;1;2;30
2601409;Barreiros;2705101;Matriz de Camaragibe;1;1;2;52
2703908;Jundiá;2705101;Matriz de Camaragibe;1;1;2;29
2704500;Maragogi;2705101;Matriz de Camaragibe;1;1;2;36
2304400;Fortaleza;2705002;Mata Grande;1;1;2;598
2701605;Canapi;2705002;Mata Grande;1;1;2;15
2701902;Chã Preta;2704906;Mar Vermelho;1;1;2;24
1721000;Palmas;2704807;Maribondo;1;1;2;1329
2700300;Arapiraca;2704807;Maribondo;1;1;2;48
2700805;Belém;2704807;Maribondo;1;1;2;21
2702355;Craíbas;2704807;Maribondo;1;1;2;51
2704203;Limoeiro de Anadia;2704807;Maribondo;1;1;2;28
2704708;Marechal Deodoro;2704807;Maribondo;1;1;2;47
2703759;Jequiá da Praia;2704708;Marechal Deodoro;1;1;2;36
2700706;Batalha;2704401;Major Isidoro;1;1;2;22
2704302;Maceió;2704401;Major Isidoro;1;1;2;136
1302603;Manaus;2704302;Maceió;1;1;2;2743
1400100;Boa Vista;2704302;Maceió;1;1;2;3041
1504208;Marabá;2704302;Maceió;1;1;2;1532
1506138;Redenção;2704302;Maceió;1;1;2;1571
2105302;Imperatriz;2704302;Maceió;1;1;2;1356
2107506;Paço do Lumiar;2704302;Maceió;1;1;2;1202
2111201;São José de Ribamar;2704302;Maceió;1;1;2;1198
2112209;Timon;2704302;Maceió;1;1;2;922
2207702;Parnaíba;2704302;Maceió;1;1;2;996
2211308;Valença do Piauí;2704302;Maceió;1;1;2;753
2307304;Juazeiro do Norte;2704302;Maceió;1;1;2;472
2312908;Sobral;2704302;Maceió;1;1;2;830
2400208;Açu;2704302;Maceió;1;1;2;468
2403251;Parnamirim;2704302;Maceió;1;1;2;415
2408300;Nova Cruz;2704302;Maceió;1;1;2;351
2503704;Cajazeiras;2704302;Maceió;1;1;2;434
2506301;Guarabira;2704302;Maceió;1;1;2;309
2510808;Patos;2704302;Maceió;1;1;2;334
2602308;Bonito;2704302;Maceió;1;1;2;129
2604502;Chã Grande;2704302;Maceió;1;1;2;158
2606200;Goiana;2704302;Maceió;1;1;2;244
2609402;Moreno;2704302;Maceió;1;1;2;182
2610707;Paulista;2704302;Maceió;1;1;2;211
2613909;Serra Talhada;2704302;Maceió;1;1;2;336
2616407;Vitória de Santo Antão;2704302;Maceió;1;1;2;175
2700508;Barra de Santo Antônio;2704302;Maceió;1;1;2;37
2700607;Barra de São Miguel;2704302;Maceió;1;1;2;28
2700706;Batalha;2704302;Maceió;1;1;2;151
2701209;Cacimbinhas;2704302;Maceió;1;1;2;138
2702108;Colônia Leopoldina;2704302;Maceió;1;1;2;80
2702900;Girau do Ponciano;2704302;Maceió;1;1;2;121
2703205;Igreja Nova;2704302;Maceió;1;1;2;114
2703759;Jequiá da Praia;2704302;Maceió;1;1;2;51
2704104;Lagoa da Canoa;2704302;Maceió;1;1;2;110
2701506;Campo Grande;2704203;Limoeiro de Anadia;1;1;2;40
2702009;Coité do Nóia;2704203;Limoeiro de Anadia;1;1;2;15
2702009;Coité do Nóia;2704104;Lagoa da Canoa;1;1;2;28
2702900;Girau do Ponciano;2704104;Lagoa da Canoa;1;1;2;12
2414100;Tenente Ananias;2704005;Junqueiro;1;1;2;425
2702553;Estrela de Alagoas;2704005;Junqueiro;1;1;2;66
2701357;Campestre;2703908;Jundiá;1;1;2;10
2703809;Joaquim Gomes;2703908;Jundiá;1;1;2;29
2700607;Barra de São Miguel;2703759;Jequiá da Praia;1;1;2;23
2702306;Coruripe;2703759;Jequiá da Praia;1;1;2;20
2700300;Arapiraca;2703700;Jaramataia;1;1;2;36
2606002;Garanhuns;2703403;Jacaré dos Homens;1;1;2;114
1508407;Xinguara;2703205;Igreja Nova;1;1;2;1486
2400703;Alto do Rodrigues;2703205;Igreja Nova;1;1;2;535
2702306;Coruripe;2703205;Igreja Nova;1;1;2;53
2607901;Jaboatão dos Guararapes;2703106;Igaci;1;1;2;235
2610707;Paulista;2702553;Estrela de Alagoas;1;1;2;261
1100122;Ji-Paraná;2702405;Delmiro Gouveia;1;1;2;2639
1721000;Palmas;2702405;Delmiro Gouveia;1;1;2;1147
2507507;João Pessoa;2702405;Delmiro Gouveia;1;1;2;419
2605707;Floresta;2702405;Delmiro Gouveia;1;1;2;108
2607901;Jaboatão dos Guararapes;2702405;Delmiro Gouveia;1;1;2;352
2700706;Batalha;2702405;Delmiro Gouveia;1;1;2;103
2304285;Eusébio;2702306;Coruripe;1;1;2;733
2602100;Bom Conselho;2702306;Coruripe;1;1;2;117
2611606;Recife;2702306;Coruripe;1;1;2;260
2700409;Atalaia;2702306;Coruripe;1;1;2;71
2607901;Jaboatão dos Guararapes;2702108;Colônia Leopoldina;1;1;2;115
2701407;Campo Alegre;2702009;Coité do Nóia;1;1;2;30
2701308;Cajueiro;2701902;Chã Preta;1;1;2;22
2609600;Olinda;2701704;Capela;1;1;2;202
2701308;Cajueiro;2701704;Capela;1;1;2;9
2700409;Atalaia;2701308;Cajueiro;1;1;2;18
2700607;Barra de São Miguel;2701308;Cajueiro;1;1;2;56
2700201;Anadia;2701001;Boca da Mata;1;1;2;10
2700300;Arapiraca;2700904;Belo Monte;1;1;2;65
2304400;Fortaleza;2700706;Batalha;1;1;2;672
2611606;Recife;2700706;Batalha;1;1;2;295
2700300;Arapiraca;2700607;Barra de São Miguel;1;1;2;87
2208007;Picos;2700300;Arapiraca;1;1;2;601
2408003;Mossoró;2700300;Arapiraca;1;1;2;511
2601201;Arcoverde;2700300;Arapiraca;1;1;2;151
2602902;Cabo de Santo Agostinho;2700300;Arapiraca;1;1;2;246
2604106;Caruaru;2700300;Arapiraca;1;1;2;181
2609600;Olinda;2700300;Arapiraca;1;1;2;277
2610707;Paulista;2700300;Arapiraca;1;1;2;283
2612505;Santa Cruz do Capibaribe;2700300;Arapiraca;1;1;2;207
1501402;Belém;2616407;Vitória de Santo Antão;1;1;2;1621
2403251;Parnamirim;2616407;Vitória de Santo Antão;1;1;2;244
2408003;Mossoró;2616407;Vitória de Santo Antão;1;1;2;395
2600054;Abreu e Lima;2616407;Vitória de Santo Antão;1;1;2;49
2601904;Bezerros;2616407;Vitória de Santo Antão;1;1;2;57
2604403;Chã de Alegria;2616407;Vitória de Santo Antão;1;1;2;15
2604502;Chã Grande;2616407;Vitória de Santo Antão;1;1;2;23
2605400;Feira Nova;2616407;Vitória de Santo Antão;1;1;2;21
2607208;Ipojuca;2616407;Vitória de Santo Antão;1;1;2;40
2607901;Jaboatão dos Guararapes;2616407;Vitória de Santo Antão;1;1;2;28
2609600;Olinda;2616407;Vitória de Santo Antão;1;1;2;45
2610707;Paulista;2616407;Vitória de Santo Antão;1;1;2;49
2610905;Pesqueira;2616407;Vitória de Santo Antão;1;1;2;162
2611101;Petrolina;2616407;Vitória de Santo Antão;1;1;2;594
2612505;Santa Cruz do Capibaribe;2616407;Vitória de Santo Antão;1;1;2;102
2600708;Aliança;2616308;Vicência;1;1;2;12
2602704;Buenos Aires;2616308;Vicência;1;1;2;8
2603603;Camutanga;2616308;Vicência;1;1;2;27
2607208;Ipojuca;2616308;Vicência;1;1;2;87
2609006;Macaparana;2616308;Vicência;1;1;2;18
2610608;Paudalho;2616308;Vicência;1;1;2;31
2611903;Rio Formoso;2616308;Vicência;1;1;2;113
2614501;Surubim;2616308;Vicência;1;1;2;50
2616209;Vertentes;2616308;Vicência;1;1;2;78
2506004;Esperança;2616209;Vertentes;1;1;2;100
2604106;Caruaru;2616209;Vertentes;1;1;2;42
2614501;Surubim;2616209;Vertentes;1;1;2;28
2615003;Taquaritinga do Norte;2616209;Vertentes;1;1;2;7
2503209;Cabedelo;2616183;Vertente do Lério;1;1;2;136
2606408;Gravatá;2616183;Vertente do Lério;1;1;2;56
2604304;Cedro;2616100;Verdejante;1;1;2;37
2609303;Mirandiba;2616100;Verdejante;1;1;2;35
2610400;Parnamirim;2616100;Verdejante;1;1;2;69
2612208;Salgueiro;2616100;Verdejante;1;1;2;30
2615201;Terra Nova;2616100;Verdejante;1;1;2;58
2602803;Buíque;2616001;Venturosa;1;1;2;30
2603207;Caetés;2616001;Venturosa;1;1;2;35
2610806;Pedra;2616001;Venturosa;1;1;2;11
2614105;Sertânia;2616001;Venturosa;1;1;2;75
2607109;Ingazeira;2615904;Tuparetama;1;1;2;16
2610400;Parnamirim;2615904;Tuparetama;1;1;2;254
2613602;São José do Egito;2615904;Tuparetama;1;1;2;15
2614600;Tabira;2615904;Tuparetama;1;1;2;24
2607505;Itaíba;2615805;Tupanatinga;1;1;2;23
2611606;Recife;2615805;Tupanatinga;1;1;2;274
2605608;Flores;2615706;Triunfo;1;1;2;14
2607901;Jaboatão dos Guararapes;2615706;Triunfo;1;1;2;340
2611606;Recife;2615706;Triunfo;1;1;2;351
2612471;Santa Cruz da Baixa Verde;2615706;Triunfo;1;1;2;6
2613503;São José do Belmonte;2615706;Triunfo;1;1;2;75
1507607;São Miguel do Guamá;2615607;Trindade;1;1;2;1044
2203909;Floriano;2615607;Trindade;1;1;2;321
2603009;Cabrobó;2615607;Trindade;1;1;2;132
2605707;Floresta;2615607;Trindade;1;1;2;205
2607307;Ipubi;2615607;Trindade;1;1;2;22
2612208;Salgueiro;2615607;Trindade;1;1;2;129
2612554;Santa Filomena;2615607;Trindade;1;1;2;55
2604007;Carpina;2615508;Tracunhaém;1;1;2;4
2615300;Timbaúba;2615508;Tracunhaém;1;1;2;34
2208403;Piripiri;2615409;Toritama;1;1;2;751
2304400;Fortaleza;2615409;Toritama;1;1;2;541
2601706;Belo Jardim;2615409;Toritama;1;1;2;58
2602209;Bom Jardim;2615409;Toritama;1;1;2;56
2602308;Bonito;2615409;Toritama;1;1;2;64
2602605;Brejo da Madre de Deus;2615409;Toritama;1;1;2;39
2604205;Catende;2615409;Toritama;1;1;2;83
2606002;Garanhuns;2615409;Toritama;1;1;2;109
2609600;Olinda;2615409;Toritama;1;1;2;127
2611101;Petrolina;2615409;Toritama;1;1;2;516
1501402;Belém;2615300;Timbaúba;1;1;2;1593
2103307;Codó;2615300;Timbaúba;1;1;2;1007
2109106;Presidente Dutra;2615300;Timbaúba;1;1;2;1041
2111102;São João dos Patos;2615300;Timbaúba;1;1;2;932
2304400;Fortaleza;2615300;Timbaúba;1;1;2;545
2500601;Alhandra;2615300;Timbaúba;1;1;2;44
2501807;Bayeux;2615300;Timbaúba;1;1;2;59
2503001;Caaporã;2615300;Timbaúba;1;1;2;44
2503704;Cajazeiras;2615300;Timbaúba;1;1;2;368
2504603;Conde;2615300;Timbaúba;1;1;2;52
2506400;Gurinhém;2615300;Timbaúba;1;1;2;44
2507903;Juripiranga;2615300;Timbaúba;1;1;2;17
2508901;Mamanguape;2615300;Timbaúba;1;1;2;74
2511509;Pilar;2615300;Timbaúba;1;1;2;27
2513109;Salgado de São Félix;2615300;Timbaúba;1;1;2;22
2600054;Abreu e Lima;2615300;Timbaúba;1;1;2;62
2601052;Araçoiaba;2615300;Timbaúba;1;1;2;39
2602209;Bom Jardim;2615300;Timbaúba;1;1;2;44
2602704;Buenos Aires;2615300;Timbaúba;1;1;2;24
2604106;Caruaru;2615300;Timbaúba;1;1;2;115
2605400;Feira Nova;2615300;Timbaúba;1;1;2;50
2606002;Garanhuns;2615300;Timbaúba;1;1;2;201
2606101;Glória do Goitá;2615300;Timbaúba;1;1;2;55
2607802;Itaquitinga;2615300;Timbaúba;1;1;2;29
2607901;Jaboatão dos Guararapes;2615300;Timbaúba;1;1;2;74
2608107;João Alfredo;2615300;Timbaúba;1;1;2;49
2608503;Lagoa do Itaenga;2615300;Timbaúba;1;1;2;47
2609105;Machados;2615300;Timbaúba;1;1;2;31
2609402;Moreno;2615300;Timbaúba;1;1;2;71
2609600;Olinda;2615300;Timbaúba;1;1;2;70
2609907;Ouricuri;2615300;Timbaúba;1;1;2;532
2610608;Paudalho;2615300;Timbaúba;1;1;2;45
2611101;Petrolina;2615300;Timbaúba;1;1;2;612
2612208;Salgueiro;2615300;Timbaúba;1;1;2;431
2612505;Santa Cruz do Capibaribe;2615300;Timbaúba;1;1;2;111
2613701;São Lourenço da Mata;2615300;Timbaúba;1;1;2;62
2613800;São Vicente Ferrer;2615300;Timbaúba;1;1;2;22
2613909;Serra Talhada;2615300;Timbaúba;1;1;2;335
2603009;Cabrobó;2615201;Terra Nova;1;1;2;28
2610400;Parnamirim;2615201;Terra Nova;1;1;2;24
2613909;Serra Talhada;2615201;Terra Nova;1;1;2;125
2601003;Angelim;2615102;Terezinha;1;1;2;41
2602100;Bom Conselho;2615102;Terezinha;1;1;2;18
2602407;Brejão;2615102;Terezinha;1;1;2;7
2506004;Esperança;2615003;Taquaritinga do Norte;1;1;2;101
2512705;Remígio;2615003;Taquaritinga do Norte;1;1;2;113
2610004;Palmares;2615003;Taquaritinga do Norte;1;1;2;101
2614501;Surubim;2615003;Taquaritinga do Norte;1;1;2;35
2613404;São José da Coroa Grande;2614857;Tamandaré;1;1;2;12
2600500;Águas Belas;2614808;Tacaratu;1;1;2;113
2600302;Agrestina;2614709;Tacaimbó;1;1;2;41
2600500;Águas Belas;2614709;Tacaimbó;1;1;2;129
2600609;Alagoinha;2614709;Tacaimbó;1;1;2;56
2600807;Altinho;2614709;Tacaimbó;1;1;2;32
2601706;Belo Jardim;2614709;Tacaimbó;1;1;2;15
2604106;Caruaru;2614709;Tacaimbó;1;1;2;33
2610905;Pesqueira;2614709;Tacaimbó;1;1;2;49
2611200;Poção;2614709;Tacaimbó;1;1;2;48
2613107;São Caitano;2614709;Tacaimbó;1;1;2;17
2605103;Custódia;2614600;Tabira;1;1;2;59
2605608;Flores;2614600;Tabira;1;1;2;57
2607703;Itapetim;2614600;Tabira;1;1;2;45
2611101;Petrolina;2614600;Tabira;1;1;2;382
2611606;Recife;2614600;Tabira;1;1;2;294
2614402;Solidão;2614600;Tabira;1;1;2;13
2614501;Surubim;2614600;Tabira;1;1;2;199
2304400;Fortaleza;2614501;Surubim;1;1;2;543
2306306;Itapagé;2614501;Surubim;1;1;2;622
2408003;Mossoró;2614501;Surubim;1;1;2;340
2506905;Itabaiana;2614501;Surubim;1;1;2;70
2507507;João Pessoa;2614501;Surubim;1;1;2;120
2517001;Umbuzeiro;2614501;Surubim;1;1;2;16
2600054;Abreu e Lima;2614501;Surubim;1;1;2;93
2600104;Afogados da Ingazeira;2614501;Surubim;1;1;2;207
2600708;Aliança;2614501;Surubim;1;1;2;62
2602902;Cabo de Santo Agostinho;2614501;Surubim;1;1;2;95
2603454;Camaragibe;2614501;Surubim;1;1;2;85
2604155;Casinhas;2614501;Surubim;1;1;2;9
2606200;Goiana;2614501;Surubim;1;1;2;87
2607901;Jaboatão dos Guararapes;2614501;Surubim;1;1;2;85
2609006;Macaparana;2614501;Surubim;1;1;2;43
2609501;Nazaré da Mata;2614501;Surubim;1;1;2;58
2612703;Santa Maria do Cambucá;2614501;Surubim;1;1;2;17
2603900;Carnaíba;2614402;Solidão;1;1;2;28
2409902;Pendências;2614204;Sirinhaém;1;1;2;402
2605202;Escada;2614204;Sirinhaém;1;1;2;25
2607752;Itapissuma;2614204;Sirinhaém;1;1;2;92
2610707;Paulista;2614204;Sirinhaém;1;1;2;77
2304400;Fortaleza;2614105;Sertânia;1;1;2;492
2509701;Monteiro;2614105;Sertânia;1;1;2;23
2603702;Canhotinho;2614105;Sertânia;1;1;2;154
2604106;Caruaru;2614105;Sertânia;1;1;2;146
2605301;Exu;2614105;Sertânia;1;1;2;273
2607901;Jaboatão dos Guararapes;2614105;Sertânia;1;1;2;250
2608008;Jataúba;2614105;Sertânia;1;1;2;89
2610905;Pesqueira;2614105;Sertânia;1;1;2;70
2611002;Petrolândia;2614105;Sertânia;1;1;2;159
2611101;Petrolina;2614105;Sertânia;1;1;2;384
2611507;Quipapá;2614105;Sertânia;1;1;2;163
2605301;Exu;2614006;Serrita;1;1;2;63
2610400;Parnamirim;2614006;Serrita;1;1;2;36
2613503;São José do Belmonte;2614006;Serrita;1;1;2;57
2208007;Picos;2613909;Serra Talhada;1;1;2;362
2304202;Crato;2613909;Serra Talhada;1;1;2;146
2307304;Juazeiro do Norte;2613909;Serra Talhada;1;1;2;137
2309607;Pacajus;2613909;Serra Talhada;1;1;2;418
2507507;João Pessoa;2613909;Serra Talhada;1;1;2;389
2512309;Princesa Isabel;2613909;Serra Talhada;1;1;2;42
2601706;Belo Jardim;2613909;Serra Talhada;1;1;2;213
2602902;Cabo de Santo Agostinho;2613909;Serra Talhada;1;1;2;364
2603405;Calumbi;2613909;Serra Talhada;1;1;2;17
2605608;Flores;2613909;Serra Talhada;1;1;2;38
2606002;Garanhuns;2613909;Serra Talhada;1;1;2;219
2607208;Ipojuca;2613909;Serra Talhada;1;1;2;361
2607901;Jaboatão dos Guararapes;2613909;Serra Talhada;1;1;2;361
2609600;Olinda;2613909;Serra Talhada;1;1;2;375
2501302;Aroeiras;2613800;São Vicente Ferrer;1;1;2;24
2603603;Camutanga;2613800;São Vicente Ferrer;1;1;2;30
2609006;Macaparana;2613800;São Vicente Ferrer;1;1;2;6
2306306;Itapagé;2613701;São Lourenço da Mata;1;1;2;691
2602902;Cabo de Santo Agostinho;2613701;São Lourenço da Mata;1;1;2;31
2604502;Chã Grande;2613701;São Lourenço da Mata;1;1;2;53
2606804;Igarassu;2613701;São Lourenço da Mata;1;1;2;21
2608453;Lagoa do Carro;2613701;São Lourenço da Mata;1;1;2;35
2608909;Limoeiro;2613701;São Lourenço da Mata;1;1;2;47
2203909;Floriano;2613602;São José do Egito;1;1;2;636
2500106;Água Branca;2613602;São José do Egito;1;1;2;39
2506707;Imaculada;2613602;São José do Egito;1;1;2;26
2510808;Patos;2613602;São José do Egito;1;1;2;51
2302503;Brejo Santo;2613503;São José do Belmonte;1;1;2;54
2510808;Patos;2613503;São José do Belmonte;1;1;2;193
2609303;Mirandiba;2613503;São José do Belmonte;1;1;2;25
2609907;Ouricuri;2613503;São José do Belmonte;1;1;2;147
2610400;Parnamirim;2613503;São José do Belmonte;1;1;2;90
2606804;Igarassu;2613404;São José da Coroa Grande;1;1;2;114
2609006;Macaparana;2613404;São José da Coroa Grande;1;1;2;147
2611903;Rio Formoso;2613404;São José da Coroa Grande;1;1;2;21
2601904;Bezerros;2613305;São Joaquim do Monte;1;1;2;22
2607950;Jaqueira;2613305;São Joaquim do Monte;1;1;2;33
2611606;Recife;2613305;São Joaquim do Monte;1;1;2;102
2608255;Jucati;2613206;São João;1;1;2;23
2608800;Lajedo;2613206;São João;1;1;2;24
2610103;Palmeirina;2613206;São João;1;1;2;15
2610301;Paranatama;2613206;São João;1;1;2;32
2613008;São Bento do Una;2613206;São João;1;1;2;34
2602605;Brejo da Madre de Deus;2613107;São Caitano;1;1;2;32
2608453;Lagoa do Carro;2613107;São Caitano;1;1;2;105
2610608;Paudalho;2613107;São Caitano;1;1;2;116
2611606;Recife;2613107;São Caitano;1;1;2;135
2601409;Barreiros;2613008;São Bento do Una;1;1;2;138
2603801;Capoeiras;2613008;São Bento do Una;1;1;2;27
2604106;Caruaru;2613008;São Bento do Una;1;1;2;59
2606002;Garanhuns;2613008;São Bento do Una;1;1;2;32
2607950;Jaqueira;2612901;São Benedito do Sul;1;1;2;20
2608404;Jurema;2612901;São Benedito do Sul;1;1;2;23
2608602;Lagoa do Ouro;2612901;São Benedito do Sul;1;1;2;66
2610202;Panelas;2612901;São Benedito do Sul;1;1;2;17
2611507;Quipapá;2612901;São Benedito do Sul;1;1;2;9
2602209;Bom Jardim;2612703;Santa Maria do Cambucá;1;1;2;35
2606408;Gravatá;2612703;Santa Maria do Cambucá;1;1;2;55
2211001;Teresina;2612604;Santa Maria da Boa Vista;1;1;2;518
2605301;Exu;2612604;Santa Maria da Boa Vista;1;1;2;132
2608750;Lagoa Grande;2612604;Santa Maria da Boa Vista;1;1;2;55
2609907;Ouricuri;2612604;Santa Maria da Boa Vista;1;1;2;100
2612208;Salgueiro;2612604;Santa Maria da Boa Vista;1;1;2;101
2606309;Granito;2612554;Santa Filomena;1;1;2;116
2609907;Ouricuri;2612554;Santa Filomena;1;1;2;64
1600501;Oiapoque;2612505;Santa Cruz do Capibaribe;1;1;2;2146
2306306;Itapagé;2612505;Santa Cruz do Capibaribe;1;1;2;601
2408102;Natal;2612505;Santa Cruz do Capibaribe;1;1;2;259
2501302;Aroeiras;2612505;Santa Cruz do Capibaribe;1;1;2;71
2504306;Catolé do Rocha;2612505;Santa Cruz do Capibaribe;1;1;2;246
2506004;Esperança;2612505;Santa Cruz do Capibaribe;1;1;2;112
2510808;Patos;2612505;Santa Cruz do Capibaribe;1;1;2;157
2513901;São Bento;2612505;Santa Cruz do Capibaribe;1;1;2;213
2600302;Agrestina;2612505;Santa Cruz do Capibaribe;1;1;2;62
2601409;Barreiros;2612505;Santa Cruz do Capibaribe;1;1;2;144
2601706;Belo Jardim;2612505;Santa Cruz do Capibaribe;1;1;2;51
2604809;Cortês;2612505;Santa Cruz do Capibaribe;1;1;2;93
2607208;Ipojuca;2612505;Santa Cruz do Capibaribe;1;1;2;135
2607901;Jaboatão dos Guararapes;2612505;Santa Cruz do Capibaribe;1;1;2;130
2608453;Lagoa do Carro;2612505;Santa Cruz do Capibaribe;1;1;2;98
2610004;Palmares;2612505;Santa Cruz do Capibaribe;1;1;2;106
2610905;Pesqueira;2612505;Santa Cruz do Capibaribe;1;1;2;73
2611200;Poção;2612505;Santa Cruz do Capibaribe;1;1;2;61
2612471;Santa Cruz da Baixa Verde;2612505;Santa Cruz do Capibaribe;1;1;2;215
2607901;Jaboatão dos Guararapes;2612471;Santa Cruz da Baixa Verde;1;1;2;346
2607307;Ipubi;2612455;Santa Cruz;1;1;2;68
2609600;Olinda;2612455;Santa Cruz;1;1;2;599
2609907;Ouricuri;2612455;Santa Cruz;1;1;2;47
2611101;Petrolina;2612455;Santa Cruz;1;1;2;120
2604106;Caruaru;2612406;Sanharó;1;1;2;63
2608800;Lajedo;2612406;Sanharó;1;1;2;43
2603801;Capoeiras;2612307;Saloá;1;1;2;27
2606507;Iati;2612307;Saloá;1;1;2;19
1501402;Belém;2612208;Salgueiro;1;1;2;1261
2201903;Bom Jesus;2612208;Salgueiro;1;1;2;585
2302503;Brejo Santo;2612208;Salgueiro;1;1;2;73
2305506;Iguatu;2612208;Salgueiro;1;1;2;197
2307304;Juazeiro do Norte;2612208;Salgueiro;1;1;2;101
2402006;Caicó;2612208;Salgueiro;1;1;2;290
2503308;Cachoeira dos Índios;2612208;Salgueiro;1;1;2;143
2507507;João Pessoa;2612208;Salgueiro;1;1;2;485
2600500;Águas Belas;2612208;Salgueiro;1;1;2;251
2601201;Arcoverde;2612208;Salgueiro;1;1;2;233
2602902;Cabo de Santo Agostinho;2612208;Salgueiro;1;1;2;456
2604106;Caruaru;2612208;Salgueiro;1;1;2;349
2604304;Cedro;2612208;Salgueiro;1;1;2;46
2605301;Exu;2612208;Salgueiro;1;1;2;89
2605707;Floresta;2612208;Salgueiro;1;1;2;80
2606002;Garanhuns;2612208;Salgueiro;1;1;2;301
2606606;Ibimirim;2612208;Salgueiro;1;1;2;169
2607307;Ipubi;2612208;Salgueiro;1;1;2;121
2607406;Itacuruba;2612208;Salgueiro;1;1;2;86
2607703;Itapetim;2612208;Salgueiro;1;1;2;232
2607901;Jaboatão dos Guararapes;2612208;Salgueiro;1;1;2;455
2609808;Orocó;2612208;Salgueiro;1;1;2;66
2611002;Petrolândia;2612208;Salgueiro;1;1;2;141
2608107;João Alfredo;2612109;Salgadinho;1;1;2;9
2608909;Limoeiro;2612109;Salgadinho;1;1;2;21
2601904;Bezerros;2612000;Sairé;1;1;2;15
2611606;Recife;2612000;Sairé;1;1;2;88
1702406;Arraias;2611903;Rio Formoso;1;1;2;1389
2605905;Gameleira;2611903;Rio Formoso;1;1;2;25
2607208;Ipojuca;2611903;Rio Formoso;1;1;2;32
2602308;Bonito;2611804;Ribeirão;1;1;2;37
2604809;Cortês;2611804;Ribeirão;1;1;2;16
2606002;Garanhuns;2611804;Ribeirão;1;1;2;131
2607208;Ipojuca;2611804;Ribeirão;1;1;2;38
2603108;Cachoeirinha;2611705;Riacho das Almas;1;1;2;56
2610905;Pesqueira;2611705;Riacho das Almas;1;1;2;98
1100023;Ariquemes;2611606;Recife;1;1;2;3109
1301902;Itacoatiara;2611606;Recife;1;1;2;2636
1500347;Água Azul do Norte;2611606;Recife;1;1;2;1716
1501303;Barcarena;2611606;Recife;1;1;2;1669
1502400;Castanhal;2611606;Recife;1;1;2;1610
1503804;Jacundá;2611606;Recife;1;1;2;1612
1505635;Piçarra;2611606;Recife;1;1;2;1545
1506807;Santarém;2611606;Recife;1;1;2;2259
1508100;Tucuruí;2611606;Recife;1;1;2;1695
1508209;Vigia;2611606;Recife;1;1;2;1654
1508407;Xinguara;2611606;Recife;1;1;2;1655
1600303;Macapá;2611606;Recife;1;1;2;1988
1714880;Nova Olinda;2611606;Recife;1;1;2;1487
1722107;Xambioá;2611606;Recife;1;1;2;1507
2100055;Açailândia;2611606;Recife;1;1;2;1421
2103307;Codó;2611606;Recife;1;1;2;1068
2103802;Dom Pedro;2611606;Recife;1;1;2;1100
2104800;Grajaú;2611606;Recife;1;1;2;1258
2109908;Santa Inês;2611606;Recife;1;1;2;1247
2110203;Santa Rita;2611606;Recife;1;1;2;1171
2112308;Tuntum;2611606;Recife;1;1;2;1114
2112704;Vargem Grande;2611606;Recife;1;1;2;1106
2200400;Altos;2611606;Recife;1;1;2;894
2202208;Campo Maior;2611606;Recife;1;1;2;876
2203602;Eliseu Martins;2611606;Recife;1;1;2;960
2205706;Luís Correia;2611606;Recife;1;1;2;938
2210003;São João do Piauí;2611606;Recife;1;1;2;810
2211100;União;2611606;Recife;1;1;2;952
2301000;Aquiraz;2611606;Recife;1;1;2;602
2301851;Banabuiú;2611606;Recife;1;1;2;539
2302503;Brejo Santo;2611606;Recife;1;1;2;454
2304202;Crato;2611606;Recife;1;1;2;503
2305407;Icó;2611606;Recife;1;1;2;472
2306553;Itarema;2611606;Recife;1;1;2;794
2307007;Jaguaruana;2611606;Recife;1;1;2;480
2307601;Limoeiro do Norte;2611606;Recife;1;1;2;478
2308302;Milagres;2611606;Recife;1;1;2;451
2308401;Missão Velha;2611606;Recife;1;1;2;474
2308708;Morada Nova;2611606;Recife;1;1;2;503
2311306;Quixadá;2611606;Recife;1;1;2;572
2311801;Russas;2611606;Recife;1;1;2;486
2313104;Tabuleiro do Norte;2611606;Recife;1;1;2;474
2313302;Tauá;2611606;Recife;1;1;2;638
2313955;Varjota;2611606;Recife;1;1;2;748
2401305;Augusto Severo;2611606;Recife;1;1;2;362
2401404;Baía Formosa;2611606;Recife;1;1;2;193
2401453;Baraúna;2611606;Recife;1;1;2;448
2403103;Currais Novos;2611606;Recife;1;1;2;270
2404101;Galinhos;2611606;Recife;1;1;2;364
2406502;Lagoa Nova;2611606;Recife;1;1;2;281
2411403;Santana do Matos;2611606;Recife;1;1;2;305
2411502;Santo Antônio;2611606;Recife;1;1;2;209
2411601;São Bento do Norte;2611606;Recife;1;1;2;353
2412203;São José de Mipibu;2611606;Recife;1;1;2;228
2412906;São Tomé;2611606;Recife;1;1;2;272
2504355;Caturité;2611606;Recife;1;1;2;144
2506004;Esperança;2611606;Recife;1;1;2;158
2508604;Lucena;2611606;Recife;1;1;2;132
2511202;Pedras de Fogo;2611606;Recife;1;1;2;84
2511608;Pilões;2611606;Recife;1;1;2;155
2516201;Sousa;2611606;Recife;1;1;2;397
2600203;Afrânio;2611606;Recife;1;1;2;676
2600708;Aliança;2611606;Recife;1;1;2;66
2600906;Amaraji;2611606;Recife;1;1;2;64
2601003;Angelim;2611606;Recife;1;1;2;172
2601300;Barra de Guabiraba;2611606;Recife;1;1;2;86
2602001;Bodocó;2611606;Recife;1;1;2;553
2602209;Bom Jardim;2611606;Recife;1;1;2;81
2602407;Brejão;2611606;Recife;1;1;2;207
2603009;Cabrobó;2611606;Recife;1;1;2;482
2603504;Camocim de São Félix;2611606;Recife;1;1;2;95
2603603;Camutanga;2611606;Recife;1;1;2;88
2604601;Condado;2611606;Recife;1;1;2;62
2604809;Cortês;2611606;Recife;1;1;2;77
2605004;Cupira;2611606;Recife;1;1;2;125
2605103;Custódia;2611606;Recife;1;1;2;297
2605301;Exu;2611606;Recife;1;1;2;532
2605905;Gameleira;2611606;Recife;1;1;2;71
2606606;Ibimirim;2611606;Recife;1;1;2;306
2607307;Ipubi;2611606;Recife;1;1;2;577
2608503;Lagoa do Itaenga;2611606;Recife;1;1;2;45
2610509;Passira;2611606;Recife;1;1;2;73
2607950;Jaqueira;2611507;Quipapá;1;1;2;28
2608800;Lajedo;2611507;Quipapá;1;1;2;35
2610004;Palmares;2611507;Quipapá;1;1;2;51
2610202;Panelas;2611507;Quipapá;1;1;2;17
2600906;Amaraji;2611309;Pombos;1;1;2;27
2600609;Alagoinha;2611200;Poção;1;1;2;32
2602803;Buíque;2611200;Poção;1;1;2;68
1500800;Ananindeua;2611101;Petrolina;1;1;2;1225
2101202;Bacabal;2611101;Petrolina;1;1;2;727
2101608;Barra do Corda;2611101;Petrolina;1;1;2;662
2109908;Santa Inês;2611101;Petrolina;1;1;2;808
2112209;Timon;2611101;Petrolina;1;1;2;527
2202307;Canto do Buriti;2611101;Petrolina;1;1;2;299
2202901;Corrente;2611101;Petrolina;1;1;2;524
2203503;Elesbão Veloso;2611101;Petrolina;1;1;2;385
2203909;Floriano;2611101;Petrolina;1;1;2;388
2207702;Parnaíba;2611101;Petrolina;1;1;2;724
2207801;Paulistana;2611101;Petrolina;1;1;2;137
2210805;Simplício Mendes;2611101;Petrolina;1;1;2;221
2211209;Uruçuí;2611101;Petrolina;1;1;2;497
2300754;Amontada;2611101;Petrolina;1;1;2;662
2301901;Barbalha;2611101;Petrolina;1;1;2;257
2302602;Camocim;2611101;Petrolina;1;1;2;706
2302701;Campos Sales;2611101;Petrolina;1;1;2;247
2302800;Canindé;2611101;Petrolina;1;1;2;564
2304103;Crateús;2611101;Petrolina;1;1;2;457
2304202;Crato;2611101;Petrolina;1;1;2;262
2305506;Iguatu;2611101;Petrolina;1;1;2;352
2306256;Itaitinga;2611101;Petrolina;1;1;2;629
2306405;Itapipoca;2611101;Petrolina;1;1;2;650
2307106;Jardim;2611101;Petrolina;1;1;2;234
2307650;Maracanaú;2611101;Petrolina;1;1;2;637
2307809;Marco;2611101;Petrolina;1;1;2;685
2311306;Quixadá;2611101;Petrolina;1;1;2;507
2311405;Quixeramobim;2611101;Petrolina;1;1;2;475
2313609;Ubajara;2611101;Petrolina;1;1;2;604
2404705;Ipanguaçu;2611101;Petrolina;1;1;2;582
2408102;Natal;2611101;Petrolina;1;1;2;695
2409902;Pendências;2611101;Petrolina;1;1;2;613
2516201;Sousa;2611101;Petrolina;1;1;2;374
2600203;Afrânio;2611101;Petrolina;1;1;2;103
2600500;Águas Belas;2611101;Petrolina;1;1;2;376
2601706;Belo Jardim;2611101;Petrolina;1;1;2;463
2602001;Bodocó;2611101;Petrolina;1;1;2;181
2602803;Buíque;2611101;Petrolina;1;1;2;381
2602902;Cabo de Santo Agostinho;2611101;Petrolina;1;1;2;615
2604007;Carpina;2611101;Petrolina;1;1;2;602
2605004;Cupira;2611101;Petrolina;1;1;2;509
2605103;Custódia;2611101;Petrolina;1;1;2;345
2605459;Fernando de Noronha;2611101;Petrolina;1;1;2;1067
2607208;Ipojuca;2611101;Petrolina;1;1;2;609
2608057;Jatobá;2611101;Petrolina;1;1;2;249
2610707;Paulista;2611101;Petrolina;1;1;2;637
2610905;Pesqueira;2611101;Petrolina;1;1;2;430
2611002;Petrolândia;2611101;Petrolina;1;1;2;246
2407104;Macaíba;2611002;Petrolândia;1;1;2;481
2600500;Águas Belas;2611002;Petrolândia;1;1;2;131
2304400;Fortaleza;2610905;Pesqueira;1;1;2;543
2503209;Cabedelo;2610905;Pesqueira;1;1;2;252
2600104;Afogados da Ingazeira;2610905;Pesqueira;1;1;2;115
2602803;Buíque;2610905;Pesqueira;1;1;2;54
2602902;Cabo de Santo Agostinho;2610905;Pesqueira;1;1;2;189
2604007;Carpina;2610905;Pesqueira;1;1;2;173
2604502;Chã Grande;2610905;Pesqueira;1;1;2;141
2608800;Lajedo;2610905;Pesqueira;1;1;2;58
2608909;Limoeiro;2610905;Pesqueira;1;1;2;151
2609303;Mirandiba;2610905;Pesqueira;1;1;2;221
2610806;Pedra;2610905;Pesqueira;1;1;2;28
2308708;Morada Nova;2610806;Pedra;1;1;2;404
1501402;Belém;2610707;Paulista;1;1;2;1653
2211001;Teresina;2610707;Paulista;1;1;2;924
2306306;Itapagé;2610707;Paulista;1;1;2;698
2307304;Juazeiro do Norte;2610707;Paulista;1;1;2;493
2504009;Campina Grande;2610707;Paulista;1;1;2;137
2513703;Santa Rita;2610707;Paulista;1;1;2;89
2602308;Bonito;2610707;Paulista;1;1;2;110
2606002;Garanhuns;2610707;Paulista;1;1;2;208
2606408;Gravatá;2610707;Paulista;1;1;2;80
2607208;Ipojuca;2610707;Paulista;1;1;2;55
2608107;João Alfredo;2610707;Paulista;1;1;2;77
2608800;Lajedo;2610707;Paulista;1;1;2;177
2609501;Nazaré da Mata;2610707;Paulista;1;1;2;43
2304400;Fortaleza;2610608;Paudalho;1;1;2;587
2601052;Araçoiaba;2610608;Paudalho;1;1;2;15
2603454;Camaragibe;2610608;Paudalho;1;1;2;24
2604106;Caruaru;2610608;Paudalho;1;1;2;100
2605202;Escada;2610608;Paudalho;1;1;2;51
2607901;Jaboatão dos Guararapes;2610608;Paudalho;1;1;2;29
2608503;Lagoa do Itaenga;2610608;Paudalho;1;1;2;13
2609105;Machados;2610608;Paudalho;1;1;2;44
2609600;Olinda;2610608;Paudalho;1;1;2;32
2601706;Belo Jardim;2610509;Passira;1;1;2;101
2604007;Carpina;2610509;Passira;1;1;2;41
2604908;Cumaru;2610509;Passira;1;1;2;13
2608107;João Alfredo;2610509;Passira;1;1;2;15
2609006;Macaparana;2610509;Passira;1;1;2;51
2308104;Mauriti;2610400;Parnamirim;1;1;2;118
2601102;Araripina;2610400;Parnamirim;1;1;2;115
2602308;Bonito;2610202;Panelas;1;1;2;37
2604106;Caruaru;2610202;Panelas;1;1;2;42
2604205;Catende;2610202;Panelas;1;1;2;32
2606002;Garanhuns;2610202;Panelas;1;1;2;62
2606606;Ibimirim;2610202;Panelas;1;1;2;185
2603801;Capoeiras;2610103;Palmeirina;1;1;2;44
2507507;João Pessoa;2610004;Palmares;1;1;2;184
2600401;Água Preta;2610004;Palmares;1;1;2;7
2601904;Bezerros;2610004;Palmares;1;1;2;56
2602605;Brejo da Madre de Deus;2610004;Palmares;1;1;2;105
2607752;Itapissuma;2610004;Palmares;1;1;2;125
2608206;Joaquim Nabuco;2610004;Palmares;1;1;2;10
2609204;Maraial;2610004;Palmares;1;1;2;29
2112209;Timon;2609907;Ouricuri;1;1;2;429
2304202;Crato;2609907;Ouricuri;1;1;2;107
2304400;Fortaleza;2609907;Ouricuri;1;1;2;487
2605202;Escada;2609907;Ouricuri;1;1;2;541
2607901;Jaboatão dos Guararapes;2609907;Ouricuri;1;1;2;560
2517001;Umbuzeiro;2609709;Orobó;1;1;2;7
2608909;Limoeiro;2609709;Orobó;1;1;2;24
1500800;Ananindeua;2609600;Olinda;1;1;2;1648
2211209;Uruçuí;2609600;Olinda;1;1;2;1066
2306306;Itapagé;2609600;Olinda;1;1;2;701
2307650;Maracanaú;2609600;Olinda;1;1;2;614
2307700;Maranguape;2609600;Olinda;1;1;2;615
2408003;Mossoró;2609600;Olinda;1;1;2;411
2412005;São Gonçalo do Amarante;2609600;Olinda;1;1;2;248
2506905;Itabaiana;2609600;Olinda;1;1;2;84
2510808;Patos;2609600;Olinda;1;1;2;283
2600500;Águas Belas;2609600;Olinda;1;1;2;275
2601102;Araripina;2609600;Olinda;1;1;2;616
2602209;Bom Jardim;2609600;Olinda;1;1;2;79
2604007;Carpina;2609600;Olinda;1;1;2;42
2604502;Chã Grande;2609600;Olinda;1;1;2;67
2414100;Tenente Ananias;2609501;Nazaré da Mata;1;1;2;355
2600708;Aliança;2609501;Nazaré da Mata;1;1;2;15
2601052;Araçoiaba;2609501;Nazaré da Mata;1;1;2;16
2602704;Buenos Aires;2609501;Nazaré da Mata;1;1;2;11
2606200;Goiana;2609501;Nazaré da Mata;1;1;2;32
2607208;Ipojuca;2609501;Nazaré da Mata;1;1;2;75
2608503;Lagoa do Itaenga;2609501;Nazaré da Mata;1;1;2;23
2608909;Limoeiro;2609501;Nazaré da Mata;1;1;2;29
2407104;Macaíba;2609402;Moreno;1;1;2;251
2608453;Lagoa do Carro;2609402;Moreno;1;1;2;38
2601300;Barra de Guabiraba;2609204;Maraial;1;1;2;46
2601508;Belém de Maria;2609204;Maraial;1;1;2;21
2607950;Jaqueira;2609204;Maraial;1;1;2;9
2600500;Águas Belas;2609154;Manari;1;1;2;59
2602803;Buíque;2609154;Manari;1;1;2;66
2509909;Natuba;2609105;Machados;1;1;2;9
2608107;João Alfredo;2609105;Machados;1;1;2;20
2608453;Lagoa do Carro;2609105;Machados;1;1;2;28
2509909;Natuba;2609006;Macaparana;1;1;2;15
2600708;Aliança;2609006;Macaparana;1;1;2;25
2602308;Bonito;2609006;Macaparana;1;1;2;106
2604007;Carpina;2609006;Macaparana;1;1;2;39
2606200;Goiana;2609006;Macaparana;1;1;2;50
2504009;Campina Grande;2608909;Limoeiro;1;1;2;89
2602209;Bom Jardim;2608909;Limoeiro;1;1;2;17
2602902;Cabo de Santo Agostinho;2608909;Limoeiro;1;1;2;65
2604106;Caruaru;2608909;Limoeiro;1;1;2;75
2604908;Cumaru;2608909;Limoeiro;1;1;2;31
2607901;Jaboatão dos Guararapes;2608909;Limoeiro;1;1;2;53
2608453;Lagoa do Carro;2608909;Limoeiro;1;1;2;15
2602902;Cabo de Santo Agostinho;2608800;Lajedo;1;1;2;149
2603207;Caetés;2608800;Lajedo;1;1;2;35
2603306;Calçado;2608800;Lajedo;1;1;2;9
2604106;Caruaru;2608800;Lajedo;1;1;2;55
2606705;Ibirajuba;2608800;Lajedo;1;1;2;18
2608305;Jupi;2608800;Lajedo;1;1;2;12
2608404;Jurema;2608800;Lajedo;1;1;2;21
2211001;Teresina;2608750;Lagoa Grande;1;1;2;513
2601102;Araripina;2608750;Lagoa Grande;1;1;2;161
2607307;Ipubi;2608750;Lagoa Grande;1;1;2;149
2602100;Bom Conselho;2608602;Lagoa do Ouro;1;1;2;27
2602407;Brejão;2608602;Lagoa do Ouro;1;1;2;16
2603207;Caetés;2608602;Lagoa do Ouro;1;1;2;43
2606002;Garanhuns;2608602;Lagoa do Ouro;1;1;2;32
2600906;Amaraji;2608503;Lagoa do Itaenga;1;1;2;53
2601052;Araçoiaba;2608503;Lagoa do Itaenga;1;1;2;27
2604007;Carpina;2608503;Lagoa do Itaenga;1;1;2;12
2605400;Feira Nova;2608503;Lagoa do Itaenga;1;1;2;11
2606101;Glória do Goitá;2608503;Lagoa do Itaenga;1;1;2;7
2603108;Cachoeirinha;2608453;Lagoa do Carro;1;1;2;124
2603454;Camaragibe;2608453;Lagoa do Carro;1;1;2;40
2604403;Chã de Alegria;2608453;Lagoa do Carro;1;1;2;20
2605400;Feira Nova;2608453;Lagoa do Carro;1;1;2;14
2602308;Bonito;2608404;Jurema;1;1;2;52
2603108;Cachoeirinha;2608305;Jupi;1;1;2;32
2603306;Calçado;2608305;Jupi;1;1;2;10
2606002;Garanhuns;2608305;Jupi;1;1;2;20
2608255;Jucati;2608305;Jupi;1;1;2;8
2607901;Jaboatão dos Guararapes;2608107;João Alfredo;1;1;2;67
2507507;João Pessoa;2608008;Jataúba;1;1;2;201
2602605;Brejo da Madre de Deus;2608008;Jataúba;1;1;2;22
2604106;Caruaru;2608008;Jataúba;1;1;2;64
2601508;Belém de Maria;2607950;Jaqueira;1;1;2;13
2604205;Catende;2607950;Jaqueira;1;1;2;11
2605004;Cupira;2607950;Jaqueira;1;1;2;21
1400100;Boa Vista;2607901;Jaboatão dos Guararapes;1;1;2;3057
1500602;Altamira;2607901;Jaboatão dos Guararapes;1;1;2;1965
1501501;Benevides;2607901;Jaboatão dos Guararapes;1;1;2;1629
1505437;Ourilândia do Norte;2607901;Jaboatão dos Guararapes;1;1;2;1773
1505536;Parauapebas;2607901;Jaboatão dos Guararapes;1;1;2;1646
1506807;Santarém;2607901;Jaboatão dos Guararapes;1;1;2;2248
1600303;Macapá;2607901;Jaboatão dos Guararapes;1;1;2;1978
2100055;Açailândia;2607901;Jaboatão dos Guararapes;1;1;2;1410
2101509;Barão de Grajaú;2607901;Jaboatão dos Guararapes;1;1;2;894
2103000;Caxias;2607901;Jaboatão dos Guararapes;1;1;2;979
2111201;São José de Ribamar;2607901;Jaboatão dos Guararapes;1;1;2;1165
2304285;Eusébio;2607901;Jaboatão dos Guararapes;1;1;2;599
2306256;Itaitinga;2607901;Jaboatão dos Guararapes;1;1;2;598
2307007;Jaguaruana;2607901;Jaboatão dos Guararapes;1;1;2;472
2307304;Juazeiro do Norte;2607901;Jaboatão dos Guararapes;1;1;2;481
2408003;Mossoró;2607901;Jaboatão dos Guararapes;1;1;2;412
2412005;São Gonçalo do Amarante;2607901;Jaboatão dos Guararapes;1;1;2;259
2503001;Caaporã;2607901;Jaboatão dos Guararapes;1;1;2;68
2508901;Mamanguape;2607901;Jaboatão dos Guararapes;1;1;2;140
2509008;Manaíra;2607901;Jaboatão dos Guararapes;1;1;2;347
2512309;Princesa Isabel;2607901;Jaboatão dos Guararapes;1;1;2;329
2516201;Sousa;2607901;Jaboatão dos Guararapes;1;1;2;386
2601052;Araçoiaba;2607901;Jaboatão dos Guararapes;1;1;2;37
2601102;Araripina;2607901;Jaboatão dos Guararapes;1;1;2;602
2601201;Arcoverde;2607901;Jaboatão dos Guararapes;1;1;2;228
2601300;Barra de Guabiraba;2607901;Jaboatão dos Guararapes;1;1;2;76
2601904;Bezerros;2607901;Jaboatão dos Guararapes;1;1;2;85
2604502;Chã Grande;2607901;Jaboatão dos Guararapes;1;1;2;49
2606200;Goiana;2607901;Jaboatão dos Guararapes;1;1;2;61
2606804;Igarassu;2607901;Jaboatão dos Guararapes;1;1;2;32
2607752;Itapissuma;2607901;Jaboatão dos Guararapes;1;1;2;40
2601052;Araçoiaba;2607802;Itaquitinga;1;1;2;14
2606200;Goiana;2607802;Itaquitinga;1;1;2;16
1500800;Ananindeua;2607752;Itapissuma;1;1;2;1637
2309706;Pacatuba;2607752;Itapissuma;1;1;2;584
2402006;Caicó;2607752;Itapissuma;1;1;2;283
2607208;Ipojuca;2607752;Itapissuma;1;1;2;71
2500601;Alhandra;2607653;Itambé;1;1;2;22
2503209;Cabedelo;2607653;Itambé;1;1;2;49
2503704;Cajazeiras;2607653;Itambé;1;1;2;387
2506004;Esperança;2607653;Itambé;1;1;2;91
2506905;Itabaiana;2607653;Itambé;1;1;2;22
2507903;Juripiranga;2607653;Itambé;1;1;2;14
2607208;Ipojuca;2607653;Itambé;1;1;2;110
2103307;Codó;2607505;Itaíba;1;1;2;867
2602803;Buíque;2607505;Itaíba;1;1;2;48
2606200;Goiana;2607307;Ipubi;1;1;2;568
1100205;Porto Velho;2607208;Ipojuca;1;1;2;3176
1501402;Belém;2607208;Ipojuca;1;1;2;1656
1504208;Marabá;2607208;Ipojuca;1;1;2;1577
2211001;Teresina;2607208;Ipojuca;1;1;2;924
2306306;Itapagé;2607208;Ipojuca;1;1;2;719
2404507;Guamaré;2607208;Ipojuca;1;1;2;389
2407104;Macaíba;2607208;Ipojuca;1;1;2;283
2602209;Bom Jardim;2607208;Ipojuca;1;1;2;88
2604403;Chã de Alegria;2607208;Ipojuca;1;1;2;48
2604502;Chã Grande;2607208;Ipojuca;1;1;2;47
2606408;Gravatá;2607208;Ipojuca;1;1;2;59
2600104;Afogados da Ingazeira;2607109;Ingazeira;1;1;2;21
2512309;Princesa Isabel;2607000;Inajá;1;1;2;129
2601201;Arcoverde;2607000;Inajá;1;1;2;100
2606606;Ibimirim;2607000;Inajá;1;1;2;45
2600104;Afogados da Ingazeira;2606903;Iguaraci;1;1;2;13
2304400;Fortaleza;2606804;Igarassu;1;1;2;600
2307650;Maracanaú;2606804;Igarassu;1;1;2;600
2403251;Parnamirim;2606804;Igarassu;1;1;2;217
2408102;Natal;2606804;Igarassu;1;1;2;227
2412005;São Gonçalo do Amarante;2606804;Igarassu;1;1;2;231
2603454;Camaragibe;2606804;Igarassu;1;1;2;21
2407104;Macaíba;2606606;Ibimirim;1;1;2;391
2509701;Monteiro;2606606;Ibimirim;1;1;2;92
2604205;Catende;2606606;Ibimirim;1;1;2;217
2604700;Correntes;2606507;Iati;1;1;2;57
2306306;Itapagé;2606408;Gravatá;1;1;2;666
2501807;Bayeux;2606408;Gravatá;1;1;2;138
2503704;Cajazeiras;2606408;Gravatá;1;1;2;362
2601201;Arcoverde;2606408;Gravatá;1;1;2;168
2602308;Bonito;2606408;Gravatá;1;1;2;35
2604007;Carpina;2606408;Gravatá;1;1;2;53
2606002;Garanhuns;2606408;Gravatá;1;1;2;129
2606200;Goiana;2606408;Gravatá;1;1;2;94
2605301;Exu;2606309;Granito;1;1;2;22
1501402;Belém;2606200;Goiana;1;1;2;1626
1502202;Capanema;2606200;Goiana;1;1;2;1507
1503606;Itaituba;2606200;Goiana;1;1;2;2340
2103307;Codó;2606200;Goiana;1;1;2;1041
2103406;Coelho Neto;2606200;Goiana;1;1;2;959
2302701;Campos Sales;2606200;Goiana;1;1;2;594
2304400;Fortaleza;2606200;Goiana;1;1;2;573
2306256;Itaitinga;2606200;Goiana;1;1;2;556
2500601;Alhandra;2606200;Goiana;1;1;2;17
2503001;Caaporã;2606200;Goiana;1;1;2;11
2504009;Campina Grande;2606200;Goiana;1;1;2;107
2511202;Pedras de Fogo;2606200;Goiana;1;1;2;23
2513703;Santa Rita;2606200;Goiana;1;1;2;48
2604502;Chã Grande;2606200;Goiana;1;1;2;90
2604007;Carpina;2606101;Glória do Goitá;1;1;2;19
1702109;Araguaína;2606002;Garanhuns;1;1;2;1294
2101400;Balsas;2606002;Garanhuns;1;1;2;1057
2308708;Morada Nova;2606002;Garanhuns;1;1;2;458
2404903;Itaú;2606002;Garanhuns;1;1;2;369
2504009;Campina Grande;2606002;Garanhuns;1;1;2;194
2510808;Patos;2606002;Garanhuns;1;1;2;218
2600104;Afogados da Ingazeira;2606002;Garanhuns;1;1;2;168
2601003;Angelim;2606002;Garanhuns;1;1;2;28
2603207;Caetés;2606002;Garanhuns;1;1;2;13
2603454;Camaragibe;2606002;Garanhuns;1;1;2;191
2603801;Capoeiras;2606002;Garanhuns;1;1;2;16
2604205;Catende;2606002;Garanhuns;1;1;2;92
2602902;Cabo de Santo Agostinho;2605905;Gameleira;1;1;2;52
2605202;Escada;2605905;Gameleira;1;1;2;31
2304400;Fortaleza;2605707;Floresta;1;1;2;533
2601201;Arcoverde;2605707;Floresta;1;1;2;169
2604106;Caruaru;2605707;Floresta;1;1;2;289
2603900;Carnaíba;2605608;Flores;1;1;2;21
2412005;São Gonçalo do Amarante;2605459;Fernando de Noronha;1;1;2;383
2600708;Aliança;2605400;Feira Nova;1;1;2;42
2604007;Carpina;2605400;Feira Nova;1;1;2;20
2304202;Crato;2605301;Exu;1;1;2;51
2304400;Fortaleza;2605301;Exu;1;1;2;439
2601607;Belém de São Francisco;2605301;Exu;1;1;2;154
2604304;Cedro;2605301;Exu;1;1;2;57
2507507;João Pessoa;2605202;Escada;1;1;2;135
2602308;Bonito;2605202;Escada;1;1;2;57
2604007;Carpina;2605202;Escada;1;1;2;58
2604205;Catende;2605202;Escada;1;1;2;64
2605004;Cupira;2605202;Escada;1;1;2;85
2504009;Campina Grande;2605103;Custódia;1;1;2;215
2601201;Arcoverde;2605103;Custódia;1;1;2;72
2601805;Betânia;2605103;Custódia;1;1;2;48
2600302;Agrestina;2605004;Cupira;1;1;2;18
2600807;Altinho;2605004;Cupira;1;1;2;18
2601300;Barra de Guabiraba;2605004;Cupira;1;1;2;39
2601904;Bezerros;2605004;Cupira;1;1;2;46
2401404;Baía Formosa;2604809;Cortês;1;1;2;238
2602308;Bonito;2604809;Cortês;1;1;2;21
2600500;Águas Belas;2604700;Correntes;1;1;2;87
2602100;Bom Conselho;2604700;Correntes;1;1;2;41
2602407;Brejão;2604700;Correntes;1;1;2;28
2501807;Bayeux;2604502;Chã Grande;1;1;2;136
2504009;Campina Grande;2604502;Chã Grande;1;1;2;124
2603504;Camocim de São Félix;2604502;Chã Grande;1;1;2;36
2602902;Cabo de Santo Agostinho;2604205;Catende;1;1;2;87
1500800;Ananindeua;2604106;Caruaru;1;1;2;1556
1502400;Castanhal;2604106;Caruaru;1;1;2;1516
2101400;Balsas;2604106;Caruaru;1;1;2;1111
2208007;Picos;2604106;Caruaru;1;1;2;617
2304285;Eusébio;2604106;Caruaru;1;1;2;555
2307650;Maracanaú;2604106;Caruaru;1;1;2;568
2311959;Salitre;2604106;Caruaru;1;1;2;503
2402006;Caicó;2604106;Caruaru;1;1;2;237
2402204;Canguaretama;2604106;Caruaru;1;1;2;231
2403251;Parnamirim;2604106;Caruaru;1;1;2;274
2412005;São Gonçalo do Amarante;2604106;Caruaru;1;1;2;285
2501807;Bayeux;2604106;Caruaru;1;1;2;173
2504603;Conde;2604106;Caruaru;1;1;2;165
2512507;Queimadas;2604106;Caruaru;1;1;2;106
2600054;Abreu e Lima;2604106;Caruaru;1;1;2;127
2600708;Aliança;2604106;Caruaru;1;1;2;113
2602308;Bonito;2604106;Caruaru;1;1;2;36
2306306;Itapagé;2604007;Carpina;1;1;2;662
2408003;Mossoró;2604007;Carpina;1;1;2;373
2408102;Natal;2604007;Carpina;1;1;2;224
2511202;Pedras de Fogo;2604007;Carpina;1;1;2;52
2600708;Aliança;2604007;Carpina;1;1;2;26
2600807;Altinho;2604007;Carpina;1;1;2;115
2601052;Araçoiaba;2604007;Carpina;1;1;2;18
2602704;Buenos Aires;2604007;Carpina;1;1;2;15
2602902;Cabo de Santo Agostinho;2604007;Carpina;1;1;2;55
2603108;Cachoeirinha;2604007;Carpina;1;1;2;131
2509404;Mogeiro;2603603;Camutanga;1;1;2;25
2511202;Pedras de Fogo;2603603;Camutanga;1;1;2;20
2600708;Aliança;2603603;Camutanga;1;1;2;22
2601300;Barra de Guabiraba;2603504;Camocim de São Félix;1;1;2;13
2603306;Calçado;2603504;Camocim de São Félix;1;1;2;76
2304400;Fortaleza;2603454;Camaragibe;1;1;2;610
2306306;Itapagé;2603454;Camaragibe;1;1;2;695
2408003;Mossoró;2603454;Camaragibe;1;1;2;406
2412906;São Tomé;2603454;Camaragibe;1;1;2;258
2507507;João Pessoa;2603454;Camaragibe;1;1;2;94
2600054;Abreu e Lima;2603454;Camaragibe;1;1;2;18
2601409;Barreiros;2603454;Camaragibe;1;1;2;90
2602902;Cabo de Santo Agostinho;2603454;Camaragibe;1;1;2;29
2601201;Arcoverde;2603207;Caetés;1;1;2;61
2308708;Morada Nova;2603108;Cachoeirinha;1;1;2;438
2304400;Fortaleza;2603009;Cabrobó;1;1;2;524
2310605;Penaforte;2603009;Cabrobó;1;1;2;72
2601607;Belém de São Francisco;2603009;Cabrobó;1;1;2;47
1302603;Manaus;2602902;Cabo de Santo Agostinho;1;1;2;2800
1504422;Marituba;2602902;Cabo de Santo Agostinho;1;1;2;1647
2211001;Teresina;2602902;Cabo de Santo Agostinho;1;1;2;923
2307650;Maracanaú;2602902;Cabo de Santo Agostinho;1;1;2;630
2407104;Macaíba;2602902;Cabo de Santo Agostinho;1;1;2;271
2408003;Mossoró;2602902;Cabo de Santo Agostinho;1;1;2;427
2408904;Parelhas;2602902;Cabo de Santo Agostinho;1;1;2;252
2504009;Campina Grande;2602902;Cabo de Santo Agostinho;1;1;2;153
2601102;Araripina;2602902;Cabo de Santo Agostinho;1;1;2;605
2601706;Belo Jardim;2602902;Cabo de Santo Agostinho;1;1;2;154
2600104;Afogados da Ingazeira;2602803;Buíque;1;1;2;107
2600500;Águas Belas;2602803;Buíque;1;1;2;56
2507507;João Pessoa;2602308;Bonito;1;1;2;171
2600302;Agrestina;2602308;Bonito;1;1;2;23
2601300;Barra de Guabiraba;2602308;Bonito;1;1;2;10
2517001;Umbuzeiro;2602209;Bom Jardim;1;1;2;14
2600500;Águas Belas;2602100;Bom Conselho;1;1;2;47
2304400;Fortaleza;2601904;Bezerros;1;1;2;578
2408102;Natal;2601904;Bezerros;1;1;2;274
2507507;João Pessoa;2601904;Bezerros;1;1;2;155
2101400;Balsas;2601706;Belo Jardim;1;1;2;1065
2304400;Fortaleza;2601706;Belo Jardim;1;1;2;559
2600807;Altinho;2601508;Belém de Maria;1;1;2;31
2304400;Fortaleza;2601201;Arcoverde;1;1;2;543
2408102;Natal;2601201;Arcoverde;1;1;2;354
2504009;Campina Grande;2601201;Arcoverde;1;1;2;189
2509701;Monteiro;2601201;Arcoverde;1;1;2;64
2601102;Araripina;2601201;Arcoverde;1;1;2;387
2203909;Floriano;2601102;Araripina;1;1;2;293
2204303;Fronteiras;2601102;Araripina;1;1;2;55
2210607;São Raimundo Nonato;2601102;Araripina;1;1;2;294
2211001;Teresina;2601102;Araripina;1;1;2;374
2302701;Campos Sales;2601102;Araripina;1;1;2;55
2305506;Iguatu;2601102;Araripina;1;1;2;184
2307650;Maracanaú;2601102;Araripina;1;1;2;456
2308401;Missão Velha;2601102;Araripina;1;1;2;151
2600302;Agrestina;2600807;Altinho;1;1;2;13
2208650;Queimada Nova;2600203;Afrânio;1;1;2;41
2112209;Timon;2600104;Afogados da Ingazeira;1;1;2;646
2510808;Patos;2600104;Afogados da Ingazeira;1;1;2;92
2307650;Maracanaú;2600054;Abreu e Lima;1;1;2;606
2509701;Monteiro;2517407;Zabelê;1;1;2;23
2312205;Santa Quitéria;2517209;Vieirópolis;1;1;2;320
2408904;Parelhas;2517100;Várzea;1;1;2;38
2513406;Santa Luzia;2517100;Várzea;1;1;2;13
2504009;Campina Grande;2517001;Umbuzeiro;1;1;2;60
2507507;João Pessoa;2517001;Umbuzeiro;1;1;2;105
2512507;Queimadas;2517001;Umbuzeiro;1;1;2;49
2407005;Luís Gomes;2516904;Uiraúna;1;1;2;12
2407252;Major Sales;2516904;Uiraúna;1;1;2;16
2500700;São João do Rio do Peixe;2516904;Uiraúna;1;1;2;24
2507507;João Pessoa;2516904;Uiraúna;1;1;2;400
2509156;Marizópolis;2516904;Uiraúna;1;1;2;36
2514503;São José de Piranhas;2516904;Uiraúna;1;1;2;67
2500700;São João do Rio do Peixe;2516805;Triunfo;1;1;2;23
2503704;Cajazeiras;2516805;Triunfo;1;1;2;35
2405702;Jardim do Seridó;2516755;Tenório;1;1;2;45
2507705;Juazeirinho;2516755;Tenório;1;1;2;20
2503704;Cajazeiras;2516706;Teixeira;1;1;2;151
2507507;João Pessoa;2516706;Teixeira;1;1;2;265
2508505;Livramento;2516706;Teixeira;1;1;2;38
2509396;Maturéia;2516706;Teixeira;1;1;2;12
2500106;Água Branca;2516607;Tavares;1;1;2;30
2507507;João Pessoa;2516607;Tavares;1;1;2;337
2507507;João Pessoa;2516508;Taperoá;1;1;2;217
2513406;Santa Luzia;2516508;Taperoá;1;1;2;39
2506301;Guarabira;2516409;Campo de Santana;1;1;2;41
2304400;Fortaleza;2516300;Sumé;1;1;2;468
2307304;Juazeiro do Norte;2516300;Sumé;1;1;2;273
2504009;Campina Grande;2516300;Sumé;1;1;2;119
2505105;Cuité;2516300;Sumé;1;1;2;154
2507507;João Pessoa;2516300;Sumé;1;1;2;229
2508307;Lagoa Seca;2516300;Sumé;1;1;2;126
2514107;São João do Tigre;2516300;Sumé;1;1;2;45
2515500;Serra Branca;2516300;Sumé;1;1;2;31
2304202;Crato;2516201;Sousa;1;1;2;135
2306900;Jaguaribe;2516201;Sousa;1;1;2;103
2307304;Juazeiro do Norte;2516201;Sousa;1;1;2;125
2307601;Limoeiro do Norte;2516201;Sousa;1;1;2;181
2307650;Maracanaú;2516201;Sousa;1;1;2;324
2400703;Alto do Rodrigues;2516201;Sousa;1;1;2;234
2408102;Natal;2516201;Sousa;1;1;2;351
2414100;Tenente Ananias;2516201;Sousa;1;1;2;35
2414506;Umarizal;2516201;Sousa;1;1;2;100
2508901;Mamanguape;2516201;Sousa;1;1;2;346
2509156;Marizópolis;2516201;Sousa;1;1;2;11
2513802;Santa Teresinha;2516201;Sousa;1;1;2;99
2501302;Aroeiras;2516102;Soledade;1;1;2;90
2503704;Cajazeiras;2516102;Soledade;1;1;2;246
2507507;João Pessoa;2516102;Soledade;1;1;2;167
2512002;Pocinhos;2516102;Soledade;1;1;2;33
2304400;Fortaleza;2516003;Solânea;1;1;2;457
2408300;Nova Cruz;2516003;Solânea;1;1;2;44
2409100;Passa e Fica;2516003;Solânea;1;1;2;38
2500304;Alagoa Grande;2516003;Solânea;1;1;2;31
2501500;Bananeiras;2516003;Solânea;1;1;2;8
2501906;Belém;2516003;Solânea;1;1;2;20
2503209;Cabedelo;2516003;Solânea;1;1;2;98
2503506;Cacimba de Dentro;2516003;Solânea;1;1;2;18
2503605;Caiçara;2516003;Solânea;1;1;2;40
2503704;Cajazeiras;2516003;Solânea;1;1;2;319
2505105;Cuité;2516003;Solânea;1;1;2;60
2512705;Remígio;2516003;Solânea;1;1;2;21
2515906;Serraria;2516003;Solânea;1;1;2;12
2407104;Macaíba;2515971;Sobrado;1;1;2;143
2500908;Arara;2515906;Serraria;1;1;2;15
2507507;João Pessoa;2515906;Serraria;1;1;2;92
2509206;Massaranduba;2515807;Serra Redonda;1;1;2;13
2501807;Bayeux;2515609;Serra da Raiz;1;1;2;75
2508208;Lagoa de Dentro;2515609;Serra da Raiz;1;1;2;7
2504009;Campina Grande;2515500;Serra Branca;1;1;2;89
2507507;João Pessoa;2515500;Serra Branca;1;1;2;201
2508307;Lagoa Seca;2515500;Serra Branca;1;1;2;95
2508505;Livramento;2515500;Serra Branca;1;1;2;36
2502508;Boqueirão;2515401;Seridó;1;1;2;68
2304400;Fortaleza;2515302;Sapé;1;1;2;517
2408003;Mossoró;2515302;Sapé;1;1;2;314
2500304;Alagoa Grande;2515302;Sapé;1;1;2;43
2501807;Bayeux;2515302;Sapé;1;1;2;33
2502508;Boqueirão;2515302;Sapé;1;1;2;109
2503704;Cajazeiras;2515302;Sapé;1;1;2;371
2503803;Caldas Brandão;2515302;Sapé;1;1;2;11
2508901;Mamanguape;2515302;Sapé;1;1;2;27
2512903;Rio Tinto;2515302;Sapé;1;1;2;39
2509701;Monteiro;2515203;São Sebastião do Umbuzeiro;1;1;2;34
2501203;Areial;2515104;São Sebastião de Lagoa de Roça;1;1;2;11
2503704;Cajazeiras;2515104;São Sebastião de Lagoa de Roça;1;1;2;304
2507507;João Pessoa;2515005;São Miguel de Taipu;1;1;2;39
2507606;Juarez Távora;2515005;São Miguel de Taipu;1;1;2;42
2404804;Ipueira;2514909;São Mamede;1;1;2;17
2507507;João Pessoa;2514909;São Mamede;1;1;2;249
2509701;Monteiro;2514800;São José dos Cordeiros;1;1;2;67
2504009;Campina Grande;2514701;São José do Sabugi;1;1;2;109
2513901;São Bento;2514651;São José do Brejo do Cruz;1;1;2;32
2510808;Patos;2514602;São José do Bonfim;1;1;2;16
2308104;Mauriti;2514503;São José de Piranhas;1;1;2;42
2500205;Aguiar;2514503;São José de Piranhas;1;1;2;37
2500700;São João do Rio do Peixe;2514503;São José de Piranhas;1;1;2;44
2502409;Bonito de Santa Fé;2514503;São José de Piranhas;1;1;2;21
2504405;Conceição;2514503;São José de Piranhas;1;1;2;47
2513208;Santa Cruz;2514503;São José de Piranhas;1;1;2;81
2506400;Gurinhém;2514453;São José dos Ramos;1;1;2;15
2405702;Jardim do Seridó;2514404;São José de Espinharas;1;1;2;68
2500205;Aguiar;2514305;São José de Caiana;1;1;2;23
2503704;Cajazeiras;2514305;São José de Caiana;1;1;2;50
2507507;João Pessoa;2514206;São José da Lagoa Tapada;1;1;2;366
2503902;Camalaú;2514107;São João do Tigre;1;1;2;21
2509701;Monteiro;2514107;São João do Tigre;1;1;2;41
2507507;João Pessoa;2514008;São João do Cariri;1;1;2;186
2509701;Monteiro;2514008;São João do Cariri;1;1;2;88
2500775;Aparecida;2513984;São Francisco;1;1;2;18
2513208;Santa Cruz;2513984;São Francisco;1;1;2;10
2509701;Monteiro;2513943;São Domingos do Cariri;1;1;2;85
1502103;Cametá;2513901;São Bento;1;1;2;1415
2405603;Jardim de Piranhas;2513901;São Bento;1;1;2;16
2408102;Natal;2513901;São Bento;1;1;2;255
2409308;Patu;2513901;São Bento;1;1;2;49
2502300;Bom Sucesso;2513901;São Bento;1;1;2;53
2503704;Cajazeiras;2513901;São Bento;1;1;2;133
2504009;Campina Grande;2513901;São Bento;1;1;2;189
2506202;Frei Martinho;2513901;São Bento;1;1;2;110
2506301;Guarabira;2513901;São Bento;1;1;2;221
2507507;João Pessoa;2513901;São Bento;1;1;2;297
2507705;Juazeirinho;2513901;São Bento;1;1;2;119
2512101;Pombal;2513901;São Bento;1;1;2;50
2504009;Campina Grande;2513802;Santa Teresinha;1;1;2;172
2505907;Emas;2513802;Santa Teresinha;1;1;2;29
2410256;Porto do Mangue;2513703;Santa Rita;1;1;2;301
2503209;Cabedelo;2513703;Santa Rita;1;1;2;18
2504009;Campina Grande;2513703;Santa Rita;1;1;2;100
2504900;Cruz do Espírito Santo;2513703;Santa Rita;1;1;2;10
2506905;Itabaiana;2513703;Santa Rita;1;1;2;43
2508604;Lucena;2513703;Santa Rita;1;1;2;24
2508901;Mamanguape;2513703;Santa Rita;1;1;2;35
2504405;Conceição;2513604;Santana dos Garrotes;1;1;2;58
2504405;Conceição;2513505;Santana de Mangueira;1;1;2;17
2412609;São Paulo do Potengi;2513406;Santa Luzia;1;1;2;167
2503209;Cabedelo;2513406;Santa Luzia;1;1;2;229
2503704;Cajazeiras;2513406;Santa Luzia;1;1;2;184
2505105;Cuité;2513406;Santa Luzia;1;1;2;95
2507507;João Pessoa;2513406;Santa Luzia;1;1;2;231
2507804;Junco do Seridó;2513406;Santa Luzia;1;1;2;27
2510808;Patos;2513406;Santa Luzia;1;1;2;43
2512101;Pombal;2513406;Santa Luzia;1;1;2;94
2503704;Cajazeiras;2513307;Santa Helena;1;1;2;20
2400505;Alexandria;2513208;Santa Cruz;1;1;2;14
2500775;Aparecida;2513208;Santa Cruz;1;1;2;28
2504009;Campina Grande;2513158;Santa Cecília;1;1;2;59
2507507;João Pessoa;2513109;Salgado de São Félix;1;1;2;67
2504603;Conde;2512903;Rio Tinto;1;1;2;56
2507507;João Pessoa;2512804;Riacho dos Cavalos;1;1;2;321
2511301;Piancó;2512804;Riacho dos Cavalos;1;1;2;95
2508208;Lagoa de Dentro;2512721;Pedro Régis;1;1;2;10
2502508;Boqueirão;2512705;Remígio;1;1;2;72
2506301;Guarabira;2512705;Remígio;1;1;2;39
2507507;João Pessoa;2512705;Remígio;1;1;2;113
2304285;Eusébio;2512507;Queimadas;1;1;2;472
2408904;Parelhas;2512507;Queimadas;1;1;2;109
2500304;Alagoa Grande;2512507;Queimadas;1;1;2;44
2500403;Alagoa Nova;2512507;Queimadas;1;1;2;32
2503100;Cabaceiras;2512507;Queimadas;1;1;2;46
2504355;Caturité;2512507;Queimadas;1;1;2;18
2509206;Massaranduba;2512507;Queimadas;1;1;2;18
2509503;Montadas;2512507;Queimadas;1;1;2;25
2512002;Pocinhos;2512507;Queimadas;1;1;2;33
2507507;João Pessoa;2512408;Puxinanã;1;1;2;122
2509503;Montadas;2512408;Puxinanã;1;1;2;8
2507507;João Pessoa;2512309;Princesa Isabel;1;1;2;351
2508000;Juru;2512309;Princesa Isabel;1;1;2;30
2509008;Manaíra;2512309;Princesa Isabel;1;1;2;18
2304400;Fortaleza;2512101;Pombal;1;1;2;346
2406502;Lagoa Nova;2512101;Pombal;1;1;2;164
2413409;Serra Negra do Norte;2512101;Pombal;1;1;2;44
2504009;Campina Grande;2512101;Pombal;1;1;2;212
2507002;Itaporanga;2512101;Pombal;1;1;2;68
2507408;Jericó;2512101;Pombal;1;1;2;28
2511301;Piancó;2512101;Pombal;1;1;2;51
2505105;Cuité;2512002;Pocinhos;1;1;2;67
2506004;Esperança;2512002;Pocinhos;1;1;2;25
2509503;Montadas;2512002;Pocinhos;1;1;2;15
2500601;Alhandra;2511905;Pitimbu;1;1;2;9
2503001;Caaporã;2511905;Pitimbu;1;1;2;9
2503209;Cabedelo;2511905;Pitimbu;1;1;2;46
2507507;João Pessoa;2511905;Pitimbu;1;1;2;31
2505808;Duas Estradas;2511806;Pirpirituba;1;1;2;14
2507507;João Pessoa;2511806;Pirpirituba;1;1;2;84
2508901;Mamanguape;2511806;Pirpirituba;1;1;2;40
2506301;Guarabira;2511707;Pilõezinhos;1;1;2;6
2507507;João Pessoa;2511608;Pilões;1;1;2;90
2501807;Bayeux;2511509;Pilar;1;1;2;39
2507507;João Pessoa;2511509;Pilar;1;1;2;45
2507903;Juripiranga;2511509;Pilar;1;1;2;12
2400109;Acari;2511400;Picuí;1;1;2;35
2402204;Canguaretama;2511400;Picuí;1;1;2;136
2402402;Carnaúba dos Dantas;2511400;Picuí;1;1;2;27
2405009;Jaçanã;2511400;Picuí;1;1;2;21
2405702;Jardim do Seridó;2511400;Picuí;1;1;2;48
2408904;Parelhas;2511400;Picuí;1;1;2;37
2411205;Santa Cruz;2511400;Picuí;1;1;2;51
2412203;São José de Mipibu;2511400;Picuí;1;1;2;131
2501005;Araruna;2511400;Picuí;1;1;2;67
2505006;Cubati;2511400;Picuí;1;1;2;35
2505105;Cuité;2511400;Picuí;1;1;2;24
2506004;Esperança;2511400;Picuí;1;1;2;76
2506707;Imaculada;2511400;Picuí;1;1;2;158
2509396;Maturéia;2511400;Picuí;1;1;2;136
2510303;Nova Palmeira;2511400;Picuí;1;1;2;16
2511103;Pedra Lavrada;2511400;Picuí;1;1;2;27
2507002;Itaporanga;2511301;Piancó;1;1;2;26
2507507;João Pessoa;2511301;Piancó;1;1;2;339
2509206;Massaranduba;2511301;Piancó;1;1;2;236
2504900;Cruz do Espírito Santo;2511202;Pedras de Fogo;1;1;2;27
2506905;Itabaiana;2511202;Pedras de Fogo;1;1;2;22
2504009;Campina Grande;2511103;Pedra Lavrada;1;1;2;81
2507507;João Pessoa;2511103;Pedra Lavrada;1;1;2;186
2407609;Messias Targino;2510907;Paulista;1;1;2;58
2502805;Brejo do Cruz;2510907;Paulista;1;1;2;30
1503606;Itaituba;2510808;Patos;1;1;2;2086
2111300;São Luís;2510808;Patos;1;1;2;913
2112209;Timon;2510808;Patos;1;1;2;650
2208007;Picos;2510808;Patos;1;1;2;464
2304285;Eusébio;2510808;Patos;1;1;2;370
2305407;Icó;2510808;Patos;1;1;2;188
2305506;Iguatu;2510808;Patos;1;1;2;239
2403103;Currais Novos;2510808;Patos;1;1;2;119
2408102;Natal;2510808;Patos;1;1;2;260
2409407;Pau dos Ferros;2510808;Patos;1;1;2;148
2412104;São João do Sabugi;2510808;Patos;1;1;2;34
2502508;Boqueirão;2510808;Patos;1;1;2;137
2506004;Esperança;2510808;Patos;1;1;2;159
2506301;Guarabira;2510808;Patos;1;1;2;199
2507002;Itaporanga;2510808;Patos;1;1;2;102
2507705;Juazeirinho;2510808;Patos;1;1;2;78
2508703;Mãe d'Água;2510808;Patos;1;1;2;31
2509396;Maturéia;2510808;Patos;1;1;2;29
2509701;Monteiro;2510808;Patos;1;1;2;96
2509701;Monteiro;2510659;Parari;1;1;2;84
2507507;João Pessoa;2510600;Ouro Velho;1;1;2;257
2505907;Emas;2510402;Olho d'Água;1;1;2;14
2307650;Maracanaú;2510303;Nova Palmeira;1;1;2;396
2504009;Campina Grande;2510303;Nova Palmeira;1;1;2;82
2105989;Lajeado Novo;2510105;Nova Floresta;1;1;2;1198
2501609;Barra de Santa Rosa;2510105;Nova Floresta;1;1;2;33
2506004;Esperança;2510105;Nova Floresta;1;1;2;74
2500304;Alagoa Grande;2509800;Mulungu;1;1;2;18
2506400;Gurinhém;2509800;Mulungu;1;1;2;12
2507507;João Pessoa;2509800;Mulungu;1;1;2;69
2500734;Amparo;2509701;Monteiro;1;1;2;36
2501708;Barra de São Miguel;2509701;Monteiro;1;1;2;94
2502151;Boa Vista;2509701;Monteiro;1;1;2;123
2504009;Campina Grande;2509701;Monteiro;1;1;2;158
2504074;Caraúbas;2509701;Monteiro;1;1;2;76
2504702;Congo;2509701;Monteiro;1;1;2;56
2504850;Coxixola;2509701;Monteiro;1;1;2;68
2506509;Gurjão;2509701;Monteiro;1;1;2;102
2508505;Livramento;2509701;Monteiro;1;1;2;61
2503704;Cajazeiras;2509602;Monte Horebe;1;1;2;35
2408102;Natal;2509305;Mataraca;1;1;2;89
2504009;Campina Grande;2509206;Massaranduba;1;1;2;12
2506806;Ingá;2509206;Massaranduba;1;1;2;21
2503704;Cajazeiras;2509156;Marizópolis;1;1;2;27
2507507;João Pessoa;2509156;Marizópolis;1;1;2;388
2501807;Bayeux;2509107;Mari;1;1;2;43
2502508;Boqueirão;2509107;Mari;1;1;2;101
2501401;Baía da Traição;2509057;Marcação;1;1;2;10
2401453;Baraúna;2508901;Mamanguape;1;1;2;336
2408003;Mossoró;2508901;Mamanguape;1;1;2;305
2500601;Alhandra;2508901;Mamanguape;1;1;2;69
2501401;Baía da Traição;2508901;Mamanguape;1;1;2;25
2501500;Bananeiras;2508901;Mamanguape;1;1;2;55
2503001;Caaporã;2508901;Mamanguape;1;1;2;77
2504033;Capim;2508901;Mamanguape;1;1;2;7
2506004;Esperança;2508901;Mamanguape;1;1;2;79
2507002;Itaporanga;2508901;Mamanguape;1;1;2;336
2507101;Itapororoca;2508901;Mamanguape;1;1;2;12
2507507;João Pessoa;2508802;Malta;1;1;2;296
2505402;Desterro;2508505;Livramento;1;1;2;19
2502508;Boqueirão;2508307;Lagoa Seca;1;1;2;46
2506905;Itabaiana;2508307;Lagoa Seca;1;1;2;64
2507507;João Pessoa;2508307;Lagoa Seca;1;1;2;110
2501807;Bayeux;2508208;Lagoa de Dentro;1;1;2;70
2502706;Borborema;2508208;Lagoa de Dentro;1;1;2;31
2507408;Jericó;2508109;Lagoa;1;1;2;12
2503001;Caaporã;2507903;Juripiranga;1;1;2;40
2506905;Itabaiana;2507903;Juripiranga;1;1;2;8
2507507;João Pessoa;2507903;Juripiranga;1;1;2;47
2504009;Campina Grande;2507804;Junco do Seridó;1;1;2;93
2501351;Assunção;2507705;Juazeirinho;1;1;2;17
2506806;Ingá;2507705;Juazeirinho;1;1;2;108
2507507;João Pessoa;2507705;Juazeirinho;1;1;2;190
2507507;João Pessoa;2507606;Juarez Távora;1;1;2;80
1100288;Rolim de Moura;2507507;João Pessoa;1;1;2;3028
1400100;Boa Vista;2507507;João Pessoa;1;1;2;3046
1703206;Bernardo Sayão;2507507;João Pessoa;1;1;2;1553
2104800;Grajaú;2507507;João Pessoa;1;1;2;1253
2109908;Santa Inês;2507507;João Pessoa;1;1;2;1223
2112209;Timon;2507507;João Pessoa;1;1;2;911
2203909;Floriano;2507507;João Pessoa;1;1;2;902
2207702;Parnaíba;2507507;João Pessoa;1;1;2;900
2208007;Picos;2507507;João Pessoa;1;1;2;731
2208403;Piripiri;2507507;João Pessoa;1;1;2;828
2301000;Aquiraz;2507507;João Pessoa;1;1;2;533
2304202;Crato;2507507;João Pessoa;1;1;2;503
2305506;Iguatu;2507507;João Pessoa;1;1;2;503
2307650;Maracanaú;2507507;João Pessoa;1;1;2;556
2313401;Tianguá;2507507;João Pessoa;1;1;2;776
2402204;Canguaretama;2507507;João Pessoa;1;1;2;95
2405801;João Câmara;2507507;João Pessoa;1;1;2;211
2407104;Macaíba;2507507;João Pessoa;1;1;2;157
2408508;Ouro Branco;2507507;João Pessoa;1;1;2;237
2411205;Santa Cruz;2507507;João Pessoa;1;1;2;165
2412005;São Gonçalo do Amarante;2507507;João Pessoa;1;1;2;163
2500106;Água Branca;2507507;João Pessoa;1;1;2;310
2500205;Aguiar;2507507;João Pessoa;1;1;2;366
2500502;Alagoinha;2507507;João Pessoa;1;1;2;80
2500809;Araçagi;2507507;João Pessoa;1;1;2;69
2500908;Arara;2507507;João Pessoa;1;1;2;107
2501005;Araruna;2507507;João Pessoa;1;1;2;120
2501104;Areia;2507507;João Pessoa;1;1;2;95
2501500;Bananeiras;2507507;João Pessoa;1;1;2;98
2501534;Baraúna;2507507;João Pessoa;1;1;2;166
2501906;Belém;2507507;João Pessoa;1;1;2;88
2502003;Belém do Brejo do Cruz;2507507;João Pessoa;1;1;2;316
2502151;Boa Vista;2507507;João Pessoa;1;1;2;153
2502409;Bonito de Santa Fé;2507507;João Pessoa;1;1;2;404
2502805;Brejo do Cruz;2507507;João Pessoa;1;1;2;306
2502904;Brejo dos Santos;2507507;João Pessoa;1;1;2;340
2503100;Cabaceiras;2507507;João Pessoa;1;1;2;161
2503803;Caldas Brandão;2507507;João Pessoa;1;1;2;53
2504355;Caturité;2507507;João Pessoa;1;1;2;132
2504405;Conceição;2507507;João Pessoa;1;1;2;403
2504504;Condado;2507507;João Pessoa;1;1;2;304
2506400;Gurinhém;2507507;João Pessoa;1;1;2;63
2506608;Ibiara;2507507;João Pessoa;1;1;2;393
2506806;Ingá;2507507;João Pessoa;1;1;2;84
2507002;Itaporanga;2507507;João Pessoa;1;1;2;365
2507101;Itapororoca;2507507;João Pessoa;1;1;2;59
2507408;Jericó;2507507;João Pessoa;1;1;2;333
2304400;Fortaleza;2507200;Itatuba;1;1;2;512
2504009;Campina Grande;2507200;Itatuba;1;1;2;35
2506103;Fagundes;2507200;Itatuba;1;1;2;16
2506806;Ingá;2507200;Itatuba;1;1;2;12
2500502;Alagoinha;2507101;Itapororoca;1;1;2;36
2304400;Fortaleza;2507002;Itaporanga;1;1;2;392
2502409;Bonito de Santa Fé;2507002;Itaporanga;1;1;2;40
2409100;Passa e Fica;2506905;Itabaiana;1;1;2;108
2503704;Cajazeiras;2506905;Itabaiana;1;1;2;365
2504009;Campina Grande;2506905;Itabaiana;1;1;2;67
2504603;Conde;2506905;Itabaiana;1;1;2;46
2502508;Boqueirão;2506806;Ingá;1;1;2;62
2505006;Cubati;2506806;Ingá;1;1;2;94
2505402;Desterro;2506707;Imaculada;1;1;2;47
2504405;Conceição;2506608;Ibiara;1;1;2;11
2503803;Caldas Brandão;2506400;Gurinhém;1;1;2;11
2504009;Campina Grande;2506400;Gurinhém;1;1;2;53
2407104;Macaíba;2506301;Guarabira;1;1;2;111
2408300;Nova Cruz;2506301;Guarabira;1;1;2;42
2500304;Alagoa Grande;2506301;Guarabira;1;1;2;26
2503605;Caiçara;2506301;Guarabira;1;1;2;34
2503704;Cajazeiras;2506301;Guarabira;1;1;2;342
2505204;Cuitegi;2506301;Guarabira;1;1;2;6
2502508;Boqueirão;2506251;Gado Bravo;1;1;2;39
2504009;Campina Grande;2506251;Gado Bravo;1;1;2;43
2506103;Fagundes;2506251;Gado Bravo;1;1;2;25
2402402;Carnaúba dos Dantas;2506202;Frei Martinho;1;1;2;23
2501302;Aroeiras;2506103;Fagundes;1;1;2;22
2403251;Parnamirim;2506004;Esperança;1;1;2;137
2501609;Barra de Santa Rosa;2506004;Esperança;1;1;2;41
2503209;Cabedelo;2506004;Esperança;1;1;2;109
2503704;Cajazeiras;2506004;Esperança;1;1;2;303
2505105;Cuité;2506004;Esperança;1;1;2;68
2504207;Catingueira;2505907;Emas;1;1;2;12
2502102;Boa Ventura;2505600;Diamante;1;1;2;6
2504009;Campina Grande;2505402;Desterro;1;1;2;132
2501005;Araruna;2505352;Damião;1;1;2;18
2503506;Cacimba de Dentro;2505352;Damião;1;1;2;14
2500304;Alagoa Grande;2505204;Cuitegi;1;1;2;20
2400109;Acari;2505105;Cuité;1;1;2;54
2405009;Jaçanã;2505105;Cuité;1;1;2;8
2408102;Natal;2505105;Cuité;1;1;2;124
2411205;Santa Cruz;2505105;Cuité;1;1;2;30
2501104;Areia;2505105;Cuité;1;1;2;74
2501534;Baraúna;2505105;Cuité;1;1;2;22
2504009;Campina Grande;2505006;Cubati;1;1;2;63
2503704;Cajazeiras;2504801;Coremas;1;1;2;73
2408102;Natal;2504603;Conde;1;1;2;164
2501807;Bayeux;2504603;Conde;1;1;2;15
2502409;Bonito de Santa Fé;2504405;Conceição;1;1;2;26
2503704;Cajazeiras;2504405;Conceição;1;1;2;73
2408102;Natal;2504355;Caturité;1;1;2;197
2304400;Fortaleza;2504306;Catolé do Rocha;1;1;2;298
2310803;Pereiro;2504306;Catolé do Rocha;1;1;2;86
2400505;Alexandria;2504306;Catolé do Rocha;1;1;2;31
2403103;Currais Novos;2504306;Catolé do Rocha;1;1;2;137
2407609;Messias Targino;2504306;Catolé do Rocha;1;1;2;39
2408003;Mossoró;2504306;Catolé do Rocha;1;1;2;136
2409407;Pau dos Ferros;2504306;Catolé do Rocha;1;1;2;61
2502805;Brejo do Cruz;2504306;Catolé do Rocha;1;1;2;28
2503209;Cabedelo;2504157;Casserengue;1;1;2;111
1502400;Castanhal;2504009;Campina Grande;1;1;2;1473
1503606;Itaituba;2504009;Campina Grande;1;1;2;2238
2112209;Timon;2504009;Campina Grande;1;1;2;801
2400208;Açu;2504009;Campina Grande;1;1;2;214
2401008;Apodi;2504009;Campina Grande;1;1;2;267
2401107;Areia Branca;2504009;Campina Grande;1;1;2;283
2403103;Currais Novos;2504009;Campina Grande;1;1;2;125
2403251;Parnamirim;2504009;Campina Grande;1;1;2;159
2403400;Equador;2504009;Campina Grande;1;1;2;97
2405702;Jardim do Seridó;2504009;Campina Grande;1;1;2;121
2408904;Parelhas;2504009;Campina Grande;1;1;2;102
2411205;Santa Cruz;2504009;Campina Grande;1;1;2;107
2414506;Umarizal;2504009;Campina Grande;1;1;2;250
2501609;Barra de Santa Rosa;2504009;Campina Grande;1;1;2;57
2502151;Boa Vista;2504009;Campina Grande;1;1;2;38
2301901;Barbalha;2503704;Cajazeiras;1;1;2;93
2303808;Cedro;2503704;Cajazeiras;1;1;2;62
2304202;Crato;2503704;Cajazeiras;1;1;2;98
2308104;Mauriti;2503704;Cajazeiras;1;1;2;58
2408003;Mossoró;2503704;Cajazeiras;1;1;2;233
2500304;Alagoa Grande;2503704;Cajazeiras;1;1;2;328
2500601;Alhandra;2503704;Cajazeiras;1;1;2;410
2503209;Cabedelo;2503704;Cajazeiras;1;1;2;413
2503308;Cachoeira dos Índios;2503704;Cajazeiras;1;1;2;11
2500809;Araçagi;2503605;Caiçara;1;1;2;33
2408300;Nova Cruz;2503506;Cacimba de Dentro;1;1;2;44
2501005;Araruna;2503506;Cacimba de Dentro;1;1;2;11
1302603;Manaus;2503209;Cabedelo;1;1;2;2806
1501303;Barcarena;2503209;Cabedelo;1;1;2;1634
1502400;Castanhal;2503209;Cabedelo;1;1;2;1571
2111300;São Luís;2503209;Cabedelo;1;1;2;1147
2204303;Fronteiras;2503209;Cabedelo;1;1;2;636
2306306;Itapagé;2503209;Cabedelo;1;1;2;641
2400208;Açu;2503209;Cabedelo;1;1;2;282
2403251;Parnamirim;2503209;Cabedelo;1;1;2;133
2403400;Equador;2503209;Cabedelo;1;1;2;208
2408003;Mossoró;2503209;Cabedelo;1;1;2;344
2408904;Parelhas;2503209;Cabedelo;1;1;2;203
2412203;São José de Mipibu;2503209;Cabedelo;1;1;2;116
2500403;Alagoa Nova;2503209;Cabedelo;1;1;2;100
1502202;Capanema;2503001;Caaporã;1;1;2;1514
2500809;Araçagi;2503001;Caaporã;1;1;2;90
2402006;Caicó;2502805;Brejo do Cruz;1;1;2;43
2407609;Messias Targino;2502805;Brejo do Cruz;1;1;2;30
2502706;Borborema;2502805;Brejo do Cruz;1;1;2;213
1502202;Capanema;2502508;Boqueirão;1;1;2;1394
2500403;Alagoa Nova;2502508;Boqueirão;1;1;2;61
2501351;Assunção;2502151;Boa Vista;1;1;2;58
2408300;Nova Cruz;2501906;Belém;1;1;2;31
2500304;Alagoa Grande;2501906;Belém;1;1;2;35
1302603;Manaus;2501807;Bayeux;1;1;2;2798
1400100;Boa Vista;2501807;Bayeux;1;1;2;3036
1500800;Ananindeua;2501807;Bayeux;1;1;2;1609
1502400;Castanhal;2501807;Bayeux;1;1;2;1566
2111300;São Luís;2501807;Bayeux;1;1;2;1143
2306256;Itaitinga;2501807;Bayeux;1;1;2;528
2501302;Aroeiras;2501575;Barra de Santana;1;1;2;32
2304285;Eusébio;2501302;Aroeiras;1;1;2;504
2500403;Alagoa Nova;2501302;Aroeiras;1;1;2;53
2405702;Jardim do Seridó;2501104;Areia;1;1;2;128
2408300;Nova Cruz;2501005;Araruna;1;1;2;35
2500403;Alagoa Nova;2500908;Arara;1;1;2;27
2303808;Cedro;2500700;São João do Rio do Peixe;1;1;2;69
2304400;Fortaleza;2500601;Alhandra;1;1;2;569
2305233;Horizonte;2500601;Alhandra;1;1;2;540
2500304;Alagoa Grande;2500502;Alagoinha;1;1;2;13
2500304;Alagoa Grande;2500403;Alagoa Nova;1;1;2;16
2304400;Fortaleza;2500304;Alagoa Grande;1;1;2;484
2408102;Natal;2415008;Vila Flor;1;1;2;58
2408102;Natal;2414902;Viçosa;1;1;2;299
2403103;Currais Novos;2414803;Vera Cruz;1;1;2;122
2403251;Parnamirim;2414803;Vera Cruz;1;1;2;23
2406601;Lagoa Salgada;2414803;Vera Cruz;1;1;2;12
2408102;Natal;2414803;Vera Cruz;1;1;2;32
2412203;São José de Mipibu;2414803;Vera Cruz;1;1;2;19
2403251;Parnamirim;2414704;Várzea;1;1;2;49
2408102;Natal;2414704;Várzea;1;1;2;60
2411502;Santo Antônio;2414704;Várzea;1;1;2;12
2408102;Natal;2414605;Upanema;1;1;2;224
2401008;Apodi;2414506;Umarizal;1;1;2;24
2403103;Currais Novos;2414506;Umarizal;1;1;2;147
2404903;Itaú;2414506;Umarizal;1;1;2;26
2407104;Macaíba;2414506;Umarizal;1;1;2;273
2407302;Marcelino Vieira;2414506;Umarizal;1;1;2;51
2408102;Natal;2414506;Umarizal;1;1;2;285
2408409;Olho-d'Água do Borges;2414506;Umarizal;1;1;2;13
2409308;Patu;2414506;Umarizal;1;1;2;22
2401404;Baía Formosa;2414407;Touros;1;1;2;137
2403608;Extremoz;2414407;Touros;1;1;2;56
2409902;Pendências;2414407;Touros;1;1;2;133
2411205;Santa Cruz;2414407;Touros;1;1;2;127
2412559;São Miguel de Touros;2414407;Touros;1;1;2;22
2414001;Tangará;2414407;Touros;1;1;2;113
2402006;Caicó;2414308;Timbaúba dos Batistas;1;1;2;16
2408102;Natal;2414308;Timbaúba dos Batistas;1;1;2;235
2413409;Serra Negra do Norte;2414308;Timbaúba dos Batistas;1;1;2;26
2401404;Baía Formosa;2414209;Tibau do Sul;1;1;2;21
2403103;Currais Novos;2414209;Tibau do Sul;1;1;2;155
2404101;Galinhos;2414209;Tibau do Sul;1;1;2;177
2402709;Cerro Corá;2414159;Tenente Laurentino Cruz;1;1;2;43
2403103;Currais Novos;2414159;Tenente Laurentino Cruz;1;1;2;26
2403806;Florânia;2414159;Tenente Laurentino Cruz;1;1;2;11
2406502;Lagoa Nova;2414159;Tenente Laurentino Cruz;1;1;2;28
2301950;Barreira;2414100;Tenente Ananias;1;1;2;246
2304350;Forquilha;2414100;Tenente Ananias;1;1;2;374
2406908;Lucrécia;2414100;Tenente Ananias;1;1;2;55
2408102;Natal;2414100;Tenente Ananias;1;1;2;332
2409407;Pau dos Ferros;2414100;Tenente Ananias;1;1;2;41
2401701;Bom Jesus;2414001;Tangará;1;1;2;34
2411205;Santa Cruz;2414001;Tangará;1;1;2;24
2411502;Santo Antônio;2414001;Tangará;1;1;2;38
2412203;São José de Mipibu;2414001;Tangará;1;1;2;62
2413706;Sítio Novo;2414001;Tangará;1;1;2;16
2109908;Santa Inês;2413904;Taipu;1;1;2;1107
2402600;Ceará-Mirim;2413904;Taipu;1;1;2;20
2407104;Macaíba;2413904;Taipu;1;1;2;38
2408003;Mossoró;2413904;Taipu;1;1;2;200
2410108;Poço Branco;2413904;Taipu;1;1;2;7
2408102;Natal;2413805;Taboleiro Grande;1;1;2;310
2408102;Natal;2413706;Sítio Novo;1;1;2;80
2401008;Apodi;2413607;Severiano Melo;1;1;2;11
2404903;Itaú;2413557;Serrinha dos Pintos;1;1;2;30
2406908;Lucrécia;2413557;Serrinha dos Pintos;1;1;2;16
2407401;Martins;2413557;Serrinha dos Pintos;1;1;2;6
2408102;Natal;2413508;Serrinha;1;1;2;58
2403004;Cruzeta;2413409;Serra Negra do Norte;1;1;2;73
2402303;Caraúbas;2413359;Serra do Mel;1;1;2;90
2408102;Natal;2413359;Serra do Mel;1;1;2;210
2409100;Passa e Fica;2413300;Serra de São Bento;1;1;2;7
2407104;Macaíba;2413201;Senador Georgino Avelino;1;1;2;42
2408102;Natal;2413201;Senador Georgino Avelino;1;1;2;41
2412203;São José de Mipibu;2413201;Senador Georgino Avelino;1;1;2;17
2402600;Ceará-Mirim;2413102;Senador Elói de Souza;1;1;2;53
2408102;Natal;2413102;Senador Elói de Souza;1;1;2;55
2412906;São Tomé;2413102;Senador Elói de Souza;1;1;2;44
2403103;Currais Novos;2413003;São Vicente;1;1;2;20
2403806;Florânia;2413003;São Vicente;1;1;2;18
2405801;João Câmara;2412906;São Tomé;1;1;2;55
2406502;Lagoa Nova;2412807;São Rafael;1;1;2;56
2408102;Natal;2412807;São Rafael;1;1;2;181
2403251;Parnamirim;2412708;São Pedro;1;1;2;41
2409332;Santa Maria;2412708;São Pedro;1;1;2;9
2412609;São Paulo do Potengi;2412708;São Pedro;1;1;2;14
2401503;Barcelona;2412609;São Paulo do Potengi;1;1;2;19
2403251;Parnamirim;2412609;São Paulo do Potengi;1;1;2;55
2404606;Ielmo Marinho;2412609;São Paulo do Potengi;1;1;2;25
2409332;Santa Maria;2412609;São Paulo do Potengi;1;1;2;10
2203909;Floriano;2412500;São Miguel;1;1;2;507
2304400;Fortaleza;2412500;São Miguel;1;1;2;270
2306900;Jaguaribe;2412500;São Miguel;1;1;2;37
2402303;Caraúbas;2412500;São Miguel;1;1;2;112
2403103;Currais Novos;2412500;São Miguel;1;1;2;218
2408003;Mossoró;2412500;São Miguel;1;1;2;169
2412005;São Gonçalo do Amarante;2412500;São Miguel;1;1;2;352
2400109;Acari;2412401;São José do Seridó;1;1;2;26
2403400;Equador;2412401;São José do Seridó;1;1;2;57
2408102;Natal;2412401;São José do Seridó;1;1;2;193
2408904;Parelhas;2412401;São José do Seridó;1;1;2;36
2403103;Currais Novos;2412302;São José do Campestre;1;1;2;87
2408102;Natal;2412302;São José do Campestre;1;1;2;77
2411205;Santa Cruz;2412302;São José do Campestre;1;1;2;32
2400703;Alto do Rodrigues;2412203;São José de Mipibu;1;1;2;188
2401404;Baía Formosa;2412203;São José de Mipibu;1;1;2;41
2402006;Caicó;2412203;São José de Mipibu;1;1;2;211
2402600;Ceará-Mirim;2412203;São José de Mipibu;1;1;2;52
2403103;Currais Novos;2412203;São José de Mipibu;1;1;2;140
2407807;Monte Alegre;2412203;São José de Mipibu;1;1;2;8
2409332;Santa Maria;2412203;São José de Mipibu;1;1;2;56
2411205;Santa Cruz;2412203;São José de Mipibu;1;1;2;85
2411502;Santo Antônio;2412203;São José de Mipibu;1;1;2;35
2405702;Jardim do Seridó;2412104;São João do Sabugi;1;1;2;49
2408102;Natal;2412104;São João do Sabugi;1;1;2;238
2408904;Parelhas;2412104;São João do Sabugi;1;1;2;60
2400109;Acari;2412005;São Gonçalo do Amarante;1;1;2;162
2401859;Caiçara do Norte;2412005;São Gonçalo do Amarante;1;1;2;114
2401909;Caiçara do Rio do Vento;2412005;São Gonçalo do Amarante;1;1;2;74
2402600;Ceará-Mirim;2412005;São Gonçalo do Amarante;1;1;2;19
2403608;Extremoz;2412005;São Gonçalo do Amarante;1;1;2;10
2406700;Lajes;2412005;São Gonçalo do Amarante;1;1;2;104
2408201;Nísia Floresta;2412005;São Gonçalo do Amarante;1;1;2;36
2408706;Paraú;2412005;São Gonçalo do Amarante;1;1;2;196
2408953;Rio do Fogo;2412005;São Gonçalo do Amarante;1;1;2;52
2409332;Santa Maria;2412005;São Gonçalo do Amarante;1;1;2;41
2403301;Encanto;2411908;São Francisco do Oeste;1;1;2;22
2408102;Natal;2411908;São Francisco do Oeste;1;1;2;323
2410504;Rafael Fernandes;2411908;São Francisco do Oeste;1;1;2;26
2408102;Natal;2411809;São Fernando;1;1;2;223
2402600;Ceará-Mirim;2411601;São Bento do Norte;1;1;2;85
2408102;Natal;2411601;São Bento do Norte;1;1;2;112
2411502;Santo Antônio;2411601;São Bento do Norte;1;1;2;144
2304400;Fortaleza;2411502;Santo Antônio;1;1;2;440
2401404;Baía Formosa;2411502;Santo Antônio;1;1;2;50
2409100;Passa e Fica;2411502;Santo Antônio;1;1;2;23
2410306;Presidente Juscelino;2411502;Santo Antônio;1;1;2;34
2405702;Jardim do Seridó;2411429;Santana do Seridó;1;1;2;24
2408102;Natal;2411429;Santana do Seridó;1;1;2;195
2406106;Jucurutu;2411403;Santana do Matos;1;1;2;36
2406700;Lajes;2411403;Santana do Matos;1;1;2;48
2304400;Fortaleza;2411205;Santa Cruz;1;1;2;391
2400109;Acari;2411205;Santa Cruz;1;1;2;73
2401404;Baía Formosa;2411205;Santa Cruz;1;1;2;110
2401701;Bom Jesus;2411205;Santa Cruz;1;1;2;56
2401800;Brejinho;2411205;Santa Cruz;1;1;2;73
2402006;Caicó;2411205;Santa Cruz;1;1;2;126
2402105;Campo Redondo;2411205;Santa Cruz;1;1;2;19
2405009;Jaçanã;2411205;Santa Cruz;1;1;2;29
2408003;Mossoró;2411205;Santa Cruz;1;1;2;188
2408300;Nova Cruz;2411205;Santa Cruz;1;1;2;70
2410306;Presidente Juscelino;2411205;Santa Cruz;1;1;2;37
2401503;Barcelona;2411106;Ruy Barbosa;1;1;2;8
2408102;Natal;2411106;Ruy Barbosa;1;1;2;76
2404408;Grossos;2411056;Tibau;1;1;2;19
2408102;Natal;2411056;Tibau;1;1;2;249
2408102;Natal;2411007;Rodolfo Fernandes;1;1;2;313
2403251;Parnamirim;2410900;Riachuelo;1;1;2;63
2408102;Natal;2410900;Riachuelo;1;1;2;64
2409332;Santa Maria;2410900;Riachuelo;1;1;2;15
2408102;Natal;2410801;Riacho de Santana;1;1;2;343
2408102;Natal;2410702;Riacho da Cruz;1;1;2;299
2400604;Almino Afonso;2410603;Rafael Godeiro;1;1;2;10
2408102;Natal;2410603;Rafael Godeiro;1;1;2;275
2408409;Olho-d'Água do Borges;2410603;Rafael Godeiro;1;1;2;13
2407005;Luís Gomes;2410504;Rafael Fernandes;1;1;2;30
2408102;Natal;2410504;Rafael Fernandes;1;1;2;332
2401453;Baraúna;2410405;Pureza;1;1;2;232
2402600;Ceará-Mirim;2410405;Pureza;1;1;2;25
2408102;Natal;2410405;Pureza;1;1;2;52
2408102;Natal;2410306;Presidente Juscelino;1;1;2;61
2300200;Acaraú;2410256;Porto do Mangue;1;1;2;438
2402204;Canguaretama;2410256;Porto do Mangue;1;1;2;234
2408003;Mossoró;2410256;Porto do Mangue;1;1;2;63
2400901;Antônio Martins;2410207;Portalegre;1;1;2;23
2403905;Francisco Dantas;2410207;Portalegre;1;1;2;16
2407401;Martins;2410207;Portalegre;1;1;2;11
2408003;Mossoró;2410207;Portalegre;1;1;2;117
2408102;Natal;2410207;Portalegre;1;1;2;304
2402600;Ceará-Mirim;2410108;Poço Branco;1;1;2;28
2408102;Natal;2410009;Pilões;1;1;2;313
2102036;Bom Jesus das Selvas;2409902;Pendências;1;1;2;1121
2408102;Natal;2409902;Pendências;1;1;2;170
2301109;Aracati;2409803;Pedro Velho;1;1;2;347
2402600;Ceará-Mirim;2409803;Pedro Velho;1;1;2;90
2403103;Currais Novos;2409803;Pedro Velho;1;1;2;144
2407104;Macaíba;2409803;Pedro Velho;1;1;2;66
2408102;Natal;2409803;Pedro Velho;1;1;2;69
2408300;Nova Cruz;2409803;Pedro Velho;1;1;2;23
2301109;Aracati;2409704;Pedro Avelino;1;1;2;184
2400703;Alto do Rodrigues;2409704;Pedro Avelino;1;1;2;49
2404507;Guamaré;2409704;Pedro Avelino;1;1;2;46
2408003;Mossoró;2409704;Pedro Avelino;1;1;2;112
2408102;Natal;2409704;Pedro Avelino;1;1;2;131
2404507;Guamaré;2409605;Pedra Preta;1;1;2;58
2203909;Floriano;2409407;Pau dos Ferros;1;1;2;535
2304400;Fortaleza;2409407;Pau dos Ferros;1;1;2;260
2308708;Morada Nova;2409407;Pau dos Ferros;1;1;2;108
2403251;Parnamirim;2409407;Pau dos Ferros;1;1;2;331
2403905;Francisco Dantas;2409407;Pau dos Ferros;1;1;2;14
2407401;Martins;2409407;Pau dos Ferros;1;1;2;37
2401503;Barcelona;2409332;Santa Maria;1;1;2;28
2401701;Bom Jesus;2409332;Santa Maria;1;1;2;20
2403251;Parnamirim;2409332;Santa Maria;1;1;2;49
2407104;Macaíba;2409332;Santa Maria;1;1;2;38
2400901;Antônio Martins;2409308;Patu;1;1;2;32
2401008;Apodi;2409308;Patu;1;1;2;42
2402006;Caicó;2409308;Patu;1;1;2;70
2403103;Currais Novos;2409308;Patu;1;1;2;127
2405207;Janduís;2409308;Patu;1;1;2;27
2407401;Martins;2409308;Patu;1;1;2;29
2407609;Messias Targino;2409308;Patu;1;1;2;15
2408003;Mossoró;2409308;Patu;1;1;2;105
2408102;Natal;2409308;Patu;1;1;2;267
2408102;Natal;2409209;Passagem;1;1;2;53
2403251;Parnamirim;2409100;Passa e Fica;1;1;2;71
2406700;Lajes;2409100;Passa e Fica;1;1;2;102
2400703;Alto do Rodrigues;2408904;Parelhas;1;1;2;155
2402402;Carnaúba dos Dantas;2408904;Parelhas;1;1;2;16
2406106;Jucurutu;2408904;Parelhas;1;1;2;80
2408003;Mossoró;2408904;Parelhas;1;1;2;183
2405801;João Câmara;2408805;Parazinho;1;1;2;35
2408102;Natal;2408805;Parazinho;1;1;2;93
2407609;Messias Targino;2408706;Paraú;1;1;2;57
2408102;Natal;2408706;Paraú;1;1;2;205
2405702;Jardim do Seridó;2408508;Ouro Branco;1;1;2;24
2408102;Natal;2408508;Ouro Branco;1;1;2;212
2401107;Areia Branca;2408409;Olho-d'Água do Borges;1;1;2;127
2408102;Natal;2408409;Olho-d'Água do Borges;1;1;2;273
2401404;Baía Formosa;2408300;Nova Cruz;1;1;2;45
2402204;Canguaretama;2408300;Nova Cruz;1;1;2;35
2406205;Lagoa d'Anta;2408300;Nova Cruz;1;1;2;21
2407104;Macaíba;2408300;Nova Cruz;1;1;2;69
1500800;Ananindeua;2408102;Natal;1;1;2;1531
1504208;Marabá;2408102;Natal;1;1;2;1534
1721000;Palmas;2408102;Natal;1;1;2;1545
2208007;Picos;2408102;Natal;1;1;2;704
2301109;Aracati;2408102;Natal;1;1;2;309
2302602;Camocim;2408102;Natal;1;1;2;700
2303501;Cascavel;2408102;Natal;1;1;2;380
2304202;Crato;2408102;Natal;1;1;2;487
2304509;Frecheirinha;2408102;Natal;1;1;2;656
2305233;Horizonte;2408102;Natal;1;1;2;406
2305308;Ibiapina;2408102;Natal;1;1;2;658
2305357;Icapuí;2408102;Natal;1;1;2;263
2307403;Jucás;2408102;Natal;1;1;2;484
2310258;Paraipaba;2408102;Natal;1;1;2;505
2310506;Pedra Branca;2408102;Natal;1;1;2;496
2311405;Quixeramobim;2408102;Natal;1;1;2;452
2311801;Russas;2408102;Natal;1;1;2;318
2400109;Acari;2408102;Natal;1;1;2;169
2400307;Afonso Bezerra;2408102;Natal;1;1;2;144
2400406;Água Nova;2408102;Natal;1;1;2;341
2401305;Augusto Severo;2408102;Natal;1;1;2;228
2401404;Baía Formosa;2408102;Natal;1;1;2;67
2401453;Baraúna;2408102;Natal;1;1;2;275
2401602;Bento Fernandes;2408102;Natal;1;1;2;65
2401701;Bom Jesus;2408102;Natal;1;1;2;41
2401909;Caiçara do Rio do Vento;2408102;Natal;1;1;2;83
2402105;Campo Redondo;2408102;Natal;1;1;2;114
2402303;Caraúbas;2408102;Natal;1;1;2;257
2402709;Cerro Corá;2408102;Natal;1;1;2;124
2402907;Coronel João Pessoa;2408102;Natal;1;1;2;358
2403202;Doutor Severiano;2408102;Natal;1;1;2;348
2403301;Encanto;2408102;Natal;1;1;2;340
2403400;Equador;2408102;Natal;1;1;2;206
2403509;Espírito Santo;2408102;Natal;1;1;2;57
2403707;Felipe Guerra;2408102;Natal;1;1;2;271
2403806;Florânia;2408102;Natal;1;1;2;177
2403905;Francisco Dantas;2408102;Natal;1;1;2;319
2404002;Frutuoso Gomes;2408102;Natal;1;1;2;290
2404101;Galinhos;2408102;Natal;1;1;2;138
2404309;Governador Dix-Sept Rosado;2408102;Natal;1;1;2;253
2404408;Grossos;2408102;Natal;1;1;2;230
2404606;Ielmo Marinho;2408102;Natal;1;1;2;34
2404804;Ipueira;2408102;Natal;1;1;2;243
2404903;Itaú;2408102;Natal;1;1;2;304
2405009;Jaçanã;2408102;Natal;1;1;2;126
2405306;Januário Cicco;2408102;Natal;1;1;2;54
2405504;Jardim de Angicos;2408102;Natal;1;1;2;82
2405900;João Dias;2408102;Natal;1;1;2;287
2406007;José da Penha;2408102;Natal;1;1;2;341
2406205;Lagoa d'Anta;2408102;Natal;1;1;2;74
2406403;Lagoa de Velhos;2408102;Natal;1;1;2;72
2406502;Lagoa Nova;2408102;Natal;1;1;2;139
2406700;Lajes;2408102;Natal;1;1;2;113
2406809;Lajes Pintadas;2408102;Natal;1;1;2;103
2406908;Lucrécia;2408102;Natal;1;1;2;286
2407005;Luís Gomes;2408102;Natal;1;1;2;354
2407302;Marcelino Vieira;2408102;Natal;1;1;2;328
2407500;Maxaranguape;2408102;Natal;1;1;2;38
2407708;Montanhas;2408102;Natal;1;1;2;74
1302603;Manaus;2408003;Mossoró;1;1;2;2522
2303808;Cedro;2408003;Mossoró;1;1;2;247
2306207;Itaiçaba;2408003;Mossoró;1;1;2;77
2307700;Maranguape;2408003;Mossoró;1;1;2;206
2307809;Marco;2408003;Mossoró;1;1;2;385
2308708;Morada Nova;2408003;Mossoró;1;1;2;115
2311504;Quixeré;2408003;Mossoró;1;1;2;72
2400307;Afonso Bezerra;2408003;Mossoró;1;1;2;99
2400703;Alto do Rodrigues;2408003;Mossoró;1;1;2;66
2402501;Carnaubais;2408003;Mossoró;1;1;2;60
2404507;Guamaré;2408003;Mossoró;1;1;2;114
2404705;Ipanguaçu;2408003;Mossoró;1;1;2;64
2405702;Jardim do Seridó;2408003;Mossoró;1;1;2;165
2405801;João Câmara;2408003;Mossoró;1;1;2;174
2406908;Lucrécia;2408003;Mossoró;1;1;2;116
2407500;Maxaranguape;2408003;Mossoró;1;1;2;228
2401206;Arês;2407807;Monte Alegre;1;1;2;24
2401404;Baía Formosa;2407807;Monte Alegre;1;1;2;48
2403103;Currais Novos;2407807;Monte Alegre;1;1;2;132
2404200;Goianinha;2407807;Monte Alegre;1;1;2;34
2402204;Canguaretama;2407708;Montanhas;1;1;2;21
2407104;Macaíba;2407708;Montanhas;1;1;2;70
2400901;Antônio Martins;2407609;Messias Targino;1;1;2;46
2402303;Caraúbas;2407609;Messias Targino;1;1;2;34
2405207;Janduís;2407609;Messias Targino;1;1;2;14
2402600;Ceará-Mirim;2407500;Maxaranguape;1;1;2;22
2401305;Augusto Severo;2407401;Martins;1;1;2;71
2403251;Parnamirim;2407252;Major Sales;1;1;2;343
2302602;Camocim;2407203;Macau;1;1;2;530
2304400;Fortaleza;2407203;Macau;1;1;2;259
2400307;Afonso Bezerra;2407203;Macau;1;1;2;44
2400802;Angicos;2407203;Macau;1;1;2;69
2401107;Areia Branca;2407203;Macau;1;1;2;59
2401206;Arês;2407203;Macau;1;1;2;201
2402204;Canguaretama;2407203;Macau;1;1;2;217
2404408;Grossos;2407203;Macau;1;1;2;61
2404705;Ipanguaçu;2407203;Macau;1;1;2;49
2401008;Apodi;2407104;Macaíba;1;1;2;277
2401453;Baraúna;2407104;Macaíba;1;1;2;265
2401701;Bom Jesus;2407104;Macaíba;1;1;2;29
2401800;Brejinho;2407104;Macaíba;1;1;2;37
2402006;Caicó;2407104;Macaíba;1;1;2;207
2402204;Canguaretama;2407104;Macaíba;1;1;2;63
2402303;Caraúbas;2407104;Macaíba;1;1;2;245
2403509;Espírito Santo;2407104;Macaíba;1;1;2;53
2404903;Itaú;2407104;Macaíba;1;1;2;292
2406601;Lagoa Salgada;2407104;Macaíba;1;1;2;34
2304400;Fortaleza;2406700;Lajes;1;1;2;334
2404507;Guamaré;2406700;Lajes;1;1;2;72
2401800;Brejinho;2406601;Lagoa Salgada;1;1;2;16
2403251;Parnamirim;2406601;Lagoa Salgada;1;1;2;35
2209401;Santo Antônio de Lisboa;2406502;Lagoa Nova;1;1;2;537
2402006;Caicó;2406502;Lagoa Nova;1;1;2;83
2402105;Campo Redondo;2406502;Lagoa Nova;1;1;2;36
2405702;Jardim do Seridó;2406502;Lagoa Nova;1;1;2;62
2402709;Cerro Corá;2406106;Jucurutu;1;1;2;69
2404853;Itajá;2406106;Jucurutu;1;1;2;45
2401602;Bento Fernandes;2405801;João Câmara;1;1;2;18
2401859;Caiçara do Norte;2405801;João Câmara;1;1;2;58
2403004;Cruzeta;2405801;João Câmara;1;1;2;145
2403103;Currais Novos;2405801;João Câmara;1;1;2;111
2403251;Parnamirim;2405801;João Câmara;1;1;2;75
2404507;Guamaré;2405801;João Câmara;1;1;2;73
2404606;Ielmo Marinho;2405801;João Câmara;1;1;2;43
2405108;Jandaíra;2405801;João Câmara;1;1;2;40
2304400;Fortaleza;2405702;Jardim do Seridó;1;1;2;365
2403103;Currais Novos;2405702;Jardim do Seridó;1;1;2;45
2403251;Parnamirim;2405702;Jardim do Seridó;1;1;2;183
2404804;Ipueira;2405702;Jardim do Seridó;1;1;2;54
2405603;Jardim de Piranhas;2405702;Jardim do Seridó;1;1;2;66
2203909;Floriano;2405603;Jardim de Piranhas;1;1;2;629
2403103;Currais Novos;2405603;Jardim de Piranhas;1;1;2;94
2401305;Augusto Severo;2405207;Janduís;1;1;2;20
2401453;Baraúna;2405207;Janduís;1;1;2;106
2402808;Coronel Ezequiel;2405009;Jaçanã;1;1;2;5
2208205;Pio IX;2404903;Itaú;1;1;2;310
2402303;Caraúbas;2404903;Itaú;1;1;2;48
2400802;Angicos;2404853;Itajá;1;1;2;30
2401909;Caiçara do Rio do Vento;2404705;Ipanguaçu;1;1;2;99
2303709;Caucaia;2404507;Guamaré;1;1;2;302
2400109;Acari;2404507;Guamaré;1;1;2;151
2400208;Açu;2404507;Guamaré;1;1;2;84
2400802;Angicos;2404507;Guamaré;1;1;2;77
2403103;Currais Novos;2404507;Guamaré;1;1;2;129
2403251;Parnamirim;2404507;Guamaré;1;1;2;147
2400208;Açu;2404408;Grossos;1;1;2;70
2401008;Apodi;2404309;Governador Dix-Sept Rosado;1;1;2;53
2402303;Caraúbas;2404309;Governador Dix-Sept Rosado;1;1;2;36
2401206;Arês;2404200;Goianinha;1;1;2;16
2403103;Currais Novos;2404200;Goianinha;1;1;2;148
2403251;Parnamirim;2404101;Galinhos;1;1;2;143
2400901;Antônio Martins;2404002;Frutuoso Gomes;1;1;2;10
2400208;Açu;2403756;Fernando Pedroza;1;1;2;46
2403004;Cruzeta;2403400;Equador;1;1;2;59
1502202;Capanema;2403251;Parnamirim;1;1;2;1412
2304285;Eusébio;2403251;Parnamirim;1;1;2;418
2305506;Iguatu;2403251;Parnamirim;1;1;2;453
2312908;Sobral;2403251;Parnamirim;1;1;2;617
2400208;Açu;2403251;Parnamirim;1;1;2;188
2400802;Angicos;2403251;Parnamirim;1;1;2;151
2401008;Apodi;2403251;Parnamirim;1;1;2;288
2401701;Bom Jesus;2403251;Parnamirim;1;1;2;36
2402501;Carnaubais;2403251;Parnamirim;1;1;2;185
2203909;Floriano;2403103;Currais Novos;1;1;2;723
2304400;Fortaleza;2403103;Currais Novos;1;1;2;355
2307650;Maracanaú;2403103;Currais Novos;1;1;2;354
2310803;Pereiro;2403103;Currais Novos;1;1;2;218
2400505;Alexandria;2403103;Currais Novos;1;1;2;167
2402105;Campo Redondo;2403103;Currais Novos;1;1;2;36
2402204;Canguaretama;2403103;Currais Novos;1;1;2;154
2402600;Ceará-Mirim;2403103;Currais Novos;1;1;2;139
2304400;Fortaleza;2403004;Cruzeta;1;1;2;350
2400109;Acari;2402709;Cerro Corá;1;1;2;54
1701002;Ananás;2402600;Ceará-Mirim;1;1;2;1405
2307700;Maranguape;2402600;Ceará-Mirim;1;1;2;411
2401453;Baraúna;2402600;Ceará-Mirim;1;1;2;252
2401859;Caiçara do Norte;2402600;Ceará-Mirim;1;1;2;96
2400208;Açu;2402303;Caraúbas;1;1;2;75
2400604;Almino Afonso;2402303;Caraúbas;1;1;2;47
2400901;Antônio Martins;2402303;Caraúbas;1;1;2;61
2300200;Acaraú;2402204;Canguaretama;1;1;2;669
2304400;Fortaleza;2402204;Canguaretama;1;1;2;474
2202307;Canto do Buriti;2402006;Caicó;1;1;2;670
2203909;Floriano;2402006;Caicó;1;1;2;654
2206407;Monsenhor Gil;2402006;Caicó;1;1;2;614
2208007;Picos;2402006;Caicó;1;1;2;486
2301901;Barbalha;2402006;Caicó;1;1;2;260
2309607;Pacajus;2402006;Caicó;1;1;2;292
2400109;Acari;2402006;Caicó;1;1;2;54
2400802;Angicos;2402006;Caicó;1;1;2;97
2401206;Arês;2401701;Bom Jesus;1;1;2;52
2304400;Fortaleza;2401453;Baraúna;1;1;2;177
2307601;Limoeiro do Norte;2401453;Baraúna;1;1;2;52
2311504;Quixeré;2401453;Baraúna;1;1;2;41
2401008;Apodi;2401453;Baraúna;1;1;2;82
1501402;Belém;2401107;Areia Branca;1;1;2;1312
2302206;Beberibe;2401107;Areia Branca;1;1;2;140
2304400;Fortaleza;2401107;Areia Branca;1;1;2;204
2401008;Apodi;2401107;Areia Branca;1;1;2;121
2304400;Fortaleza;2401008;Apodi;1;1;2;235
2305357;Icapuí;2401008;Apodi;1;1;2;128
2304400;Fortaleza;2400802;Angicos;1;1;2;304
2400208;Açu;2400802;Angicos;1;1;2;39
2310209;Paracuru;2400703;Alto do Rodrigues;1;1;2;322
2400307;Afonso Bezerra;2400703;Alto do Rodrigues;1;1;2;37
1501501;Benevides;2400208;Açu;1;1;2;1334
2203909;Floriano;2400208;Açu;1;1;2;690
2211001;Teresina;2400208;Açu;1;1;2;652
2304285;Eusébio;2400208;Açu;1;1;2;251
2311801;Russas;2400208;Açu;1;1;2;136
2112506;Tutóia;2314102;Viçosa do Ceará;1;1;2;159
2207702;Parnaíba;2314102;Viçosa do Ceará;1;1;2;108
2211001;Teresina;2314102;Viçosa do Ceará;1;1;2;254
2305308;Ibiapina;2314102;Viçosa do Ceará;1;1;2;46
2305506;Iguatu;2314102;Viçosa do Ceará;1;1;2;365
2312205;Santa Quitéria;2314102;Viçosa do Ceará;1;1;2;134
2300309;Acopiara;2314003;Várzea Alegre;1;1;2;80
2300804;Antonina do Norte;2314003;Várzea Alegre;1;1;2;77
2301109;Aracati;2314003;Várzea Alegre;1;1;2;299
2304202;Crato;2314003;Várzea Alegre;1;1;2;49
2305407;Icó;2314003;Várzea Alegre;1;1;2;64
2307502;Lavras da Mangabeira;2314003;Várzea Alegre;1;1;2;36
2307650;Maracanaú;2314003;Várzea Alegre;1;1;2;332
2311801;Russas;2314003;Várzea Alegre;1;1;2;252
2303659;Catunda;2313955;Varjota;1;1;2;59
2306108;Irauçuba;2313955;Varjota;1;1;2;91
2312205;Santa Quitéria;2313955;Varjota;1;1;2;38
2312304;São Benedito;2313955;Varjota;1;1;2;45
2313559;Tururu;2313807;Uruburetama;1;1;2;9
2313757;Umirim;2313807;Uruburetama;1;1;2;18
2306405;Itapipoca;2313757;Umirim;1;1;2;32
2312403;São Gonçalo do Amarante;2313757;Umirim;1;1;2;43
2312601;São Luís do Curu;2313757;Umirim;1;1;2;12
2313559;Tururu;2313757;Umirim;1;1;2;14
2305704;Ipaumirim;2313708;Umari;1;1;2;16
2201507;Batalha;2313609;Ubajara;1;1;2;130
2202000;Buriti dos Lopes;2313609;Ubajara;1;1;2;123
2202208;Campo Maior;2313609;Ubajara;1;1;2;179
2205581;Lagoa do Piauí;2313609;Ubajara;1;1;2;258
2303402;Carnaubal;2313609;Ubajara;1;1;2;35
2304400;Fortaleza;2313609;Ubajara;1;1;2;265
2306553;Itarema;2313609;Ubajara;1;1;2;152
2308005;Massapê;2313609;Ubajara;1;1;2;74
2313500;Trairi;2313609;Ubajara;1;1;2;197
2304400;Fortaleza;2313559;Tururu;1;1;2;102
2306405;Itapipoca;2313559;Tururu;1;1;2;18
2304400;Fortaleza;2313500;Trairi;1;1;2;98
2306405;Itapipoca;2313500;Trairi;1;1;2;46
2307403;Jucás;2313500;Trairi;1;1;2;361
2309706;Pacatuba;2313500;Trairi;1;1;2;108
2310209;Paracuru;2313500;Trairi;1;1;2;34
2310258;Paraipaba;2313500;Trairi;1;1;2;24
2311603;Redenção;2313500;Trairi;1;1;2;120
2312403;São Gonçalo do Amarante;2313500;Trairi;1;1;2;51
2312601;São Luís do Curu;2313500;Trairi;1;1;2;47
2208403;Piripiri;2313401;Tianguá;1;1;2;107
2300200;Acaraú;2313401;Tianguá;1;1;2;135
2304103;Crateús;2313401;Tianguá;1;1;2;164
2304509;Frecheirinha;2313401;Tianguá;1;1;2;20
2304707;Granja;2313401;Tianguá;1;1;2;68
2305803;Ipu;2313401;Tianguá;1;1;2;71
2307304;Juazeiro do Norte;2313401;Tianguá;1;1;2;429
2307650;Maracanaú;2313401;Tianguá;1;1;2;262
2309003;Mucambo;2313401;Tianguá;1;1;2;34
2309300;Nova Russas;2313401;Tianguá;1;1;2;119
2311702;Reriutaba;2313401;Tianguá;1;1;2;64
2311801;Russas;2313401;Tianguá;1;1;2;360
2300903;Apuiarés;2313351;Tejuçuoca;1;1;2;17
2304400;Fortaleza;2313351;Tejuçuoca;1;1;2;118
2306306;Itapagé;2313351;Tejuçuoca;1;1;2;33
2310258;Paraipaba;2313351;Tejuçuoca;1;1;2;78
2310704;Pentecoste;2313351;Tejuçuoca;1;1;2;41
2312403;São Gonçalo do Amarante;2313351;Tejuçuoca;1;1;2;80
2312601;São Luís do Curu;2313351;Tejuçuoca;1;1;2;52
2208007;Picos;2313302;Tauá;1;1;2;174
2300309;Acopiara;2313302;Tauá;1;1;2;96
2301604;Assaré;2313302;Tauá;1;1;2;108
2302107;Baturité;2313302;Tauá;1;1;2;244
2302404;Boa Viagem;2313302;Tauá;1;1;2;112
2304285;Eusébio;2313302;Tauá;1;1;2;312
2307700;Maranguape;2313302;Tauá;1;1;2;296
2310506;Pedra Branca;2313302;Tauá;1;1;2;91
2311801;Russas;2313302;Tauá;1;1;2;286
2312700;Senador Pompeu;2313302;Tauá;1;1;2;110
2301604;Assaré;2313252;Tarrafas;1;1;2;23
2305506;Iguatu;2313252;Tarrafas;1;1;2;60
2305506;Iguatu;2313203;Tamboril;1;1;2;202
2309409;Novo Oriente;2313203;Tamboril;1;1;2;95
2311801;Russas;2313203;Tamboril;1;1;2;259
2312205;Santa Quitéria;2313203;Tamboril;1;1;2;56
2312304;São Benedito;2313203;Tamboril;1;1;2;104
2301109;Aracati;2313104;Tabuleiro do Norte;1;1;2;86
2305506;Iguatu;2313104;Tabuleiro do Norte;1;1;2;181
2306009;Iracema;2313104;Tabuleiro do Norte;1;1;2;65
2306801;Jaguaribara;2313104;Tabuleiro do Norte;1;1;2;71
2307700;Maranguape;2313104;Tabuleiro do Norte;1;1;2;162
2309607;Pacajus;2313104;Tabuleiro do Norte;1;1;2;124
2311405;Quixeramobim;2313104;Tabuleiro do Norte;1;1;2;128
2300309;Acopiara;2313005;Solonópole;1;1;2;64
2304400;Fortaleza;2313005;Solonópole;1;1;2;224
2310506;Pedra Branca;2313005;Solonópole;1;1;2;84
2311306;Quixadá;2313005;Solonópole;1;1;2;86
1500800;Ananindeua;2312908;Sobral;1;1;2;924
2101202;Bacabal;2312908;Sobral;1;1;2;490
2101400;Balsas;2312908;Sobral;1;1;2;764
2105302;Imperatriz;2312908;Sobral;1;1;2;813
2300507;Alcântaras;2312908;Sobral;1;1;2;22
2301000;Aquiraz;2312908;Sobral;1;1;2;221
2301109;Aracati;2312908;Sobral;1;1;2;308
2302800;Canindé;2312908;Sobral;1;1;2;139
2304251;Cruz;2312908;Sobral;1;1;2;85
2304285;Eusébio;2312908;Sobral;1;1;2;214
2305803;Ipu;2312908;Sobral;1;1;2;80
2305902;Ipueiras;2312908;Sobral;1;1;2;101
2307254;Jijoca de Jericoacoara;2312908;Sobral;1;1;2;95
2307700;Maranguape;2312908;Sobral;1;1;2;188
2307809;Marco;2312908;Sobral;1;1;2;65
2308005;Massapê;2312908;Sobral;1;1;2;16
2308906;Morrinhos;2312908;Sobral;1;1;2;55
2309003;Mucambo;2312908;Sobral;1;1;2;50
2309300;Nova Russas;2312908;Sobral;1;1;2;117
2309904;Pacujá;2312908;Sobral;1;1;2;51
2310209;Paracuru;2312908;Sobral;1;1;2;154
2311801;Russas;2312908;Sobral;1;1;2;300
2312403;São Gonçalo do Amarante;2312908;Sobral;1;1;2;155
2300309;Acopiara;2312700;Senador Pompeu;1;1;2;58
2305506;Iguatu;2312700;Senador Pompeu;1;1;2;88
2308500;Mombaça;2312700;Senador Pompeu;1;1;2;26
2310506;Pedra Branca;2312700;Senador Pompeu;1;1;2;33
2311306;Quixadá;2312700;Senador Pompeu;1;1;2;79
2311405;Quixeramobim;2312700;Senador Pompeu;1;1;2;44
2300903;Apuiarés;2312601;São Luís do Curu;1;1;2;37
2304400;Fortaleza;2312601;São Luís do Curu;1;1;2;79
2310704;Pentecoste;2312601;São Luís do Curu;1;1;2;14
2304400;Fortaleza;2312502;São João do Jaguaribe;1;1;2;169
2306256;Itaitinga;2312502;São João do Jaguaribe;1;1;2;147
2311801;Russas;2312502;São João do Jaguaribe;1;1;2;50
2100204;Alcântara;2312403;São Gonçalo do Amarante;1;1;2;619
2203909;Floriano;2312403;São Gonçalo do Amarante;1;1;2;574
2301000;Aquiraz;2312403;São Gonçalo do Amarante;1;1;2;72
2304202;Crato;2312403;São Gonçalo do Amarante;1;1;2;402
2304285;Eusébio;2312403;São Gonçalo do Amarante;1;1;2;66
2305233;Horizonte;2312403;São Gonçalo do Amarante;1;1;2;76
2306256;Itaitinga;2312403;São Gonçalo do Amarante;1;1;2;63
2307601;Limoeiro do Norte;2312403;São Gonçalo do Amarante;1;1;2;197
2309607;Pacajus;2312403;São Gonçalo do Amarante;1;1;2;84
2311603;Redenção;2312403;São Gonçalo do Amarante;1;1;2;71
1501402;Belém;2312304;São Benedito;1;1;2;891
2211001;Teresina;2312304;São Benedito;1;1;2;245
2301257;Ararendá;2312304;São Benedito;1;1;2;78
2303105;Cariré;2312304;São Benedito;1;1;2;44
2305506;Iguatu;2312304;São Benedito;1;1;2;306
2305902;Ipueiras;2312304;São Benedito;1;1;2;52
2307304;Juazeiro do Norte;2312304;São Benedito;1;1;2;391
2307650;Maracanaú;2312304;São Benedito;1;1;2;247
2309409;Novo Oriente;2312304;São Benedito;1;1;2;164
2311264;Quiterianópolis;2312304;São Benedito;1;1;2;199
2311306;Quixadá;2312304;São Benedito;1;1;2;224
2311702;Reriutaba;2312304;São Benedito;1;1;2;32
2311801;Russas;2312304;São Benedito;1;1;2;334
2208205;Pio IX;2312205;Santa Quitéria;1;1;2;282
2211001;Teresina;2312205;Santa Quitéria;1;1;2;305
2302602;Camocim;2312205;Santa Quitéria;1;1;2;174
2305506;Iguatu;2312205;Santa Quitéria;1;1;2;242
2305803;Ipu;2312205;Santa Quitéria;1;1;2;60
2305902;Ipueiras;2312205;Santa Quitéria;1;1;2;67
2308609;Monsenhor Tabosa;2312205;Santa Quitéria;1;1;2;52
2311009;Poranga;2312205;Santa Quitéria;1;1;2;97
2311306;Quixadá;2312205;Santa Quitéria;1;1;2;142
2208007;Picos;2312106;Santana do Cariri;1;1;2;192
2301307;Araripe;2312106;Santana do Cariri;1;1;2;46
2304202;Crato;2312106;Santana do Cariri;1;1;2;36
2304400;Fortaleza;2312106;Santana do Cariri;1;1;2;401
2311801;Russas;2312106;Santana do Cariri;1;1;2;316
2305506;Iguatu;2312007;Santana do Acaraú;1;1;2;331
2307809;Marco;2312007;Santana do Acaraú;1;1;2;39
2308005;Massapê;2312007;Santana do Acaraú;1;1;2;22
2304202;Crato;2311959;Salitre;1;1;2;116
2300804;Antonina do Norte;2311900;Saboeiro;1;1;2;29
2304400;Fortaleza;2311900;Saboeiro;1;1;2;341
2305506;Iguatu;2311900;Saboeiro;1;1;2;67
2207702;Parnaíba;2311801;Russas;1;1;2;479
2300101;Abaiara;2311801;Russas;1;1;2;294
2300606;Altaneira;2311801;Russas;1;1;2;302
2301604;Assaré;2311801;Russas;1;1;2;300
2301703;Aurora;2311801;Russas;1;1;2;247
2301851;Banabuiú;2311801;Russas;1;1;2;115
2302008;Barro;2311801;Russas;1;1;2;264
2302107;Baturité;2311801;Russas;1;1;2;120
2302404;Boa Viagem;2311801;Russas;1;1;2;195
2302503;Brejo Santo;2311801;Russas;1;1;2;305
2302701;Campos Sales;2311801;Russas;1;1;2;356
2302909;Capistrano;2311801;Russas;1;1;2;116
2303204;Caririaçu;2311801;Russas;1;1;2;275
2303808;Cedro;2311801;Russas;1;1;2;221
2304301;Farias Brito;2311801;Russas;1;1;2;283
2304459;Fortim;2311801;Russas;1;1;2;56
2305233;Horizonte;2311801;Russas;1;1;2;108
2305266;Ibaretama;2311801;Russas;1;1;2;87
2305332;Ibicuitinga;2311801;Russas;1;1;2;74
2305357;Icapuí;2311801;Russas;1;1;2;71
2305605;Independência;2311801;Russas;1;1;2;268
2306009;Iracema;2311801;Russas;1;1;2;104
2306207;Itaiçaba;2311801;Russas;1;1;2;33
2306405;Itapipoca;2311801;Russas;1;1;2;238
2306504;Itapiúna;2311801;Russas;1;1;2;112
2306801;Jaguaribara;2311801;Russas;1;1;2;108
2307106;Jardim;2311801;Russas;1;1;2;328
2307205;Jati;2311801;Russas;1;1;2;326
2307502;Lavras da Mangabeira;2311801;Russas;1;1;2;230
2307650;Maracanaú;2311801;Russas;1;1;2;139
2308104;Mauriti;2311801;Russas;1;1;2;285
2308401;Missão Velha;2311801;Russas;1;1;2;288
2309201;Nova Olinda;2311801;Russas;1;1;2;305
2309300;Nova Russas;2311801;Russas;1;1;2;286
2309409;Novo Oriente;2311801;Russas;1;1;2;317
2309508;Orós;2311801;Russas;1;1;2;180
2309607;Pacajus;2311801;Russas;1;1;2;99
2310605;Penaforte;2311801;Russas;1;1;2;343
2311108;Porteiras;2311801;Russas;1;1;2;315
2311207;Potengi;2311801;Russas;1;1;2;330
2311264;Quiterianópolis;2311801;Russas;1;1;2;319
2311405;Quixeramobim;2311801;Russas;1;1;2;148
2306405;Itapipoca;2311702;Reriutaba;1;1;2;131
2304954;Guaiúba;2311603;Redenção;1;1;2;21
2306306;Itapagé;2311603;Redenção;1;1;2;110
2306405;Itapipoca;2311603;Redenção;1;1;2;122
2306504;Itapiúna;2311603;Redenção;1;1;2;45
2306553;Itarema;2311603;Redenção;1;1;2;193
2307700;Maranguape;2311603;Redenção;1;1;2;35
2309102;Mulungu;2311603;Redenção;1;1;2;31
2309706;Pacatuba;2311603;Redenção;1;1;2;27
2310506;Pedra Branca;2311603;Redenção;1;1;2;176
2302206;Beberibe;2311504;Quixeré;1;1;2;100
2303709;Caucaia;2311504;Quixeré;1;1;2;168
2305506;Iguatu;2311504;Quixeré;1;1;2;205
2301109;Aracati;2311405;Quixeramobim;1;1;2;184
2304103;Crateús;2311405;Quixeramobim;1;1;2;152
2305266;Ibaretama;2311405;Quixeramobim;1;1;2;73
2303303;Cariús;2311355;Quixelô;1;1;2;43
2304202;Crato;2311355;Quixelô;1;1;2;107
2305506;Iguatu;2311355;Quixelô;1;1;2;15
2307304;Juazeiro do Norte;2311355;Quixelô;1;1;2;106
2307403;Jucás;2311355;Quixelô;1;1;2;46
2310506;Pedra Branca;2311355;Quixelô;1;1;2;105
1501402;Belém;2311306;Quixadá;1;1;2;1112
2300754;Amontada;2311306;Quixadá;1;1;2;197
2301109;Aracati;2311306;Quixadá;1;1;2;151
2302107;Baturité;2311306;Quixadá;1;1;2;72
2302404;Boa Viagem;2311306;Quixadá;1;1;2;78
2302800;Canindé;2311306;Quixadá;1;1;2;73
2303501;Cascavel;2311306;Quixadá;1;1;2;128
2303709;Caucaia;2311306;Quixadá;1;1;2;142
2304103;Crateús;2311306;Quixadá;1;1;2;180
2305332;Ibicuitinga;2311306;Quixadá;1;1;2;46
2306405;Itapipoca;2311306;Quixadá;1;1;2;171
2306504;Itapiúna;2311306;Quixadá;1;1;2;46
2307304;Juazeiro do Norte;2311306;Quixadá;1;1;2;253
2307650;Maracanaú;2311306;Quixadá;1;1;2;129
2308708;Morada Nova;2311306;Quixadá;1;1;2;77
2309458;Ocara;2311306;Quixadá;1;1;2;72
2309607;Pacajus;2311306;Quixadá;1;1;2;108
2310506;Pedra Branca;2311306;Quixadá;1;1;2;92
2300408;Aiuaba;2311264;Quiterianópolis;1;1;2;103
2304202;Crato;2311264;Quiterianópolis;1;1;2;208
2305506;Iguatu;2311264;Quiterianópolis;1;1;2;162
2310308;Parambu;2311264;Quiterianópolis;1;1;2;40
2301307;Araripe;2311207;Potengi;1;1;2;18
2301604;Assaré;2311207;Potengi;1;1;2;31
2302701;Campos Sales;2311207;Potengi;1;1;2;37
2304202;Crato;2311207;Potengi;1;1;2;69
2307304;Juazeiro do Norte;2311207;Potengi;1;1;2;80
2309201;Nova Olinda;2311207;Potengi;1;1;2;38
2304400;Fortaleza;2311108;Porteiras;1;1;2;422
2308302;Milagres;2311108;Porteiras;1;1;2;31
2305902;Ipueiras;2311009;Poranga;1;1;2;34
2309300;Nova Russas;2311009;Poranga;1;1;2;42
2304269;Deputado Irapuan Pinheiro;2310902;Piquet Carneiro;1;1;2;24
2301109;Aracati;2310852;Pindoretama;1;1;2;86
2302057;Barroquinha;2310852;Pindoretama;1;1;2;333
2302206;Beberibe;2310852;Pindoretama;1;1;2;26
2304285;Eusébio;2310852;Pindoretama;1;1;2;22
2303709;Caucaia;2310803;Pereiro;1;1;2;257
2309508;Orós;2310803;Pereiro;1;1;2;55
2302800;Canindé;2310704;Pentecoste;1;1;2;62
2304236;Croatá;2310704;Pentecoste;1;1;2;194
2306306;Itapagé;2310704;Pentecoste;1;1;2;37
2306405;Itapipoca;2310704;Pentecoste;1;1;2;47
2310209;Paracuru;2310704;Pentecoste;1;1;2;51
2310258;Paraipaba;2310704;Pentecoste;1;1;2;41
2304400;Fortaleza;2310605;Penaforte;1;1;2;453
2307304;Juazeiro do Norte;2310605;Penaforte;1;1;2;72
2308104;Mauriti;2310605;Penaforte;1;1;2;60
2300309;Acopiara;2310506;Pedra Branca;1;1;2;75
2301000;Aquiraz;2310506;Pedra Branca;1;1;2;226
2303600;Catarina;2310506;Pedra Branca;1;1;2;77
2304103;Crateús;2310506;Pedra Branca;1;1;2;109
2305506;Iguatu;2310506;Pedra Branca;1;1;2;108
2305605;Independência;2310506;Pedra Branca;1;1;2;70
2309607;Pacajus;2310506;Pedra Branca;1;1;2;198
2304608;General Sampaio;2310407;Paramoti;1;1;2;23
2300408;Aiuaba;2310308;Parambu;1;1;2;75
2304202;Crato;2310308;Parambu;1;1;2;180
2305605;Independência;2310308;Parambu;1;1;2;97
2303709;Caucaia;2310258;Paraipaba;1;1;2;61
2306405;Itapipoca;2310258;Paraipaba;1;1;2;49
2306900;Jaguaribe;2310258;Paraipaba;1;1;2;279
2307650;Maracanaú;2310258;Paraipaba;1;1;2;73
2307700;Maranguape;2310258;Paraipaba;1;1;2;72
2305506;Iguatu;2310209;Paracuru;1;1;2;326
2307700;Maranguape;2310209;Paracuru;1;1;2;62
2309805;Pacoti;2310100;Palmácia;1;1;2;12
2301000;Aquiraz;2310001;Palhano;1;1;2;105
2305233;Horizonte;2310001;Palhano;1;1;2;93
2305332;Ibicuitinga;2310001;Palhano;1;1;2;80
2305506;Iguatu;2310001;Palhano;1;1;2;234
2307007;Jaguaruana;2310001;Palhano;1;1;2;22
2304657;Graça;2309904;Pacujá;1;1;2;9
2302305;Bela Cruz;2309805;Pacoti;1;1;2;191
1302603;Manaus;2309706;Pacatuba;1;1;2;2378
1500800;Ananindeua;2309706;Pacatuba;1;1;2;1120
1504422;Marituba;2309706;Pacatuba;1;1;2;1117
2207702;Parnaíba;2309706;Pacatuba;1;1;2;372
2301000;Aquiraz;2309706;Pacatuba;1;1;2;27
2303006;Caridade;2309706;Pacatuba;1;1;2;69
2305233;Horizonte;2309706;Pacatuba;1;1;2;19
2306256;Itaitinga;2309706;Pacatuba;1;1;2;10
2301950;Barreira;2309607;Pacajus;1;1;2;24
2302602;Camocim;2309607;Pacajus;1;1;2;302
2305506;Iguatu;2309607;Pacajus;1;1;2;259
2307007;Jaguaruana;2309607;Pacajus;1;1;2;105
2307304;Juazeiro do Norte;2309607;Pacajus;1;1;2;351
2302701;Campos Sales;2309508;Orós;1;1;2;184
2303808;Cedro;2309508;Orós;1;1;2;41
2304202;Crato;2309508;Orós;1;1;2;118
2305407;Icó;2309508;Orós;1;1;2;17
2306801;Jaguaribara;2309508;Orós;1;1;2;74
2301208;Aracoiaba;2309458;Ocara;1;1;2;27
2301851;Banabuiú;2309458;Ocara;1;1;2;98
2301950;Barreira;2309458;Ocara;1;1;2;23
2304400;Fortaleza;2309409;Novo Oriente;1;1;2;314
2305506;Iguatu;2309409;Novo Oriente;1;1;2;183
2305605;Independência;2309409;Novo Oriente;1;1;2;49
2305803;Ipu;2309409;Novo Oriente;1;1;2;135
2306256;Itaitinga;2309409;Novo Oriente;1;1;2;302
2211001;Teresina;2309300;Nova Russas;1;1;2;253
2301257;Ararendá;2309300;Nova Russas;1;1;2;32
2302404;Boa Viagem;2309300;Nova Russas;1;1;2;107
2305506;Iguatu;2309300;Nova Russas;1;1;2;226
2305902;Ipueiras;2309300;Nova Russas;1;1;2;31
2301307;Araripe;2309201;Nova Olinda;1;1;2;53
2304400;Fortaleza;2309201;Nova Olinda;1;1;2;389
2307650;Maracanaú;2309201;Nova Olinda;1;1;2;375
2305100;Guaramiranga;2309102;Mulungu;1;1;2;8
2306504;Itapiúna;2309102;Mulungu;1;1;2;30
2304657;Graça;2309003;Mucambo;1;1;2;15
2305308;Ibiapina;2309003;Mucambo;1;1;2;16
2304400;Fortaleza;2308906;Morrinhos;1;1;2;186
2304004;Coreaú;2308807;Moraújo;1;1;2;8
2301109;Aracati;2308708;Morada Nova;1;1;2;94
2305704;Ipaumirim;2308708;Morada Nova;1;1;2;187
2306900;Jaguaribe;2308708;Morada Nova;1;1;2;90
2307304;Juazeiro do Norte;2308708;Morada Nova;1;1;2;254
2307650;Maracanaú;2308708;Morada Nova;1;1;2;143
2307700;Maranguape;2308708;Morada Nova;1;1;2;141
2308500;Mombaça;2308708;Morada Nova;1;1;2;152
2304103;Crateús;2308609;Monsenhor Tabosa;1;1;2;79
2300309;Acopiara;2308500;Mombaça;1;1;2;45
2302800;Canindé;2308500;Mombaça;1;1;2;154
2304269;Deputado Irapuan Pinheiro;2308500;Mombaça;1;1;2;46
2211001;Teresina;2308401;Missão Velha;1;1;2;468
2301703;Aurora;2308401;Missão Velha;1;1;2;40
2302008;Barro;2308401;Missão Velha;1;1;2;41
2304202;Crato;2308401;Missão Velha;1;1;2;30
2305407;Icó;2308401;Missão Velha;1;1;2;98
2307106;Jardim;2308401;Missão Velha;1;1;2;41
2308302;Milagres;2308401;Missão Velha;1;1;2;23
2300200;Acaraú;2308377;Miraíma;1;1;2;75
2303659;Catunda;2308377;Miraíma;1;1;2;122
2306405;Itapipoca;2308377;Miraíma;1;1;2;44
2306553;Itarema;2308377;Miraíma;1;1;2;72
2300309;Acopiara;2308351;Milhã;1;1;2;55
2304400;Fortaleza;2308351;Milhã;1;1;2;223
2109908;Santa Inês;2308302;Milagres;1;1;2;812
2304202;Crato;2308302;Milagres;1;1;2;52
2307304;Juazeiro do Norte;2308302;Milagres;1;1;2;42
2307502;Lavras da Mangabeira;2308302;Milagres;1;1;2;61
2308104;Mauriti;2308302;Milagres;1;1;2;21
2301000;Aquiraz;2308203;Meruoca;1;1;2;233
2304400;Fortaleza;2308203;Meruoca;1;1;2;214
2306306;Itapagé;2308203;Meruoca;1;1;2;98
2308005;Massapê;2308203;Meruoca;1;1;2;13
2300101;Abaiara;2308104;Mauriti;1;1;2;30
2301703;Aurora;2308104;Mauriti;1;1;2;54
2305506;Iguatu;2308104;Mauriti;1;1;2;130
2204303;Fronteiras;2308005;Massapê;1;1;2;394
2300200;Acaraú;2308005;Massapê;1;1;2;74
2303709;Caucaia;2308005;Massapê;1;1;2;187
2305506;Iguatu;2308005;Massapê;1;1;2;332
2306553;Itarema;2308005;Massapê;1;1;2;82
2304400;Fortaleza;2307908;Martinópole;1;1;2;247
1501402;Belém;2307809;Marco;1;1;2;941
1501501;Benevides;2307809;Marco;1;1;2;920
2105302;Imperatriz;2307809;Marco;1;1;2;854
2306306;Itapagé;2307809;Marco;1;1;2;88
2306405;Itapipoca;2307809;Marco;1;1;2;75
2306553;Itarema;2307809;Marco;1;1;2;34
2307601;Limoeiro do Norte;2307809;Marco;1;1;2;321
1302603;Manaus;2307700;Maranguape;1;1;2;2371
1506807;Santarém;2307700;Maranguape;1;1;2;1787
1703909;Caseara;2307700;Maranguape;1;1;2;1392
2211001;Teresina;2307700;Maranguape;1;1;2;476
2300150;Acarapé;2307700;Maranguape;1;1;2;37
2301109;Aracati;2307700;Maranguape;1;1;2;129
2301950;Barreira;2307700;Maranguape;1;1;2;44
2302503;Brejo Santo;2307700;Maranguape;1;1;2;399
2302800;Canindé;2307700;Maranguape;1;1;2;87
2303501;Cascavel;2307700;Maranguape;1;1;2;56
2304103;Crateús;2307700;Maranguape;1;1;2;261
2304202;Crato;2307700;Maranguape;1;1;2;376
2306009;Iracema;2307700;Maranguape;1;1;2;217
2306405;Itapipoca;2307700;Maranguape;1;1;2;108
2306900;Jaguaribe;2307700;Maranguape;1;1;2;223
2307007;Jaguaruana;2307700;Maranguape;1;1;2;145
2307601;Limoeiro do Norte;2307700;Maranguape;1;1;2;154
1302603;Manaus;2307650;Maracanaú;1;1;2;2376
1500800;Ananindeua;2307650;Maracanaú;1;1;2;1114
2105302;Imperatriz;2307650;Maracanaú;1;1;2;995
2112209;Timon;2307650;Maracanaú;1;1;2;489
2202307;Canto do Buriti;2307650;Maracanaú;1;1;2;668
2301000;Aquiraz;2307650;Maracanaú;1;1;2;28
2301109;Aracati;2307650;Maracanaú;1;1;2;126
2304202;Crato;2307650;Maracanaú;1;1;2;381
2304509;Frecheirinha;2307650;Maracanaú;1;1;2;242
2304954;Guaiúba;2307650;Maracanaú;1;1;2;20
2306009;Iracema;2307650;Maracanaú;1;1;2;219
2304400;Fortaleza;2307635;Madalena;1;1;2;167
2305506;Iguatu;2307635;Madalena;1;1;2;167
2306603;Itatira;2307635;Madalena;1;1;2;30
2304285;Eusébio;2307601;Limoeiro do Norte;1;1;2;145
2305001;Guaraciaba do Norte;2307601;Limoeiro do Norte;1;1;2;314
2305407;Icó;2307601;Limoeiro do Norte;1;1;2;165
2306702;Jaguaretama;2307601;Limoeiro do Norte;1;1;2;92
2307007;Jaguaruana;2307601;Limoeiro do Norte;1;1;2;48
2304400;Fortaleza;2307403;Jucás;1;1;2;323
2305506;Iguatu;2307403;Jucás;1;1;2;30
2305704;Ipaumirim;2307403;Jucás;1;1;2;99
2306900;Jaguaribe;2307403;Jucás;1;1;2;123
1500800;Ananindeua;2307304;Juazeiro do Norte;1;1;2;1188
1502400;Castanhal;2307304;Juazeiro do Norte;1;1;2;1150
1508100;Tucuruí;2307304;Juazeiro do Norte;1;1;2;1210
2105302;Imperatriz;2307304;Juazeiro do Norte;1;1;2;916
2111300;São Luís;2307304;Juazeiro do Norte;1;1;2;750
2112209;Timon;2307304;Juazeiro do Norte;1;1;2;454
2204303;Fronteiras;2307304;Juazeiro do Norte;1;1;2;144
2207702;Parnaíba;2307304;Juazeiro do Norte;1;1;2;553
2300101;Abaiara;2307304;Juazeiro do Norte;1;1;2;33
2301703;Aurora;2307304;Juazeiro do Norte;1;1;2;50
2302404;Boa Viagem;2307304;Juazeiro do Norte;1;1;2;229
2302800;Canindé;2307304;Juazeiro do Norte;1;1;2;318
2303501;Cascavel;2307304;Juazeiro do Norte;1;1;2;362
2304103;Crateús;2307304;Juazeiro do Norte;1;1;2;271
2304269;Deputado Irapuan Pinheiro;2307304;Juazeiro do Norte;1;1;2;145
2304301;Farias Brito;2307304;Juazeiro do Norte;1;1;2;43
2304509;Frecheirinha;2307304;Juazeiro do Norte;1;1;2;417
2305001;Guaraciaba do Norte;2307304;Juazeiro do Norte;1;1;2;373
2300754;Amontada;2307254;Jijoca de Jericoacoara;1;1;2;97
2304004;Coreaú;2307254;Jijoca de Jericoacoara;1;1;2;81
2306306;Itapagé;2307254;Jijoca de Jericoacoara;1;1;2;141
2302503;Brejo Santo;2307205;Jati;1;1;2;22
2304400;Fortaleza;2307205;Jati;1;1;2;437
2301000;Aquiraz;2307106;Jardim;1;1;2;419
2303808;Cedro;2307106;Jardim;1;1;2;111
2304202;Crato;2307106;Jardim;1;1;2;43
2204501;Guadalupe;2307007;Jaguaruana;1;1;2;676
2206209;Miguel Alves;2307007;Jaguaruana;1;1;2;569
2300200;Acaraú;2307007;Jaguaruana;1;1;2;333
2300705;Alto Santo;2307007;Jaguaruana;1;1;2;93
2301109;Aracati;2307007;Jaguaruana;1;1;2;30
2302206;Beberibe;2307007;Jaguaruana;1;1;2;82
2303709;Caucaia;2307007;Jaguaruana;1;1;2;158
2305357;Icapuí;2307007;Jaguaruana;1;1;2;47
2305506;Iguatu;2307007;Jaguaruana;1;1;2;240
2306207;Itaiçaba;2307007;Jaguaruana;1;1;2;18
2306405;Itapipoca;2307007;Jaguaruana;1;1;2;248
2305407;Icó;2306900;Jaguaribe;1;1;2;62
2306009;Iracema;2306900;Jaguaribe;1;1;2;37
2306702;Jaguaretama;2306900;Jaguaribe;1;1;2;31
2302008;Barro;2306801;Jaguaribara;1;1;2;169
2304400;Fortaleza;2306801;Jaguaribara;1;1;2;209
2306702;Jaguaretama;2306801;Jaguaribara;1;1;2;14
2302404;Boa Viagem;2306603;Itatira;1;1;2;68
2205706;Luís Correia;2306553;Itarema;1;1;2;195
2303709;Caucaia;2306553;Itarema;1;1;2;164
2304004;Coreaú;2306553;Itarema;1;1;2;107
2304251;Cruz;2306553;Itarema;1;1;2;29
2305506;Iguatu;2306553;Itarema;1;1;2;385
2302107;Baturité;2306504;Itapiúna;1;1;2;26
2304400;Fortaleza;2306504;Itapiúna;1;1;2;98
1302603;Manaus;2306405;Itapipoca;1;1;2;2272
2301000;Aquiraz;2306405;Itapipoca;1;1;2;140
2302206;Beberibe;2306405;Itapipoca;1;1;2;178
2302305;Bela Cruz;2306405;Itapipoca;1;1;2;83
2302602;Camocim;2306405;Itapipoca;1;1;2;158
2302800;Canindé;2306405;Itapipoca;1;1;2;98
2303709;Caucaia;2306405;Itapipoca;1;1;2;104
2304251;Cruz;2306405;Itapipoca;1;1;2;92
2305233;Horizonte;2306405;Itapipoca;1;1;2;138
2300200;Acaraú;2306306;Itapagé;1;1;2;103
2300507;Alcântaras;2306306;Itapagé;1;1;2;107
2300754;Amontada;2306306;Itapagé;1;1;2;45
2300903;Apuiarés;2306306;Itapagé;1;1;2;34
2302800;Canindé;2306306;Itapagé;1;1;2;79
2303709;Caucaia;2306306;Itapagé;1;1;2;101
2304608;General Sampaio;2306306;Itapagé;1;1;2;42
1501402;Belém;2306256;Itaitinga;1;1;2;1136
2111300;São Luís;2306256;Itaitinga;1;1;2;653
2211001;Teresina;2306256;Itaitinga;1;1;2;490
2300150;Acarapé;2306256;Itaitinga;1;1;2;35
2301000;Aquiraz;2306256;Itaitinga;1;1;2;17
2302305;Bela Cruz;2306256;Itaitinga;1;1;2;210
2303956;Chorozinho;2306256;Itaitinga;1;1;2;37
2304954;Guaiúba;2306256;Itaitinga;1;1;2;14
2305506;Iguatu;2306256;Itaitinga;1;1;2;278
2305605;Independência;2306256;Itaitinga;1;1;2;257
2301000;Aquiraz;2306207;Itaiçaba;1;1;2;106
2301000;Aquiraz;2306108;Irauçuba;1;1;2;156
2304400;Fortaleza;2306009;Iracema;1;1;2;228
2301257;Ararendá;2305902;Ipueiras;1;1;2;30
2303659;Catunda;2305902;Ipueiras;1;1;2;62
2305506;Iguatu;2305902;Ipueiras;1;1;2;257
2211001;Teresina;2305803;Ipu;1;1;2;248
2302602;Camocim;2305803;Ipu;1;1;2;154
2304103;Crateús;2305803;Ipu;1;1;2;96
2305001;Guaraciaba do Norte;2305803;Ipu;1;1;2;16
2305506;Iguatu;2305803;Ipu;1;1;2;272
2302008;Barro;2305704;Ipaumirim;1;1;2;43
2303808;Cedro;2305704;Ipaumirim;1;1;2;43
2304202;Crato;2305704;Ipaumirim;1;1;2;90
2304103;Crateús;2305654;Ipaporanga;1;1;2;32
2304103;Crateús;2305605;Independência;1;1;2;43
2304350;Forquilha;2305605;Independência;1;1;2;177
2300200;Acaraú;2305506;Iguatu;1;1;2;390
2300408;Aiuaba;2305506;Iguatu;1;1;2;91
2300804;Antonina do Norte;2305506;Iguatu;1;1;2;87
2301000;Aquiraz;2305506;Iguatu;1;1;2;290
2302107;Baturité;2305506;Iguatu;1;1;2;229
2302602;Camocim;2305506;Iguatu;1;1;2;415
2302800;Canindé;2305506;Iguatu;1;1;2;221
2303006;Caridade;2305506;Iguatu;1;1;2;235
2303501;Cascavel;2305506;Iguatu;1;1;2;273
2304103;Crateús;2305506;Iguatu;1;1;2;196
2304301;Farias Brito;2305506;Iguatu;1;1;2;69
2304806;Granjeiro;2305506;Iguatu;1;1;2;61
2305001;Guaraciaba do Norte;2305506;Iguatu;1;1;2;288
2305308;Ibiapina;2305506;Iguatu;1;1;2;319
2300309;Acopiara;2305407;Icó;1;1;2;77
2303808;Cedro;2305407;Icó;1;1;2;31
2304202;Crato;2305407;Icó;1;1;2;107
2304285;Eusébio;2305357;Icapuí;1;1;2;152
2305266;Ibaretama;2305332;Ibicuitinga;1;1;2;23
2211001;Teresina;2305308;Ibiapina;1;1;2;248
2304103;Crateús;2305308;Ibiapina;1;1;2;140
2304400;Fortaleza;2305308;Ibiapina;1;1;2;262
2305001;Guaraciaba do Norte;2305308;Ibiapina;1;1;2;31
2304285;Eusébio;2305266;Ibaretama;1;1;2;106
2304400;Fortaleza;2305266;Ibaretama;1;1;2;117
1100205;Porto Velho;2305233;Horizonte;1;1;2;2876
1302603;Manaus;2305233;Horizonte;1;1;2;2392
1504422;Marituba;2305233;Horizonte;1;1;2;1133
2302206;Beberibe;2305233;Horizonte;1;1;2;42
2303501;Cascavel;2305233;Horizonte;1;1;2;29
2303709;Caucaia;2305233;Horizonte;1;1;2;46
2304285;Eusébio;2305233;Horizonte;1;1;2;24
2305001;Guaraciaba do Norte;2305209;Hidrolândia;1;1;2;44
2301000;Aquiraz;2305100;Guaramiranga;1;1;2;72
2211001;Teresina;2305001;Guaraciaba do Norte;1;1;2;249
2303402;Carnaubal;2305001;Guaraciaba do Norte;1;1;2;22
2304103;Crateús;2305001;Guaraciaba do Norte;1;1;2;111
2304707;Granja;2305001;Guaraciaba do Norte;1;1;2;114
2301950;Barreira;2304954;Guaiúba;1;1;2;27
2303105;Cariré;2304905;Groaíras;1;1;2;11
2304350;Forquilha;2304905;Groaíras;1;1;2;19
2304202;Crato;2304806;Granjeiro;1;1;2;42
2300200;Acaraú;2304707;Granja;1;1;2;87
2300754;Amontada;2304707;Granja;1;1;2;115
2302057;Barroquinha;2304707;Granja;1;1;2;35
2304509;Frecheirinha;2304657;Graça;1;1;2;32
1600303;Macapá;2304509;Frecheirinha;1;1;2;1216
2304350;Forquilha;2304509;Frecheirinha;1;1;2;62
1501402;Belém;2304459;Fortim;1;1;2;1227
2303501;Cascavel;2304459;Fortim;1;1;2;60
1100023;Ariquemes;2304400;Fortaleza;1;1;2;2815
1100049;Cacoal;2304400;Fortaleza;1;1;2;2701
1100304;Vilhena;2304400;Fortaleza;1;1;2;2623
1300201;Atalaia do Norte;2304400;Fortaleza;1;1;2;3520
1300409;Barcelos;2304400;Fortaleza;1;1;2;2725
1300607;Benjamin Constant;2304400;Fortaleza;1;1;2;3502
1300805;Borba;2304400;Fortaleza;1;1;2;2340
1301308;Codajás;2304400;Fortaleza;1;1;2;2610
1301407;Eirunepé;2304400;Fortaleza;1;1;2;3504
1301852;Iranduba;2304400;Fortaleza;1;1;2;2404
1301902;Itacoatiara;2304400;Fortaleza;1;1;2;2209
1302702;Manicoré;2304400;Fortaleza;1;1;2;2536
1302900;Maués;2304400;Fortaleza;1;1;2;2123
1303007;Nhamundá;2304400;Fortaleza;1;1;2;2030
1303205;Novo Airão;2304400;Fortaleza;1;1;2;2490
1303403;Parintins;2304400;Fortaleza;1;1;2;2024
1303601;Santa Isabel do Rio Negro;2304400;Fortaleza;1;1;2;2959
1303809;São Gabriel da Cachoeira;2304400;Fortaleza;1;1;2;3189
1304062;Tabatinga;2304400;Fortaleza;1;1;2;3483
1304302;Urucará;2304400;Fortaleza;1;1;2;2138
1500602;Altamira;2304400;Fortaleza;1;1;2;1523
1501501;Benevides;2304400;Fortaleza;1;1;2;1109
1502202;Capanema;2304400;Fortaleza;1;1;2;997
1503606;Itaituba;2304400;Fortaleza;1;1;2;1941
1503804;Jacundá;2304400;Fortaleza;1;1;2;1180
1505304;Oriximiná;2304400;Fortaleza;1;1;2;1930
1506138;Redenção;2304400;Fortaleza;1;1;2;1361
1508407;Xinguara;2304400;Fortaleza;1;1;2;1321
2100055;Açailândia;2304400;Fortaleza;1;1;2;1001
2100477;Alto Alegre do Pindaré;2304400;Fortaleza;1;1;2;818
2101608;Barra do Corda;2304400;Fortaleza;1;1;2;768
2102101;Brejo;2304400;Fortaleza;1;1;2;468
2102325;Buriticupu;2304400;Fortaleza;1;1;2;876
2102556;Campestre do Maranhão;2304400;Fortaleza;1;1;2;1017
2102804;Carolina;2304400;Fortaleza;1;1;2;1067
2103208;Chapadinha;2304400;Fortaleza;1;1;2;537
2103406;Coelho Neto;2304400;Fortaleza;1;1;2;505
2103901;Duque Bacelar;2304400;Fortaleza;1;1;2;491
2104305;Godofredo Viana;2304400;Fortaleza;1;1;2;845
2104800;Grajaú;2304400;Fortaleza;1;1;2;875
2105401;Itapecuru Mirim;2304400;Fortaleza;1;1;2;642
2105427;Itinga do Maranhão;2304400;Fortaleza;1;1;2;998
2105708;Lago da Pedra;2304400;Fortaleza;1;1;2;741
2105963;Lagoa Grande do Maranhão;2304400;Fortaleza;1;1;2;764
2106326;Maracaçumé;2304400;Fortaleza;1;1;2;845
2106904;Monção;2304400;Fortaleza;1;1;2;744
2107357;Nova Olinda do Maranhão;2304400;Fortaleza;1;1;2;801
2108207;Pedreiras;2304400;Fortaleza;1;1;2;676
2108454;Peritoró;2304400;Fortaleza;1;1;2;648
2109007;Porto Franco;2304400;Fortaleza;1;1;2;1023
2110005;Santa Luzia;2304400;Fortaleza;1;1;2;797
2110039;Santa Luzia do Paruá;2304400;Fortaleza;1;1;2;813
2110104;Santa Quitéria do Maranhão;2304400;Fortaleza;1;1;2;450
2110302;Santo Antônio dos Lopes;2304400;Fortaleza;1;1;2;659
2110500;São Bento;2304400;Fortaleza;1;1;2;707
2111029;São João do Carú;2304400;Fortaleza;1;1;2;858
2111508;São Mateus do Maranhão;2304400;Fortaleza;1;1;2;660
2111706;São Vicente Ferrer;2304400;Fortaleza;1;1;2;710
2111748;Senador Alexandre Costa;2304400;Fortaleza;1;1;2;635
2112803;Viana;2304400;Fortaleza;1;1;2;731
2200202;Água Branca;2304400;Fortaleza;1;1;2;513
2201903;Bom Jesus;2304400;Fortaleza;1;1;2;876
2202901;Corrente;2304400;Fortaleza;1;1;2;1045
2203701;Esperantina;2304400;Fortaleza;1;1;2;411
2205581;Lagoa do Piauí;2304400;Fortaleza;1;1;2;492
2207009;Oeiras;2304400;Fortaleza;1;1;2;537
2207801;Paulistana;2304400;Fortaleza;1;1;2;569
2207900;Pedro II;2304400;Fortaleza;1;1;2;332
2208205;Pio IX;2304400;Fortaleza;1;1;2;410
2210003;São João do Piauí;2304400;Fortaleza;1;1;2;658
2211209;Uruçuí;2304400;Fortaleza;1;1;2;771
2211308;Valença do Piauí;2304400;Fortaleza;1;1;2;465
2300606;Altaneira;2304400;Fortaleza;1;1;2;382
2300754;Amontada;2304400;Fortaleza;1;1;2;150
2300804;Antonina do Norte;2304400;Fortaleza;1;1;2;370
2301208;Aracoiaba;2304400;Fortaleza;1;1;2;73
2301703;Aurora;2304400;Fortaleza;1;1;2;353
2302008;Barro;2304400;Fortaleza;1;1;2;378
2303303;Cariús;2304400;Fortaleza;1;1;2;324
2303659;Catunda;2304400;Fortaleza;1;1;2;209
2304251;Cruz;2304400;Fortaleza;1;1;2;204
2304269;Deputado Irapuan Pinheiro;2304400;Fortaleza;1;1;2;251
2304301;Farias Brito;2304400;Fortaleza;1;1;2;368
2300606;Altaneira;2304301;Farias Brito;1;1;2;21
2302701;Campos Sales;2304301;Farias Brito;1;1;2;89
2304202;Crato;2304301;Farias Brito;1;1;2;36
1200401;Rio Branco;2304285;Eusébio;1;1;2;3349
1501501;Benevides;2304285;Eusébio;1;1;2;1122
1503200;Igarapé-Açu;2304285;Eusébio;1;1;2;1060
1506500;Santa Isabel do Pará;2304285;Eusébio;1;1;2;1114
2109908;Santa Inês;2304285;Eusébio;1;1;2;776
2208403;Piripiri;2304285;Eusébio;1;1;2;372
2300200;Acaraú;2304285;Eusébio;1;1;2;212
2301901;Barbalha;2304285;Eusébio;1;1;2;391
2302107;Baturité;2304285;Eusébio;1;1;2;68
2303501;Cascavel;2304285;Eusébio;1;1;2;36
2303709;Caucaia;2304285;Eusébio;1;1;2;31
2303956;Chorozinho;2304285;Eusébio;1;1;2;46
2304202;Crato;2304285;Eusébio;1;1;2;383
2205706;Luís Correia;2304251;Cruz;1;1;2;166
2300309;Acopiara;2304251;Cruz;1;1;2;359
2304004;Coreaú;2304251;Cruz;1;1;2;87
2303659;Catunda;2304236;Croatá;1;1;2;83
2111300;São Luís;2304202;Crato;1;1;2;741
2112209;Timon;2304202;Crato;1;1;2;444
2203909;Floriano;2304202;Crato;1;1;2;401
2300309;Acopiara;2304202;Crato;1;1;2;125
2300408;Aiuaba;2304202;Crato;1;1;2;106
2300606;Altaneira;2304202;Crato;1;1;2;43
2301505;Arneiroz;2304202;Crato;1;1;2;130
2302701;Campos Sales;2304202;Crato;1;1;2;106
2303204;Caririaçu;2304202;Crato;1;1;2;23
2303303;Cariús;2304202;Crato;1;1;2;75
2303709;Caucaia;2304202;Crato;1;1;2;394
2303808;Cedro;2304202;Crato;1;1;2;77
2208007;Picos;2304103;Crateús;1;1;2;230
2208403;Piripiri;2304103;Crateús;1;1;2;159
2211001;Teresina;2304103;Crateús;1;1;2;237
2302107;Baturité;2304103;Crateús;1;1;2;218
2303501;Cascavel;2304103;Crateús;1;1;2;292
2304004;Coreaú;2304103;Crateús;1;1;2;181
2300754;Amontada;2304004;Coreaú;1;1;2;94
2302305;Bela Cruz;2304004;Coreaú;1;1;2;74
2204501;Guadalupe;2303956;Chorozinho;1;1;2;625
2302107;Baturité;2303956;Chorozinho;1;1;2;43
2207702;Parnaíba;2303907;Chaval;1;1;2;63
1507474;São João de Pirabas;2303709;Caucaia;1;1;2;998
2208403;Piripiri;2303709;Caucaia;1;1;2;351
2300754;Amontada;2303709;Caucaia;1;1;2;134
2301109;Aracati;2303709;Caucaia;1;1;2;139
2302107;Baturité;2303709;Caucaia;1;1;2;71
2302206;Beberibe;2303709;Caucaia;1;1;2;79
2301000;Aquiraz;2303501;Cascavel;1;1;2;31
2301950;Barreira;2303501;Cascavel;1;1;2;48
2302800;Canindé;2303501;Cascavel;1;1;2;122
2204808;Ipiranga do Piauí;2303303;Cariús;1;1;2;254
2300309;Acopiara;2303303;Cariús;1;1;2;50
2301703;Aurora;2303204;Caririaçu;1;1;2;37
2302800;Canindé;2303006;Caridade;1;1;2;19
2302107;Baturité;2302909;Capistrano;1;1;2;14
2204501;Guadalupe;2302800;Canindé;1;1;2;542
2302107;Baturité;2302800;Canindé;1;1;2;48
2103307;Codó;2302701;Campos Sales;1;1;2;488
2211001;Teresina;2302701;Campos Sales;1;1;2;347
2301307;Araripe;2302701;Campos Sales;1;1;2;25
2301604;Assaré;2302701;Campos Sales;1;1;2;59
2301901;Barbalha;2302701;Campos Sales;1;1;2;119
1501402;Belém;2302602;Camocim;1;1;2;856
2112209;Timon;2302602;Camocim;1;1;2;328
2211001;Teresina;2302602;Camocim;1;1;2;320
2300200;Acaraú;2302602;Camocim;1;1;2;88
1504208;Marabá;2302503;Brejo Santo;1;1;2;1136
2301901;Barbalha;2302503;Brejo Santo;1;1;2;38
2301851;Banabuiú;2302404;Boa Viagem;1;1;2;87
2300200;Acaraú;2302305;Bela Cruz;1;1;2;20
2301000;Aquiraz;2302305;Bela Cruz;1;1;2;221
2204352;Geminiano;2302206;Beberibe;1;1;2;488
2301000;Aquiraz;2302206;Beberibe;1;1;2;42
2301109;Aracati;2302107;Baturité;1;1;2;129
2301950;Barreira;2302107;Baturité;1;1;2;27
2205706;Luís Correia;2302057;Barroquinha;1;1;2;60
2301901;Barbalha;2302008;Barro;1;1;2;61
2301000;Aquiraz;2301950;Barreira;1;1;2;51
1500800;Ananindeua;2301901;Barbalha;1;1;2;1194
2112209;Timon;2301901;Barbalha;1;1;2;460
2208007;Picos;2301901;Barbalha;1;1;2;240
2300408;Aiuaba;2301604;Assaré;1;1;2;43
2300804;Antonina do Norte;2301604;Assaré;1;1;2;16
1501709;Bragança;2301109;Aracati;1;1;2;1073
1503093;Goianésia do Pará;2301109;Aracati;1;1;2;1260
2300200;Acaraú;2301109;Aracati;1;1;2;319
2301000;Aquiraz;2301109;Aracati;1;1;2;103
1302603;Manaus;2301000;Aquiraz;1;1;2;2404
1400100;Boa Vista;2301000;Aquiraz;1;1;2;2581
2106904;Monção;2301000;Aquiraz;1;1;2;761
2111300;São Luís;2301000;Aquiraz;1;1;2;666
2300754;Amontada;2301000;Aquiraz;1;1;2;171
2300309;Acopiara;2300804;Antonina do Norte;1;1;2;95
2300200;Acaraú;2300754;Amontada;1;1;2;58
2201903;Bom Jesus;2300408;Aiuaba;1;1;2;546
2102325;Buriticupu;2300309;Acopiara;1;1;2;790
2210706;Simões;2300309;Acopiara;1;1;2;223
1501402;Belém;2300200;Acaraú;1;1;2;942
2111300;São Luís;2300200;Acaraú;1;1;2;462
2112506;Tutóia;2300200;Acaraú;1;1;2;246
2204907;Isaías Coelho;2211506;Vera Mendes;1;1;2;26
2205003;Itainópolis;2211506;Vera Mendes;1;1;2;18
2210979;Tanque do Piauí;2211407;Várzea Grande;1;1;2;7
2211308;Valença do Piauí;2211407;Várzea Grande;1;1;2;51
2200400;Altos;2211308;Valença do Piauí;1;1;2;165
2200905;Aroazes;2211308;Valença do Piauí;1;1;2;30
2201903;Bom Jesus;2211308;Valença do Piauí;1;1;2;411
2202208;Campo Maior;2211308;Valença do Piauí;1;1;2;176
2202604;Castelo do Piauí;2211308;Valença do Piauí;1;1;2;120
2202901;Corrente;2211308;Valença do Piauí;1;1;2;583
2203701;Esperantina;2211308;Valença do Piauí;1;1;2;282
2204709;Inhuma;2211308;Valença do Piauí;1;1;2;31
2204808;Ipiranga do Piauí;2211308;Valença do Piauí;1;1;2;48
2205599;Lagoa do Sítio;2211308;Valença do Piauí;1;1;2;28
2207801;Paulistana;2211308;Valença do Piauí;1;1;2;215
2208304;Piracuruca;2211308;Valença do Piauí;1;1;2;271
2208403;Piripiri;2211308;Valença do Piauí;1;1;2;234
2209104;Santa Cruz do Piauí;2211308;Valença do Piauí;1;1;2;90
2209500;Santo Inácio do Piauí;2211308;Valença do Piauí;1;1;2;116
2210805;Simplício Mendes;2211308;Valença do Piauí;1;1;2;163
2211100;União;2211308;Valença do Piauí;1;1;2;229
2102804;Carolina;2211209;Uruçuí;1;1;2;318
2207009;Oeiras;2211209;Uruçuí;1;1;2;268
2103000;Caxias;2211100;União;1;1;2;60
2202208;Campo Maior;2211100;União;1;1;2;77
2205508;José de Freitas;2211100;União;1;1;2;35
2205557;Lagoa Alegre;2211100;União;1;1;2;26
2208403;Piripiri;2211100;União;1;1;2;123
1100205;Porto Velho;2211001;Teresina;1;1;2;2380
1501501;Benevides;2211001;Teresina;1;1;2;731
1505502;Paragominas;2211001;Teresina;1;1;2;553
1506807;Santarém;2211001;Teresina;1;1;2;1352
1507474;São João de Pirabas;2211001;Teresina;1;1;2;680
1702109;Araguaína;2211001;Teresina;1;1;2;644
1702208;Araguatins;2211001;Teresina;1;1;2;593
1702554;Augustinópolis;2211001;Teresina;1;1;2;568
1702901;Axixá do Tocantins;2211001;Teresina;1;1;2;555
1703800;Buriti do Tocantins;2211001;Teresina;1;1;2;603
1720804;Sítio Novo do Tocantins;2211001;Teresina;1;1;2;540
1720903;Taguatinga;2211001;Teresina;1;1;2;906
1721000;Palmas;2211001;Teresina;1;1;2;852
2100055;Açailândia;2211001;Teresina;1;1;2;518
2100303;Aldeias Altas;2211001;Teresina;1;1;2;91
2100436;Alto Alegre do Maranhão;2211001;Teresina;1;1;2;207
2100501;Alto Parnaíba;2211001;Teresina;1;1;2;567
2100600;Amarante do Maranhão;2211001;Teresina;1;1;2;448
2100709;Anajatuba;2211001;Teresina;1;1;2;286
2100907;Araioses;2211001;Teresina;1;1;2;261
2100956;Arame;2211001;Teresina;1;1;2;354
2101004;Arari;2211001;Teresina;1;1;2;285
2101509;Barão de Grajaú;2211001;Teresina;1;1;2;180
2101707;Barreirinhas;2211001;Teresina;1;1;2;255
2101970;Boa Vista do Gurupi;2211001;Teresina;1;1;2;534
2102002;Bom Jardim;2211001;Teresina;1;1;2;354
2102101;Brejo;2211001;Teresina;1;1;2;156
2102309;Buriti Bravo;2211001;Teresina;1;1;2;154
2102325;Buriticupu;2211001;Teresina;1;1;2;408
2102606;Cândido Mendes;2211001;Teresina;1;1;2;517
2102705;Cantanhede;2211001;Teresina;1;1;2;238
2102804;Carolina;2211001;Teresina;1;1;2;572
2102903;Carutapera;2211001;Teresina;1;1;2;557
2103406;Coelho Neto;2211001;Teresina;1;1;2;97
2103505;Colinas;2211001;Teresina;1;1;2;194
2103604;Coroatá;2211001;Teresina;1;1;2;181
2103703;Cururupu;2211001;Teresina;1;1;2;428
2103802;Dom Pedro;2211001;Teresina;1;1;2;184
2104057;Estreito;2211001;Teresina;1;1;2;538
2104099;Formosa da Serra Negra;2211001;Teresina;1;1;2;405
2104107;Fortaleza dos Nogueiras;2211001;Teresina;1;1;2;429
2104404;Gonçalves Dias;2211001;Teresina;1;1;2;166
2104677;Governador Nunes Freire;2211001;Teresina;1;1;2;474
2105005;Humberto de Campos;2211001;Teresina;1;1;2;285
2105104;Icatu;2211001;Teresina;1;1;2;292
2105203;Igarapé Grande;2211001;Teresina;1;1;2;235
2105427;Itinga do Maranhão;2211001;Teresina;1;1;2;526
2105500;João Lisboa;2211001;Teresina;1;1;2;512
2105708;Lago da Pedra;2211001;Teresina;1;1;2;268
2106326;Maracaçumé;2211001;Teresina;1;1;2;486
2106409;Mata Roma;2211001;Teresina;1;1;2;166
2106607;Matões;2211001;Teresina;1;1;2;65
2106755;Miranda do Norte;2211001;Teresina;1;1;2;260
2106805;Mirinzal;2211001;Teresina;1;1;2;398
2107357;Nova Olinda do Maranhão;2211001;Teresina;1;1;2;406
2108009;Pastos Bons;2211001;Teresina;1;1;2;222
2108454;Peritoró;2211001;Teresina;1;1;2;188
2108504;Pindaré-Mirim;2211001;Teresina;1;1;2;324
2108702;Pio XII;2211001;Teresina;1;1;2;298
2108900;Poção de Pedras;2211001;Teresina;1;1;2;236
2109007;Porto Franco;2211001;Teresina;1;1;2;526
2109502;Riachão;2211001;Teresina;1;1;2;494
2109809;Santa Helena;2211001;Teresina;1;1;2;414
2110005;Santa Luzia;2211001;Teresina;1;1;2;345
2110039;Santa Luzia do Paruá;2211001;Teresina;1;1;2;428
2110302;Santo Antônio dos Lopes;2211001;Teresina;1;1;2;175
2110500;São Bento;2211001;Teresina;1;1;2;347
2110609;São Bernardo;2211001;Teresina;1;1;2;196
2110708;São Domingos do Maranhão;2211001;Teresina;1;1;2;185
2111003;São João Batista;2211001;Teresina;1;1;2;325
2111201;São José de Ribamar;2211001;Teresina;1;1;2;315
2111508;São Mateus do Maranhão;2211001;Teresina;1;1;2;219
2111532;São Pedro da Água Branca;2211001;Teresina;1;1;2;618
2111607;São Raimundo das Mangabeiras;2211001;Teresina;1;1;2;362
2111706;São Vicente Ferrer;2211001;Teresina;1;1;2;335
2112308;Tuntum;2211001;Teresina;1;1;2;207
2112407;Turiaçu;2211001;Teresina;1;1;2;477
2112506;Tutóia;2211001;Teresina;1;1;2;260
2112605;Urbano Santos;2211001;Teresina;1;1;2;219
2112704;Vargem Grande;2211001;Teresina;1;1;2;210
2112803;Viana;2211001;Teresina;1;1;2;332
2112852;Vila Nova dos Martírios;2211001;Teresina;1;1;2;578
2112902;Vitória do Mearim;2211001;Teresina;1;1;2;292
2113009;Vitorino Freire;2211001;Teresina;1;1;2;308
2114007;Zé Doca;2211001;Teresina;1;1;2;393
2200608;Angical do Piauí;2211001;Teresina;1;1;2;110
2200707;Anísio de Abreu;2211001;Teresina;1;1;2;456
2201002;Arraial;2211001;Teresina;1;1;2;175
2201101;Avelino Lopes;2211001;Teresina;1;1;2;573
2201150;Baixa Grande do Ribeiro;2211001;Teresina;1;1;2;407
2201408;Barro Duro;2211001;Teresina;1;1;2;86
2201960;Brasileira;2211001;Teresina;1;1;2;154
2201988;Brejo do Piauí;2211001;Teresina;1;1;2;345
2202091;Caldeirão Grande do Piauí;2211001;Teresina;1;1;2;345
2202307;Canto do Buriti;2211001;Teresina;1;1;2;328
2202505;Caracol;2211001;Teresina;1;1;2;467
2202752;Colônia do Gurguéia;2211001;Teresina;1;1;2;359
2202802;Conceição do Canindé;2211001;Teresina;1;1;2;335
2203107;Cristino Castro;2211001;Teresina;1;1;2;442
2203602;Eliseu Martins;2211001;Teresina;1;1;2;349
2204006;Francinópolis;2211001;Teresina;1;1;2;156
2204105;Francisco Ayres;2211001;Teresina;1;1;2;170
2204204;Francisco Santos;2211001;Teresina;1;1;2;280
2204402;Gilbués;2211001;Teresina;1;1;2;597
2204709;Inhuma;2211001;Teresina;1;1;2;209
2204808;Ipiranga do Piauí;2211001;Teresina;1;1;2;223
2205003;Itainópolis;2211001;Teresina;1;1;2;299
2205409;Joaquim Pires;2211001;Teresina;1;1;2;187
2205557;Lagoa Alegre;2211001;Teresina;1;1;2;66
2205953;Marcolândia;2211001;Teresina;1;1;2;349
2206605;Monte Alegre do Piauí;2211001;Teresina;1;1;2;587
2206704;Nazaré do Piauí;2211001;Teresina;1;1;2;210
2206951;Novo Santo Antônio;2211001;Teresina;1;1;2;98
2208106;Pimenteiras;2211001;Teresina;1;1;2;199
2208205;Pio IX;2211001;Teresina;1;1;2;310
2208502;Porto;2211001;Teresina;1;1;2;133
2208601;Prata do Piauí;2211001;Teresina;1;1;2;91
2208700;Redenção do Gurguéia;2211001;Teresina;1;1;2;524
2208908;Ribeiro Gonçalves;2211001;Teresina;1;1;2;386
2209104;Santa Cruz do Piauí;2211001;Teresina;1;1;2;260
2209906;São João da Serra;2211001;Teresina;1;1;2;110
2210102;São José do Peixe;2211001;Teresina;1;1;2;267
2210409;São Miguel do Tapuio;2211001;Teresina;1;1;2;168
2210656;Sigefredo Pacheco;2211001;Teresina;1;1;2;119
2210706;Simões;2211001;Teresina;1;1;2;354
2201556;Bela Vista do Piauí;2210805;Simplício Mendes;1;1;2;16
2202802;Conceição do Canindé;2210805;Simplício Mendes;1;1;2;37
2207306;Paes Landim;2210805;Simplício Mendes;1;1;2;36
2207934;Pedro Laurentino;2210805;Simplício Mendes;1;1;2;46
2209401;Santo Antônio de Lisboa;2210805;Simplício Mendes;1;1;2;123
2210607;São Raimundo Nonato;2210805;Simplício Mendes;1;1;2;152
2200277;Alegrete do Piauí;2210706;Simões;1;1;2;39
2202554;Caridade do Piauí;2210706;Simões;1;1;2;25
2205953;Marcolândia;2210706;Simões;1;1;2;21
2207207;Padre Marcos;2210706;Simões;1;1;2;28
2207801;Paulistana;2210706;Simões;1;1;2;75
2208007;Picos;2210706;Simões;1;1;2;93
2202208;Campo Maior;2210656;Sigefredo Pacheco;1;1;2;52
2203909;Floriano;2210631;Sebastião Leal;1;1;2;142
2202901;Corrente;2210623;Sebastião Barros;1;1;2;55
2203008;Cristalândia do Piauí;2210623;Sebastião Barros;1;1;2;43
2202851;Coronel José Dias;2210607;São Raimundo Nonato;1;1;2;30
2203206;Curimatá;2210607;São Raimundo Nonato;1;1;2;209
2207009;Oeiras;2210607;São Raimundo Nonato;1;1;2;228
2200103;Agricolândia;2210508;São Pedro do Piauí;1;1;2;14
2200509;Amarante;2210508;São Pedro do Piauí;1;1;2;40
2202406;Capitão de Campos;2210409;São Miguel do Tapuio;1;1;2;134
2205516;Juazeiro do Piauí;2210409;São Miguel do Tapuio;1;1;2;54
2201408;Barro Duro;2210383;São Miguel da Baixa Grande;1;1;2;37
2200277;Alegrete do Piauí;2210300;São Julião;1;1;2;18
2202133;Campo Grande do Piauí;2210300;São Julião;1;1;2;24
2204303;Fronteiras;2210300;São Julião;1;1;2;24
2207207;Padre Marcos;2210300;São Julião;1;1;2;31
2201507;Batalha;2210052;São José do Divino;1;1;2;36
2208403;Piripiri;2210052;São José do Divino;1;1;2;52
1702158;Araguanã;2210003;São João do Piauí;1;1;2;723
2201200;Barras;2210003;São João do Piauí;1;1;2;455
2201988;Brejo do Piauí;2210003;São João do Piauí;1;1;2;62
2203107;Cristino Castro;2210003;São João do Piauí;1;1;2;219
2207009;Oeiras;2210003;São João do Piauí;1;1;2;152
2207801;Paulistana;2210003;São João do Piauí;1;1;2;129
2207959;Nova Santa Rita;2210003;São João do Piauí;1;1;2;40
2208874;Ribeira do Piauí;2210003;São João do Piauí;1;1;2;88
2201507;Batalha;2209971;São João do Arraial;1;1;2;47
2205409;Joaquim Pires;2209971;São João do Arraial;1;1;2;44
2202778;Colônia do Piauí;2209955;São João da Varjota;1;1;2;45
2202604;Castelo do Piauí;2209906;São João da Serra;1;1;2;40
2208403;Piripiri;2209906;São João da Serra;1;1;2;137
2202703;Cocal;2209872;São João da Fronteira;1;1;2;62
2208403;Piripiri;2209872;São João da Fronteira;1;1;2;68
2200202;Água Branca;2209807;São Gonçalo do Piauí;1;1;2;14
2205250;Jardim do Mulato;2209807;São Gonçalo do Piauí;1;1;2;14
2202802;Conceição do Canindé;2209658;São Francisco de Assis do Piauí;1;1;2;42
2207801;Paulistana;2209658;São Francisco de Assis do Piauí;1;1;2;63
2200707;Anísio de Abreu;2209559;São Braz do Piauí;1;1;2;27
2201929;Bonfim do Piauí;2209559;São Braz do Piauí;1;1;2;27
2205532;Jurema;2209559;São Braz do Piauí;1;1;2;33
2202075;Cajazeiras do Piauí;2209377;Santa Rosa do Piauí;1;1;2;12
2207009;Oeiras;2209377;Santa Rosa do Piauí;1;1;2;27
2208007;Picos;2209351;Santana do Piauí;1;1;2;15
2203107;Cristino Castro;2209302;Santa Luz;1;1;2;17
2200905;Aroazes;2209153;Santa Cruz dos Milagres;1;1;2;40
2203602;Eliseu Martins;2209104;Santa Cruz do Piauí;1;1;2;230
2208007;Picos;2209104;Santa Cruz do Piauí;1;1;2;36
2203909;Floriano;2209005;Rio Grande do Piauí;1;1;2;109
2205102;Itaueira;2209005;Rio Grande do Piauí;1;1;2;20
2102804;Carolina;2208908;Ribeiro Gonçalves;1;1;2;242
2111300;São Luís;2208908;Ribeiro Gonçalves;1;1;2;568
2106607;Matões;2208809;Regeneração;1;1;2;101
2201002;Arraial;2208809;Regeneração;1;1;2;45
2203503;Elesbão Veloso;2208809;Regeneração;1;1;2;56
2203909;Floriano;2208809;Regeneração;1;1;2;72
2207009;Oeiras;2208809;Regeneração;1;1;2;99
2201903;Bom Jesus;2208700;Redenção do Gurguéia;1;1;2;51
2203602;Eliseu Martins;2208650;Queimada Nova;1;1;2;250
2205565;Lagoa do Barro do Piauí;2208650;Queimada Nova;1;1;2;17
2200806;Antônio Almeida;2208551;Porto Alegre do Piauí;1;1;2;28
2202174;Campo Largo do Piauí;2208502;Porto;1;1;2;13
2205508;José de Freitas;2208502;Porto;1;1;2;97
2103000;Caxias;2208403;Piripiri;1;1;2;182
2105302;Imperatriz;2208403;Piripiri;1;1;2;643
2109908;Santa Inês;2208403;Piripiri;1;1;2;409
2112209;Timon;2208403;Piripiri;1;1;2;152
2201606;Beneditinos;2208403;Piripiri;1;1;2;145
2201770;Boa Hora;2208403;Piripiri;1;1;2;37
2201960;Brasileira;2208403;Piripiri;1;1;2;16
2202059;Cabeceiras do Piauí;2208403;Piripiri;1;1;2;63
2202703;Cocal;2208403;Piripiri;1;1;2;92
2202711;Cocal de Telha;2208403;Piripiri;1;1;2;38
2202901;Corrente;2208403;Piripiri;1;1;2;779
2203305;Demerval Lobão;2208403;Piripiri;1;1;2;160
2205516;Juazeiro do Piauí;2208403;Piripiri;1;1;2;99
2205573;Lagoa de São Francisco;2208403;Piripiri;1;1;2;24
2205805;Luzilândia;2208403;Piripiri;1;1;2;107
2206209;Miguel Alves;2208403;Piripiri;1;1;2;122
2206753;Nossa Senhora de Nazaré;2208403;Piripiri;1;1;2;59
2207801;Paulistana;2208403;Piripiri;1;1;2;441
2208007;Picos;2208403;Piripiri;1;1;2;312
2112209;Timon;2208304;Piracuruca;1;1;2;182
2201507;Batalha;2208304;Piracuruca;1;1;2;41
2202604;Castelo do Piauí;2208304;Piracuruca;1;1;2;154
2201200;Barras;2208205;Pio IX;1;1;2;341
2203503;Elesbão Veloso;2208205;Pio IX;1;1;2;184
2201200;Barras;2208106;Pimenteiras;1;1;2;241
1501402;Belém;2208007;Picos;1;1;2;992
2101202;Bacabal;2208007;Picos;1;1;2;480
2101509;Barão de Grajaú;2208007;Picos;1;1;2;177
2101608;Barra do Corda;2208007;Picos;1;1;2;448
2105302;Imperatriz;2208007;Picos;1;1;2;681
2109106;Presidente Dutra;2208007;Picos;1;1;2;386
2109908;Santa Inês;2208007;Picos;1;1;2;565
2111300;São Luís;2208007;Picos;1;1;2;588
2200277;Alegrete do Piauí;2208007;Picos;1;1;2;70
2200509;Amarante;2208007;Picos;1;1;2;173
2202604;Castelo do Piauí;2208007;Picos;1;1;2;194
2204204;Francisco Santos;2208007;Picos;1;1;2;39
2204808;Ipiranga do Piauí;2208007;Picos;1;1;2;43
2205565;Lagoa do Barro do Piauí;2208007;Picos;1;1;2;154
2205953;Marcolândia;2208007;Picos;1;1;2;94
2206407;Monsenhor Gil;2208007;Picos;1;1;2;209
2207553;Paquetá;2208007;Picos;1;1;2;25
2200400;Altos;2207900;Pedro II;1;1;2;132
2203701;Esperantina;2207900;Pedro II;1;1;2;107
2205508;José de Freitas;2207900;Pedro II;1;1;2;130
2205573;Lagoa de São Francisco;2207900;Pedro II;1;1;2;18
2205805;Luzilândia;2207900;Pedro II;1;1;2;145
2206357;Milton Brandão;2207900;Pedro II;1;1;2;28
2203800;Flores do Piauí;2207850;Pavussu;1;1;2;38
2200053;Acauã;2207801;Paulistana;1;1;2;4
2200202;Água Branca;2207801;Paulistana;1;1;2;306
2202802;Conceição do Canindé;2207801;Paulistana;1;1;2;64
2205151;Jacobina do Piauí;2207801;Paulistana;1;1;2;31
2207207;Padre Marcos;2207801;Paulistana;1;1;2;97
2207777;Patos do Piauí;2207801;Paulistana;1;1;2;61
2205201;Jaicós;2207777;Patos do Piauí;1;1;2;33
1302603;Manaus;2207702;Parnaíba;1;1;2;2028
2101608;Barra do Corda;2207702;Parnaíba;1;1;2;481
2102101;Brejo;2207702;Parnaíba;1;1;2;139
2110104;Santa Quitéria do Maranhão;2207702;Parnaíba;1;1;2;112
2200400;Altos;2207702;Parnaíba;1;1;2;252
2201919;Bom Princípio do Piauí;2207702;Parnaíba;1;1;2;38
2202901;Corrente;2207702;Parnaíba;1;1;2;918
2203909;Floriano;2207702;Parnaíba;1;1;2;456
2205508;José de Freitas;2207702;Parnaíba;1;1;2;226
2202901;Corrente;2207603;Parnaguá;1;1;2;62
2203206;Curimatá;2207603;Parnaguá;1;1;2;42
2102804;Carolina;2207504;Palmeirais;1;1;2;508
2206407;Monsenhor Gil;2207504;Palmeirais;1;1;2;68
2202307;Canto do Buriti;2207355;Pajeú do Piauí;1;1;2;26
2200277;Alegrete do Piauí;2207207;Padre Marcos;1;1;2;13
2204303;Fronteiras;2207207;Padre Marcos;1;1;2;45
2101400;Balsas;2207009;Oeiras;1;1;2;438
2202307;Canto do Buriti;2207009;Oeiras;1;1;2;148
2203503;Elesbão Veloso;2207009;Oeiras;1;1;2;87
2205003;Itainópolis;2207009;Oeiras;1;1;2;88
2206704;Nazaré do Piauí;2207009;Oeiras;1;1;2;60
2200400;Altos;2206951;Novo Santo Antônio;1;1;2;64
2201176;Barra d'Alcântara;2206902;Novo Oriente do Piauí;1;1;2;21
2204709;Inhuma;2206902;Novo Oriente do Piauí;1;1;2;31
2201200;Barras;2206803;Nossa Senhora dos Remédios;1;1;2;47
2202174;Campo Largo do Piauí;2206803;Nossa Senhora dos Remédios;1;1;2;18
2106607;Matões;2206753;Nossa Senhora de Nazaré;1;1;2;150
2202208;Campo Maior;2206753;Nossa Senhora de Nazaré;1;1;2;24
2203909;Floriano;2206704;Nazaré do Piauí;1;1;2;43
2205409;Joaquim Pires;2206696;Murici dos Portelas;1;1;2;24
2201101;Avelino Lopes;2206654;Morro Cabeça no Tempo;1;1;2;46
2101509;Barão de Grajaú;2206605;Monte Alegre do Piauí;1;1;2;418
2200251;Alagoinha do Piauí;2206506;Monsenhor Hipólito;1;1;2;10
2200103;Agricolândia;2206407;Monsenhor Gil;1;1;2;27
2200202;Água Branca;2206407;Monsenhor Gil;1;1;2;36
2204600;Hugo Napoleão;2206407;Monsenhor Gil;1;1;2;47
2102804;Carolina;2206209;Miguel Alves;1;1;2;616
2103406;Coelho Neto;2206209;Miguel Alves;1;1;2;21
2200400;Altos;2206209;Miguel Alves;1;1;2;106
2202208;Campo Maior;2206209;Miguel Alves;1;1;2;105
2205508;José de Freitas;2206209;Miguel Alves;1;1;2;71
2102804;Carolina;2206100;Matias Olímpio;1;1;2;676
2201507;Batalha;2206100;Matias Olímpio;1;1;2;63
2203909;Floriano;2205904;Manoel Emídio;1;1;2;163
2102804;Carolina;2205805;Luzilândia;1;1;2;708
2203701;Esperantina;2205805;Luzilândia;1;1;2;44
2112209;Timon;2205706;Luís Correia;1;1;2;280
2202083;Cajueiro da Praia;2205706;Luís Correia;1;1;2;35
2202703;Cocal;2205706;Luís Correia;1;1;2;66
2204659;Ilha Grande;2205706;Luís Correia;1;1;2;18
2205409;Joaquim Pires;2205706;Luís Correia;1;1;2;90
2203305;Demerval Lobão;2205581;Lagoa do Piauí;1;1;2;10
2200400;Altos;2205557;Lagoa Alegre;1;1;2;62
2203701;Esperantina;2205557;Lagoa Alegre;1;1;2;82
2200707;Anísio de Abreu;2205532;Jurema;1;1;2;10
2202505;Caracol;2205532;Jurema;1;1;2;24
2202604;Castelo do Piauí;2205516;Juazeiro do Piauí;1;1;2;22
2200400;Altos;2205508;José de Freitas;1;1;2;35
2202059;Cabeceiras do Piauí;2205508;José de Freitas;1;1;2;43
2201507;Batalha;2205409;Joaquim Pires;1;1;2;59
2203701;Esperantina;2205409;Joaquim Pires;1;1;2;41
2201705;Bertolínia;2205300;Jerumenha;1;1;2;80
2202133;Campo Grande do Piauí;2205201;Jaicós;1;1;2;32
2200053;Acauã;2205151;Jacobina do Piauí;1;1;2;34
2204709;Inhuma;2204808;Ipiranga do Piauí;1;1;2;18
2200202;Água Branca;2204600;Hugo Napoleão;1;1;2;15
2201200;Barras;2204402;Gilbués;1;1;2;702
2202901;Corrente;2204402;Gilbués;1;1;2;70
1721000;Palmas;2204303;Fronteiras;1;1;2;934
2202133;Campo Grande do Piauí;2204204;Francisco Santos;1;1;2;18
2103307;Codó;2203909;Floriano;1;1;2;276
2103406;Coelho Neto;2203909;Floriano;1;1;2;282
2103505;Colinas;2203909;Floriano;1;1;2;159
2103802;Dom Pedro;2203909;Floriano;1;1;2;250
2107704;Paraibano;2203909;Floriano;1;1;2;114
2109106;Presidente Dutra;2203909;Floriano;1;1;2;232
2110708;São Domingos do Maranhão;2203909;Floriano;1;1;2;201
2111300;São Luís;2203909;Floriano;1;1;2;491
2111607;São Raimundo das Mangabeiras;2203909;Floriano;1;1;2;269
2112308;Tuntum;2203909;Floriano;1;1;2;248
2200509;Amarante;2203909;Floriano;1;1;2;63
2201200;Barras;2203909;Floriano;1;1;2;294
2201705;Bertolínia;2203909;Floriano;1;1;2;140
2202208;Campo Maior;2203909;Floriano;1;1;2;235
2202901;Corrente;2203909;Floriano;1;1;2;467
2203305;Demerval Lobão;2203909;Floriano;1;1;2;162
2201507;Batalha;2203701;Esperantina;1;1;2;24
2202059;Cabeceiras do Piauí;2203701;Esperantina;1;1;2;66
2202208;Campo Maior;2203701;Esperantina;1;1;2;107
2202604;Castelo do Piauí;2203701;Esperantina;1;1;2;176
2201903;Bom Jesus;2203602;Eliseu Martins;1;1;2;132
2202752;Colônia do Gurguéia;2203602;Eliseu Martins;1;1;2;18
2112209;Timon;2203503;Elesbão Veloso;1;1;2;143
2112209;Timon;2203305;Demerval Lobão;1;1;2;31
2202554;Caridade do Piauí;2203271;Curral Novo do Piauí;1;1;2;15
2202901;Corrente;2203206;Curimatá;1;1;2;104
2200459;Alvorada do Gurguéia;2203107;Cristino Castro;1;1;2;65
2202752;Colônia do Gurguéia;2203107;Cristino Castro;1;1;2;85
2202703;Cocal;2202901;Corrente;1;1;2;864
2201903;Bom Jesus;2202752;Colônia do Gurguéia;1;1;2;117
2200400;Altos;2202737;Coivaras;1;1;2;12
2201200;Barras;2202703;Cocal;1;1;2;119
2202000;Buriti dos Lopes;2202703;Cocal;1;1;2;42
2202406;Capitão de Campos;2202703;Cocal;1;1;2;117
2202539;Caraúbas do Piauí;2202703;Cocal;1;1;2;32
2200400;Altos;2202604;Castelo do Piauí;1;1;2;101
2201606;Beneditinos;2202604;Castelo do Piauí;1;1;2;87
2202026;Buriti dos Montes;2202604;Castelo do Piauí;1;1;2;54
2200707;Anísio de Abreu;2202505;Caracol;1;1;2;33
2202117;Campo Alegre do Fidalgo;2202455;Capitão Gervásio Oliveira;1;1;2;13
2201903;Bom Jesus;2202307;Canto do Buriti;1;1;2;193
2111300;São Luís;2202208;Campo Maior;1;1;2;341
2200301;Alto Longá;2202208;Campo Maior;1;1;2;45
2201903;Bom Jesus;2202208;Campo Maior;1;1;2;526
2201945;Boqueirão do Piauí;2202208;Campo Maior;1;1;2;42
2201960;Brasileira;2202208;Campo Maior;1;1;2;91
2202059;Cabeceiras do Piauí;2202174;Campo Largo do Piauí;1;1;2;82
2200277;Alegrete do Piauí;2202133;Campo Grande do Piauí;1;1;2;23
1505536;Parauapebas;2202117;Campo Alegre do Fidalgo;1;1;2;918
2201200;Barras;2202059;Cabeceiras do Piauí;1;1;2;25
2201051;Assunção do Piauí;2202026;Buriti dos Montes;1;1;2;62
2200202;Água Branca;2201903;Bom Jesus;1;1;2;399
2200707;Anísio de Abreu;2201903;Bom Jesus;1;1;2;148
2201200;Barras;2201903;Bom Jesus;1;1;2;579
2112209;Timon;2201606;Beneditinos;1;1;2;66
1709500;Gurupi;2201408;Barro Duro;1;1;2;979
2103000;Caxias;2201200;Barras;1;1;2;132
2200400;Altos;2201200;Barras;1;1;2;91
2200509;Amarante;2201200;Barras;1;1;2;231
2106102;Loreto;2201150;Baixa Grande do Ribeiro;1;1;2;85
2109700;Sambaíba;2201150;Baixa Grande do Ribeiro;1;1;2;80
2111300;São Luís;2201150;Baixa Grande do Ribeiro;1;1;2;598
2111607;São Raimundo das Mangabeiras;2201150;Baixa Grande do Ribeiro;1;1;2;99
2200509;Amarante;2200608;Angical do Piauí;1;1;2;22
2106607;Matões;2200509;Amarante;1;1;2;93
2107803;Parnarama;2200509;Amarante;1;1;2;74
2112209;Timon;2200251;Alagoinha do Piauí;1;1;2;297
2100055;Açailândia;2114007;Zé Doca;1;1;2;263
2100873;Araguanã;2114007;Zé Doca;1;1;2;37
2101202;Bacabal;2114007;Zé Doca;1;1;2;161
2103802;Dom Pedro;2114007;Zé Doca;1;1;2;251
2104677;Governador Nunes Freire;2114007;Zé Doca;1;1;2;124
2105302;Imperatriz;2114007;Zé Doca;1;1;2;309
2105401;Itapecuru Mirim;2114007;Zé Doca;1;1;2;170
2107357;Nova Olinda do Maranhão;2114007;Zé Doca;1;1;2;46
2108207;Pedreiras;2114007;Zé Doca;1;1;2;201
2109809;Santa Helena;2114007;Zé Doca;1;1;2;125
2102903;Carutapera;2113009;Vitorino Freire;1;1;2;322
2103802;Dom Pedro;2113009;Vitorino Freire;1;1;2;150
2108702;Pio XII;2113009;Vitorino Freire;1;1;2;33
2109106;Presidente Dutra;2113009;Vitorino Freire;1;1;2;169
2110005;Santa Luzia;2113009;Vitorino Freire;1;1;2;38
2111300;São Luís;2113009;Vitorino Freire;1;1;2;211
2100436;Alto Alegre do Maranhão;2112902;Vitória do Mearim;1;1;2;96
2101004;Arari;2112902;Vitória do Mearim;1;1;2;10
2102002;Bom Jardim;2112902;Vitória do Mearim;1;1;2;80
2103307;Codó;2112902;Vitória do Mearim;1;1;2;153
2108702;Pio XII;2112902;Vitória do Mearim;1;1;2;54
2109106;Presidente Dutra;2112902;Vitória do Mearim;1;1;2;208
2109908;Santa Inês;2112902;Vitória do Mearim;1;1;2;75
2100055;Açailândia;2112852;Vila Nova dos Martírios;1;1;2;60
2101608;Barra do Corda;2112852;Vila Nova dos Martírios;1;1;2;314
2102804;Carolina;2112852;Vila Nova dos Martírios;1;1;2;270
2101202;Bacabal;2112803;Viana;1;1;2;122
2105302;Imperatriz;2112803;Viana;1;1;2;368
2105401;Itapecuru Mirim;2112803;Viana;1;1;2;91
2108256;Pedro do Rosário;2112803;Viana;1;1;2;36
2109601;Rosário;2112803;Viana;1;1;2;96
2110500;São Bento;2112803;Viana;1;1;2;60
2111201;São José de Ribamar;2112803;Viana;1;1;2;136
2111508;São Mateus do Maranhão;2112803;Viana;1;1;2;119
2102101;Brejo;2112704;Vargem Grande;1;1;2;127
2103802;Dom Pedro;2112704;Vargem Grande;1;1;2;179
2110500;São Bento;2112704;Vargem Grande;1;1;2;139
2111300;São Luís;2112704;Vargem Grande;1;1;2;118
2101251;Bacabeira;2112605;Urbano Santos;1;1;2;105
2111300;São Luís;2112605;Urbano Santos;1;1;2;119
2100907;Araioses;2112506;Tutóia;1;1;2;42
2101707;Barreirinhas;2112506;Tutóia;1;1;2;55
2105401;Itapecuru Mirim;2112506;Tutóia;1;1;2;233
2108058;Paulino Neves;2112506;Tutóia;1;1;2;27
2111300;São Luís;2112506;Tutóia;1;1;2;217
2111607;São Raimundo das Mangabeiras;2112506;Tutóia;1;1;2;581
2108603;Pinheiro;2112456;Turilândia;1;1;2;42
2111300;São Luís;2112456;Turilândia;1;1;2;129
2100550;Amapá do Maranhão;2112407;Turiaçu;1;1;2;61
2106326;Maracaçumé;2112407;Turiaçu;1;1;2;76
2108603;Pinheiro;2112407;Turiaçu;1;1;2;99
2100501;Alto Parnaíba;2112308;Tuntum;1;1;2;449
2101608;Barra do Corda;2112308;Tuntum;1;1;2;69
2102309;Buriti Bravo;2112308;Tuntum;1;1;2;108
2105609;Joselândia;2112308;Tuntum;1;1;2;33
2107902;Passagem Franca;2112308;Tuntum;1;1;2;140
2111300;São Luís;2112308;Tuntum;1;1;2;306
2109908;Santa Inês;2112274;Tufilândia;1;1;2;17
2111300;São Luís;2112274;Tufilândia;1;1;2;198
2101202;Bacabal;2112233;Trizidela do Vale;1;1;2;39
2101608;Barra do Corda;2112233;Trizidela do Vale;1;1;2;127
2103307;Codó;2112233;Trizidela do Vale;1;1;2;77
2103604;Coroatá;2112233;Trizidela do Vale;1;1;2;68
2111201;São José de Ribamar;2112233;Trizidela do Vale;1;1;2;231
1500800;Ananindeua;2112209;Timon;1;1;2;738
1501402;Belém;2112209;Timon;1;1;2;743
1502400;Castanhal;2112209;Timon;1;1;2;702
1702109;Araguaína;2112209;Timon;1;1;2;636
2101202;Bacabal;2112209;Timon;1;1;2;232
2103208;Chapadinha;2112209;Timon;1;1;2;165
2105708;Lago da Pedra;2112209;Timon;1;1;2;263
2106326;Maracaçumé;2112209;Timon;1;1;2;484
2109106;Presidente Dutra;2112209;Timon;1;1;2;182
2110039;Santa Luzia do Paruá;2112209;Timon;1;1;2;425
2110500;São Bento;2112209;Timon;1;1;2;346
2103000;Caxias;2112100;Timbiras;1;1;2;95
2103604;Coroatá;2112100;Timbiras;1;1;2;27
2105401;Itapecuru Mirim;2112100;Timbiras;1;1;2;103
2110906;São Francisco do Maranhão;2111953;Sucupira do Riachão;1;1;2;76
2109106;Presidente Dutra;2111904;Sucupira do Norte;1;1;2;134
2105989;Lajeado Novo;2111805;Sítio Novo;1;1;2;45
2109106;Presidente Dutra;2111805;Sítio Novo;1;1;2;259
2111300;São Luís;2111805;Sítio Novo;1;1;2;465
2101301;Bacuri;2111789;Serrano do Maranhão;1;1;2;17
2100055;Açailândia;2111763;Senador La Rocque;1;1;2;57
2103752;Davinópolis;2111763;Senador La Rocque;1;1;2;20
2104552;Governador Edison Lobão;2111763;Senador La Rocque;1;1;2;35
2104602;Governador Eugênio Barros;2111748;Senador Alexandre Costa;1;1;2;22
2109106;Presidente Dutra;2111748;Senador Alexandre Costa;1;1;2;49
2107407;Olho d'Água das Cunhãs;2111722;Satubinha;1;1;2;33
2111300;São Luís;2111722;Satubinha;1;1;2;185
2105401;Itapecuru Mirim;2111706;São Vicente Ferrer;1;1;2;84
2109908;Santa Inês;2111706;São Vicente Ferrer;1;1;2;121
2104008;Esperantinópolis;2111672;São Roberto;1;1;2;34
2101301;Bacuri;2111607;São Raimundo das Mangabeiras;1;1;2;585
2101509;Barão de Grajaú;2111607;São Raimundo das Mangabeiras;1;1;2;268
2102309;Buriti Bravo;2111607;São Raimundo das Mangabeiras;1;1;2;207
2102804;Carolina;2111607;São Raimundo das Mangabeiras;1;1;2;223
2104107;Fortaleza dos Nogueiras;2111607;São Raimundo das Mangabeiras;1;1;2;81
2106102;Loreto;2111607;São Raimundo das Mangabeiras;1;1;2;35
2110302;Santo Antônio dos Lopes;2111607;São Raimundo das Mangabeiras;1;1;2;263
2110609;São Bernardo;2111607;São Raimundo das Mangabeiras;1;1;2;522
2111300;São Luís;2111607;São Raimundo das Mangabeiras;1;1;2;511
2111508;São Mateus do Maranhão;2111607;São Raimundo das Mangabeiras;1;1;2;343
1503606;Itaituba;2111532;São Pedro da Água Branca;1;1;2;851
1702109;Araguaína;2111532;São Pedro da Água Branca;1;1;2;231
1709500;Gurupi;2111532;São Pedro da Água Branca;1;1;2;734
2102556;Campestre do Maranhão;2111532;São Pedro da Água Branca;1;1;2;162
2103802;Dom Pedro;2111532;São Pedro da Água Branca;1;1;2;435
2104057;Estreito;2111532;São Pedro da Água Branca;1;1;2;193
2109007;Porto Franco;2111532;São Pedro da Água Branca;1;1;2;177
2111300;São Luís;2111532;São Pedro da Água Branca;1;1;2;539
2101251;Bacabeira;2111508;São Mateus do Maranhão;1;1;2;119
2101400;Balsas;2111508;São Mateus do Maranhão;1;1;2;422
2103000;Caxias;2111508;São Mateus do Maranhão;1;1;2;157
2103406;Coelho Neto;2111508;São Mateus do Maranhão;1;1;2;159
2103505;Colinas;2111508;São Mateus do Maranhão;1;1;2;225
2103604;Coroatá;2111508;São Mateus do Maranhão;1;1;2;39
2105302;Imperatriz;2111508;São Mateus do Maranhão;1;1;2;368
2101202;Bacabal;2111409;São Luís Gonzaga do Maranhão;1;1;2;21
2105906;Lago Verde;2111409;São Luís Gonzaga do Maranhão;1;1;2;50
1100122;Ji-Paraná;2111300;São Luís;1;1;2;2185
1500107;Abaetetuba;2111300;São Luís;1;1;2;518
1500503;Almeirim;2111300;São Luís;1;1;2;934
1501501;Benevides;2111300;São Luís;1;1;2;464
1501709;Bragança;2111300;São Luís;1;1;2;326
1502103;Cametá;2111300;São Luís;1;1;2;591
1502301;Capitão Poço;2111300;São Luís;1;1;2;326
1502939;Dom Eliseu;2111300;São Luís;1;1;2;422
1505502;Paragominas;2111300;São Luís;1;1;2;350
1506187;Rondon do Pará;2111300;São Luís;1;1;2;495
1508209;Vigia;2111300;São Luís;1;1;2;471
1600600;Santana;2111300;São Luís;1;1;2;820
2100436;Alto Alegre do Maranhão;2111300;São Luís;1;1;2;188
2100550;Amapá do Maranhão;2111300;São Luís;1;1;2;217
2100600;Amarante do Maranhão;2111300;São Luís;1;1;2;444
2100873;Araguanã;2111300;São Luís;1;1;2;166
2100907;Araioses;2111300;São Luís;1;1;2;258
2101301;Bacuri;2111300;São Luís;1;1;2;135
2101772;Bela Vista do Maranhão;2111300;São Luís;1;1;2;179
2102036;Bom Jesus das Selvas;2111300;São Luís;1;1;2;351
2102200;Buriti;2111300;São Luís;1;1;2;214
2102804;Carolina;2111300;São Luís;1;1;2;642
2102903;Carutapera;2111300;São Luís;1;1;2;246
2103257;Cidelândia;2111300;São Luís;1;1;2;491
2103703;Cururupu;2111300;São Luís;1;1;2;105
2104107;Fortaleza dos Nogueiras;2111300;São Luís;1;1;2;536
2104800;Grajaú;2111300;São Luís;1;1;2;420
2105005;Humberto de Campos;2111300;São Luís;1;1;2;86
2105153;Igarapé do Meio;2111300;São Luís;1;1;2;167
2105203;Igarapé Grande;2111300;São Luís;1;1;2;237
2105427;Itinga do Maranhão;2111300;São Luís;1;1;2;420
2105500;João Lisboa;2111300;São Luís;1;1;2;478
2106706;Mirador;2111300;São Luís;1;1;2;425
2106805;Mirinzal;2111300;São Luís;1;1;2;78
2107100;Morros;2111300;São Luís;1;1;2;43
2107357;Nova Olinda do Maranhão;2111300;São Luís;1;1;2;166
2108108;Paulo Ramos;2111300;São Luís;1;1;2;237
2109007;Porto Franco;2111300;São Luís;1;1;2;548
2109452;Raposa;2111300;São Luís;1;1;2;19
2110005;Santa Luzia;2111300;São Luís;1;1;2;229
2110609;São Bernardo;2111300;São Luís;1;1;2;222
1502400;Castanhal;2111201;São José de Ribamar;1;1;2;451
2100808;Anapurus;2111201;São José de Ribamar;1;1;2;164
2101202;Bacabal;2111201;São José de Ribamar;1;1;2;201
2103000;Caxias;2111201;São José de Ribamar;1;1;2;270
2103208;Chapadinha;2111201;São José de Ribamar;1;1;2;152
2106508;Matinha;2111201;São José de Ribamar;1;1;2;127
2109908;Santa Inês;2111201;São José de Ribamar;1;1;2;212
2101400;Balsas;2111102;São João dos Patos;1;1;2;286
2101509;Barão de Grajaú;2111102;São João dos Patos;1;1;2;77
2103307;Codó;2111102;São João dos Patos;1;1;2;222
2108603;Pinheiro;2111102;São João dos Patos;1;1;2;466
2100477;Alto Alegre do Pindaré;2111029;São João do Carú;1;1;2;42
2102002;Bom Jardim;2111029;São João do Carú;1;1;2;74
2101202;Bacabal;2111003;São João Batista;1;1;2;139
2109106;Presidente Dutra;2111003;São João Batista;1;1;2;262
2100055;Açailândia;2110856;São Francisco do Brejão;1;1;2;20
2105302;Imperatriz;2110856;São Francisco do Brejão;1;1;2;43
2102804;Carolina;2110807;São Félix de Balsas;1;1;2;290
2103307;Codó;2110708;São Domingos do Maranhão;1;1;2;132
2103802;Dom Pedro;2110708;São Domingos do Maranhão;1;1;2;61
2105401;Itapecuru Mirim;2110708;São Domingos do Maranhão;1;1;2;243
2109759;Santa Filomena do Maranhão;2110708;São Domingos do Maranhão;1;1;2;22
2110658;São Domingos do Azeitão;2110708;São Domingos do Maranhão;1;1;2;138
2108009;Pastos Bons;2110658;São Domingos do Azeitão;1;1;2;65
2109106;Presidente Dutra;2110658;São Domingos do Azeitão;1;1;2;167
2102101;Brejo;2110609;São Bernardo;1;1;2;51
2106300;Magalhães de Almeida;2110609;São Bernardo;1;1;2;24
2106672;Milagres do Maranhão;2110609;São Bernardo;1;1;2;34
2101202;Bacabal;2110500;São Bento;1;1;2;167
2103307;Codó;2110500;São Bento;1;1;2;220
2101202;Bacabal;2110401;São Benedito do Rio Preto;1;1;2;166
1501402;Belém;2110302;Santo Antônio dos Lopes;1;1;2;594
2101202;Bacabal;2110302;Santo Antônio dos Lopes;1;1;2;84
2105005;Humberto de Campos;2110278;Santo Amaro do Maranhão;1;1;2;25
2102325;Buriticupu;2110203;Santa Rita;1;1;2;274
2103307;Codó;2110203;Santa Rita;1;1;2;163
2107100;Morros;2110203;Santa Rita;1;1;2;36
2100907;Araioses;2110104;Santa Quitéria do Maranhão;1;1;2;98
2106672;Milagres do Maranhão;2110104;Santa Quitéria do Maranhão;1;1;2;10
2101202;Bacabal;2110039;Santa Luzia do Paruá;1;1;2;209
2106326;Maracaçumé;2110039;Santa Luzia do Paruá;1;1;2;68
2107357;Nova Olinda do Maranhão;2110039;Santa Luzia do Paruá;1;1;2;26
2109239;Presidente Médici;2110039;Santa Luzia do Paruá;1;1;2;27
1504208;Marabá;2110005;Santa Luzia;1;1;2;407
2100055;Açailândia;2110005;Santa Luzia;1;1;2;224
2100477;Alto Alegre do Pindaré;2110005;Santa Luzia;1;1;2;39
2102002;Bom Jardim;2110005;Santa Luzia;1;1;2;51
2103000;Caxias;2110005;Santa Luzia;1;1;2;282
2105302;Imperatriz;2110005;Santa Luzia;1;1;2;257
2105401;Itapecuru Mirim;2110005;Santa Luzia;1;1;2;168
2105708;Lago da Pedra;2110005;Santa Luzia;1;1;2;88
2108702;Pio XII;2110005;Santa Luzia;1;1;2;60
1502202;Capanema;2109908;Santa Inês;1;1;2;342
1504422;Marituba;2109908;Santa Inês;1;1;2;423
2101400;Balsas;2109908;Santa Inês;1;1;2;412
2101905;Bequimão;2109908;Santa Inês;1;1;2;170
2102036;Bom Jesus das Selvas;2109908;Santa Inês;1;1;2;161
2102325;Buriticupu;2109908;Santa Inês;1;1;2;121
2102903;Carutapera;2109908;Santa Inês;1;1;2;296
2103208;Chapadinha;2109908;Santa Inês;1;1;2;230
2104677;Governador Nunes Freire;2109908;Santa Inês;1;1;2;195
2106326;Maracaçumé;2109908;Santa Inês;1;1;2;206
2108207;Pedreiras;2109908;Santa Inês;1;1;2;125
2103703;Cururupu;2109809;Santa Helena;1;1;2;67
2109106;Presidente Dutra;2109759;Santa Filomena do Maranhão;1;1;2;23
2101251;Bacabeira;2109601;Rosário;1;1;2;9
2101905;Bequimão;2109601;Rosário;1;1;2;77
2103307;Codó;2109601;Rosário;1;1;2;177
2105005;Humberto de Campos;2109601;Rosário;1;1;2;96
2105302;Imperatriz;2109601;Rosário;1;1;2;456
2106755;Miranda do Norte;2109601;Rosário;1;1;2;81
2108207;Pedreiras;2109601;Rosário;1;1;2;185
2108801;Pirapemas;2109601;Rosário;1;1;2;90
1702554;Augustinópolis;2109551;Ribamar Fiquene;1;1;2;78
2104057;Estreito;2109551;Ribamar Fiquene;1;1;2;71
2105302;Imperatriz;2109551;Ribamar Fiquene;1;1;2;47
2109007;Porto Franco;2109551;Ribamar Fiquene;1;1;2;47
1722107;Xambioá;2109502;Riachão;1;1;2;236
2105302;Imperatriz;2109502;Riachão;1;1;2;226
2109106;Presidente Dutra;2109502;Riachão;1;1;2;327
2101202;Bacabal;2109452;Raposa;1;1;2;210
1503606;Itaituba;2109106;Presidente Dutra;1;1;2;1280
2100956;Arame;2109106;Presidente Dutra;1;1;2;171
2102705;Cantanhede;2109106;Presidente Dutra;1;1;2;185
2102804;Carolina;2109106;Presidente Dutra;1;1;2;397
2103406;Coelho Neto;2109106;Presidente Dutra;1;1;2;198
2104057;Estreito;2109106;Presidente Dutra;1;1;2;353
2104081;Fernando Falcão;2109106;Presidente Dutra;1;1;2;104
2104099;Formosa da Serra Negra;2109106;Presidente Dutra;1;1;2;226
2104107;Fortaleza dos Nogueiras;2109106;Presidente Dutra;1;1;2;262
2104206;Fortuna;2109106;Presidente Dutra;1;1;2;60
2104404;Gonçalves Dias;2109106;Presidente Dutra;1;1;2;27
2104503;Governador Archer;2109106;Presidente Dutra;1;1;2;40
2104628;Governador Luiz Rocha;2109106;Presidente Dutra;1;1;2;50
2104909;Guimarães;2109106;Presidente Dutra;1;1;2;351
2105203;Igarapé Grande;2109106;Presidente Dutra;1;1;2;89
2105302;Imperatriz;2109106;Presidente Dutra;1;1;2;327
2105401;Itapecuru Mirim;2109106;Presidente Dutra;1;1;2;212
2105500;João Lisboa;2109106;Presidente Dutra;1;1;2;323
2106102;Loreto;2109106;Presidente Dutra;1;1;2;209
2106607;Matões;2109106;Presidente Dutra;1;1;2;146
2106631;Matões do Norte;2109106;Presidente Dutra;1;1;2;185
2106706;Mirador;2109106;Presidente Dutra;1;1;2;119
2106755;Miranda do Norte;2109106;Presidente Dutra;1;1;2;192
2106805;Mirinzal;2109106;Presidente Dutra;1;1;2;357
2108603;Pinheiro;2109106;Presidente Dutra;1;1;2;317
2108801;Pirapemas;2109106;Presidente Dutra;1;1;2;177
2106805;Mirinzal;2109056;Porto Rico do Maranhão;1;1;2;29
1700301;Aguiarnópolis;2109007;Porto Franco;1;1;2;26
1702208;Araguatins;2109007;Porto Franco;1;1;2;114
1716109;Paraíso do Tocantins;2109007;Porto Franco;1;1;2;455
2100055;Açailândia;2109007;Porto Franco;1;1;2;155
2100600;Amarante do Maranhão;2109007;Porto Franco;1;1;2;104
2101400;Balsas;2109007;Porto Franco;1;1;2;192
2101608;Barra do Corda;2109007;Porto Franco;1;1;2;254
2102804;Carolina;2109007;Porto Franco;1;1;2;112
2103752;Davinópolis;2109007;Porto Franco;1;1;2;88
2103802;Dom Pedro;2109007;Porto Franco;1;1;2;352
2107704;Paraibano;2109007;Porto Franco;1;1;2;376
2101939;Bernardo do Mearim;2108900;Poção de Pedras;1;1;2;20
2104008;Esperantinópolis;2108900;Poção de Pedras;1;1;2;26
2105203;Igarapé Grande;2108900;Poção de Pedras;1;1;2;15
2105807;Lago do Junco;2108900;Poção de Pedras;1;1;2;27
2105948;Lago dos Rodrigues;2108900;Poção de Pedras;1;1;2;19
2108207;Pedreiras;2108900;Poção de Pedras;1;1;2;40
2108454;Peritoró;2108900;Poção de Pedras;1;1;2;72
2106904;Monção;2108702;Pio XII;1;1;2;43
2107407;Olho d'Água das Cunhãs;2108702;Pio XII;1;1;2;30
2101202;Bacabal;2108603;Pinheiro;1;1;2;193
2101301;Bacuri;2108603;Pinheiro;1;1;2;88
2105401;Itapecuru Mirim;2108603;Pinheiro;1;1;2;134
2106805;Mirinzal;2108603;Pinheiro;1;1;2;60
2108256;Pedro do Rosário;2108603;Pinheiro;1;1;2;58
2101251;Bacabeira;2108504;Pindaré-Mirim;1;1;2;134
2102002;Bom Jardim;2108504;Pindaré-Mirim;1;1;2;30
2105302;Imperatriz;2108504;Pindaré-Mirim;1;1;2;314
2100303;Aldeias Altas;2108454;Peritoró;1;1;2;99
2100436;Alto Alegre do Maranhão;2108454;Peritoró;1;1;2;23
2106755;Miranda do Norte;2108454;Peritoró;1;1;2;94
2108207;Pedreiras;2108454;Peritoró;1;1;2;32
2103307;Codó;2108306;Penalva;1;1;2;195
2105401;Itapecuru Mirim;2108306;Penalva;1;1;2;100
2101202;Bacabal;2108256;Pedro do Rosário;1;1;2;152
2101707;Barreirinhas;2108207;Pedreiras;1;1;2;277
2101939;Bernardo do Mearim;2108207;Pedreiras;1;1;2;22
2102325;Buriticupu;2108207;Pedreiras;1;1;2;204
2102804;Carolina;2108207;Pedreiras;1;1;2;444
2103000;Caxias;2108207;Pedreiras;1;1;2;143
2103208;Chapadinha;2108207;Pedreiras;1;1;2;162
2103505;Colinas;2108207;Pedreiras;1;1;2;170
2103604;Coroatá;2108207;Pedreiras;1;1;2;64
2104008;Esperantinópolis;2108207;Pedreiras;1;1;2;40
2104909;Guimarães;2108207;Pedreiras;1;1;2;268
2105203;Igarapé Grande;2108207;Pedreiras;1;1;2;32
2106003;Lima Campos;2108207;Pedreiras;1;1;2;12
2105708;Lago da Pedra;2108108;Paulo Ramos;1;1;2;15
2100907;Araioses;2108058;Paulino Neves;1;1;2;68
2107704;Paraibano;2108009;Pastos Bons;1;1;2;29
2107902;Passagem Franca;2108009;Pastos Bons;1;1;2;60
1508100;Tucuruí;2107902;Passagem Franca;1;1;2;710
2102309;Buriti Bravo;2107902;Passagem Franca;1;1;2;34
2103505;Colinas;2107902;Passagem Franca;1;1;2;53
2107803;Parnarama;2107902;Passagem Franca;1;1;2;89
2102804;Carolina;2107803;Parnarama;1;1;2;510
2103000;Caxias;2107803;Parnarama;1;1;2;94
2103505;Colinas;2107803;Parnarama;1;1;2;129
2103505;Colinas;2107704;Paraibano;1;1;2;49
2103802;Dom Pedro;2107704;Paraibano;1;1;2;159
2103208;Chapadinha;2107506;Paço do Lumiar;1;1;2;156
2101400;Balsas;2107258;Nova Colinas;1;1;2;48
2105989;Lajeado Novo;2107258;Nova Colinas;1;1;2;134
2101202;Bacabal;2107100;Morros;1;1;2;168
2105427;Itinga do Maranhão;2107001;Montes Altos;1;1;2;160
2105500;João Lisboa;2107001;Montes Altos;1;1;2;56
2101772;Bela Vista do Maranhão;2106904;Monção;1;1;2;33
2102002;Bom Jardim;2106904;Monção;1;1;2;41
2104909;Guimarães;2106805;Mirinzal;1;1;2;21
2103208;Chapadinha;2106755;Miranda do Norte;1;1;2;136
2103307;Codó;2106755;Miranda do Norte;1;1;2;124
2103505;Colinas;2106706;Mirador;1;1;2;37
2104800;Grajaú;2106706;Mirador;1;1;2;205
1503606;Itaituba;2106607;Matões;1;1;2;1425
2100303;Aldeias Altas;2106607;Matões;1;1;2;104
2103000;Caxias;2106508;Matinha;1;1;2;272
2100808;Anapurus;2106409;Mata Roma;1;1;2;5
2102903;Carutapera;2106326;Maracaçumé;1;1;2;91
2101400;Balsas;2106102;Loreto;1;1;2;112
2104099;Formosa da Serra Negra;2105989;Lajeado Novo;1;1;2;97
2105302;Imperatriz;2105989;Lajeado Novo;1;1;2;87
2104008;Esperantinópolis;2105963;Lagoa Grande do Maranhão;1;1;2;68
2105708;Lago da Pedra;2105963;Lagoa Grande do Maranhão;1;1;2;34
2103554;Conceição do Lago-Açu;2105906;Lago Verde;1;1;2;16
2103307;Codó;2105807;Lago do Junco;1;1;2;111
2102002;Bom Jardim;2105708;Lago da Pedra;1;1;2;123
2102309;Buriti Bravo;2105708;Lago da Pedra;1;1;2;203
2103307;Codó;2105708;Lago da Pedra;1;1;2;136
2103604;Coroatá;2105708;Lago da Pedra;1;1;2;121
2104305;Godofredo Viana;2105708;Lago da Pedra;1;1;2;356
2105302;Imperatriz;2105708;Lago da Pedra;1;1;2;274
2104677;Governador Nunes Freire;2105658;Junco do Maranhão;1;1;2;39
1506187;Rondon do Pará;2105427;Itinga do Maranhão;1;1;2;74
1508126;Ulianópolis;2105427;Itinga do Maranhão;1;1;2;78
2101202;Bacabal;2105427;Itinga do Maranhão;1;1;2;307
2101608;Barra do Corda;2105427;Itinga do Maranhão;1;1;2;279
2102325;Buriticupu;2105427;Itinga do Maranhão;1;1;2;122
2103802;Dom Pedro;2105427;Itinga do Maranhão;1;1;2;344
2104057;Estreito;2105427;Itinga do Maranhão;1;1;2;234
1501709;Bragança;2105401;Itapecuru Mirim;1;1;2;377
1502202;Capanema;2105401;Itapecuru Mirim;1;1;2;396
1502400;Castanhal;2105401;Itapecuru Mirim;1;1;2;463
2101608;Barra do Corda;2105401;Itapecuru Mirim;1;1;2;255
2101707;Barreirinhas;2105401;Itapecuru Mirim;1;1;2;180
2102002;Bom Jardim;2105401;Itapecuru Mirim;1;1;2;143
2102101;Brejo;2105401;Itapecuru Mirim;1;1;2;176
2103000;Caxias;2105401;Itapecuru Mirim;1;1;2;195
2103604;Coroatá;2105401;Itapecuru Mirim;1;1;2;86
2103802;Dom Pedro;2105401;Itapecuru Mirim;1;1;2;183
2105104;Icatu;2105401;Itapecuru Mirim;1;1;2;74
2105302;Imperatriz;2105401;Itapecuru Mirim;1;1;2;420
1500602;Altamira;2105302;Imperatriz;1;1;2;591
1501576;Bom Jesus do Tocantins;2105302;Imperatriz;1;1;2;139
1501758;Brejo Grande do Araguaia;2105302;Imperatriz;1;1;2;110
1501782;Breu Branco;2105302;Imperatriz;1;1;2;279
1503093;Goianésia do Pará;2105302;Imperatriz;1;1;2;259
1504059;Mãe do Rio;2105302;Imperatriz;1;1;2;385
1505437;Ourilândia do Norte;2105302;Imperatriz;1;1;2;428
1507151;São Domingos do Araguaia;2105302;Imperatriz;1;1;2;144
1507458;São Geraldo do Araguaia;2105302;Imperatriz;1;1;2;160
1508407;Xinguara;2105302;Imperatriz;1;1;2;327
1701002;Ananás;2105302;Imperatriz;1;1;2;118
1703057;Bandeirantes do Tocantins;2105302;Imperatriz;1;1;2;279
2100956;Arame;2105302;Imperatriz;1;1;2;176
2101251;Bacabeira;2105302;Imperatriz;1;1;2;445
2102036;Bom Jesus das Selvas;2105302;Imperatriz;1;1;2;142
2102358;Buritirana;2105302;Imperatriz;1;1;2;48
2103257;Cidelândia;2105302;Imperatriz;1;1;2;53
2103604;Coroatá;2105302;Imperatriz;1;1;2;394
2103752;Davinópolis;2105302;Imperatriz;1;1;2;5
2103802;Dom Pedro;2105302;Imperatriz;1;1;2;335
2104552;Governador Edison Lobão;2105302;Imperatriz;1;1;2;28
2101202;Bacabal;2105153;Igarapé do Meio;1;1;2;81
2100600;Amarante do Maranhão;2104800;Grajaú;1;1;2;78
2100956;Arame;2104800;Grajaú;1;1;2;104
2103257;Cidelândia;2104800;Grajaú;1;1;2;196
2103307;Codó;2104800;Grajaú;1;1;2;284
2103802;Dom Pedro;2104800;Grajaú;1;1;2;204
2104057;Estreito;2104800;Grajaú;1;1;2;164
2104602;Governador Eugênio Barros;2104701;Graça Aranha;1;1;2;14
2104404;Gonçalves Dias;2104602;Governador Eugênio Barros;1;1;2;17
2102556;Campestre do Maranhão;2104552;Governador Edison Lobão;1;1;2;47
2102606;Cândido Mendes;2104305;Godofredo Viana;1;1;2;8
2101608;Barra do Corda;2104107;Fortaleza dos Nogueiras;1;1;2;192
2104073;Feira Nova do Maranhão;2104107;Fortaleza dos Nogueiras;1;1;2;56
2101608;Barra do Corda;2104099;Formosa da Serra Negra;1;1;2;148
2100055;Açailândia;2104081;Fernando Falcão;1;1;2;314
2101608;Barra do Corda;2104081;Fernando Falcão;1;1;2;79
1100205;Porto Velho;2104057;Estreito;1;1;2;1841
1501402;Belém;2104057;Estreito;1;1;2;585
1504208;Marabá;2104057;Estreito;1;1;2;229
1706506;Darcinópolis;2104057;Estreito;1;1;2;42
1714302;Nazaré;2104057;Estreito;1;1;2;36
1720002;Santa Terezinha do Tocantins;2104057;Estreito;1;1;2;33
2101251;Bacabeira;2104057;Estreito;1;1;2;524
2101400;Balsas;2104057;Estreito;1;1;2;181
2102556;Campestre do Maranhão;2104057;Estreito;1;1;2;44
2103802;Dom Pedro;2104057;Estreito;1;1;2;367
2102804;Carolina;2103901;Duque Bacelar;1;1;2;612
2103406;Coelho Neto;2103901;Duque Bacelar;1;1;2;16
2100055;Açailândia;2103802;Dom Pedro;1;1;2;335
2100436;Alto Alegre do Maranhão;2103802;Dom Pedro;1;1;2;92
2101004;Arari;2103802;Dom Pedro;1;1;2;180
2101400;Balsas;2103802;Dom Pedro;1;1;2;325
2101707;Barreirinhas;2103802;Dom Pedro;1;1;2;310
2102309;Buriti Bravo;2103802;Dom Pedro;1;1;2;111
2102556;Campestre do Maranhão;2103802;Dom Pedro;1;1;2;346
2102903;Carutapera;2103802;Dom Pedro;1;1;2;457
2103000;Caxias;2103802;Dom Pedro;1;1;2;127
2103208;Chapadinha;2103802;Dom Pedro;1;1;2;189
2103406;Coelho Neto;2103802;Dom Pedro;1;1;2;178
2103505;Colinas;2103802;Dom Pedro;1;1;2;114
2103604;Coroatá;2103802;Dom Pedro;1;1;2;104
2101301;Bacuri;2103703;Cururupu;1;1;2;33
1501402;Belém;2103604;Coroatá;1;1;2;567
2100436;Alto Alegre do Maranhão;2103604;Coroatá;1;1;2;34
2101707;Barreirinhas;2103604;Coroatá;1;1;2;213
2103406;Coelho Neto;2103604;Coroatá;1;1;2;121
2103307;Codó;2103505;Colinas;1;1;2;178
2103307;Codó;2103406;Coelho Neto;1;1;2;101
1501402;Belém;2103307;Codó;1;1;2;605
2100477;Alto Alegre do Pindaré;2103307;Codó;1;1;2;235
2101004;Arari;2103307;Codó;1;1;2;147
2102002;Bom Jardim;2103307;Codó;1;1;2;211
2102101;Brejo;2103307;Codó;1;1;2;159
2102325;Buriticupu;2103307;Codó;1;1;2;274
1502939;Dom Eliseu;2103257;Cidelândia;1;1;2;97
1702208;Araguatins;2103257;Cidelândia;1;1;2;64
2100436;Alto Alegre do Maranhão;2103208;Chapadinha;1;1;2;131
2101202;Bacabal;2103208;Chapadinha;1;1;2;162
2101400;Balsas;2103208;Chapadinha;1;1;2;514
2101707;Barreirinhas;2103208;Chapadinha;1;1;2;121
2102200;Buriti;2103208;Chapadinha;1;1;2;55
2103158;Centro do Guilherme;2103174;Centro Novo do Maranhão;1;1;2;32
2100303;Aldeias Altas;2103000;Caxias;1;1;2;30
1508308;Viseu;2102903;Carutapera;1;1;2;17
2100055;Açailândia;2102903;Carutapera;1;1;2;443
2101202;Bacabal;2102903;Carutapera;1;1;2;360
2101608;Barra do Corda;2102903;Carutapera;1;1;2;483
1501402;Belém;2102804;Carolina;1;1;2;671
1503044;Floresta do Araguaia;2102804;Carolina;1;1;2;254
1505635;Piçarra;2102804;Carolina;1;1;2;190
1507458;São Geraldo do Araguaia;2102804;Carolina;1;1;2;171
1507508;São João do Araguaia;2102804;Carolina;1;1;2;268
1508407;Xinguara;2102804;Carolina;1;1;2;278
1701002;Ananás;2102804;Carolina;1;1;2;130
1702109;Araguaína;2102804;Carolina;1;1;2;88
1702158;Araguanã;2102804;Carolina;1;1;2;157
1703701;Brejinho de Nazaré;2102804;Carolina;1;1;2;423
1707405;Esperantina;2102804;Carolina;1;1;2;253
1709500;Gurupi;2102804;Carolina;1;1;2;514
1709807;Ipueiras;2102804;Carolina;1;1;2;444
1710904;Itapiratins;2102804;Carolina;1;1;2;136
1712009;Lajeado;2102804;Carolina;1;1;2;284
1715705;Palmeirante;2102804;Carolina;1;1;2;78
1716307;Pau d'Arco;2102804;Carolina;1;1;2;211
1716604;Peixe;2102804;Carolina;1;1;2;530
1718758;Rio Sono;2102804;Carolina;1;1;2;225
1718808;Sampaio;2102804;Carolina;1;1;2;228
1718865;Santa Fé do Araguaia;2102804;Carolina;1;1;2;144
1720200;São Miguel do Tocantins;2102804;Carolina;1;1;2;201
1720309;São Sebastião do Tocantins;2102804;Carolina;1;1;2;246
1721109;Tocantínia;2102804;Carolina;1;1;2;265
1721208;Tocantinópolis;2102804;Carolina;1;1;2;115
1721307;Tupiratins;2102804;Carolina;1;1;2;138
1722107;Xambioá;2102804;Carolina;1;1;2;160
2100501;Alto Parnaíba;2102804;Carolina;1;1;2;250
2101400;Balsas;2102804;Carolina;1;1;2;151
2101806;Benedito Leite;2102804;Carolina;1;1;2;314
2102101;Brejo;2102804;Carolina;1;1;2;656
2101202;Bacabal;2102606;Cândido Mendes;1;1;2;325
2101202;Bacabal;2102507;Cajari;1;1;2;103
2101202;Bacabal;2102408;Cajapió;1;1;2;147
2100055;Açailândia;2102309;Buriti Bravo;1;1;2;406
2101608;Barra do Corda;2102309;Buriti Bravo;1;1;2;150
2100808;Anapurus;2102200;Buriti;1;1;2;37
2101202;Bacabal;2102002;Bom Jardim;1;1;2;120
1502400;Castanhal;2101970;Boa Vista do Gurupi;1;1;2;187
1506559;Santa Luzia do Pará;2101970;Boa Vista do Gurupi;1;1;2;77
2101202;Bacabal;2101772;Bela Vista do Maranhão;1;1;2;83
2101400;Balsas;2101608;Barra do Corda;1;1;2;239
1501402;Belém;2101400;Balsas;1;1;2;726
1504208;Marabá;2101400;Balsas;1;1;2;409
1703842;Campos Lindos;2101400;Balsas;1;1;2;103
1705508;Colinas do Tocantins;2101400;Balsas;1;1;2;273
1709500;Gurupi;2101400;Balsas;1;1;2;572
1722107;Xambioá;2101400;Balsas;1;1;2;297
2100055;Açailândia;2101400;Balsas;1;1;2;321
2100832;Apicum-Açu;2101301;Bacuri;1;1;2;20
1501402;Belém;2101251;Bacabeira;1;1;2;490
1503606;Itaituba;2101251;Bacabeira;1;1;2;1307
2101202;Bacabal;2101251;Bacabeira;1;1;2;145
1500131;Abel Figueiredo;2101202;Bacabal;1;1;2;414
1500909;Augusto Corrêa;2101202;Bacabal;1;1;2;411
1501709;Bragança;2101202;Bacabal;1;1;2;415
1502202;Capanema;2101202;Bacabal;1;1;2;422
1504208;Marabá;2101202;Bacabal;1;1;2;501
1504422;Marituba;2101202;Bacabal;1;1;2;509
1506187;Rondon do Pará;2101202;Bacabal;1;1;2;375
2100436;Alto Alegre do Maranhão;2101202;Bacabal;1;1;2;33
1501956;Cachoeira do Piriá;2100550;Amapá do Maranhão;1;1;2;65
1501402;Belém;2100501;Alto Parnaíba;1;1;2;895
1716109;Paraíso do Tocantins;2100501;Alto Parnaíba;1;1;2;343
1721000;Palmas;2100501;Alto Parnaíba;1;1;2;298
1302603;Manaus;2100055;Açailândia;1;1;2;1406
1500503;Almeirim;2100055;Açailândia;1;1;2;683
1505064;Novo Repartimento;2100055;Açailândia;1;1;2;289
1506187;Rondon do Pará;2100055;Açailândia;1;1;2;69
1507953;Tailândia;2100055;Açailândia;1;1;2;273
1600535;Porto Grande;2100055;Açailândia;1;1;2;763
1702208;Araguatins;2100055;Açailândia;1;1;2;105
1706506;Darcinópolis;2100055;Açailândia;1;1;2;197
1711902;Lagoa da Confusão;2100055;Açailândia;1;1;2;689
1721000;Palmas;2100055;Açailândia;1;1;2;606
1722081;Wanderlândia;2100055;Açailândia;1;1;2;218
1502202;Capanema;1722107;Xambioá;1;1;2;588
1504208;Marabá;1722107;Xambioá;1;1;2;133
1507458;São Geraldo do Araguaia;1722107;Xambioá;1;1;2;11
1507953;Tailândia;1722107;Xambioá;1;1;2;387
1701002;Ananás;1722107;Xambioá;1;1;2;52
1702158;Araguanã;1722107;Xambioá;1;1;2;20
1702554;Augustinópolis;1722107;Xambioá;1;1;2;129
1705508;Colinas do Tocantins;1722107;Xambioá;1;1;2;181
1717206;Piraquê;1722107;Xambioá;1;1;2;46
1718865;Santa Fé do Araguaia;1722107;Xambioá;1;1;2;81
1721000;Palmas;1722107;Xambioá;1;1;2;436
1721208;Tocantinópolis;1722107;Xambioá;1;1;2;120
1702109;Araguaína;1722081;Wanderlândia;1;1;2;45
1702554;Augustinópolis;1722081;Wanderlândia;1;1;2;157
1710904;Itapiratins;1721307;Tupiratins;1;1;2;2
1709302;Guaraí;1721257;Tupirama;1;1;2;38
1716505;Pedro Afonso;1721257;Tupirama;1;1;2;5
1501402;Belém;1721208;Tocantinópolis;1;1;2;558
1504208;Marabá;1721208;Tocantinópolis;1;1;2;211
1700301;Aguiarnópolis;1721208;Tocantinópolis;1;1;2;27
1701051;Angico;1721208;Tocantinópolis;1;1;2;47
1702901;Axixá do Tocantins;1721208;Tocantinópolis;1;1;2;86
1703800;Buriti do Tocantins;1721208;Tocantinópolis;1;1;2;141
1707405;Esperantina;1721208;Tocantinópolis;1;1;2;160
1712454;Luzinópolis;1721208;Tocantinópolis;1;1;2;48
1713809;Palmeiras do Tocantins;1721208;Tocantinópolis;1;1;2;34
1714302;Nazaré;1721208;Tocantinópolis;1;1;2;24
1720101;São Bento do Tocantins;1721208;Tocantinópolis;1;1;2;81
1708254;Fortaleza do Tabocão;1721109;Tocantínia;1;1;2;58
1200401;Rio Branco;1721000;Palmas;1;1;2;2130
1501303;Barcarena;1721000;Palmas;1;1;2;979
1502707;Conceição do Araguaia;1721000;Palmas;1;1;2;254
1506138;Redenção;1721000;Palmas;1;1;2;315
1506708;Santana do Araguaia;1721000;Palmas;1;1;2;247
1508100;Tucuruí;1721000;Palmas;1;1;2;745
1600303;Macapá;1721000;Palmas;1;1;2;1191
1700350;Aliança do Tocantins;1721000;Palmas;1;1;2;122
1700400;Almas;1721000;Palmas;1;1;2;189
1701002;Ananás;1721000;Palmas;1;1;2;442
1701903;Araguacema;1721000;Palmas;1;1;2;211
1702000;Araguaçu;1721000;Palmas;1;1;2;327
1702307;Arapoema;1721000;Palmas;1;1;2;308
1702406;Arraias;1721000;Palmas;1;1;2;327
1702554;Augustinópolis;1721000;Palmas;1;1;2;546
1703008;Babaçulândia;1721000;Palmas;1;1;2;356
1703107;Barrolândia;1721000;Palmas;1;1;2;70
1703206;Bernardo Sayão;1721000;Palmas;1;1;2;281
1703800;Buriti do Tocantins;1721000;Palmas;1;1;2;558
1703842;Campos Lindos;1721000;Palmas;1;1;2;307
1703867;Cariri do Tocantins;1721000;Palmas;1;1;2;190
1705102;Chapada da Natividade;1721000;Palmas;1;1;2;155
1705557;Combinado;1721000;Palmas;1;1;2;336
1707207;Dois Irmãos do Tocantins;1721000;Palmas;1;1;2;143
1707652;Figueirópolis;1721000;Palmas;1;1;2;216
1707702;Filadélfia;1721000;Palmas;1;1;2;348
1708205;Formoso do Araguaia;1721000;Palmas;1;1;2;204
1709005;Goiatins;1721000;Palmas;1;1;2;312
1710508;Itacajá;1721000;Palmas;1;1;2;222
1711506;Jaú do Tocantins;1721000;Palmas;1;1;2;255
1712009;Lajeado;1721000;Palmas;1;1;2;67
1712504;Marianópolis do Tocantins;1721000;Palmas;1;1;2;154
1712702;Mateiros;1721000;Palmas;1;1;2;215
1714203;Natividade;1721000;Palmas;1;1;2;165
1714880;Nova Olinda;1721000;Palmas;1;1;2;302
1715002;Nova Rosalândia;1721000;Palmas;1;1;2;64
1715101;Novo Acordo;1721000;Palmas;1;1;2;86
1715754;Palmeirópolis;1721000;Palmas;1;1;2;298
1716208;Paranã;1721000;Palmas;1;1;2;259
1717008;Pindorama do Tocantins;1721000;Palmas;1;1;2;122
1717909;Ponte Alta do Tocantins;1721000;Palmas;1;1;2;100
1718402;Presidente Kennedy;1721000;Palmas;1;1;2;202
1720150;São Félix do Tocantins;1721000;Palmas;1;1;2;189
1720499;São Valério da Natividade;1721000;Palmas;1;1;2;179
1720655;Silvanópolis;1721000;Palmas;1;1;2;90
1720804;Sítio Novo do Tocantins;1721000;Palmas;1;1;2;532
1720903;Taguatinga;1721000;Palmas;1;1;2;311
1709500;Gurupi;1720978;Talismã;1;1;2;120
1700400;Almas;1720903;Taguatinga;1;1;2;121
1702406;Arraias;1720903;Taguatinga;1;1;2;83
1702703;Aurora do Tocantins;1720903;Taguatinga;1;1;2;34
1705557;Combinado;1720903;Taguatinga;1;1;2;44
1717008;Pindorama do Tocantins;1720903;Taguatinga;1;1;2;188
1718204;Porto Nacional;1720903;Taguatinga;1;1;2;281
1702901;Axixá do Tocantins;1720804;Sítio Novo do Tocantins;1;1;2;15
1707009;Dianópolis;1720655;Silvanópolis;1;1;2;152
1709807;Ipueiras;1720655;Silvanópolis;1;1;2;32
1718204;Porto Nacional;1720655;Silvanópolis;1;1;2;53
1709500;Gurupi;1720499;São Valério da Natividade;1;1;2;95
1715754;Palmeirópolis;1720259;São Salvador do Tocantins;1;1;2;37
1716208;Paranã;1720259;São Salvador do Tocantins;1;1;2;51
1703826;Cachoeirinha;1720101;São Bento do Tocantins;1;1;2;28
1700400;Almas;1718907;Santa Rosa do Tocantins;1;1;2;104
1714203;Natividade;1718907;Santa Rosa do Tocantins;1;1;2;48
1709500;Gurupi;1718899;Santa Rita do Tocantins;1;1;2;95
1709302;Guaraí;1718881;Santa Maria do Tocantins;1;1;2;80
1710508;Itacajá;1718881;Santa Maria do Tocantins;1;1;2;39
1716505;Pedro Afonso;1718881;Santa Maria do Tocantins;1;1;2;47
1701309;Aragominas;1718865;Santa Fé do Araguaia;1;1;2;20
1702000;Araguaçu;1718840;Sandolândia;1;1;2;45
1708205;Formoso do Araguaia;1718840;Sandolândia;1;1;2;92
1718303;Praia Norte;1718808;Sampaio;1;1;2;9
1711902;Lagoa da Confusão;1718550;Riachinho;1;1;2;509
1712454;Luzinópolis;1718550;Riachinho;1;1;2;42
1710508;Itacajá;1718501;Recursolândia;1;1;2;65
1705508;Colinas do Tocantins;1718402;Presidente Kennedy;1;1;2;53
1710508;Itacajá;1718402;Presidente Kennedy;1;1;2;83
1702554;Augustinópolis;1718303;Praia Norte;1;1;2;10
1302603;Manaus;1718204;Porto Nacional;1;1;2;1518
1500800;Ananindeua;1718204;Porto Nacional;1;1;2;1033
1501402;Belém;1718204;Porto Nacional;1;1;2;1031
1506708;Santana do Araguaia;1718204;Porto Nacional;1;1;2;268
1703701;Brejinho de Nazaré;1718204;Porto Nacional;1;1;2;41
1705508;Colinas do Tocantins;1718204;Porto Nacional;1;1;2;293
1706100;Cristalândia;1718204;Porto Nacional;1;1;2;92
1707553;Fátima;1718204;Porto Nacional;1;1;2;60
1711902;Lagoa da Confusão;1718204;Porto Nacional;1;1;2;139
1713601;Monte do Carmo;1718204;Porto Nacional;1;1;2;28
1717008;Pindorama do Tocantins;1718204;Porto Nacional;1;1;2;98
1707009;Dianópolis;1718006;Porto Alegre do Tocantins;1;1;2;22
1715101;Novo Acordo;1717909;Ponte Alta do Tocantins;1;1;2;90
1502939;Dom Eliseu;1717503;Pium;1;1;2;699
1505502;Paragominas;1717503;Pium;1;1;2;845
1703206;Bernardo Sayão;1717503;Pium;1;1;2;286
1706100;Cristalândia;1717503;Pium;1;1;2;18
1709500;Gurupi;1717503;Pium;1;1;2;141
1712702;Mateiros;1717503;Pium;1;1;2;303
1703701;Brejinho de Nazaré;1717008;Pindorama do Tocantins;1;1;2;108
1714203;Natividade;1717008;Pindorama do Tocantins;1;1;2;71
1701903;Araguacema;1716703;Colméia;1;1;2;85
1705508;Colinas do Tocantins;1716703;Colméia;1;1;2;81
1708254;Fortaleza do Tabocão;1716703;Colméia;1;1;2;45
1716109;Paraíso do Tocantins;1716703;Colméia;1;1;2;159
1707108;Divinópolis do Tocantins;1716653;Pequizeiro;1;1;2;134
1711100;Itaporã do Tocantins;1716653;Pequizeiro;1;1;2;29
1707652;Figueirópolis;1716604;Peixe;1;1;2;73
1713304;Miranorte;1716604;Peixe;1;1;2;278
1501402;Belém;1716505;Pedro Afonso;1;1;2;845
1703305;Bom Jesus do Tocantins;1716505;Pedro Afonso;1;1;2;5
1705508;Colinas do Tocantins;1716505;Pedro Afonso;1;1;2;110
1707009;Dianópolis;1716505;Pedro Afonso;1;1;2;324
1710508;Itacajá;1716505;Pedro Afonso;1;1;2;77
1713205;Miracema do Tocantins;1716505;Pedro Afonso;1;1;2;66
1713304;Miranorte;1716505;Pedro Afonso;1;1;2;73
1702109;Araguaína;1716307;Pau d'Arco;1;1;2;130
1703008;Babaçulândia;1716307;Pau d'Arco;1;1;2;176
1501402;Belém;1716208;Paranã;1;1;2;1246
1709500;Gurupi;1716208;Paranã;1;1;2;171
1302603;Manaus;1716109;Paraíso do Tocantins;1;1;2;1438
1501402;Belém;1716109;Paraíso do Tocantins;1;1;2;973
1508407;Xinguara;1716109;Paraíso do Tocantins;1;1;2;357
1701903;Araguacema;1716109;Paraíso do Tocantins;1;1;2;163
1703909;Caseara;1716109;Paraíso do Tocantins;1;1;2;151
1705508;Colinas do Tocantins;1716109;Paraíso do Tocantins;1;1;2;238
1707009;Dianópolis;1716109;Paraíso do Tocantins;1;1;2;277
1707553;Fátima;1716109;Paraíso do Tocantins;1;1;2;66
1709500;Gurupi;1715754;Palmeirópolis;1;1;2;165
1707702;Filadélfia;1715705;Palmeirante;1;1;2;75
1707553;Fátima;1715507;Oliveira de Fátima;1;1;2;6
1707009;Dianópolis;1715259;Novo Jardim;1;1;2;33
1701101;Aparecida do Rio Negro;1715101;Novo Acordo;1;1;2;31
1703057;Bandeirantes do Tocantins;1714880;Nova Olinda;1;1;2;22
1710904;Itapiratins;1714880;Nova Olinda;1;1;2;90
1712504;Marianópolis do Tocantins;1714880;Nova Olinda;1;1;2;275
1712454;Luzinópolis;1714302;Nazaré;1;1;2;30
1501402;Belém;1714203;Natividade;1;1;2;1148
1705102;Chapada da Natividade;1714203;Natividade;1;1;2;14
1703701;Brejinho de Nazaré;1713601;Monte do Carmo;1;1;2;57
1501402;Belém;1713304;Miranorte;1;1;2;900
1503044;Floresta do Araguaia;1713304;Miranorte;1;1;2;249
1702109;Araguaína;1713304;Miranorte;1;1;2;260
1501402;Belém;1713205;Miracema do Tocantins;1;1;2;904
1703107;Barrolândia;1713205;Miracema do Tocantins;1;1;2;46
1705508;Colinas do Tocantins;1713205;Miracema do Tocantins;1;1;2;165
1709500;Gurupi;1713205;Miracema do Tocantins;1;1;2;249
1701002;Ananás;1712801;Maurilândia do Tocantins;1;1;2;77
1703909;Caseara;1712504;Marianópolis do Tocantins;1;1;2;66
1707108;Divinópolis do Tocantins;1712504;Marianópolis do Tocantins;1;1;2;48
1709500;Gurupi;1712504;Marianópolis do Tocantins;1;1;2;221
1701002;Ananás;1712454;Luzinópolis;1;1;2;31
1702208;Araguatins;1712454;Luzinópolis;1;1;2;65
1702000;Araguaçu;1712009;Lajeado;1;1;2;388
1700350;Aliança do Tocantins;1711902;Lagoa da Confusão;1;1;2;94
1707207;Dois Irmãos do Tocantins;1711902;Lagoa da Confusão;1;1;2;181
1708304;Goianorte;1711902;Lagoa da Confusão;1;1;2;236
1709302;Guaraí;1711803;Juarina;1;1;2;103
1709302;Guaraí;1711100;Itaporã do Tocantins;1;1;2;39
1703602;Brasilândia do Tocantins;1710904;Itapiratins;1;1;2;41
1710508;Itacajá;1710904;Itapiratins;1;1;2;39
1703073;Barra do Ouro;1710508;Itacajá;1;1;2;81
1705508;Colinas do Tocantins;1710508;Itacajá;1;1;2;89
1709302;Guaraí;1710508;Itacajá;1;1;2;96
1302603;Manaus;1709500;Gurupi;1;1;2;1517
1501303;Barcarena;1709500;Gurupi;1;1;2;1129
1501402;Belém;1709500;Gurupi;1;1;2;1144
1501576;Bom Jesus do Tocantins;1709500;Gurupi;1;1;2;738
1504208;Marabá;1709500;Gurupi;1;1;2;701
1505536;Parauapebas;1709500;Gurupi;1;1;2;637
1506138;Redenção;1709500;Gurupi;1;1;2;422
1506708;Santana do Araguaia;1709500;Gurupi;1;1;2;300
1507151;São Domingos do Araguaia;1709500;Gurupi;1;1;2;684
1600303;Macapá;1709500;Gurupi;1;1;2;1322
1700251;Abreulândia;1709500;Gurupi;1;1;2;231
1700400;Almas;1709500;Gurupi;1;1;2;205
1700707;Alvorada;1709500;Gurupi;1;1;2;85
1701903;Araguacema;1709500;Gurupi;1;1;2;322
1702406;Arraias;1709500;Gurupi;1;1;2;268
1703909;Caseara;1709500;Gurupi;1;1;2;286
1705508;Colinas do Tocantins;1709500;Gurupi;1;1;2;409
1705607;Conceição do Tocantins;1709500;Gurupi;1;1;2;201
1706100;Cristalândia;1709500;Gurupi;1;1;2;123
1707108;Divinópolis do Tocantins;1709500;Gurupi;1;1;2;212
1707207;Dois Irmãos do Tocantins;1709500;Gurupi;1;1;2;271
1707306;Dueré;1709500;Gurupi;1;1;2;46
1707553;Fátima;1709500;Gurupi;1;1;2;106
1709302;Guaraí;1709500;Gurupi;1;1;2;319
1501402;Belém;1709302;Guaraí;1;1;2;830
1702208;Araguatins;1709302;Guaraí;1;1;2;360
1706001;Couto de Magalhães;1709302;Guaraí;1;1;2;101
1708304;Goianorte;1709302;Guaraí;1;1;2;47
1702109;Araguaína;1709005;Goiatins;1;1;2;110
1703842;Campos Lindos;1709005;Goiatins;1;1;2;68
1302603;Manaus;1708254;Fortaleza do Tabocão;1;1;2;1419
1506583;Santa Maria das Barreiras;1708205;Formoso do Araguaia;1;1;2;326
1707652;Figueirópolis;1708205;Formoso do Araguaia;1;1;2;53
1700350;Aliança do Tocantins;1707652;Figueirópolis;1;1;2;96
1703867;Cariri do Tocantins;1707652;Figueirópolis;1;1;2;27
1700251;Abreulândia;1707207;Dois Irmãos do Tocantins;1;1;2;41
1701903;Araguacema;1707207;Dois Irmãos do Tocantins;1;1;2;70
1707108;Divinópolis do Tocantins;1707207;Dois Irmãos do Tocantins;1;1;2;62
1506708;Santana do Araguaia;1707108;Divinópolis do Tocantins;1;1;2;138
1701903;Araguacema;1707108;Divinópolis do Tocantins;1;1;2;113
1702109;Araguaína;1707108;Divinópolis do Tocantins;1;1;2;309
1703909;Caseara;1707108;Divinópolis do Tocantins;1;1;2;100
1706100;Cristalândia;1707108;Divinópolis do Tocantins;1;1;2;89
1501402;Belém;1707009;Dianópolis;1;1;2;1147
1702208;Araguatins;1707009;Dianópolis;1;1;2;676
1702703;Aurora do Tocantins;1707009;Dianópolis;1;1;2;129
1705557;Combinado;1707009;Dianópolis;1;1;2;133
1700350;Aliança do Tocantins;1706258;Crixás do Tocantins;1;1;2;23
1501402;Belém;1705508;Colinas do Tocantins;1;1;2;739
1701002;Ananás;1705508;Colinas do Tocantins;1;1;2;192
1702208;Araguatins;1705508;Colinas do Tocantins;1;1;2;269
1703008;Babaçulândia;1705508;Colinas do Tocantins;1;1;2;123
1506708;Santana do Araguaia;1703909;Caseara;1;1;2;46
1700251;Abreulândia;1703909;Caseara;1;1;2;96
1703008;Babaçulândia;1703842;Campos Lindos;1;1;2;139
1703073;Barra do Ouro;1703842;Campos Lindos;1;1;2;98
1702208;Araguatins;1703800;Buriti do Tocantins;1;1;2;39
1702901;Axixá do Tocantins;1703800;Buriti do Tocantins;1;1;2;61
1501402;Belém;1703206;Bernardo Sayão;1;1;2;720
1702109;Araguaína;1703073;Barra do Ouro;1;1;2;84
1702307;Arapoema;1703057;Bandeirantes do Tocantins;1;1;2;54
1506500;Santa Isabel do Pará;1703008;Babaçulândia;1;1;2;654
1702109;Araguaína;1703008;Babaçulândia;1;1;2;47
1702208;Araguatins;1702901;Axixá do Tocantins;1;1;2;38
1702554;Augustinópolis;1702901;Axixá do Tocantins;1;1;2;24
1701002;Ananás;1702554;Augustinópolis;1;1;2;104
1501402;Belém;1702208;Araguatins;1;1;2;474
1504208;Marabá;1702208;Araguatins;1;1;2;114
1500800;Ananindeua;1702109;Araguaína;1;1;2;645
1501576;Bom Jesus do Tocantins;1702109;Araguaína;1;1;2;241
1502939;Dom Eliseu;1702109;Araguaína;1;1;2;325
1502954;Eldorado dos Carajás;1702109;Araguaína;1;1;2;175
1505064;Novo Repartimento;1702109;Araguaína;1;1;2;379
1505536;Parauapebas;1702109;Araguaína;1;1;2;224
1506161;Rio Maria;1702109;Araguaína;1;1;2;203
1506500;Santa Isabel do Pará;1702109;Araguaína;1;1;2;652
1508126;Ulianópolis;1702109;Araguaína;1;1;2;390
1600303;Macapá;1702109;Araguaína;1;1;2;864
1700301;Aguiarnópolis;1702109;Araguaína;1;1;2;107
1501402;Belém;1702000;Araguaçu;1;1;2;1287
1700707;Alvorada;1702000;Araguaçu;1;1;2;90
1700350;Aliança do Tocantins;1701002;Ananás;1;1;2;554
1500503;Almeirim;1600808;Vitória do Jari;1;1;2;77
1600279;Laranjal do Jari;1600808;Vitória do Jari;1;1;2;60
1600303;Macapá;1600808;Vitória do Jari;1;1;2;181
1600303;Macapá;1600709;Tartarugalzinho;1;1;2;159
1600501;Oiapoque;1600709;Tartarugalzinho;1;1;2;271
1500602;Altamira;1600600;Santana;1;1;2;369
1502400;Castanhal;1600600;Santana;1;1;2;390
1506351;Santa Bárbara do Pará;1600600;Santana;1;1;2;348
1506807;Santarém;1600600;Santana;1;1;2;481
1600501;Oiapoque;1600600;Santana;1;1;2;426
1501402;Belém;1600535;Porto Grande;1;1;2;403
1600204;Calçoene;1600535;Porto Grande;1;1;2;207
1600238;Ferreira Gomes;1600535;Porto Grande;1;1;2;29
1600204;Calçoene;1600501;Oiapoque;1;1;2;169
1600279;Laranjal do Jari;1600501;Oiapoque;1;1;2;542
1100122;Ji-Paraná;1600303;Macapá;1;1;2;1717
1100205;Porto Velho;1600303;Macapá;1;1;2;1731
1200203;Cruzeiro do Sul;1600303;Macapá;1;1;2;2554
1200401;Rio Branco;1600303;Macapá;1;1;2;2177
1500503;Almeirim;1600303;Macapá;1;1;2;240
1500602;Altamira;1600303;Macapá;1;1;2;381
1501303;Barcarena;1600303;Macapá;1;1;2;326
1503606;Itaituba;1600303;Macapá;1;1;2;725
1504208;Marabá;1600303;Macapá;1;1;2;642
1505536;Parauapebas;1600303;Macapá;1;1;2;687
1506500;Santa Isabel do Pará;1600303;Macapá;1;1;2;360
1600105;Amapá;1600303;Macapá;1;1;2;221
1500305;Afuá;1600253;Itaubal;1;1;2;109
1501402;Belém;1600253;Itaubal;1;1;2;350
1501402;Belém;1600238;Ferreira Gomes;1;1;2;392
1505536;Parauapebas;1600154;Pedra Branca do Amaparí;1;1;2;785
1501253;Bannach;1508407;Xinguara;1;1;2;59
1501501;Benevides;1508407;Xinguara;1;1;2;660
1502103;Cametá;1508407;Xinguara;1;1;2;542
1502152;Canaã dos Carajás;1508407;Xinguara;1;1;2;66
1502400;Castanhal;1508407;Xinguara;1;1;2;679
1502954;Eldorado dos Carajás;1508407;Xinguara;1;1;2;126
1503044;Floresta do Araguaia;1508407;Xinguara;1;1;2;56
1503804;Jacundá;1508407;Xinguara;1;1;2;308
1505437;Ourilândia do Norte;1508407;Xinguara;1;1;2;133
1505486;Pacajá;1508407;Xinguara;1;1;2;363
1507458;São Geraldo do Araguaia;1508407;Xinguara;1;1;2;167
1507755;Sapucaia;1508407;Xinguara;1;1;2;32
1100130;Machadinho d'Oeste;1508357;Vitória do Xingu;1;1;2;1334
1302603;Manaus;1508357;Vitória do Xingu;1;1;2;892
1501600;Bonito;1508308;Viseu;1;1;2;128
1501956;Cachoeira do Piriá;1508308;Viseu;1;1;2;67
1502202;Capanema;1508308;Viseu;1;1;2;113
1503077;Garrafão do Norte;1508308;Viseu;1;1;2;129
1501501;Benevides;1508209;Vigia;1;1;2;55
1501709;Bragança;1508209;Vigia;1;1;2;154
1502202;Capanema;1508209;Vigia;1;1;2;116
1502608;Colares;1508209;Vigia;1;1;2;15
1503606;Itaituba;1508209;Vigia;1;1;2;950
1507003;Santo Antônio do Tauá;1508209;Vigia;1;1;2;30
1508001;Tomé-Açu;1508209;Vigia;1;1;2;166
1500859;Anapu;1508159;Uruará;1;1;2;284
1501725;Brasil Novo;1508159;Uruará;1;1;2;141
1506807;Santarém;1508159;Uruará;1;1;2;174
1501402;Belém;1508126;Ulianópolis;1;1;2;282
1502202;Capanema;1508126;Ulianópolis;1;1;2;274
1100205;Porto Velho;1508100;Tucuruí;1;1;2;1672
1500131;Abel Figueiredo;1508100;Tucuruí;1;1;2;200
1501303;Barcarena;1508100;Tucuruí;1;1;2;277
1501576;Bom Jesus do Tocantins;1508100;Tucuruí;1;1;2;190
1502400;Castanhal;1508100;Tucuruí;1;1;2;339
1503705;Itupiranga;1508100;Tucuruí;1;1;2;157
1504976;Nova Ipixuna;1508100;Tucuruí;1;1;2;148
1505486;Pacajá;1508100;Tucuruí;1;1;2;100
1506138;Redenção;1508100;Tucuruí;1;1;2;472
1507953;Tailândia;1508100;Tucuruí;1;1;2;128
1500347;Água Azul do Norte;1508084;Tucumã;1;1;2;77
1502707;Conceição do Araguaia;1508084;Tucumã;1;1;2;265
1504208;Marabá;1508084;Tucumã;1;1;2;274
1505536;Parauapebas;1508084;Tucumã;1;1;2;167
1506161;Rio Maria;1508084;Tucumã;1;1;2;139
1501402;Belém;1508050;Trairão;1;1;2;932
1501402;Belém;1508035;Tracuateua;1;1;2;174
1501501;Benevides;1508035;Tracuateua;1;1;2;153
1500800;Ananindeua;1508001;Tomé-Açu;1;1;2;114
1501105;Bagre;1508001;Tomé-Açu;1;1;2;232
1501303;Barcarena;1508001;Tomé-Açu;1;1;2;109
1501907;Bujaru;1508001;Tomé-Açu;1;1;2;95
1502400;Castanhal;1508001;Tomé-Açu;1;1;2;123
1504703;Moju;1508001;Tomé-Açu;1;1;2;81
1506500;Santa Isabel do Pará;1508001;Tomé-Açu;1;1;2;120
1507201;São Domingos do Capim;1508001;Tomé-Açu;1;1;2;89
1507953;Tailândia;1508001;Tomé-Açu;1;1;2;103
1505106;Óbidos;1507979;Terra Santa;1;1;2;114
1506807;Santarém;1507979;Terra Santa;1;1;2;200
1501402;Belém;1507961;Terra Alta;1;1;2;69
1502905;Curuçá;1507961;Terra Alta;1;1;2;34
1500206;Acará;1507953;Tailândia;1;1;2;134
1500800;Ananindeua;1507953;Tailândia;1;1;2;184
1500859;Anapu;1507953;Tailândia;1;1;2;262
1501204;Baião;1507953;Tailândia;1;1;2;85
1501303;Barcarena;1507953;Tailândia;1;1;2;162
1501782;Breu Branco;1507953;Tailândia;1;1;2;133
1503804;Jacundá;1507953;Tailândia;1;1;2;165
1504059;Mãe do Rio;1507953;Tailândia;1;1;2;181
1504208;Marabá;1507953;Tailândia;1;1;2;269
1505486;Pacajá;1507953;Tailândia;1;1;2;218
1505502;Paragominas;1507953;Tailândia;1;1;2;174
1500800;Ananindeua;1507904;Soure;1;1;2;73
1501303;Barcarena;1507904;Soure;1;1;2;88
1501808;Breves;1507904;Soure;1;1;2;241
1502004;Cachoeira do Arari;1507904;Soure;1;1;2;54
1505502;Paragominas;1507904;Soure;1;1;2;286
1505700;Ponta de Pedras;1507904;Soure;1;1;2;84
1501253;Bannach;1507755;Sapucaia;1;1;2;91
1501402;Belém;1507755;Sapucaia;1;1;2;631
1501105;Bagre;1507706;São Sebastião da Boa Vista;1;1;2;80
1501402;Belém;1507706;São Sebastião da Boa Vista;1;1;2;127
1501808;Breves;1507706;São Sebastião da Boa Vista;1;1;2;104
1502004;Cachoeira do Arari;1507706;São Sebastião da Boa Vista;1;1;2;100
1302603;Manaus;1507607;São Miguel do Guamá;1;1;2;1407
1500800;Ananindeua;1507607;São Miguel do Guamá;1;1;2;103
1501105;Bagre;1507607;São Miguel do Guamá;1;1;2;307
1501600;Bonito;1507607;São Miguel do Guamá;1;1;2;32
1502103;Cametá;1507607;São Miguel do Guamá;1;1;2;240
1502301;Capitão Poço;1507607;São Miguel do Guamá;1;1;2;48
1503457;Ipixuna do Pará;1507607;São Miguel do Guamá;1;1;2;105
1503507;Irituia;1507607;São Miguel do Guamá;1;1;2;19
1505007;Nova Timboteua;1507607;São Miguel do Guamá;1;1;2;45
1506609;Santa Maria do Pará;1507607;São Miguel do Guamá;1;1;2;29
1501402;Belém;1507508;São João do Araguaia;1;1;2;442
1504208;Marabá;1507508;São João do Araguaia;1;1;2;34
1501402;Belém;1507474;São João de Pirabas;1;1;2;155
1506203;Salinópolis;1507474;São João de Pirabas;1;1;2;19
1502152;Canaã dos Carajás;1507458;São Geraldo do Araguaia;1;1;2;142
1502954;Eldorado dos Carajás;1507458;São Geraldo do Araguaia;1;1;2;88
1503705;Itupiranga;1507458;São Geraldo do Araguaia;1;1;2;162
1505064;Novo Repartimento;1507458;São Geraldo do Araguaia;1;1;2;278
1505635;Piçarra;1507458;São Geraldo do Araguaia;1;1;2;31
1507151;São Domingos do Araguaia;1507458;São Geraldo do Araguaia;1;1;2;93
1501303;Barcarena;1507409;São Francisco do Pará;1;1;2;100
1100023;Ariquemes;1507300;São Félix do Xingu;1;1;2;1281
1502152;Canaã dos Carajás;1507300;São Félix do Xingu;1;1;2;226
1502707;Conceição do Araguaia;1507300;São Félix do Xingu;1;1;2;338
1505635;Piçarra;1507300;São Félix do Xingu;1;1;2;337
1506161;Rio Maria;1507300;São Félix do Xingu;1;1;2;219
1501402;Belém;1507201;São Domingos do Capim;1;1;2;80
1503200;Igarapé-Açu;1507201;São Domingos do Capim;1;1;2;62
1503507;Irituia;1507201;São Domingos do Capim;1;1;2;39
1504059;Mãe do Rio;1507201;São Domingos do Capim;1;1;2;46
1501576;Bom Jesus do Tocantins;1507151;São Domingos do Araguaia;1;1;2;55
1501758;Brejo Grande do Araguaia;1507151;São Domingos do Araguaia;1;1;2;40
1507003;Santo Antônio do Tauá;1507102;São Caetano de Odivelas;1;1;2;46
1500800;Ananindeua;1507003;Santo Antônio do Tauá;1;1;2;36
1501402;Belém;1507003;Santo Antônio do Tauá;1;1;2;42
1501501;Benevides;1507003;Santo Antônio do Tauá;1;1;2;26
1100205;Porto Velho;1506807;Santarém;1;1;2;1236
1303403;Parintins;1506807;Santarém;1;1;2;224
1500503;Almeirim;1506807;Santarém;1;1;2;263
1501709;Bragança;1506807;Santarém;1;1;2;898
1501725;Brasil Novo;1506807;Santarém;1;1;2;261
1503200;Igarapé-Açu;1506807;Santarém;1;1;2;806
1505908;Porto de Moz;1506807;Santarém;1;1;2;293
1504208;Marabá;1506708;Santana do Araguaia;1;1;2;459
1505536;Parauapebas;1506708;Santana do Araguaia;1;1;2;372
1502301;Capitão Poço;1506609;Santa Maria do Pará;1;1;2;69
1505502;Paragominas;1506609;Santa Maria do Pará;1;1;2;185
1504208;Marabá;1506583;Santa Maria das Barreiras;1;1;2;392
1505551;Pau d'Arco;1506583;Santa Maria das Barreiras;1;1;2;118
1501956;Cachoeira do Piriá;1506559;Santa Luzia do Pará;1;1;2;49
1504950;Nova Esperança do Piriá;1506559;Santa Luzia do Pará;1;1;2;83
1505502;Paragominas;1506559;Santa Luzia do Pará;1;1;2;172
1500107;Abaetetuba;1506500;Santa Isabel do Pará;1;1;2;90
1500206;Acará;1506500;Santa Isabel do Pará;1;1;2;70
1502756;Concórdia do Pará;1506500;Santa Isabel do Pará;1;1;2;80
1504208;Marabá;1506500;Santa Isabel do Pará;1;1;2;462
1500701;Anajás;1506351;Santa Bárbara do Pará;1;1;2;184
1500800;Ananindeua;1506351;Santa Bárbara do Pará;1;1;2;18
1501501;Benevides;1506351;Santa Bárbara do Pará;1;1;2;16
1506005;Prainha;1506351;Santa Bárbara do Pará;1;1;2;581
1502400;Castanhal;1506302;Salvaterra;1;1;2;90
1501808;Breves;1506203;Salinópolis;1;1;2;369
1504059;Mãe do Rio;1506203;Salinópolis;1;1;2;152
1500602;Altamira;1506195;Rurópolis;1;1;2;314
1503606;Itaituba;1506195;Rurópolis;1;1;2;122
1505304;Oriximiná;1506195;Rurópolis;1;1;2;280
1302603;Manaus;1506187;Rondon do Pará;1;1;2;1339
1500131;Abel Figueiredo;1506187;Rondon do Pará;1;1;2;40
1500800;Ananindeua;1506187;Rondon do Pará;1;1;2;381
1502202;Capanema;1506187;Rondon do Pará;1;1;2;401
1503804;Jacundá;1506187;Rondon do Pará;1;1;2;126
1505064;Novo Repartimento;1506187;Rondon do Pará;1;1;2;220
1505502;Paragominas;1506187;Rondon do Pará;1;1;2;212
1504208;Marabá;1506161;Rio Maria;1;1;2;239
1505536;Parauapebas;1506161;Rio Maria;1;1;2;146
1500909;Augusto Corrêa;1506138;Redenção;1;1;2;856
1503804;Jacundá;1506138;Redenção;1;1;2;408
1505502;Paragominas;1506138;Redenção;1;1;2;624
1505551;Pau d'Arco;1506138;Redenção;1;1;2;20
1501402;Belém;1506104;Primavera;1;1;2;154
1502202;Capanema;1506104;Primavera;1;1;2;38
1504422;Marituba;1506104;Primavera;1;1;2;144
1500503;Almeirim;1505908;Porto de Moz;1;1;2;49
1500602;Altamira;1505908;Porto de Moz;1;1;2;158
1500859;Anapu;1505908;Porto de Moz;1;1;2;223
1501303;Barcarena;1505809;Portel;1;1;2;245
1504208;Marabá;1505809;Portel;1;1;2;421
1505502;Paragominas;1505809;Portel;1;1;2;401
1501303;Barcarena;1505700;Ponta de Pedras;1;1;2;30
1500602;Altamira;1505650;Placas;1;1;2;234
1501402;Belém;1505650;Placas;1;1;2;699
1503606;Itaituba;1505650;Placas;1;1;2;201
1501402;Belém;1505635;Piçarra;1;1;2;562
1501600;Bonito;1505601;Peixe-Boi;1;1;2;19
1502202;Capanema;1505601;Peixe-Boi;1;1;2;18
1501402;Belém;1505551;Pau d'Arco;1;1;2;736
1501303;Barcarena;1505536;Parauapebas;1;1;2;515
1501501;Benevides;1505536;Parauapebas;1;1;2;543
1501709;Bragança;1505536;Parauapebas;1;1;2;643
1502202;Capanema;1505536;Parauapebas;1;1;2;600
1502400;Castanhal;1505536;Parauapebas;1;1;2;563
1503804;Jacundá;1505536;Parauapebas;1;1;2;192
1504976;Nova Ipixuna;1505536;Parauapebas;1;1;2;147
1500107;Abaetetuba;1505502;Paragominas;1;1;2;218
1500131;Abel Figueiredo;1505502;Paragominas;1;1;2;244
1501782;Breu Branco;1505502;Paragominas;1;1;2;260
1503093;Goianésia do Pará;1505502;Paragominas;1;1;2;214
1503457;Ipixuna do Pará;1505502;Paragominas;1;1;2;54
1503804;Jacundá;1505502;Paragominas;1;1;2;252
1504109;Magalhães Barata;1505502;Paragominas;1;1;2;248
1504422;Marituba;1505502;Paragominas;1;1;2;215
1504703;Moju;1505502;Paragominas;1;1;2;197
1500859;Anapu;1505486;Pacajá;1;1;2;78
1501725;Brasil Novo;1505486;Pacajá;1;1;2;222
1501782;Breu Branco;1505486;Pacajá;1;1;2;130
1503093;Goianésia do Pará;1505486;Pacajá;1;1;2;171
1503705;Itupiranga;1505486;Pacajá;1;1;2;194
1505064;Novo Repartimento;1505486;Pacajá;1;1;2;83
1501303;Barcarena;1505437;Ourilândia do Norte;1;1;2;641
1502707;Conceição do Araguaia;1505437;Ourilândia do Norte;1;1;2;258
1503093;Goianésia do Pará;1505437;Ourilândia do Norte;1;1;2;391
1503804;Jacundá;1505437;Ourilândia do Norte;1;1;2;337
1504422;Marituba;1505437;Ourilândia do Norte;1;1;2;670
1501782;Breu Branco;1505403;Ourém;1;1;2;377
1501303;Barcarena;1505304;Oriximiná;1;1;2;800
1502152;Canaã dos Carajás;1505304;Oriximiná;1;1;2;846
1504802;Monte Alegre;1505304;Oriximiná;1;1;2;194
1501808;Breves;1505205;Oeiras do Pará;1;1;2;76
1502806;Curralinho;1505205;Oeiras do Pará;1;1;2;27
1302603;Manaus;1505106;Óbidos;1;1;2;523
1500404;Alenquer;1505106;Óbidos;1;1;2;87
1500800;Ananindeua;1505106;Óbidos;1;1;2;794
1504802;Monte Alegre;1505106;Óbidos;1;1;2;158
1501204;Baião;1505064;Novo Repartimento;1;1;2;166
1503804;Jacundá;1505064;Novo Repartimento;1;1;2;95
1504604;Mocajuba;1505064;Novo Repartimento;1;1;2;194
1400100;Boa Vista;1505031;Novo Progresso;1;1;2;1250
1503705;Itupiranga;1504976;Nova Ipixuna;1;1;2;42
1503804;Jacundá;1504976;Nova Ipixuna;1;1;2;56
1504208;Marabá;1504976;Nova Ipixuna;1;1;2;49
1501402;Belém;1504950;Nova Esperança do Piriá;1;1;2;191
1502202;Capanema;1504950;Nova Esperança do Piriá;1;1;2;112
1502301;Capitão Poço;1504950;Nova Esperança do Piriá;1;1;2;59
1503457;Ipixuna do Pará;1504950;Nova Esperança do Piriá;1;1;2;67
1502756;Concórdia do Pará;1504901;Muaná;1;1;2;155
1302603;Manaus;1504802;Monte Alegre;1;1;2;674
1500602;Altamira;1504802;Monte Alegre;1;1;2;245
1503606;Itaituba;1504802;Monte Alegre;1;1;2;330
1503903;Juruti;1504802;Monte Alegre;1;1;2;221
1500131;Abel Figueiredo;1504703;Moju;1;1;2;337
1502103;Cametá;1504703;Moju;1;1;2;94
1502756;Concórdia do Pará;1504703;Moju;1;1;2;91
1503093;Goianésia do Pará;1504703;Moju;1;1;2;215
1502202;Capanema;1504604;Mocajuba;1;1;2;292
1500602;Altamira;1504455;Medicilândia;1;1;2;76
1501725;Brasil Novo;1504455;Medicilândia;1;1;2;39
1100205;Porto Velho;1504422;Marituba;1;1;2;1919
1500701;Anajás;1504422;Marituba;1;1;2;181
1501303;Barcarena;1504422;Marituba;1;1;2;36
1502400;Castanhal;1504307;Maracanã;1;1;2;73
1100122;Ji-Paraná;1504208;Marabá;1;1;2;1554
1501709;Bragança;1504208;Marabá;1;1;2;541
1502202;Capanema;1504208;Marabá;1;1;2;499
1501501;Benevides;1504059;Mãe do Rio;1;1;2;107
1502400;Castanhal;1504059;Mãe do Rio;1;1;2;90
1502756;Concórdia do Pará;1504059;Mãe do Rio;1;1;2;41
1100205;Porto Velho;1503903;Juruti;1;1;2;1137
1303403;Parintins;1503903;Juruti;1;1;2;93
1500602;Altamira;1503903;Juruti;1;1;2;438
1502152;Canaã dos Carajás;1503804;Jacundá;1;1;2;244
1502301;Capitão Poço;1503804;Jacundá;1;1;2;374
1100205;Porto Velho;1503606;Itaituba;1;1;2;1011
1303403;Parintins;1503606;Itaituba;1;1;2;190
1400100;Boa Vista;1503606;Itaituba;1;1;2;941
1500800;Ananindeua;1503606;Itaituba;1;1;2;903
1500859;Anapu;1503606;Itaituba;1;1;2;539
1502400;Castanhal;1503606;Itaituba;1;1;2;953
1501402;Belém;1503507;Irituia;1;1;2;119
1502202;Capanema;1503507;Irituia;1;1;2;61
1500800;Ananindeua;1503457;Ipixuna do Pará;1;1;2;164
1500958;Aurora do Pará;1503457;Ipixuna do Pará;1;1;2;48
1500701;Anajás;1503309;Igarapé-Miri;1;1;2;150
1502202;Capanema;1503309;Igarapé-Miri;1;1;2;212
1501501;Benevides;1503200;Igarapé-Açu;1;1;2;76
1502400;Castanhal;1503200;Igarapé-Açu;1;1;2;39
1500107;Abaetetuba;1503093;Goianésia do Pará;1;1;2;234
1500602;Altamira;1503093;Goianésia do Pará;1;1;2;358
1501402;Belém;1503093;Goianésia do Pará;1;1;2;282
1502103;Cametá;1503093;Goianésia do Pará;1;1;2;188
1502939;Dom Eliseu;1503093;Goianésia do Pará;1;1;2;174
1501402;Belém;1503077;Garrafão do Norte;1;1;2;166
1502301;Capitão Poço;1503077;Garrafão do Norte;1;1;2;21
1501402;Belém;1503044;Floresta do Araguaia;1;1;2;697
1500800;Ananindeua;1502939;Dom Eliseu;1;1;2;338
1502202;Capanema;1502939;Dom Eliseu;1;1;2;339
1502301;Capitão Poço;1502939;Dom Eliseu;1;1;2;290
1501402;Belém;1502905;Curuçá;1;1;2;98
1501402;Belém;1502855;Curuá;1;1;2;746
1501105;Bagre;1502806;Curralinho;1;1;2;50
1501402;Belém;1502806;Curralinho;1;1;2;158
1501808;Breves;1502806;Curralinho;1;1;2;78
1501402;Belém;1502764;Cumaru do Norte;1;1;2;758
1502400;Castanhal;1502756;Concórdia do Pará;1;1;2;76
1502152;Canaã dos Carajás;1502707;Conceição do Araguaia;1;1;2;204
1501402;Belém;1502608;Colares;1;1;2;51
1500305;Afuá;1502509;Chaves;1;1;2;38
1301902;Itacoatiara;1502400;Castanhal;1;1;2;1187
1302504;Manacapuru;1502400;Castanhal;1;1;2;1430
1303403;Parintins;1502400;Castanhal;1;1;2;994
1500107;Abaetetuba;1502400;Castanhal;1;1;2;114
1501501;Benevides;1502400;Castanhal;1;1;2;38
1501808;Breves;1502400;Castanhal;1;1;2;289
1502301;Capitão Poço;1502400;Castanhal;1;1;2;106
1501303;Barcarena;1502301;Capitão Poço;1;1;2;176
1501709;Bragança;1502301;Capitão Poço;1;1;2;82
1500107;Abaetetuba;1502202;Capanema;1;1;2;191
1501501;Benevides;1502202;Capanema;1;1;2;119
1501782;Breu Branco;1502152;Canaã dos Carajás;1;1;2;279
1501204;Baião;1502103;Cametá;1;1;2;65
1501402;Belém;1501956;Cachoeira do Piriá;1;1;2;214
1501402;Belém;1501907;Bujaru;1;1;2;50
1501501;Benevides;1501907;Bujaru;1;1;2;32
1500701;Anajás;1501808;Breves;1;1;2;89
1500800;Ananindeua;1501808;Breves;1;1;2;237
1501402;Belém;1501758;Brejo Grande do Araguaia;1;1;2;478
1500800;Ananindeua;1501725;Brasil Novo;1;1;2;510
1500800;Ananindeua;1501709;Bragança;1;1;2;181
1501303;Barcarena;1501709;Bragança;1;1;2;212
1501402;Belém;1501576;Bom Jesus do Tocantins;1;1;2;407
1100205;Porto Velho;1501501;Benevides;1;1;2;1929
1100049;Cacoal;1501402;Belém;1;1;2;1834
1100106;Guajará-Mirim;1501402;Belém;1;1;2;2157
1100114;Jaru;1501402;Belém;1;1;2;1875
1100189;Pimenta Bueno;1501402;Belém;1;1;2;1834
1100320;São Miguel do Guaporé;1501402;Belém;1;1;2;1968
1100452;Buritis;1501402;Belém;1;1;2;1981
1200104;Brasiléia;1501402;Belém;1;1;2;2509
1200500;Sena Madureira;1501402;Belém;1;1;2;2418
1200609;Tarauacá;1501402;Belém;1;1;2;2607
1200708;Xapuri;1501402;Belém;1;1;2;2468
1300706;Boca do Acre;1501402;Belém;1;1;2;2266
1301001;Carauari;1501402;Belém;1;1;2;2092
1301209;Coari;1501402;Belém;1;1;2;1665
1301704;Humaitá;1501402;Belém;1;1;2;1770
1301902;Itacoatiara;1501402;Belém;1;1;2;1128
1302900;Maués;1501402;Belém;1;1;2;1049
1303403;Parintins;1501402;Belém;1;1;2;935
1400209;Caracaraí;1501402;Belém;1;1;2;1459
1500131;Abel Figueiredo;1501402;Belém;1;1;2;396
1500347;Água Azul do Norte;1501402;Belém;1;1;2;640
1500859;Anapu;1501402;Belém;1;1;2;385
1500909;Augusto Corrêa;1501402;Belém;1;1;2;203
1500206;Acará;1501303;Barcarena;1;1;2;62
1500701;Anajás;1501303;Barcarena;1;1;2;155
1500800;Ananindeua;1500859;Anapu;1;1;2;391
1200401;Rio Branco;1500800;Ananindeua;1;1;2;2375
1400100;Boa Vista;1500800;Ananindeua;1;1;2;1447
1500107;Abaetetuba;1500800;Ananindeua;1;1;2;66
1500503;Almeirim;1500800;Ananindeua;1;1;2;467
1100288;Rolim de Moura;1500602;Altamira;1;1;2;1426
1500107;Abaetetuba;1500602;Altamira;1;1;2;410
1302603;Manaus;1500404;Alenquer;1;1;2;605
1500107;Abaetetuba;1500206;Acará;1;1;2;67
1400100;Boa Vista;1400704;Uiramutã;1;1;2;198
1302603;Manaus;1400605;São Luiz;1;1;2;454
1400209;Caracaraí;1400605;São Luiz;1;1;2;155
1400506;São João da Baliza;1400605;São Luiz;1;1;2;16
1302603;Manaus;1400506;São João da Baliza;1;1;2;448
1400233;Caroebe;1400506;São João da Baliza;1;1;2;25
1100205;Porto Velho;1400472;Rorainópolis;1;1;2;1142
1400209;Caracaraí;1400472;Rorainópolis;1;1;2;129
1400308;Mucajaí;1400472;Rorainópolis;1;1;2;171
1400159;Bonfim;1400209;Caracaraí;1;1;2;223
1400175;Cantá;1400209;Caracaraí;1;1;2;104
1100304;Vilhena;1400100;Boa Vista;1;1;2;1735
1200401;Rio Branco;1400100;Boa Vista;1;1;2;1630
1301209;Coari;1400100;Boa Vista;1;1;2;821
1301852;Iranduba;1400100;Boa Vista;1;1;2;678
1303809;São Gabriel da Cachoeira;1400100;Boa Vista;1;1;2;779
1304203;Tefé;1400100;Boa Vista;1;1;2;827
1400027;Amajari;1400100;Boa Vista;1;1;2;116
1302504;Manacapuru;1304302;Urucará;1;1;2;327
1302603;Manaus;1304260;Uarini;1;1;2;564
1302603;Manaus;1304237;Tonantins;1;1;2;865
1301407;Eirunepé;1304203;Tefé;1;1;2;677
1301605;Fonte Boa;1304203;Tefé;1;1;2;185
1302603;Manaus;1304104;Tapauá;1;1;2;444
1300607;Benjamin Constant;1304062;Tabatinga;1;1;2;25
1300805;Borba;1304062;Tabatinga;1;1;2;1143
1301209;Coari;1304062;Tabatinga;1;1;2;749
1303403;Parintins;1304062;Tabatinga;1;1;2;1468
1303700;Santo Antônio do Içá;1304062;Tabatinga;1;1;2;247
1302603;Manaus;1304005;Silves;1;1;2;205
1302603;Manaus;1303957;São Sebastião do Uatumã;1;1;2;249
1300805;Borba;1303908;São Paulo de Olivença;1;1;2;1048
1302603;Manaus;1303908;São Paulo de Olivença;1;1;2;994
1300409;Barcelos;1303809;São Gabriel da Cachoeira;1;1;2;469
1302702;Manicoré;1303809;São Gabriel da Cachoeira;1;1;2;909
1303205;Novo Airão;1303809;São Gabriel da Cachoeira;1;1;2;741
1303601;Santa Isabel do Rio Negro;1303809;São Gabriel da Cachoeira;1;1;2;232
1302504;Manacapuru;1303569;Rio Preto da Eva;1;1;2;123
1303536;Presidente Figueiredo;1303569;Rio Preto da Eva;1;1;2;87
1301902;Itacoatiara;1303536;Presidente Figueiredo;1;1;2;213
1302603;Manaus;1303502;Pauini;1;1;2;920
1300805;Borba;1303403;Parintins;1;1;2;370
1301209;Coari;1303403;Parintins;1;1;2;729
1302900;Maués;1303403;Parintins;1;1;2;127
1302504;Manacapuru;1303205;Novo Airão;1;1;2;73
1300805;Borba;1303106;Nova Olinda do Norte;1;1;2;77
1302702;Manicoré;1303106;Nova Olinda do Norte;1;1;2;319
1300680;Boa Vista do Ramos;1302900;Maués;1;1;2;43
1300060;Amaturá;1302801;Maraã;1;1;2;339
1302603;Manaus;1302801;Maraã;1;1;2;633
1100023;Ariquemes;1302702;Manicoré;1;1;2;492
1100288;Rolim de Moura;1302702;Manicoré;1;1;2;663
1300805;Borba;1302702;Manicoré;1;1;2;241
1100056;Cerejeiras;1302603;Manaus;1;1;2;1117
1100064;Colorado do Oeste;1302603;Manaus;1;1;2;1104
1100098;Espigão d'Oeste;1302603;Manaus;1;1;2;938
1100155;Ouro Preto do Oeste;1302603;Manaus;1;1;2;882
1100254;Presidente Médici;1302603;Manaus;1;1;2;916
1100320;São Miguel do Guaporé;1302603;Manaus;1;1;2;997
1101609;Theobroma;1302603;Manaus;1;1;2;827
1200450;Senador Guiomard;1302603;Manaus;1;1;2;1161
1200500;Sena Madureira;1302603;Manaus;1;1;2;1170
1300060;Amaturá;1302603;Manaus;1;1;2;909
1300086;Anamã;1302603;Manaus;1;1;2;161
1300102;Anori;1302603;Manaus;1;1;2;201
1300631;Beruri;1302603;Manaus;1;1;2;172
1300680;Boa Vista do Ramos;1302603;Manaus;1;1;2;274
1300904;Canutama;1302603;Manaus;1;1;2;616
1301100;Careiro;1302603;Manaus;1;1;2;80
1301159;Careiro da Várzea;1302603;Manaus;1;1;2;24
1301506;Envira;1302603;Manaus;1;1;2;1214
1301605;Fonte Boa;1302603;Manaus;1;1;2;677
1301654;Guajará;1302603;Manaus;1;1;2;1484
1301803;Ipixuna;1302603;Manaus;1;1;2;1372
1301951;Itamarati;1302603;Manaus;1;1;2;989
1302009;Itapiranga;1302603;Manaus;1;1;2;228
1302207;Juruá;1302603;Manaus;1;1;2;669
1302405;Lábrea;1302603;Manaus;1;1;2;705
1300631;Beruri;1302504;Manacapuru;1;1;2;110
1300706;Boca do Acre;1302405;Lábrea;1;1;2;326
1301209;Coari;1301902;Itacoatiara;1;1;2;536
1100023;Ariquemes;1301704;Humaitá;1;1;2;260
1100338;Nova Mamoré;1301704;Humaitá;1;1;2;404
1301407;Eirunepé;1301506;Envira;1;1;2;92
1300805;Borba;1301209;Coari;1;1;2;395
1300300;Autazes;1301100;Careiro;1;1;2;136
1300300;Autazes;1300805;Borba;1;1;2;102
1200401;Rio Branco;1300706;Boca do Acre;1;1;2;147
1100155;Ouro Preto do Oeste;1300144;Apuí;1;1;2;475
1100205;Porto Velho;1300144;Apuí;1;1;2;473
1200401;Rio Branco;1200807;Porto Acre;1;1;2;54
1200385;Plácido de Castro;1200609;Tarauacá;1;1;2;464
1200500;Sena Madureira;1200609;Tarauacá;1;1;2;254
1200252;Epitaciolândia;1200500;Sena Madureira;1;1;2;217
1200385;Plácido de Castro;1200500;Sena Madureira;1;1;2;213
1200203;Cruzeiro do Sul;1200450;Senador Guiomard;1;1;2;605
1200203;Cruzeiro do Sul;1200427;Rodrigues Alves;1;1;2;12
1100114;Jaru;1200401;Rio Branco;1;1;2;577
1200104;Brasiléia;1200385;Plácido de Castro;1;1;2;189
1200252;Epitaciolândia;1200385;Plácido de Castro;1;1;2;189
1100304;Vilhena;1200302;Feijó;1;1;2;1238
1200203;Cruzeiro do Sul;1200302;Feijó;1;1;2;264
1200179;Capixaba;1200252;Epitaciolândia;1;1;2;122
1200203;Cruzeiro do Sul;1200252;Epitaciolândia;1;1;2;573
1100205;Porto Velho;1200138;Bujari;1;1;2;463
1100023;Ariquemes;1101807;Vale do Paraíso;1;1;2;111
1100122;Ji-Paraná;1101807;Vale do Paraíso;1;1;2;61
1101435;Nova União;1101807;Vale do Paraíso;1;1;2;70
1101559;Teixeirópolis;1101807;Vale do Paraíso;1;1;2;56
1101609;Theobroma;1101807;Vale do Paraíso;1;1;2;31
1100023;Ariquemes;1101757;Vale do Anari;1;1;2;89
1100023;Ariquemes;1101708;Urupá;1;1;2;151
1100155;Ouro Preto do Oeste;1101708;Urupá;1;1;2;40
1100205;Porto Velho;1101708;Urupá;1;1;2;305
1100304;Vilhena;1101708;Urupá;1;1;2;305
1101302;Mirante da Serra;1101708;Urupá;1;1;2;33
1101435;Nova União;1101708;Urupá;1;1;2;31
1101500;Seringueiras;1101708;Urupá;1;1;2;107
1100122;Ji-Paraná;1101559;Teixeirópolis;1;1;2;38
1100155;Ouro Preto do Oeste;1101559;Teixeirópolis;1;1;2;20
1100205;Porto Velho;1101559;Teixeirópolis;1;1;2;295
1100015;Alta Floresta d'Oeste;1101500;Seringueiras;1;1;2;112
1100106;Guajará-Mirim;1101500;Seringueiras;1;1;2;273
1100189;Pimenta Bueno;1101500;Seringueiras;1;1;2;195
1100288;Rolim de Moura;1101500;Seringueiras;1;1;2;144
1101302;Mirante da Serra;1101500;Seringueiras;1;1;2;94
1100288;Rolim de Moura;1101492;São Francisco do Guaporé;1;1;2;205
1100304;Vilhena;1101492;São Francisco do Guaporé;1;1;2;380
1100296;Santa Luzia d'Oeste;1101484;São Felipe d'Oeste;1;1;2;31
1100379;Alto Alegre dos Parecis;1101484;São Felipe d'Oeste;1;1;2;45
1100924;Chupinguaia;1101484;São Felipe d'Oeste;1;1;2;97
1100056;Cerejeiras;1101468;Pimenteiras do Oeste;1;1;2;40
1100072;Corumbiara;1101468;Pimenteiras do Oeste;1;1;2;59
1100122;Ji-Paraná;1101468;Pimenteiras do Oeste;1;1;2;296
1100114;Jaru;1101435;Nova União;1;1;2;50
1100338;Nova Mamoré;1101435;Nova União;1;1;2;308
1101302;Mirante da Serra;1101435;Nova União;1;1;2;18
1100114;Jaru;1101401;Monte Negro;1;1;2;83
1100155;Ouro Preto do Oeste;1101401;Monte Negro;1;1;2;123
1100304;Vilhena;1101401;Monte Negro;1;1;2;447
1100403;Alto Paraíso;1101401;Monte Negro;1;1;2;58
1100601;Cacaulândia;1101401;Monte Negro;1;1;2;47
1100205;Porto Velho;1101302;Mirante da Serra;1;1;2;283
1100122;Ji-Paraná;1101203;Ministro Andreazza;1;1;2;45
1100189;Pimenta Bueno;1101203;Ministro Andreazza;1;1;2;75
1100924;Chupinguaia;1101203;Ministro Andreazza;1;1;2;177
1100205;Porto Velho;1101005;Governador Jorge Teixeira;1;1;2;234
1100122;Ji-Paraná;1100940;Cujubim;1;1;2;189
1100452;Buritis;1100940;Cujubim;1;1;2;166
1100072;Corumbiara;1100924;Chupinguaia;1;1;2;45
1100098;Espigão d'Oeste;1100924;Chupinguaia;1;1;2;114
1100122;Ji-Paraná;1100924;Chupinguaia;1;1;2;210
1100189;Pimenta Bueno;1100924;Chupinguaia;1;1;2;102
1100049;Cacoal;1100809;Candeias do Jamari;1;1;2;379
1100114;Jaru;1100809;Candeias do Jamari;1;1;2;219
1100148;Nova Brasilândia d'Oeste;1100809;Candeias do Jamari;1;1;2;352
1100189;Pimenta Bueno;1100809;Candeias do Jamari;1;1;2;418
1100304;Vilhena;1100809;Candeias do Jamari;1;1;2;589
1100403;Alto Paraíso;1100809;Candeias do Jamari;1;1;2;110
1100023;Ariquemes;1100601;Cacaulândia;1;1;2;51
1100114;Jaru;1100601;Cacaulândia;1;1;2;36
1100403;Alto Paraíso;1100601;Cacaulândia;1;1;2;82
1100296;Santa Luzia d'Oeste;1100502;Novo Horizonte do Oeste;1;1;2;32
1100015;Alta Floresta d'Oeste;1100452;Buritis;1;1;2;277
1100049;Cacoal;1100452;Buritis;1;1;2;293
1100072;Corumbiara;1100452;Buritis;1;1;2;444
1100098;Espigão d'Oeste;1100452;Buritis;1;1;2;341
1100106;Guajará-Mirim;1100452;Buritis;1;1;2;173
1100122;Ji-Paraná;1100452;Buritis;1;1;2;226
1100148;Nova Brasilândia d'Oeste;1100452;Buritis;1;1;2;233
1100155;Ouro Preto do Oeste;1100452;Buritis;1;1;2;177
1100338;Nova Mamoré;1100452;Buritis;1;1;2;166
1100346;Alvorada d'Oeste;1100452;Buritis;1;1;2;207
1100114;Jaru;1100403;Alto Paraíso;1;1;2;113
1100338;Nova Mamoré;1100403;Alto Paraíso;1;1;2;235
1100015;Alta Floresta d'Oeste;1100379;Alto Alegre dos Parecis;1;1;2;27
1100049;Cacoal;1100379;Alto Alegre dos Parecis;1;1;2;90
1100288;Rolim de Moura;1100379;Alto Alegre dos Parecis;1;1;2;41
1100015;Alta Floresta d'Oeste;1100346;Alvorada d'Oeste;1;1;2;74
1100106;Guajará-Mirim;1100346;Alvorada d'Oeste;1;1;2;331
1100114;Jaru;1100346;Alvorada d'Oeste;1;1;2;102
1100148;Nova Brasilândia d'Oeste;1100346;Alvorada d'Oeste;1;1;2;37
1100023;Ariquemes;1100338;Nova Mamoré;1;1;2;261
1100015;Alta Floresta d'Oeste;1100320;São Miguel do Guaporé;1;1;2;84
1100098;Espigão d'Oeste;1100320;São Miguel do Guaporé;1;1;2;188
1100114;Jaru;1100320;São Miguel do Guaporé;1;1;2;138
1100205;Porto Velho;1100320;São Miguel do Guaporé;1;1;2;345
1100304;Vilhena;1100320;São Miguel do Guaporé;1;1;2;306
1100098;Espigão d'Oeste;1100304;Vilhena;1;1;2;169
1100114;Jaru;1100304;Vilhena;1;1;2;368
1100254;Presidente Médici;1100304;Vilhena;1;1;2;259
1100015;Alta Floresta d'Oeste;1100296;Santa Luzia d'Oeste;1;1;2;24
1100122;Ji-Paraná;1100296;Santa Luzia d'Oeste;1;1;2;108
1100098;Espigão d'Oeste;1100288;Rolim de Moura;1;1;2;80
1100122;Ji-Paraná;1100262;Rio Crespo;1;1;2;174
1100064;Colorado do Oeste;1100254;Presidente Médici;1;1;2;258
1100080;Costa Marques;1100254;Presidente Médici;1;1;2;292
1100106;Guajará-Mirim;1100254;Presidente Médici;1;1;2;376
1100015;Alta Floresta d'Oeste;1100205;Porto Velho;1;1;2;405
1100064;Colorado do Oeste;1100205;Porto Velho;1;1;2;603
1100130;Machadinho d'Oeste;1100205;Porto Velho;1;1;2;215
1100148;Nova Brasilândia d'Oeste;1100205;Porto Velho;1;1;2;364
1100114;Jaru;1100189;Pimenta Bueno;1;1;2;200
1100015;Alta Floresta d'Oeste;1100148;Nova Brasilândia d'Oeste;1;1;2;44
1100114;Jaru;1100148;Nova Brasilândia d'Oeste;1;1;2;138
1100122;Ji-Paraná;1100148;Nova Brasilândia d'Oeste;1;1;2;94
1100056;Cerejeiras;1100130;Machadinho d'Oeste;1;1;2;435
1100106;Guajará-Mirim;1100130;Machadinho d'Oeste;1;1;2;390
1100064;Colorado do Oeste;1100122;Ji-Paraná;1;1;2;281
1100072;Corumbiara;1100122;Ji-Paraná;1;1;2;250
1100064;Colorado do Oeste;1100114;Jaru;1;1;2;367
1100015;Alta Floresta d'Oeste;1100106;Guajará-Mirim;1;1;2;384
1100023;Ariquemes;1100098;Espigão d'Oeste;1;1;2;281
1100015;Alta Floresta d'Oeste;1100080;Costa Marques;1;1;2;249
1100031;Cabixi;1100072;Corumbiara;1;1;2;70
1100023;Ariquemes;1100064;Colorado do Oeste;1;1;2;441
1100049;Cacoal;1100056;Cerejeiras;1;1;2;206
